gene,TSS,end,start,UTR_length,utr_counts,sample
C0343,2818676,2818728,2818676,52,4,utRho01
aaeB,6776526,6776526,6776376,150,20,utRho01
aaeR,6778762,6779040,6778762,278,136,utRho01
aaeX,6778860,6778860,6778674,186,170,utRho01
aat,1854920,1854920,1854864,56,32,utRho01
accA,416822,417242,416822,420,2390,utRho01
accB,6810280,6810872,6810280,592,13076,utRho01
accD,4868030,4868030,4867852,178,740,utRho01
aceB,8430804,8430956,8430804,152,102,utRho01
aceE,245938,246034,245938,96,764,utRho01
ackA,4826918,4826940,4826918,22,2578,utRho01
acnA,2670848,2671662,2670848,814,840,utRho01
acnB,263038,263230,263038,192,1182,utRho01
acpP,2303148,2303230,2303148,82,244,utRho01
acpS,5402324,5402324,5401996,328,144,utRho01
acrA,971396,971396,971238,158,436,utRho01
acrB,969370,969370,968806,564,2634,utRho01
acrD,5174950,5175190,5174950,240,98,utRho01
acrE,6827404,6827728,6827404,324,0,utRho01
acrR,971398,971522,971398,124,262,utRho01
acrZ,1589502,1589546,1589502,44,0,utRho01
acs,8575190,8575190,8574742,448,70,utRho01
actP,8569870,8569870,8569804,66,0,utRho01
ada,4620854,4620854,4620810,44,48,utRho01
add,3404404,3404466,3404404,62,22,utRho01
ade,7687802,7687928,7687802,126,0,utRho01
adhE,2596826,2596826,2596242,584,96,utRho01
adhP,3107988,3107988,3107676,312,1158,utRho01
adiA,8681112,8681112,8681042,70,48,utRho01
adiC,8674404,8674404,8674062,342,18,utRho01
adiY,8676084,8676084,8675858,226,4,utRho01
adk,994278,994350,994278,72,184,utRho01
adrA,807374,807406,807374,32,0,utRho01
aer,6438240,6438240,6438152,88,0,utRho01
aes,1000102,1000102,999946,156,42,utRho01
agaR,6557406,6557406,6557330,76,0,utRho01
agaS,6563778,6563952,6563778,174,32,utRho01
agp,2131118,2131170,2131118,52,0,utRho01
agrA,7296126,7296126,7296126,0,0,utRho01
agrB,7296588,7296588,7296588,0,0,utRho01
ahpC,1277386,1277890,1277386,504,1032,utRho01
ahpF,1278004,1279506,1278004,1502,67440,utRho01
ahr,8992698,8992698,8992418,280,0,utRho01
aidB,8828494,8828550,8828494,56,0,utRho01
ais,4731512,4731512,4731240,272,0,utRho01
alaA,4814816,4815122,4814816,306,0,utRho01
alaC,4996798,4996798,4996590,208,26,utRho01
alaE,5598140,5598328,5598140,188,152,utRho01
alaS,5644180,5644180,5644022,158,2446,utRho01
alaW,5036612,5036612,5036462,150,4,utRho01
aldA,2976380,2976464,2976380,84,60,utRho01
aldB,7513070,7513070,7513022,48,14,utRho01
alkA,4295118,4295118,4295080,38,10,utRho01
alkB,4618890,4618890,4618682,208,0,utRho01
allA,1064780,1064902,1064780,122,0,utRho01
allD,1092822,1092822,1092726,96,0,utRho01
allE,1088112,1088112,1088092,20,28,utRho01
allS,1064600,1064600,1064442,158,0,utRho01
alr,8531178,8531564,8531178,386,3874,utRho01
alsE,8617334,8617334,8616956,378,24,utRho01
alsK,8615990,8615990,8615598,392,128,utRho01
alx,6476740,6477160,6476740,420,40,utRho01
amiA,5104482,5104704,5104482,222,44,utRho01
amiC,5898378,5898378,5898020,358,18,utRho01
amn,4110062,4110122,4110062,60,14,utRho01
ampC,8758006,8758006,8757888,118,0,utRho01
ampD,237362,237466,237362,104,166,utRho01
ampG,907372,907372,907090,282,612,utRho01
ampH,792726,792726,792574,152,20,utRho01
amyA,4012230,4012312,4012230,82,32,utRho01
anmK,3439346,3439346,3439204,142,0,utRho01
ansB,6201580,6201580,6201456,124,110,utRho01
ansP,3052040,3052040,3051960,80,224,utRho01
apaG,104068,104068,103212,856,6758,utRho01
apaH,102586,102586,102444,142,6058,utRho01
apbE,4623188,4623188,4623068,120,106,utRho01
appA,2081198,2081234,2081198,36,0,utRho01
appC,2075420,2075480,2075420,60,0,utRho01
appY,1167134,1167362,1167134,228,0,utRho01
apt,982620,982824,982620,204,324,utRho01
aqpZ,1832424,1832424,1832094,330,0,utRho01
araB,140150,140150,140096,54,0,utRho01
araC,140482,140774,140482,292,4,utRho01
araE,5964416,5964416,5964364,52,0,utRho01
araF,3972476,3972476,3972256,220,0,utRho01
araH,3967120,3967120,3967086,34,0,utRho01
araJ,825058,825058,824962,96,46,utRho01
arcA,9281602,9281602,9280612,990,8770,utRho01
arcB,6706098,6706098,6706050,48,0,utRho01
arcZ,6701154,6701154,6701154,0,0,utRho01
arfA,6877346,6877346,6877298,48,508,utRho01
argA,5898312,5898484,5898312,172,10,utRho01
argC,8309770,8310002,8309770,232,68,utRho01
argD,6980442,6980442,6980360,82,0,utRho01
argE,8310156,8310156,8309694,462,152,utRho01
argF,580680,580680,580610,70,0,utRho01
argG,6637124,6637274,6637124,150,112,utRho01
argI,8956688,8956688,8956622,66,0,utRho01
argO,6137672,6137672,6137616,56,200,utRho01
argP,6119460,6119506,6119460,46,0,utRho01
argR,6769204,6769406,6769204,202,80,utRho01
argS,3920002,3920124,3920002,122,36,utRho01
argT,4855698,4855698,4855582,116,140,utRho01
argU,1129406,1129446,1129406,40,2,utRho01
argW,4932616,4932618,4932616,2,0,utRho01
argX,7964728,7964750,7964728,22,88,utRho01
aroF,5482402,5482402,5482300,102,56,utRho01
aroG,1571182,1571266,1571182,84,68,utRho01
aroH,3576636,3576870,3576636,234,384,utRho01
aroK,7038760,7038760,7038128,632,3152,utRho01
aroL,812560,812810,812560,250,146,utRho01
aroP,243342,243342,243102,240,0,utRho01
arpA,8445382,8445382,8444974,408,294,utRho01
arrS,7316108,7316108,7316108,0,0,utRho01
arsR,7297024,7297056,7297024,32,28,utRho01
artJ,1801252,1801252,1801150,102,0,utRho01
artP,1807686,1807686,1807468,218,108,utRho01
ascF,5678858,5679048,5678858,190,0,utRho01
ascG,5678574,5678574,5678528,46,0,utRho01
aslB,7965562,7965916,7965562,354,39482,utRho01
asnA,7854258,7854310,7854258,52,62,utRho01
asnB,1398444,1398444,1398354,90,886,utRho01
asnC,23562186,23562186,23562018,168,0,utRho01
asnS,1978088,1978088,1977970,118,11450,utRho01
asnT,4089082,4089098,4089082,16,86,utRho01
asnU,4119690,4119702,4119690,12,4,utRho01
asnV,4124504,4124520,4124504,16,12,utRho01
aspA,17473728,17473728,17473308,420,148,utRho01
aspC,1971486,1971486,1971418,68,416,utRho01
aspS,3901402,3901402,3901044,358,138,utRho01
aspT,7893560,7893744,7893560,184,120618,utRho01
aspV,473826,473862,473826,36,32,utRho01
asr,3342654,3342752,3342654,98,104,utRho01
astC,3664088,3664088,3663964,124,0,utRho01
astE,3654138,3654138,3653846,292,0,utRho01
atoD,4646824,4646894,4646824,70,18,utRho01
atpB,7844540,7844540,7844102,438,1124,utRho01
atpC,7832118,7832118,7831944,174,1434,utRho01
atpI,7845050,7845050,7844880,170,80,utRho01
avtA,7479348,7479410,7479348,62,224,utRho01
azoR,2965982,2965982,2965720,262,186,utRho01
azuC,3976002,3976002,3975918,84,70,utRho01
bacA,6408350,6408350,6408262,88,0,utRho01
bamA,394052,395856,394052,1804,1260,utRho01
bamB,5277950,5277950,5277304,646,2280,utRho01
bamC,5198028,5198028,5197730,298,760,utRho01
bamD,5471922,5472292,5471922,370,7700,utRho01
bamE,5506972,5507210,5506972,238,502,utRho01
basS,8666954,8666954,8666544,410,516,utRho01
bax,7474468,7474468,7474354,114,136,utRho01
bcp,5200874,5200956,5200874,82,1486,utRho01
bcsB,7385346,7385346,7385214,132,0,utRho01
bcsE,7392644,7392916,7392644,272,0,utRho01
bdcA,8948128,8948128,8948106,22,30,utRho01
bdcR,8948192,8948248,8948192,56,10,utRho01
bdm,3112680,3112680,3112560,120,0,utRho01
betA,654522,654522,654494,28,270,utRho01
betI,658722,658722,658668,54,18,utRho01
betT,658842,658926,658842,84,24,utRho01
bfr,6933498,6933498,6933450,48,8,utRho01
bglG,23440182,23440182,23439402,780,0,utRho01
bglX,4444240,4444240,4443978,262,0,utRho01
bhsA,2337962,2338146,2337962,184,52,utRho01
bioA,1618584,1618584,1618514,70,10,utRho01
bioB,1618604,1618688,1618604,84,20,utRho01
bioH,7089716,7089716,7089688,28,8,utRho01
bisC,7433026,7433026,7432788,238,18,utRho01
blc,8755490,8755490,8755444,46,20,utRho01
blr,3409024,3409102,3409024,78,102,utRho01
bluF,2431226,2431226,2430950,276,2436,utRho01
bluR,2428226,2428226,2428118,108,30,utRho01
bolA,908698,908944,908698,246,0,utRho01
borD,1157842,1157842,1157786,56,0,utRho01
brnQ,838976,839182,838976,206,2786,utRho01
bssR,1756492,1756496,1756492,4,0,utRho01
bssS,2242116,2242116,2241910,206,480,utRho01
btuB,8326798,8327278,8326798,480,3288,utRho01
cadB,8720212,8720212,8720062,150,0,utRho01
cadC,8723926,8723926,8723868,58,0,utRho01
caiE,70998,70998,70742,256,0,utRho01
caiF,68436,68600,68436,164,10,utRho01
caiT,84074,84074,83862,212,60,utRho01
can,285406,285406,285340,66,26,utRho01
carA,59102,59302,59102,200,8,utRho01
carB,61550,61634,61550,84,40,utRho01
cas2,5757830,5757830,5757706,124,12,utRho01
casA,5768638,5768638,5768276,362,0,utRho01
cbl,4121882,4121882,4121828,54,10,utRho01
cbpA,2128074,2128074,2127550,524,540,utRho01
cbrA,7738628,7738754,7738628,126,0,utRho01
cbrB,7794958,7795012,7794958,54,36,utRho01
ccmH,4585242,4585242,4584820,422,32,utRho01
cdaR,364894,364926,364894,32,42,utRho01
cdd,4463638,4463688,4463638,50,94,utRho01
cdh,8219814,8219860,8219814,46,152,utRho01
cdsA,391110,391354,391110,244,1932,utRho01
cedA,3627484,3627484,3627326,158,286,utRho01
cfa,3482402,3482826,3482402,424,714,utRho01
chaC,2544844,2544972,2544844,128,68,utRho01
chbB,3643452,3643452,3643238,214,0,utRho01
chbG,3634624,3634624,3634270,354,0,utRho01
cheW,3946924,3946924,3946678,246,470,utRho01
chiA,6939792,6939792,6939706,86,0,utRho01
chiP,1416472,1416668,1416472,196,0,utRho01
cho,3646984,3647030,3646984,46,106,utRho01
chpS,8896804,8896894,8896804,90,32,utRho01
cirA,4493884,4493884,4493538,346,710,utRho01
citC,1304078,1304078,1303712,366,10,utRho01
citT,1293264,1293264,1293160,104,0,utRho01
clcA,350104,350214,350104,110,0,utRho01
clpA,1846160,1846528,1846160,368,78,utRho01
clpB,5468410,5468410,5468346,64,54,utRho01
clpP,913154,913354,913154,200,816,utRho01
clpS,1845500,1845826,1845500,326,84,utRho01
clpX,914404,914852,914404,448,1784,utRho01
clsA,2617346,2617346,2617290,56,36,utRho01
clsC,2212584,2212710,2212584,126,398,utRho01
cmk,1922330,1922402,1922330,72,42,utRho01
cnu,3409522,3409898,3409522,376,678,utRho01
coaA,8350214,8350214,8350052,162,708,utRho01
cobC,1340092,1340092,1339814,278,862,utRho01
cobT,4129202,4129202,4128934,268,48,utRho01
cobU,4131944,4131944,4131528,416,652,utRho01
codB,709768,709844,709768,76,18,utRho01
comR,2337726,2337726,2337664,62,0,utRho01
copA,1022822,1022822,1022758,64,0,utRho01
corA,8002388,8002852,8002388,464,5526,utRho01
cpdB,8873258,8873258,8873130,128,88,utRho01
cptB,6082198,6082198,6082140,58,108,utRho01
cpxA,8210202,8210202,8209950,252,786,utRho01
cpxP,8211570,8211640,8211570,70,130,utRho01
cpxR,8211372,8211372,8211340,32,98,utRho01
cra,175894,176056,175894,162,0,utRho01
crcB,1316016,1316016,1315876,140,58,utRho01
creA,9270486,9271042,9270486,556,508,utRho01
creD,9276320,9276356,9276320,36,46,utRho01
crl,515620,515658,515620,38,1820,utRho01
crp,6971906,6972240,6971906,334,4586,utRho01
crr,5070960,5071668,5070960,708,7610,utRho01
csdA,5886414,5886674,5886414,260,160,utRho01
csgB,2207718,2207902,2207718,184,0,utRho01
csgD,2206688,2206688,2206392,296,8,utRho01
csgG,2203510,2203510,2203368,142,8,utRho01
csiD,5577854,5577970,5577854,116,6,utRho01
csiE,5330802,5330870,5330802,68,36,utRho01
csiR,5590942,5591348,5590942,406,4,utRho01
cspA,7439778,7440098,7439778,320,432866,utRho01
cspB,3283430,3283430,3283108,322,576,utRho01
cspC,3815018,3815018,3814870,148,508,utRho01
cspD,1845352,1845352,1845180,172,430,utRho01
cspE,1314294,1314584,1314294,290,60,utRho01
cspF,3283380,3283710,3283380,330,72,utRho01
cspG,2102610,2102922,2102610,312,289044,utRho01
cspH,2102746,2102746,2102350,396,704,utRho01
cspI,3277624,3277624,3277334,290,316,utRho01
csrA,5638746,5638746,5638292,454,1456,utRho01
csrB,5849048,5849048,5849048,0,0,utRho01
csrC,8102072,8102072,8102072,0,0,utRho01
csrD,6806850,6806850,6806664,186,108,utRho01
cstA,1259710,1259788,1259710,78,0,utRho01
cueO,274090,274166,274090,76,0,utRho01
cueR,1027948,1027986,1027948,38,30,utRho01
curA,3037784,3038054,3037784,270,74,utRho01
cusC,1191146,1191200,1191146,54,0,utRho01
cusR,1190924,1190924,1190886,38,70,utRho01
cutA,8730784,8730784,8730712,72,186,utRho01
cutC,3918534,3918534,3917920,614,186,utRho01
cvpA,4861600,4861600,4861526,74,74,utRho01
cvrA,2484328,2484328,2484142,186,78,utRho01
cyaA,7981548,7982306,7981548,758,1810,utRho01
cyaR,4334228,4334224,4334228,4,0,utRho01
cyaY,7988166,7988166,7988118,48,144,utRho01
cybB,2981522,2981804,2981522,282,250,utRho01
cycA,8859560,8859728,8859560,168,578,utRho01
cydA,1542340,1542916,1542340,576,114,utRho01
cydC,1858800,1858800,1858390,410,266,utRho01
cydD,1862062,1862062,1861924,138,150,utRho01
cydX,1548300,1548392,1548300,92,426,utRho01
cynR,717418,717418,717380,38,0,utRho01
cynT,1435092,1435196,1435092,104,0,utRho01
cyoA,903306,903306,903220,86,2508,utRho01
cyoE,895540,895540,895410,130,588,utRho01
cysB,2667576,2667710,2667576,134,454,utRho01
cysC,5748056,5748056,5747984,72,32,utRho01
cysD,5752736,5752736,5752658,78,16,utRho01
cysE,7565362,7565362,7565124,238,586,utRho01
cysG,6995508,6995656,6995508,148,78,utRho01
cysJ,5783928,5783928,5783796,132,1446,utRho01
cysK,5064688,5064818,5064688,130,10,utRho01
cysP,5087114,5087114,5087056,58,168,utRho01
cysS,1109154,1109222,1109154,68,74,utRho01
cysT,3984100,3984100,3983974,126,248,utRho01
cysZ,5062766,5062926,5062766,160,264,utRho01
cytR,8249018,8249018,8248912,106,164,utRho01
dacA,1328002,1328002,1327926,76,62,utRho01
dacB,6657714,6657926,6657714,212,54,utRho01
dacC,1761306,1761454,1761306,148,28,utRho01
dadA,2475018,2475142,2475018,124,0,utRho01
dam,7032504,7032504,7031826,678,1956,utRho01
damX,7035200,7035200,7034612,588,698,utRho01
dapA,5199568,5199568,5199520,48,2,utRho01
dapB,56576,56748,56576,172,44,utRho01
dapD,371954,371954,371894,60,110,utRho01
dapE,5183120,5183214,5183120,94,246,utRho01
dcp,3254844,3254844,3254760,84,110,utRho01
dcrB,7219534,7219910,7219534,376,100,utRho01
dctA,7366996,7366996,7366894,102,590,utRho01
dcuA,8733686,8733686,8733546,140,34,utRho01
dcuB,8698182,8698182,8697488,694,62,utRho01
dcuC,1312166,1312166,1311936,230,24,utRho01
dcuD,6749166,6749738,6749166,572,0,utRho01
dcuR,8701130,8701130,8700068,1062,544,utRho01
dcuS,8703370,8703370,8703324,46,68,utRho01
dcyD,3999016,3999016,3998960,56,0,utRho01
ddpX,3126498,3126498,3126152,346,0,utRho01
deaD,6615818,6615818,6615720,98,6370,utRho01
dedA,4869880,4869880,4869482,398,13274,utRho01
dedD,4863750,4863750,4863368,382,242,utRho01
def,6867300,6867380,6867300,80,156,utRho01
degP,361690,361768,361690,78,44,utRho01
degQ,6761308,6761486,6761308,178,4562,utRho01
deoB,9239134,9239206,9239134,72,4,utRho01
deoC,9233358,9234646,9233358,1288,258,utRho01
dfp,7625406,7625462,7625406,56,34,utRho01
dgcZ,3247758,3247758,3247700,58,0,utRho01
dgkA,8512914,8513274,8512914,360,426,utRho01
dgt,358392,358474,358392,82,0,utRho01
dhaK,2501888,2501888,2501676,212,144,utRho01
dhaR,2502006,2502132,2502006,126,106,utRho01
dicB,3299194,3299218,3299194,24,0,utRho01
dicC,3295752,3295752,3295700,52,0,utRho01
dinB,501760,501796,501760,36,0,utRho01
dinD,7635398,7635520,7635398,122,534,utRho01
dinG,1666146,1666140,1666146,6,14,utRho01
dinI,2243018,2243018,2242974,44,22,utRho01
dinJ,493230,493230,493004,226,62,utRho01
dinQ,7295964,7295964,7295576,388,1046,utRho01
djlA,114536,114728,114536,192,60,utRho01
dkgA,6313142,6313246,6313142,104,4,utRho01
dkgB,458196,458334,458196,138,616,utRho01
dksA,321502,321502,321208,294,134,utRho01
dld,4444164,4444370,4444164,206,36,utRho01
dmlA,3763424,3763824,3763424,400,14,utRho01
dmlR,3763710,3763710,3763618,92,12,utRho01
dmsA,1881646,1881918,1881646,272,192,utRho01
dnaA,7767922,7767922,7767458,464,6092,utRho01
dnaB,8528566,8528628,8528566,62,234,utRho01
dnaK,24096,24326,24096,230,410,utRho01
dnaN,7765466,7765466,7764642,824,1096,utRho01
dnaQ,471868,472134,471868,266,1130,utRho01
dnaT,18406460,18406460,18406068,392,580,utRho01
dnaX,984112,984184,984112,72,592,utRho01
dosP,3131486,3131486,3131466,20,0,utRho01
dpiB,1303968,1304470,1303968,502,20,utRho01
dppA,7415740,7415740,7415410,330,1364,utRho01
dps,1697900,1697900,1697822,78,18,utRho01
dsbA,8086754,8086836,8086754,82,2954,utRho01
dsbB,2466294,2466294,2466060,234,36,utRho01
dsbC,6079266,6079266,6077644,1622,1306,utRho01
dsbG,1277600,1277600,1277146,454,416,utRho01
dsdA,4958242,4958404,4958242,162,2,utRho01
dsdC,4955492,4955492,4955258,234,0,utRho01
dsdX,4955642,4955694,4955642,52,0,utRho01
dsrA,4050626,4050626,4050626,0,0,utRho01
dsrB,4049686,4049686,4049646,40,136,utRho01
dtpD,1485340,1485340,1485112,228,36,utRho01
dusA,8523200,8523338,8523200,138,4592,utRho01
dusB,6820492,6820560,6820492,68,134,utRho01
dusC,4460790,4460790,4460770,20,0,utRho01
dut,7627704,7627864,7627704,160,1520,utRho01
dxr,386670,387042,386670,372,1018,utRho01
ebgA,6445102,6445266,6445102,164,20,utRho01
ebgR,6442874,6442932,6442874,58,116,utRho01
ecnB,8753018,8753106,8753018,88,396,utRho01
eco,4607594,4607810,4607594,216,0,utRho01
ecpA,621594,621594,621342,252,48,utRho01
ecpB,620238,620238,620052,186,0,utRho01
ecpR,622964,622964,622672,292,0,utRho01
eda,3866218,3866218,3865512,706,238,utRho01
edd,3869426,3869426,3869208,218,96,utRho01
efeO,2164308,2164486,2164308,178,92,utRho01
efeU_1,2162614,2162712,2162614,98,144,utRho01
efp,8751134,8751398,8751134,264,9146,utRho01
elaA,4763372,4763372,4763086,286,12,utRho01
elaD,4765308,4765426,4765308,118,34,utRho01
elfA,1995530,1995736,1995530,206,0,utRho01
elfD,1996642,1996980,1996642,338,4,utRho01
emrD,7707690,7707844,7707690,154,44,utRho01
emrK,4966896,4966896,4966678,218,0,utRho01
emrY,4964668,4964668,4964352,316,126,utRho01
emtA,2486250,2486360,2486250,110,14,utRho01
endA,12361100,12361388,12361100,288,104,utRho01
eno,5817692,5817692,5815882,1810,6160,utRho01
entC,1249662,1249770,1249662,108,16,utRho01
entD,1220508,1220508,1220158,350,292,utRho01
entH,1258584,1258600,1258584,16,64,utRho01
entS,1244506,1244600,1244506,94,36,utRho01
envR,6827266,6827266,6826930,336,0,utRho01
epd,12295292,12295292,12294764,528,48,utRho01
epmA,8765236,8765286,8765236,50,18,utRho01
epmB,8751406,8751406,8751314,92,4776,utRho01
eptB,7421162,7421162,7420950,212,92,utRho01
eptC,8300622,8300622,8300530,92,246,utRho01
erfK,4126708,4126708,4126646,62,1566,utRho01
erpA,353122,353220,353122,98,172,utRho01
esrE,8039956,8039956,8039956,0,0,utRho01
essD,1153746,1154796,1153746,1050,274,utRho01
etk,2088606,2088606,2088420,186,0,utRho01
evgA,4967262,4967510,4967262,248,0,utRho01
exbB,6304028,6304028,6303968,60,0,utRho01
exbD,6302780,6302780,6302486,294,502,utRho01
exuR,6493016,6493304,6493016,288,262,utRho01
exuT,6490004,6490208,6490004,204,0,utRho01
fabA,2032996,2032996,2032940,56,218,utRho01
fabB,4883282,4883282,4883210,72,54,utRho01
fabH,2297032,2297518,2297032,486,4348,utRho01
fabI,2702236,2702236,2702078,158,122,utRho01
fadB,8062026,8062026,8061942,84,0,utRho01
fadD,3779614,3779614,3779492,122,0,utRho01
fadE,486812,486812,486606,206,42,utRho01
fadH,6463248,6463330,6463248,82,0,utRho01
fadI,4921022,4921022,4920938,84,0,utRho01
fadL,4922410,4922600,4922410,190,6,utRho01
fadM,928720,928804,928720,84,0,utRho01
fadR,2469810,2469876,2469810,66,0,utRho01
fbaB,4357334,4357334,4357128,206,38,utRho01
fdhE,8162722,8162722,8162456,266,1244,utRho01
fdhF,8598814,8598814,8598732,82,20,utRho01
fdnG,3094744,3094802,3094744,58,4,utRho01
fdrA,1093012,1093360,1093012,348,0,utRho01
feaB,2894994,2895038,2894994,44,0,utRho01
feaR,2894734,2894734,2894566,168,14,utRho01
fecA,9033454,9033454,9033354,100,792,utRho01
fecE,9023288,9023288,9022914,374,7464,utRho01
fecI,9036564,9036564,9036470,94,16,utRho01
feoA,7080114,7080326,7080114,212,176,utRho01
fepA,1225334,1225334,1224988,346,82,utRho01
fepB,1249454,1249454,1249020,434,240,utRho01
fepD,1244468,1244468,1244378,90,86,utRho01
fes,1225374,1225630,1225374,256,460,utRho01
ffh,5495706,5495706,5495590,116,1982,utRho01
ffs,952576,952848,952576,272,60,utRho01
fhuA,334884,334968,334884,84,420,utRho01
fhuE,2323294,2323294,2323102,192,358,utRho01
fhuF,9211504,9211504,9211326,178,2738,utRho01
fic,6983296,6983296,6982926,370,512,utRho01
fieF,8212864,8212938,8212864,74,46,utRho01
fimA,9085388,9086230,9085388,842,272,utRho01
fimB,9081334,9081914,9081334,580,588,utRho01
fimE,9083742,9084074,9083742,332,16,utRho01
fimZ,1129214,1129214,1128960,254,54,utRho01
fiu,1683296,1683296,1683062,234,112,utRho01
fixA,84650,84806,84650,156,0,utRho01
fkpA,6955050,6955050,6954838,212,9644,utRho01
fldA,2846084,2846084,2845860,224,5172,utRho01
fldB,6079644,6079710,6079644,66,96,utRho01
flgA,2261770,2261770,2261726,44,40,utRho01
flgB,2261986,2262036,2261986,50,46,utRho01
flgK,2276702,2276756,2276702,54,2334,utRho01
flgM,2260330,2260330,2260256,74,686,utRho01
flgN,2259828,2259828,2259660,168,346,utRho01
flhB,3932432,3932432,3932382,50,102,utRho01
flhC,3955864,3955864,3955688,176,182,utRho01
flhD,3957154,3957154,3956394,760,928,utRho01
fliA,4003638,4003638,4003578,60,152,utRho01
fliC,4007352,4007352,4007212,140,146,utRho01
fliD,4007634,4007744,4007634,110,170,utRho01
fliE,4026186,4026186,4026028,158,32,utRho01
fliF,4026292,4026458,4026292,166,410,utRho01
fliL,4039168,4039236,4039168,68,112,utRho01
flk,4875824,4875900,4875824,76,46,utRho01
flu,4142634,4143078,4142634,444,48,utRho01
flxA,3292776,3292810,3292776,34,48,utRho01
fnr,2799104,2799104,2799052,52,158,utRho01
fnrS,2818258,2818258,2818258,0,0,utRho01
focA,1909628,1909628,1908932,696,384,utRho01
folA,99598,99646,99598,48,2,utRho01
folB,6409296,6409296,6409178,118,0,utRho01
folD,1115562,1115562,1115482,80,248,utRho01
folE,4487696,4487696,4487304,392,4002,utRho01
fpr,8228998,8228998,8228944,54,0,utRho01
frc,4986878,4986878,4986508,370,0,utRho01
frdA,8764824,8764824,8764636,188,4,utRho01
frdD,8758948,8758948,8758732,216,152,utRho01
fre,8052886,8053054,8052886,168,2440,utRho01
frlA,6999518,6999820,6999518,302,0,utRho01
frr,385624,385744,385624,120,1542,utRho01
frsA,513004,513054,513004,50,208,utRho01
fruB,4527194,4527194,4526990,204,0,utRho01
frvR,8179804,8179804,8179710,94,0,utRho01
fryA,5008986,5008986,5008970,16,64,utRho01
fsaA,1727060,1727284,1727060,224,24,utRho01
fsr,1009710,1009710,1009392,318,44,utRho01
ftnA,3977364,3977432,3977364,68,0,utRho01
ftnB,3973550,3973850,3973550,300,32,utRho01
ftsA,207122,207964,207122,842,1370,utRho01
ftsB,5745802,5745802,5745640,162,128,utRho01
ftsH,6654204,6654204,6653870,334,1420,utRho01
ftsK,1865858,1866448,1865858,590,2430,utRho01
ftsL,181376,182064,181376,688,2294,utRho01
ftsP,6325732,6325732,6325338,394,456,utRho01
ftsQ,205484,206310,205484,826,598,utRho01
ftsX,7204512,7204512,7204172,340,652,utRho01
ftsZ,209272,210610,209272,1338,204,utRho01
fucA,5867708,5867708,5867376,332,40,utRho01
fucP,5868238,5868470,5868238,232,0,utRho01
fumA,6753760,6753760,6753508,252,1136,utRho01
fumB,8694696,8694696,8694652,44,28,utRho01
fumC,3373418,3373418,3373176,242,0,utRho01
fur,2842892,2842892,2842584,308,10168,utRho01
fusA,6947370,6947370,6947028,342,26834,utRho01
fxsA,8737206,8737328,8737206,122,116,utRho01
gabD,5581824,5582546,5581824,722,452,utRho01
gadA,7335214,7335214,7335160,54,0,utRho01
gadB,3144144,3144144,3144090,54,0,utRho01
gadC,3141168,3141168,3140978,190,36,utRho01
gadE,7315600,7316732,7315600,1132,4,utRho01
gadW,7329562,7329562,7329236,326,0,utRho01
gadX,14663356,14663356,14663240,116,4,utRho01
gadY,7329728,7329728,7329728,0,0,utRho01
galE,1584354,1584354,1584110,244,14,utRho01
galF,4228702,4228702,4228654,48,154,utRho01
galM,1577796,1577796,1577674,122,450,utRho01
galP,6176510,6176568,6176510,58,0,utRho01
galR,5953138,5953198,5953138,60,86,utRho01
galS,4483420,4483420,4483336,84,0,utRho01
galU,2582810,2582914,2582810,104,366,utRho01
gapA,3724480,3725542,3724480,1062,3406,utRho01
garP,6549868,6549868,6549814,54,0,utRho01
gatY,4354468,4354468,4354408,60,0,utRho01
gatZ,4352864,4352864,4352642,222,4608,utRho01
gcd,282558,282558,282450,108,66,utRho01
gcl,1067814,1067832,1067814,18,0,utRho01
gcvA,5885278,5885278,5885134,144,2,utRho01
gcvB,5885392,5885392,5885392,0,0,utRho01
gcvR,5199758,5199812,5199758,54,98,utRho01
gcvT,6101544,6101544,6101334,210,490,utRho01
gdhA,3684616,3684742,3684616,126,28,utRho01
gfcA,2099668,2099668,2099488,180,436,utRho01
gfcD,2096236,2096236,2095890,346,52,utRho01
ghrA,2195648,2195772,2195648,124,114,utRho01
ghrB,7434378,7434620,7434378,242,268,utRho01
glcA,6242728,6242728,6242558,170,52,utRho01
glcC,6256412,6256544,6256412,132,2,utRho01
glcD,6256152,6256152,6256042,110,2,utRho01
gldA,8278092,8278092,8278070,22,22,utRho01
glgA,7136784,7136784,7136066,718,218,utRho01
glgB,7147314,7147314,7147004,310,186,utRho01
glgC,7139142,7139142,7138656,486,90,utRho01
glgP,7133546,7133546,7133162,384,224,utRho01
glgS,6384024,6384024,6383878,146,0,utRho01
glgX,7142838,7142838,7142638,200,58,utRho01
glk,5018922,5018922,5018852,70,90,utRho01
glmS,7827622,7827622,7827336,286,8128,utRho01
glmU,7830652,7830652,7830400,252,744,utRho01
glmY,10765360,10765360,10765360,0,0,utRho01
glmZ,7972864,7972864,7972864,0,0,utRho01
glnA,16232888,16232888,16232136,752,420,utRho01
glnB,5375052,5375052,5374816,236,216,utRho01
glnD,377310,377310,377300,10,92,utRho01
glnE,6399602,6399602,6399282,320,4,utRho01
glnH,1696396,1696396,1696008,388,34,utRho01
glnK,945112,945196,945112,84,0,utRho01
glnL,8112742,8112742,8112678,64,26,utRho01
glnQ,1693262,1693262,1692926,336,390,utRho01
glnS,1411998,1412186,1411998,188,352,utRho01
gloA,3455602,3455674,3455602,72,56,utRho01
gloB,469852,469852,469564,288,1184,utRho01
glpA,4705166,4705294,4705166,128,14,utRho01
glpD,7123942,7124026,7123942,84,16,utRho01
glpE,7123698,7123698,7123646,52,224,utRho01
glpF,8236322,8236322,8236180,142,64,utRho01
glpG,7122960,7122960,7122904,56,582,utRho01
glpR,7121782,7121782,7121210,572,276,utRho01
glpT,4704902,4704902,4704748,154,16,utRho01
glpX,8231212,8231212,8231158,54,2622,utRho01
glrK,5382246,5382246,5382196,50,418,utRho01
gltA,1509534,1509534,1508936,598,20454,utRho01
gltB,6709018,6709264,6709018,246,380,utRho01
gltI,1375792,1375792,1375494,298,1628,utRho01
gltP,8588536,8588962,8588536,426,1766,utRho01
gltS,7657382,7657382,7657330,52,200,utRho01
gltX,5041568,5041568,5041344,224,132,utRho01
gluQ,320286,320286,320224,62,86,utRho01
glyA,5371148,5371148,5371014,134,2,utRho01
glyQ,7450708,7450708,7450636,72,176,utRho01
glyS,7448990,7448990,7448794,196,1938,utRho01
glyU,5998128,5998128,5998114,14,32,utRho01
glyV,8784626,8784720,8784626,94,186,utRho01
glyW,3984360,3984360,3984234,126,6,utRho01
gmhB,445612,445666,445612,54,4,utRho01
gmk,7642776,7642856,7642776,80,162,utRho01
gmr,2693686,2693686,2693484,202,194,utRho01
gnd,4202648,4202648,4202536,112,426,utRho01
gnsB,3275692,3275692,3275564,128,344,utRho01
gntK,14310580,14310580,14310368,212,504,utRho01
gntP,9102668,9102668,9102592,76,12,utRho01
gntR,7157760,7157760,7157452,308,346,utRho01
gntT,7092810,7093118,7092810,308,58,utRho01
gntU,7154170,7154170,7154122,48,0,utRho01
gntX,7089334,7089764,7089334,430,16,utRho01
gor,7292224,7292598,7292224,374,1252,utRho01
gpmA,1575340,1575340,1575190,150,0,utRho01
gpmM,7570374,7570520,7570374,146,0,utRho01
gpsA,7567620,7567620,7567322,298,6496,utRho01
gpt,511828,511954,511828,126,530,utRho01
grcA,5433046,5433046,5432898,148,150,utRho01
greA,6657728,6657728,6657430,298,1812,utRho01
greB,7073488,7073624,7073488,136,90,utRho01
groL,8741566,8742050,8741566,484,976,utRho01
groS,8741232,8741376,8741232,144,614,utRho01
grpE,5501494,5501494,5501416,78,150,utRho01
grxA,1781552,1781552,1781506,46,0,utRho01
grxB,2248206,2248206,2248108,98,142,utRho01
grxC,7569152,7569152,7568884,268,5160,utRho01
grxD,3468324,3468324,3468202,122,5634,utRho01
gspA,6911268,6911268,6910796,472,0,utRho01
gspC,6910964,6911156,6910964,192,0,utRho01
gss,6277220,6277220,6277044,176,0,utRho01
gstA,3428654,3428754,3428654,100,0,utRho01
gstB,1761038,1761038,1760960,78,8,utRho01
guaB,5268214,5268214,5268140,74,24,utRho01
gudD,5839026,5839026,5838770,256,0,utRho01
gyrA,4678914,4678914,4678840,74,34,utRho01
gyrB,7760300,7760300,7760238,62,514,utRho01
hcaE,5337964,5338064,5337964,100,22,utRho01
hcaR,5337928,5337928,5337792,136,46,utRho01
hcaT,5336106,5336106,5335692,414,24,utRho01
hchA,4071260,4071670,4071260,410,0,utRho01
hcp,1828258,1828258,1827628,630,88,utRho01
hcr,1824400,1824400,1824300,100,32,utRho01
hdeA,7313582,7313582,7313480,102,0,utRho01
hdeD,7313920,7313990,7313920,70,0,utRho01
hdfR,7896320,7896320,7895934,386,644,utRho01
hdhA,3396244,3396244,3396080,164,126,utRho01
helD,2048876,2048942,2048876,66,0,utRho01
hemA,2527166,2527428,2527166,262,222,utRho01
hemB,779722,779722,779454,268,46,utRho01
hemF,5106410,5106450,5106410,40,100,utRho01
hemH,996062,996110,996062,48,132,utRho01
hemL,349882,349882,349764,118,68,utRho01
hemN,8103886,8104090,8103886,204,18,utRho01
hepA,127176,127176,126528,648,4542,utRho01
hflD,2385372,2385372,2385262,110,1346,utRho01
hfq,8799602,8800576,8799602,974,2868,utRho01
hha,961006,961006,960616,390,552,utRho01
hicA,3018442,3018572,3018442,130,0,utRho01
higA,6468682,6468682,6468288,394,74,utRho01
higB,6468960,6468960,6468910,50,0,utRho01
hinT,2323642,2323770,2323642,128,0,utRho01
hipB,3184964,3184964,3184884,80,0,utRho01
hisB,4186720,4186936,4186720,216,576,utRho01
hisJ,4853674,4853674,4853576,98,38,utRho01
hisL,8359856,8359984,8359856,128,796,utRho01
hisS,5281284,5281284,5281150,134,430,utRho01
hlpA,400910,400964,400910,54,220,utRho01
hlyE,2460932,2460932,2460788,144,36,utRho01
hmp,5371594,5371670,5371594,76,0,utRho01
hns,2585916,2585916,2585844,72,1446,utRho01
hofM,7045856,7045856,7045502,354,0,utRho01
hokA,7441620,7441620,7441200,420,4420,utRho01
hokC,33902,33902,33806,96,206,utRho01
hokE,1215462,1215672,1215462,210,10,utRho01
holC,8968546,8968546,8968560,14,802,utRho01
holD,9215562,9215606,9215562,44,36,utRho01
holE,3850040,3850216,3850040,176,882,utRho01
hpt,282720,282862,282720,142,66,utRho01
hrpB,324150,324210,324150,60,150,utRho01
hscB,5319048,5319048,5318934,114,810,utRho01
hscC,1367188,1367188,1366786,402,142,utRho01
hsdS,9163004,9163004,9162924,80,0,utRho01
hslJ,2883560,2883560,2883486,74,212,utRho01
hslO,7059344,7059548,7059344,204,7948,utRho01
hslR,7058220,7058696,7058220,476,1050,utRho01
hslV,8244708,8244708,8244574,134,122,utRho01
hsrA,7881412,7881412,7881224,188,36,utRho01
htgA,21286,21660,21286,374,648,utRho01
htpG,989634,990240,989634,606,8290,utRho01
htpX,3825236,3825236,3825152,84,38,utRho01
htrE,311036,311036,310852,184,22,utRho01
htrL,7587668,7587668,7587366,302,74,utRho01
hupA,8400352,8400562,8400352,210,394,utRho01
hupB,1845220,1845804,1845220,584,380,utRho01
hyaA,2063968,2064278,2063968,310,8,utRho01
hybO,6292726,6292726,6292522,204,474,utRho01
hycA,5700922,5700922,5700870,52,30,utRho01
hycI,5686204,5686204,5686086,118,14,utRho01
hydN,5676264,5676264,5676210,54,0,utRho01
hyfA,5202342,5202402,5202342,60,0,utRho01
hypA,11402508,11402588,11402508,80,0,utRho01
hypB,11403356,11404004,11403356,648,120,utRho01
hypF,5676210,5676210,5674850,1360,1268,utRho01
hypT,9116634,9116634,9116578,56,12,utRho01
hyuA,6019660,6020056,6019660,396,0,utRho01
iaaA,1733074,1733136,1733074,62,36,utRho01
iadA,9119074,9119074,9119052,22,6,utRho01
iap,5753072,5753162,5753072,90,54,utRho01
ibaG,6673966,6673966,6673606,360,48,utRho01
ibpA,7735036,7735036,7734844,192,400,utRho01
ibpB,7733962,7733962,7733794,168,282,utRho01
icd,2389922,2390246,2389922,324,210,utRho01
iclR,8447304,8447304,8447256,48,60,utRho01
idi,6065876,6066130,6065876,254,0,utRho01
idnD,8988870,8988870,8988812,58,0,utRho01
idnK,8989194,8989246,8989194,52,0,utRho01
ihfA,3591442,3591442,3591104,338,1536,utRho01
ihfB,1927498,1927656,1927498,158,1784,utRho01
ileS,43666,44782,43666,1116,4362,utRho01
ileX,6431194,6431196,6431194,2,14,utRho01
ilvA,15820940,15821324,15820940,384,16,utRho01
ilvC,7915824,7915940,7915824,116,0,utRho01
ilvE,15809552,15809936,15809552,384,916,utRho01
ilvI,170840,171260,170840,420,8,utRho01
ilvL,23701308,23701932,23701308,624,234,utRho01
ilvY,7915734,7915734,7915640,94,0,utRho01
inaA,4698998,4698998,4698944,54,48,utRho01
infA,1853370,1853370,1852886,484,3728,utRho01
infC,3602692,3602692,3601276,1416,6982,utRho01
insA-5,3958452,3958452,3958430,22,10,utRho01
insA-7,9036758,9037054,9036758,296,154,utRho01
insC-5,6372080,6372284,6372080,204,126,utRho01
insEF-2,785238,785238,785820,582,494,utRho01
insEF-4,2190310,2190310,2190892,582,470,utRho01
insG,9007098,9007098,9006862,236,0,utRho01
insH-1,550596,550596,550234,362,134,utRho01
insH-11,7306538,7306538,7306396,142,80,utRho01
insH-2,1151548,1151548,1151506,42,64,utRho01
insH-3,1378444,1378444,1378026,418,176,utRho01
insH-4,2791942,2792152,2791942,210,62,utRho01
insH-5,2857852,2857852,2857452,400,0,utRho01
insH-6,4135022,4135022,4134642,380,178,utRho01
insH-7,4206186,4206186,4205822,364,8164,utRho01
insH-9,6260050,6260356,6260050,306,118,utRho01
insI-3,9017372,9017372,9017234,138,8,utRho01
insJ,7441188,7441360,7441188,172,1912,utRho01
insK,7442130,7442308,7442130,178,0,utRho01
insL-1,30760,30890,30760,130,636,utRho01
insL-2,1216112,1216130,1216112,18,50,utRho01
insL-3,5028644,5028662,5028644,18,130,utRho01
insN-1,540452,540484,540452,32,0,utRho01
intD,1132202,1132202,1131956,246,32,utRho01
intR,2826520,2826520,2826470,50,0,utRho01
intS,4933026,4933090,4933026,64,718,utRho01
intZ,5117386,5117542,5117386,156,140,utRho01
iraD,9113152,9113986,9113152,834,92,utRho01
iraM,2424246,2424246,2424006,240,20,utRho01
iraP,802638,802772,802638,134,0,utRho01
iscA,5319924,5319924,5319772,152,1700,utRho01
iscR,5324398,5324398,5324262,136,27170,utRho01
iscX,5313834,5313834,5313472,362,2702,utRho01
ispF,5743968,5743968,5743560,408,1558,utRho01
ispG,5283908,5283908,5283608,300,966,utRho01
ispU,389568,389806,389568,238,204,utRho01
isrA,2811502,2811502,2811618,116,0,utRho01
istr-1,7706384,7706384,7706384,0,0,utRho01
istr-2,7706514,7706514,7706514,0,0,utRho01
ivbL,15412092,15412092,15411952,140,552,utRho01
ivy,480638,480686,480638,48,0,utRho01
katE,3627628,3627734,3627628,106,4,utRho01
katG,8267624,8267670,8267624,46,124,utRho01
kbaZ,6557732,6557828,6557732,96,0,utRho01
kbl,7585154,7585154,7585102,52,640,utRho01
kch,2621046,2621046,2620538,508,72,utRho01
kdgR,3820506,3820506,3820198,308,8,utRho01
kdpE,1443788,1443788,1443466,322,0,utRho01
kdpF,1457698,1457698,1457642,56,0,utRho01
kdsA,2535708,2536330,2535708,622,4138,utRho01
kdsC,6683438,6684546,6683438,1108,4292,utRho01
kduI,5968388,5968388,5968248,140,406,utRho01
kefF,94160,94492,94160,332,40,utRho01
kgtP,5451624,5451624,5451492,132,1344,utRho01
kup,7862206,7862632,7862206,426,148,utRho01
lacI,735076,735076,735020,56,4,utRho01
lacZ,1465508,1465508,1465220,288,308,utRho01
ldcA,2486394,2486394,2486160,234,26,utRho01
ldhA,2885830,2885830,2885686,144,0,utRho01
ldrA,2538954,2538954,2538550,404,1812,utRho01
ldrB,2540024,2540024,2539620,404,968,utRho01
ldrC,2541092,2541092,2540690,402,1900,utRho01
ldrD,7400544,7400544,7400174,370,2366,utRho01
lepA,5414392,5414392,5414248,144,202,utRho01
lepB,5410928,5410928,5410618,310,902,utRho01
leuD,159188,159188,158906,282,28,utRho01
leuE,3761600,3761600,3761518,82,0,utRho01
leuL,168048,168048,167416,632,0,utRho01
leuO,168308,168736,168308,428,0,utRho01
leuQ,9212864,9212864,9212802,62,0,utRho01
leuU,6644556,6644556,6644316,240,5362,utRho01
leuV,9212546,9212546,9212330,216,968,utRho01
leuX,8992772,8992810,8992772,38,2,utRho01
lexA,8514174,8514230,8514174,56,66,utRho01
lhr,3456706,3458174,3456706,1468,2592,utRho01
ligA,5060402,5060402,5060352,50,8,utRho01
ligB,7642576,7642576,7642340,236,0,utRho01
lipA,1320602,1320602,1320432,170,198,utRho01
lipB,1324802,1324802,1324556,246,2146,utRho01
lit,2397032,2397390,2397032,358,122,utRho01
livJ,7199524,7199524,7199316,208,2370,utRho01
livK,7195510,7195510,7195120,390,36,utRho01
lldP,7554578,7554798,7554578,220,720,utRho01
lnt,1381968,1381968,1381762,206,462,utRho01
loiP,6163784,6163826,6163784,42,0,utRho01
lolA,1874656,1874738,1874656,82,1106,utRho01
lolB,2527112,2527112,2527000,112,98,utRho01
lolC,2350748,2350854,2350748,106,0,utRho01
lon,917630,917776,917630,146,584,utRho01
lpcA,486936,487086,486936,150,32,utRho01
lpd,255434,255824,255434,390,3880,utRho01
lplA,9248476,9248476,9248234,242,1210,utRho01
lplT,5947878,5947878,5947724,154,0,utRho01
lpoA,6586422,6586800,6586422,378,366,utRho01
lpp,3514592,3514842,3514592,250,102,utRho01
lptA,6686598,6686760,6686598,162,1866,utRho01
lptB,6686792,6687888,6686792,1096,2300,utRho01
lptD,114672,114672,114218,454,2888,utRho01
lptF,8972244,8972436,8972244,192,90,utRho01
lpxC,213016,213114,213016,98,29622,utRho01
lpxD,401920,401942,401920,22,68,utRho01
lpxL,2233418,2233418,2233164,254,80,utRho01
lpxM,3880456,3880456,3880386,70,44,utRho01
lpxP,4991156,4991290,4991156,134,696,utRho01
lrhA,4813312,4813312,4813282,30,0,utRho01
lrp,1864656,1865190,1864656,534,1206,utRho01
lspA,50028,50414,50028,386,908,utRho01
lsrA,3202920,3202980,3202920,60,0,utRho01
lsrR,3202514,3202514,3202482,32,0,utRho01
ltaE,1818640,1818640,1818588,52,10,utRho01
luxS,5630130,5630130,5629466,664,2598,utRho01
lysA,5957902,5957902,5957798,104,0,utRho01
lysC,8467232,8467232,8466466,766,826,utRho01
lysP,4497120,4497120,4497064,56,112,utRho01
lysR,5957900,5958042,5957900,142,0,utRho01
lysT,1561028,1561108,1561028,80,212,utRho01
lysU,8709610,8709610,8709434,176,46,utRho01
macB,1840188,1840694,1840188,506,282,utRho01
maeA,3111484,3111484,3111338,146,3108,utRho01
mak,820236,820288,820236,52,0,utRho01
malE,8492928,8492928,8492838,90,0,utRho01
malI,3398456,3398456,3398360,96,0,utRho01
malK,8493472,8493568,8493472,96,0,utRho01
malP,7105020,7105020,7104946,74,302,utRho01
malQ,7100798,7100798,7100140,658,254,utRho01
malS,14949880,14949988,14949880,108,40,utRho01
malT,7106048,7106170,7106048,122,0,utRho01
malX,3398626,3398710,3398626,84,46,utRho01
malZ,1689980,1690072,1689980,92,1860,utRho01
manA,3377102,3377152,3377102,50,40,utRho01
manX,3803866,3804096,3803866,230,12,utRho01
marC,3237882,3237882,3237816,66,72,utRho01
marR,3238186,3238240,3238186,54,176,utRho01
matP,2036918,2036970,2036918,52,110,utRho01
mazE,5822736,5822736,5822678,58,36,utRho01
mazG,5821720,5821720,5821370,350,2808,utRho01
mcbA,1684306,1684306,1684112,194,104,utRho01
mcbR,3040192,3040524,3040192,332,72,utRho01
mcrA,2420278,2420692,2420278,414,16,utRho01
mcrC,9156124,9156124,9155916,208,146,utRho01
mdaB,6344814,6345060,6344814,246,68,utRho01
mdfA,1767138,1767346,1767138,208,0,utRho01
mdh,6768940,6768940,6768536,404,326,utRho01
mdoB,9198988,9198988,9198882,106,1056,utRho01
mdoD,2993290,2993712,2993290,422,0,utRho01
mdoG,2218514,2218670,2218514,156,102,utRho01
mdtA,4307958,4308032,4307958,74,60,utRho01
mdtE,7318168,7318464,7318168,296,8,utRho01
mdtK,3486538,3486914,3486538,376,162,utRho01
mdtP,8602472,8602472,8602060,412,36,utRho01
melA,8683774,8683822,8683774,48,0,utRho01
melR,8683300,8683300,8683256,44,46,utRho01
menA,8240812,8240812,8240698,114,16,utRho01
menB,4753774,4753774,4753638,136,262,utRho01
mepH,3468714,3468870,3468714,156,16,utRho01
mepM,3883666,3883666,3883270,396,1118,utRho01
mepS,4539840,4539958,4539840,118,890,utRho01
metA,8428318,8428560,8428318,242,560,utRho01
metB,8257272,8257344,8257272,72,612,utRho01
metC,6304150,6304472,6304150,322,318,utRho01
metE,8025768,8026106,8025768,338,80,utRho01
metF,8265092,8265232,8265092,140,124,utRho01
metG,4388538,4388600,4388538,62,74,utRho01
metH,8447010,8447656,8447010,646,7424,utRho01
metJ,8257116,8257116,8256790,326,272,utRho01
metK,6173154,6173412,6173154,258,186,utRho01
metN,445428,445428,445290,138,6,utRho01
metR,8025710,8025710,8025632,78,0,utRho01
metT,1394326,1394326,1394266,60,332,utRho01
metY,19910250,19910250,19909734,516,9882,utRho01
metZ,11789528,11789548,11789528,20,52,utRho01
mfd,2348056,2348056,2347928,128,96,utRho01
mglA,4478782,4478782,4478578,204,32,utRho01
mglB,4481132,4481132,4480696,436,1330,utRho01
mglC,4475918,4475918,4475506,412,26,utRho01
mgrB,3817584,3817584,3817532,52,0,utRho01
mgrR,3245828,3245828,3245828,0,0,utRho01
mgsA,2054082,2054082,2054030,52,96,utRho01
mgtL,8934560,8934862,8934560,302,262,utRho01
mhpA,737038,737222,737038,184,0,utRho01
mhpR,737072,737072,736840,232,30,utRho01
mhpT,750772,750918,750772,146,0,utRho01
miaA,8797964,8798504,8797964,540,1066,utRho01
micA,5629604,5629604,5629604,0,0,utRho01
micC,2874242,2874238,2874242,4,0,utRho01
micF,4626168,4626168,4626168,0,0,utRho01
micM,1014408,1014408,1014408,0,0,utRho01
minE,2449422,2449422,2449090,332,992,utRho01
mioC,7852950,7852950,7852910,40,0,utRho01
mipA,3733012,3733012,3732944,68,3904,utRho01
mlaA,4930270,4930270,4930014,256,24,utRho01
mlc,3337206,3337206,3337128,78,68,utRho01
mlrA,4429498,4429732,4429498,234,8,utRho01
mltA,5894546,5894546,5894356,190,94,utRho01
mltD,468050,468050,467910,140,0,utRho01
mltF,5391534,5391602,5391534,68,0,utRho01
mmuP,550238,550650,550238,412,134,utRho01
mngA,1531622,1531968,1531622,346,0,utRho01
mngR,1531852,1531852,1531750,102,0,utRho01
mnmG,7851348,7851348,7851266,82,9442,utRho01
mntH,5025470,5025470,5025412,58,44,utRho01
mntP,3810918,3811376,3810918,458,978,utRho01
mntR,1706160,1706366,1706160,206,18,utRho01
mntS,1706128,1706128,1705994,134,18,utRho01
moaA,1633654,1634088,1633654,434,1674,utRho01
moaB,1635954,1636110,1635954,156,848,utRho01
mobA,8084242,8084242,8083998,244,362,utRho01
mocA,6030112,6030320,6030112,208,0,utRho01
modA,1589990,1590178,1589990,188,140,utRho01
moeA,1732788,1732788,1732728,60,72,utRho01
mokB,2984610,2984610,2984258,352,540,utRho01
molR_1,4392888,4392948,4392888,60,186,utRho01
motA,3954604,3954604,3954278,326,52,utRho01
mpaA,2781278,2781278,2781196,82,74,utRho01
mpl,8911456,8911570,8911456,114,0,utRho01
mppA,2786108,2786454,2786108,346,0,utRho01
mprA,5621494,5621540,5621494,46,470,utRho01
mqo,4613848,4613848,4613508,340,880,utRho01
mqsA,6336742,6336742,6336492,250,198,utRho01
mqsR,6337306,6337306,6337088,218,188,utRho01
mraZ,179192,179268,179192,76,30,utRho01
mrcA,7045652,7045742,7045652,90,0,utRho01
mrcB,329442,329460,329442,18,0,utRho01
mreB,13605424,13605424,13604348,1076,2244,utRho01
mreD,6798166,6798166,6797750,416,350,utRho01
mrp,4388360,4388360,4388336,24,0,utRho01
mscK,972984,973072,972984,88,44,utRho01
mscL,6876002,6876048,6876002,46,138,utRho01
mscS,6139742,6139742,6139614,128,50,utRho01
msrA,8884522,8884522,8884352,170,50,utRho01
msrB,3725168,3725168,3724858,310,0,utRho01
msyB,2228426,2228426,2228362,64,298,utRho01
mtfA,4087236,4087302,4087236,66,414,utRho01
mtgA,6699662,6699662,6699618,44,280,utRho01
mtlA,30177504,30178248,30177504,744,392,utRho01
mtn,358366,358366,358306,60,0,utRho01
mtr,6611864,6611864,6611634,230,88,utRho01
mug,6430992,6430992,6430946,46,112,utRho01
murQ,5091466,5091546,5091466,80,0,utRho01
murR,5091586,5091586,5091218,368,60,utRho01
mutH,5939164,5939324,5939164,160,494,utRho01
mutL,8794092,8794824,8794092,732,1150,utRho01
mutM,7622554,7622554,7622304,250,1972,utRho01
mutS,5714038,5714186,5714038,148,346,utRho01
mutY,18617466,18618078,18617466,612,222,utRho01
nac,4123956,4123956,4123866,90,0,utRho01
nadA,1564122,1564170,1564122,48,20,utRho01
nadB,5420714,5420840,5420714,126,16,utRho01
nadC,237326,237326,237290,36,30,utRho01
nadE,3644604,3644916,3644604,312,34,utRho01
nadK,5501526,5501662,5501526,136,108,utRho01
nagA,1406350,1406350,1405502,848,1734,utRho01
nagB,1407416,1407416,1407222,194,108,utRho01
nagC,1404016,1404016,1403188,828,202,utRho01
nagE,1407680,1407888,1407680,208,82,utRho01
nagK,2357080,2357186,2357080,106,140,utRho01
nanA,6747240,6747240,6747152,88,14,utRho01
nanC,9079856,9079856,9079002,854,2,utRho01
nanR,6749406,6749406,6748978,428,88,utRho01
nanS,9075406,9075406,9075188,218,0,utRho01
napF,4607390,4607390,4606994,396,4,utRho01
narG,2559614,2559728,2559614,114,0,utRho01
narK,2555642,2555914,2555642,272,0,utRho01
narP,4580844,4581000,4580844,156,26,utRho01
narQ,5171154,5171462,5171154,308,8,utRho01
narU,3088326,3088326,3088120,206,0,utRho01
narW,3077374,3077374,3074618,2756,0,utRho01
narX,2555554,2555554,2555236,318,18,utRho01
narZ,3085380,3085380,3085180,200,0,utRho01
ndh,2331984,2332170,2331984,186,50,utRho01
ndk,5289920,5289920,5289728,192,262,utRho01
nemR,6904084,6904092,6904084,8,52,utRho01
nepI,7683542,7683542,7683478,64,340,utRho01
nfo,4501612,4501680,4501612,68,70,utRho01
nfsB,1210906,1210906,1210848,58,42,utRho01
nfuA,7090916,7091248,7090916,332,874,utRho01
nhaA,34634,34978,34634,344,202,utRho01
nhaB,2469534,2469534,2469434,100,18,utRho01
nhoA,3067926,3068048,3067926,122,30,utRho01
nikA,7226878,7227334,7226878,456,2622,utRho01
nikR,7237074,7237176,7237074,102,64,utRho01
nirB,6987974,6988022,6987974,48,24,utRho01
nlpA,7680034,7680034,7679986,48,0,utRho01
nlpC,3585654,3585654,3585462,192,10,utRho01
nlpD,5737658,5737658,5737506,152,118,utRho01
nlpI,6618080,6618080,6617848,232,32,utRho01
nmpC,1153740,1153740,1153650,90,0,utRho01
nohA,3273206,3273206,3272734,472,88,utRho01
norR,5664614,5664614,5664578,36,0,utRho01
norV,5664878,5664952,5664878,74,0,utRho01
nrdA,4689510,4689730,4689510,220,14584,utRho01
nrdD,8925676,8925676,8925320,356,1770,utRho01
nrdH,5601312,5601446,5601312,134,794,utRho01
nrdR,865954,866004,865954,50,18,utRho01
nrfA,8575342,8575528,8575342,186,44,utRho01
nsrR,8812088,8812380,8812088,292,52516,utRho01
nudB,3897348,3897348,3897264,84,32,utRho01
nudC,8393428,8393806,8393428,378,98,utRho01
nudE,7052658,7052658,7052298,360,6958,utRho01
nudG,3682876,3682980,3682876,104,0,utRho01
nudI,4729050,4729108,4729050,58,0,utRho01
nudJ,2388874,2388874,2388576,298,2280,utRho01
nuoA,4810670,4810670,4810144,526,2262,utRho01
nuoN,4783434,4783434,4783010,424,2016,utRho01
nupC,5026018,5026084,5026018,66,26,utRho01
nupG,6211302,6211428,6211302,126,38,utRho01
ogrK,4335096,4335096,4335040,56,0,utRho01
ogt,2800568,2800568,2800472,96,182,utRho01
ohsC,5401036,5401040,5401036,4,18,utRho01
ompA,2040382,2040382,2040106,276,21384,utRho01
ompC,4625774,4625774,4625498,276,98,utRho01
ompF,1974184,1974184,1973964,220,206,utRho01
ompL,8128958,8128958,8128590,368,0,utRho01
ompN,2874158,2874158,2873786,372,0,utRho01
ompR,7073510,7073510,7073168,342,208,utRho01
ompT,1171330,1171330,1171266,64,50,utRho01
ompW,2627982,2628040,2627982,58,0,utRho01
ompX,1700418,1700900,1700418,482,1152,utRho01
omrA,5952378,5952378,5952378,0,0,utRho01
omrB,5952770,5952770,5952770,0,0,utRho01
oppA,2602170,2602364,2602170,194,23324,utRho01
orn,8783168,8783208,8783168,40,26,utRho01
osmB,2686952,2686952,2686656,296,36,utRho01
osmC,3113192,3113250,3113192,58,34,utRho01
osmE,3644566,3644566,3644512,54,22,utRho01
osmF,4439046,4439046,4438962,84,478,utRho01
osmY,9222306,9222792,9222306,486,206,utRho01
otsA,3963302,3963302,3963224,78,12,utRho01
otsB,3964930,3964930,3964774,156,22,utRho01
oxc,4984288,4984288,4983900,388,12,utRho01
oxyR,8316914,8316980,8316914,66,50,utRho01
oxyS,8316788,8316788,8316788,0,0,utRho01
paaA,2907730,2907854,2907730,124,0,utRho01
paaX,2927018,2927078,2927018,60,0,utRho01
paaZ,2907340,2907340,2907284,56,0,utRho01
pabA,6981702,6981702,6981658,44,0,utRho01
pabB,3789256,3789610,3789256,354,364,utRho01
pabC,2306186,2306600,2306186,414,506,utRho01
pagP,1313052,1313114,1313052,62,0,utRho01
panB,299260,299260,299202,58,140,utRho01
panC,297840,297840,297590,250,290,utRho01
panD,293490,293490,293388,102,74,utRho01
panZ,7195656,7195968,7195656,312,26,utRho01
parC,6332060,6332060,6331946,114,218,utRho01
patA,6438916,6438988,6438916,72,0,utRho01
patD,3030830,3031156,3030830,326,2,utRho01
pbpC,5294986,5294986,5294650,336,0,utRho01
pbpG,4450132,4450132,4449740,392,68,utRho01
pck,7065358,7065636,7065358,278,2128,utRho01
pcnB,318782,318782,318252,530,1028,utRho01
pdhR,244068,244184,244068,116,378,utRho01
pdxB,4875768,4875768,4875702,66,0,utRho01
pdxH,3436068,3436068,3436014,54,218,utRho01
pdxJ,5403626,5403626,5403458,168,230,utRho01
pdxK,5074638,5074638,5074474,164,50,utRho01
pepA,8972278,8972278,8971902,376,222,utRho01
pepD,511618,511618,511432,186,3396,utRho01
pepN,1981182,1981244,1981182,62,42,utRho01
pepQ,8062294,8062322,8062294,28,22,utRho01
pepT,2371646,2371688,2371646,42,30,utRho01
pfkA,8214948,8215104,8214948,156,206,utRho01
pfkB,3612646,3612740,3612646,94,0,utRho01
pflA,1902456,1902456,1902160,296,0,utRho01
pflB,1907850,1907850,1907108,742,1102,utRho01
pflD,8287716,8287990,8287716,274,0,utRho01
pgaA,2185046,2185046,2184578,468,80,utRho01
pgi,8467444,8467516,8467444,72,38,utRho01
pgk,12291428,12291428,12290488,940,5048,utRho01
pgl,1597078,1597172,1597078,94,62,utRho01
pgpB,2678324,2678660,2678324,336,78,utRho01
pgpC,5397276,5397276,5397100,176,52,utRho01
pgrR,2783744,2783982,2783744,238,48,utRho01
pheL,5475158,5475198,5475158,40,66,utRho01
pheM,7197204,7197204,7197080,124,36,utRho01
pheP,1203858,1203918,1203858,60,4,utRho01
pheU,8725254,8725254,8725252,2,0,utRho01
pheV,6220730,6220732,6220730,2,0,utRho01
phnC,8650412,8650412,8650330,82,0,utRho01
phoA,803414,803494,803414,80,18,utRho01
phoB,834202,834284,834202,82,0,utRho01
phoE,520316,520316,520200,116,12,utRho01
phoH,2169730,2169984,2169730,254,558,utRho01
phoP,2381016,2381016,2380894,122,920,utRho01
phoQ,2379880,2379880,2379552,328,1608,utRho01
phoU,7815330,7815330,7815156,174,216,utRho01
phr,1478842,1479014,1478842,172,90,utRho01
pinE,2419054,2419370,2419054,316,38,utRho01
pinQ,3267168,3267244,3267168,76,1480,utRho01
pinR,2867424,2867424,2867348,76,1712,utRho01
pitA,7275224,7275284,7275224,60,18,utRho01
pitB,6272806,6272806,6272742,64,0,utRho01
pka,5439862,5439906,5439862,44,52,utRho01
plaP,4174476,4174476,4174124,352,746,utRho01
pldA,8009628,8009724,8009628,96,42,utRho01
pldB,8018028,8018340,8018028,312,238,utRho01
plsB,8513196,8513196,8512932,264,376,utRho01
pmbA,8915890,8915918,8915890,28,56,utRho01
pmrD,4747148,4747148,4747076,72,28,utRho01
pncB,1980828,1980828,1980712,116,60,utRho01
pncC,5648788,5648788,5648692,96,4,utRho01
pnp,6622652,6622652,6622336,316,110,utRho01
pntA,3355950,3355950,3355806,144,0,utRho01
pntB,3353096,3353096,3352720,376,20,utRho01
polA,8093880,8093932,8093880,52,50,utRho01
polB,131606,131606,131560,46,0,utRho01
potD,2365700,2365700,2365658,42,52,utRho01
potE,1436688,1436688,1436530,158,16,utRho01
potF,1787268,1787568,1787268,300,156,utRho01
poxB,1822152,1822152,1822098,54,0,utRho01
ppa,8899372,8899372,8899304,68,286,utRho01
ppc,8306380,8306380,8306196,184,636,utRho01
ppdA,5928440,5928440,5928354,86,1270,utRho01
ppdD,235410,235410,235098,312,398,utRho01
pphA,3846770,3846770,3845938,832,2272,utRho01
pphB,5719474,5719520,5719474,46,0,utRho01
ppiA,6984898,6984898,6984594,304,62,utRho01
ppiC,7919682,7919682,7919626,56,144,utRho01
ppiD,923638,923830,923638,192,690,utRho01
ppk,5245748,5246088,5245748,340,186,utRho01
pppA,6228958,6228958,6228704,254,8,utRho01
ppsA,3574322,3574322,3574224,98,0,utRho01
ppsR,3574678,3574890,3574678,212,32,utRho01
pptA,3065716,3066104,3065716,388,36,utRho01
pqiA,2023318,2024002,2023318,684,76,utRho01
prc,3830054,3830054,3829632,422,26348,utRho01
preT,4467978,4468066,4467978,88,60,utRho01
prfC,9218688,9218828,9218688,140,1038,utRho01
prkB,6968622,6968980,6968622,358,1116,utRho01
prlC,7290476,7290476,7290364,112,262,utRho01
prlF,6553944,6554004,6553944,60,88,utRho01
proB,520432,520776,520432,344,102,utRho01
proC,811372,811372,811288,84,0,utRho01
proK,7417388,7417388,7417384,4,12,utRho01
proL,4572414,4572422,4572414,8,18,utRho01
proP,8660640,8661004,8660640,364,5608,utRho01
proS,437674,437674,437550,124,390,utRho01
proV,5609126,5609630,5609126,504,232,utRho01
prpB,697292,697364,697292,72,8,utRho01
prpR,696942,696942,696886,56,0,utRho01
prs,2524354,2524354,2523750,604,59308,utRho01
psd,8781276,8781276,8780720,556,5310,utRho01
psiE,8480600,8480650,8480600,50,30,utRho01
pspA,2736076,2736158,2736076,82,0,utRho01
pspF,2736080,2736080,2735824,256,0,utRho01
pspG,8525632,8525680,8525632,48,4,utRho01
pssA,5445156,5445454,5445156,298,1678,utRho01
pstB,7817112,7817112,7816732,380,146,utRho01
pstC,7821084,7821084,7820796,288,46,utRho01
pstS,23469408,23469408,23469150,258,12,utRho01
psuG,4517114,4517114,4516734,380,32,utRho01
psuT,4514992,4514992,4514670,322,0,utRho01
pth,2517084,2517084,2517026,58,82,utRho01
ptrA,5918022,5918022,5917768,254,34,utRho01
ptrB,3857730,3857730,3857678,52,4352,utRho01
ptsG,2315252,2315738,2315252,486,2376,utRho01
ptsH,5066996,5067528,5066996,532,2748,utRho01
purA,8809328,8809374,8809328,46,32,utRho01
purC,5195562,5195562,5195236,326,28,utRho01
purD,8411972,8411972,8411862,110,40,utRho01
purE,1106284,1106284,1106200,84,1202,utRho01
purH,8415254,8415254,8415064,190,74,utRho01
purL,5391178,5391178,5391086,92,206,utRho01
purM,5242306,5242394,5242306,88,76,utRho01
purR,3475378,3475688,3475378,310,1406,utRho01
purT,3861438,3861762,3861438,324,80,utRho01
purU,2577512,2577512,2577248,264,896,utRho01
putA,2157850,2157850,2157764,86,0,utRho01
putP,2158336,2158610,2158336,274,420,utRho01
puuA,2721936,2721936,2721816,120,0,utRho01
puuC,2725456,2725486,2725456,30,0,utRho01
puuD,2722104,2722240,2722104,136,46,utRho01
puuP,2718746,2718746,2718374,372,460,utRho01
pykA,3874988,3875298,3874988,310,382,utRho01
pykF,3510934,3511396,3510934,462,1732,utRho01
pyrC,2245286,2245286,2245214,72,164,utRho01
pyrD,2009464,2009536,2009464,72,160,utRho01
pyrE,7631970,7631970,7631536,434,76,utRho01
pyrF,2683740,2683842,2683740,102,260,utRho01
pyrG,5819594,5819594,5819332,262,3362,utRho01
pyrH,383624,383710,383624,86,1626,utRho01
pyrL,8945490,8945490,8945066,424,54,utRho01
qmcA,1031646,1031646,1031546,100,46,utRho01
qor,8528608,8528608,8528462,146,258,utRho01
qseB,6339502,6339656,6339502,154,8,utRho01
queA,849970,850022,849970,52,772,utRho01
queE,5811212,5811212,5810836,376,86,utRho01
queF,5850642,5850696,5850642,54,0,utRho01
queG,8788184,8788184,8788134,50,820,utRho01
racC,2835630,2835630,2835526,104,0,utRho01
racR,2840898,2840898,2840482,416,44,utRho01
raiA,5474208,5474308,5474208,100,294,utRho01
rarD,8008594,8008594,8008356,238,146,utRho01
ravA,7862256,7862256,7862186,70,46,utRho01
rayT,495088,495274,495088,186,0,utRho01
rbn,4763162,4763216,4763162,54,2,utRho01
rbsD,7866644,7866702,7866644,58,0,utRho01
rcnA,4371654,4371834,4371654,180,6,utRho01
rcnB,4373768,4373920,4373768,152,80,utRho01
rcnR,4371806,4371806,4371592,214,24,utRho01
rcsA,4047672,4047936,4047672,264,304,utRho01
rcsB,4631390,4632354,4631390,964,1314,utRho01
rcsC,4640162,4640162,4639656,506,588,utRho01
rcsD,4626904,4626976,4626904,72,462,utRho01
rdgB,6193240,6193362,6193240,122,500,utRho01
rdlA,2538646,2538646,2538646,0,0,utRho01
rdlB,2539712,2539716,2539712,4,0,utRho01
rdlC,2540782,2540786,2540782,4,0,utRho01
rdlD,7400272,7400272,7400272,0,0,utRho01
rdoA,8084782,8084830,8084782,48,92,utRho01
recA,11295276,11295276,11295076,200,1600,utRho01
recC,5925014,5925014,5924856,158,70,utRho01
recF,7763722,7763722,7762442,1280,12374,utRho01
recN,5503518,5503590,5503518,72,0,utRho01
recQ,8011666,8011728,8011666,62,18,utRho01
relA,5828554,5828554,5827302,1252,378,utRho01
relB,3291806,3291806,3291744,62,36,utRho01
rem,3289950,3289950,3289804,146,24,utRho01
rep,7921294,7921354,7921294,60,94,utRho01
rfaD,7587730,7587974,7587730,244,326,utRho01
rfaE,6393852,6393852,6393506,346,0,utRho01
rfaH,8049930,8049930,8049642,288,2372,utRho01
rfbX,4219436,4219436,4219168,268,3056,utRho01
rfe,7935600,7935832,7935600,232,48,utRho01
rhaB,8194944,8194944,8194896,48,0,utRho01
rhaD,8188770,8188770,8188544,226,0,utRho01
rhaS,8195422,8195472,8195422,50,0,utRho01
rhaT,8201132,8201132,8201050,82,0,utRho01
rhlE,1661566,1661744,1661566,178,840,utRho01
rhoL,47593944,47594772,47593944,828,449292,utRho01
rhsB,7238006,7238384,7238006,378,232,utRho01
rhsC,1458758,1459166,1458758,408,0,utRho01
rhsD,1046132,1046522,1046132,390,0,utRho01
rhtA,1700608,1700608,1700194,414,16,utRho01
rhtC,8015478,8015514,8015478,36,2632,utRho01
ribA,2678468,2678468,2678320,148,78,utRho01
ribC,3486916,3486916,3486484,432,178,utRho01
ribE,869008,869294,869008,286,8442,utRho01
ribF,42766,42814,42766,48,14,utRho01
ridA,8941892,8941892,8941826,66,14,utRho01
rihA,1369204,1369204,1368824,380,476,utRho01
rihB,4510504,4510504,4510372,132,0,utRho01
rimJ,2251044,2251124,2251044,80,4,utRho01
rimK,1783752,1783934,1783752,182,208,utRho01
rimL,2997486,2997876,2997486,390,118,utRho01
rimO,1756140,1756140,1756070,70,8,utRho01
rimP,6636350,6636350,6636012,338,1078,utRho01
rlmA,3814172,3814172,3814120,52,284,utRho01
rlmD,5830086,5830086,5830000,86,22,utRho01
rlmE,6655520,6655520,6655328,192,3394,utRho01
rlmF,1684384,1684664,1684384,280,102,utRho01
rlmG,6471784,6471784,6471750,34,24,utRho01
rlmI,2060002,2060002,2059938,64,98,utRho01
rlmJ,7290700,7290770,7290700,70,86,utRho01
rlmL,2015344,2015688,2015344,344,1068,utRho01
rlpA,1330444,1330444,1330380,64,242,utRho01
rluA,120900,120900,120692,208,440,utRho01
rluF,8460324,8460708,8460324,384,56,utRho01
rmf,2031006,2031430,2031006,424,1874,utRho01
rna,1290068,1290068,1290006,62,52,utRho01
rnb,2698258,2698258,2697824,434,3018,utRho01
rnc,10816892,10816892,10816252,640,12144,utRho01
rnd,3776122,3776122,3775982,140,294,utRho01
rne,2289746,2289746,2288734,1012,11162,utRho01
rnhA,472082,472082,472004,78,418,utRho01
rnk,1288360,1288360,1287934,426,110,utRho01
rnlA,5531788,5531836,5531788,48,36,utRho01
rnlB,5533414,5533968,5533414,554,2706,utRho01
rnpB,19623552,19623552,19623552,0,0,utRho01
rob,9270706,9270706,9270620,86,18,utRho01
rodZ,5285868,5285868,5285688,180,202,utRho01
rpe,7030306,7030306,7030118,188,206,utRho01
rph,15266320,15266320,15266196,124,104,utRho01
rpiA,6118706,6118706,6118650,56,0,utRho01
rpiB,8626514,8626700,8626514,186,4,utRho01
rpiR,8626274,8626274,8625982,292,0,utRho01
rplJ,8359246,8359992,8359246,746,9826,utRho01
rplK,8356708,8356894,8356708,186,832,utRho01
rplM,6757344,6757344,6757302,42,13348,utRho01
rplN,6896444,6896444,6896298,146,6274,utRho01
rplS,5489284,5489284,5489060,224,16734,utRho01
rplT,7199052,7199052,7198996,56,912,utRho01
rplU,6667036,6667036,6666902,134,198,utRho01
rplY,4564866,4565034,4564866,168,78,utRho01
rpmA,6666450,6666450,6666238,212,710,utRho01
rpmB,15247980,15247980,15246696,1284,130128,utRho01
rpmE,8253816,8254026,8253816,210,690,utRho01
rpmF,2294676,2294734,2294676,58,67760,utRho01
rpmH,7768130,7768672,7768130,542,8248,utRho01
rpmI,3600854,3600854,3599998,856,16930,utRho01
rpoB,8362126,8362490,8362126,364,672,utRho01
rpoD,6424946,6426094,6424946,1148,23030,utRho01
rpoE,5420372,5420372,5420024,348,28,utRho01
rpoH,7202006,7202006,7201566,440,25568,utRho01
rpoN,6689324,6689434,6689324,110,38,utRho01
rpoS,5736236,5736236,5735102,1134,3572,utRho01
rpoZ,7644154,7644212,7644154,58,1080,utRho01
rppH,5937986,5937986,5937954,32,6,utRho01
rprA,3540744,3540744,3540744,0,0,utRho01
rpsA,1923434,1923990,1923434,556,182504,utRho01
rpsF,8850050,8850236,8850050,186,45588,utRho01
rpsI,6756580,6756580,6756414,166,12872,utRho01
rpsJ,6906884,6906884,6906540,344,10430,utRho01
rpsL,6949242,6949242,6949104,138,220,utRho01
rpsM,6885130,6885130,6884942,188,2300,utRho01
rpsO,13247144,13247144,13246736,408,1628,utRho01
rpsP,5492508,5492508,5492370,138,38,utRho01
rpsT,42420,42420,42156,264,1098,utRho01
rpsU,12842584,12843124,12842584,540,1932,utRho01
rraA,8238716,8238716,8238660,56,88,utRho01
rraB,8956768,8956946,8956768,178,0,utRho01
rrsA,8070478,8071062,8070478,584,10182,utRho01
rrsB,16665468,16666636,16665468,1168,21780,utRho01
rrsC,7883032,7883616,7883032,584,11690,utRho01
rrsD,6858094,6858094,6857524,570,610,utRho01
rrsE,8415726,8416294,8415726,568,1474,utRho01
rrsG,5462896,5462896,5462314,582,8510,utRho01
rrsH,446970,447542,446970,572,1324,utRho01
rsd,8393908,8393908,8393616,292,124,utRho01
rseA,5419264,5419264,5418808,456,880,utRho01
rseP,392940,393092,392940,152,164,utRho01
rseX,4067298,4067298,4067298,0,0,utRho01
rsfS,1338144,1338144,1338072,72,346,utRho01
rsgA,8783132,8783132,8783018,114,92,utRho01
rsmA,105176,105176,104860,316,4690,utRho01
rsmB,6869982,6870414,6869982,432,672,utRho01
rsmC,9215736,9215736,9215400,336,714,utRho01
rsmD,7208594,7208786,7208594,192,4,utRho01
rsmE,6182036,6182268,6182036,232,306,utRho01
rsmG,7847512,7847512,7847360,152,3032,utRho01
rsmH,180020,180188,180020,168,460,utRho01
rsmI,6587106,6587106,6586670,436,1154,utRho01
rssA,2578212,2578412,2578212,200,458,utRho01
rssB,2580440,2580484,2580440,44,492,utRho01
rstA,3364276,3364300,3364276,24,0,utRho01
rsuA,4561096,4561096,4560966,130,400,utRho01
rsxA,3411510,3411534,3411510,24,8,utRho01
rtcA,7114004,7114004,7113698,306,72,utRho01
rtcB,7116214,7116214,7116158,56,0,utRho01
rtn,4541356,4541452,4541356,96,158,utRho01
rutA,2148052,2148052,2148022,30,0,utRho01
rutG,2140090,2140090,2139678,412,70,utRho01
rutR,2148226,2148484,2148226,258,4,utRho01
ruvA,7784096,7784096,7783904,192,64,utRho01
ruvB,7782176,7782176,7781424,752,760,utRho01
ruvC,3894878,3894878,3894752,126,38,utRho01
rybB,1776114,1776114,1776114,0,0,utRho01
rydB,3529860,3529860,3529322,538,358,utRho01
rydC,2983012,2983012,2983012,0,0,utRho01
ryfA,5307398,5307710,5307398,312,26,utRho01
ryfD,5468590,5468590,5468590,0,0,utRho01
ryhB,7162032,7162032,7162032,0,0,utRho01
ryjA,8556132,8556132,8556132,0,0,utRho01
ryjB,9055954,9055954,9055954,0,0,utRho01
sad,3229598,3229598,3229406,192,88,utRho01
safA,3168056,3168056,3167918,138,0,utRho01
sanA,4465368,4465756,4465368,388,128,utRho01
sapF,2705314,2705314,2705268,46,120,utRho01
sbcB,4165456,4165512,4165456,56,0,utRho01
sbcC,831694,831694,831506,188,178,utRho01
sbcD,833954,833954,833904,50,18,utRho01
sbmA,793106,793278,793106,172,38,utRho01
sbmC,4162650,4162650,4162524,126,24,utRho01
sdaA,3793618,3793864,3793618,246,196,utRho01
sdaC,5856070,5856458,5856070,388,618,utRho01
sdhC,1509916,1510354,1509916,438,22968,utRho01
sdhD,1510808,1511120,1510808,312,5748,utRho01
sdiA,3993834,3993834,3993664,170,64,utRho01
secE,8354354,8354716,8354354,362,494,utRho01
secG,6645180,6645180,6645010,170,3860,utRho01
selA,7522594,7522594,7522498,96,624,utRho01
selB,7519850,7519850,7519722,128,156,utRho01
selC,7672396,7672444,7672396,48,0,utRho01
selD,3696058,3696058,3696016,42,4982,utRho01
seqA,1425884,1425974,1425884,90,688,utRho01
serA,6117098,6117098,6116820,278,76,utRho01
serB,9249712,9249790,9249712,78,20,utRho01
serC,3830380,3830612,3830380,232,0,utRho01
serS,1878730,1878856,1878730,126,3996,utRho01
serT,2063438,2063438,2063424,14,0,utRho01
serU,4087124,4087124,4087114,10,56,utRho01
serV,5637394,5637394,5637290,104,236,utRho01
serW,1852014,1852014,1851942,72,346,utRho01
serX,2195352,2195352,2195304,48,20,utRho01
setB,4527426,4527726,4527426,300,0,utRho01
setC,7673488,7673906,7673488,418,0,utRho01
sfmA,1116124,1116424,1116124,300,0,utRho01
sfmC,1117606,1117948,1117606,342,0,utRho01
sfsA,323030,323030,322972,58,246,utRho01
sfsB,6669592,6669818,6669592,226,482,utRho01
sgrR,154676,154676,154598,78,14,utRho01
sgrS,154734,154734,154734,0,0,utRho01
shiA,4107068,4107286,4107068,218,16,utRho01
sibA,4306622,4306622,4306622,0,0,utRho01
sibB,4307292,4307292,4307292,0,0,utRho01
sibC,6113702,6113702,6113702,0,0,utRho01
sibD,6389730,6389730,6389730,0,0,utRho01
sibE,6390480,6390480,6390480,0,0,utRho01
sixA,4913998,4913998,4913624,374,2,utRho01
slp,7307872,7307922,7307872,50,0,utRho01
slt,9261400,9261466,9261400,66,42,utRho01
slyA,3442028,3442028,3441648,380,132,utRho01
slyB,3439496,3439752,3439496,256,134,utRho01
slyD,6957398,6957398,6956994,404,406,utRho01
slyX,6954862,6955280,6954862,418,10132,utRho01
smf,6867372,6867372,6867120,252,224,utRho01
smpB,5509534,5509792,5509534,258,1696,utRho01
smrA,2811872,2811958,2811872,86,132,utRho01
smrB,4896872,4897212,4896872,340,70,utRho01
smtA,1946808,1947074,1946808,266,58,utRho01
sodA,8201518,8201620,8201518,102,7842,utRho01
sodB,3470646,3470756,3470646,110,38,utRho01
sodC,3449358,3449358,3449310,48,90,utRho01
sohB,2658568,2658664,2658568,96,84,utRho01
sokB,2984232,2984238,2984232,6,30,utRho01
solA,2241218,2241218,2241172,46,34,utRho01
soxR,8554894,8554938,8554894,44,20,utRho01
soxS,8554846,8554846,8554766,80,12,utRho01
speA,6172096,6172096,6171822,274,278,utRho01
speB,6167892,6167892,6167594,298,124,utRho01
speC,6218350,6218350,6218310,40,26,utRho01
spf,8099798,8099798,8099798,0,0,utRho01
sppA,3697422,3697674,3697422,252,26,utRho01
spy,3651376,3651376,3651250,126,0,utRho01
sra,3112092,3112092,3111926,166,0,utRho01
sraB,2293178,2293178,2293178,0,0,utRho01
sraC,3846132,3846132,3846132,0,0,utRho01
srlA,5651582,5651664,5651582,82,0,utRho01
srlR,5657720,5658094,5657720,374,472,utRho01
srmB,5425752,5425792,5425752,40,88,utRho01
sroA,151216,151216,151216,0,0,utRho01
sroG,6369436,6369436,6369436,0,0,utRho01
sroH,8380974,8380974,8380974,0,0,utRho01
ssb,8548022,8548250,8548022,228,428,utRho01
sseA,5304782,5304988,5304782,206,4888,utRho01
sspA,6755138,6755138,6754840,298,1082,utRho01
ssrA,5511014,5511186,5511014,172,290,utRho01
ssrS,12223036,12223932,12223036,896,1308,utRho01
sstT,6479726,6479888,6479726,162,132,utRho01
ssuB,1988282,1988282,1988088,194,0,utRho01
ssuE,1995126,1995126,1995024,102,0,utRho01
sthA,8321604,8321604,8321580,24,2292,utRho01
stpA,5597156,5597156,5596990,166,6,utRho01
sucA,3034344,3034824,3034344,480,1696,utRho01
sufA,3528836,3528836,3528772,64,24,utRho01
sufE,3518962,3518962,3518580,382,1728,utRho01
sugE,8753588,8753750,8753588,162,1078,utRho01
sulA,2041894,2041894,2041838,56,328,utRho01
syd,5850738,5850738,5850560,178,86,utRho01
symE,9159834,9159834,9159680,154,250,utRho01
symR,9159670,9159670,9159670,0,0,utRho01
tabA,8949566,8949724,8949566,158,0,utRho01
talA,5157140,5157332,5157140,192,2,utRho01
talB,16382,16476,16382,94,6034,utRho01
tam,3214442,3214692,3214442,250,0,utRho01
tamA,8884540,8884764,8884540,224,8,utRho01
tar,3945432,3945432,3945382,50,0,utRho01
tas,5943138,5943194,5943138,56,228,utRho01
tatA,16087636,16087780,16087636,144,196,utRho01
tatE,1317742,1317894,1317742,152,60,utRho01
tauA,770410,770464,770410,54,0,utRho01
tdcA,6534186,6534186,6534130,56,0,utRho01
tdcG,6519652,6519652,6519298,354,14,utRho01
tdcR,6534380,6534760,6534380,380,0,utRho01
tdk,2586986,2587054,2586986,68,50,utRho01
tehA,3001072,3001146,3001072,74,0,utRho01
tesA,1039898,1039898,1039530,368,294,utRho01
tesB,950402,950402,950322,80,0,utRho01
tfaE,2418532,2418532,2418238,294,44,utRho01
tfaQ,3269912,3269912,3269770,142,48,utRho01
tff,379424,379256,379424,168,28,utRho01
tgt,852110,852274,852110,164,12,utRho01
thiD,4369346,4369346,4369032,314,48,utRho01
thiI,882936,883098,882936,162,306,utRho01
thiM,4370902,4370902,4370602,300,566,utRho01
thiQ,146170,146170,145854,316,216,utRho01
thrL,592,760,592,168,1180,utRho01
thrS,7210932,7210932,7210280,652,4564,utRho01
thrU,8350762,8350776,8350762,14,60,utRho01
thrV,6847414,6847414,6847310,104,158516,utRho01
thrW,525682,525742,525682,60,794,utRho01
thyA,5930696,5930696,5930310,386,3208,utRho01
tig,909986,910266,909986,280,700,utRho01
tisB,7706674,7707106,7706674,432,298,utRho01
tktA,6163414,6163414,6163270,144,74,utRho01
tktB,5158616,5159272,5158616,656,860,utRho01
tldD,6784368,6784368,6784056,312,56,utRho01
tmcA,5191876,5191876,5191718,158,0,utRho01
tnaC,15553644,15553740,15553644,96,436,utRho01
tolB,1555074,1555480,1555074,406,676,utRho01
tolC,6356008,6356230,6356008,222,1000,utRho01
tomB,961588,961588,961416,172,8422,utRho01
tonB,2622108,2622178,2622108,70,42,utRho01
topA,2661578,2662096,2661578,518,1530,utRho01
torC,2116112,2116168,2116112,56,136,utRho01
torR,2115968,2115968,2115908,60,100,utRho01
torS,2112364,2112364,2112356,8,0,utRho01
torT,2112414,2112522,2112414,108,0,utRho01
tpiA,8223138,8223138,8223014,124,130,utRho01
tppB,3425342,3425538,3425342,196,5170,utRho01
tpr,2574376,2574376,2574376,0,0,utRho01
tpx,2777688,2777688,2777622,66,906,utRho01
tqsA,3347780,3347826,3347780,46,0,utRho01
treA,2494850,2494850,2494752,98,36,utRho01
treB,8932420,8932420,8932360,60,76,utRho01
treF,7339102,7339184,7339102,82,72,utRho01
treR,8934694,8934694,8934492,202,12,utRho01
trg,2984878,2984940,2984878,62,150,utRho01
trkG,2847342,2847564,2847342,222,16,utRho01
trmA,8326590,8326590,8326540,50,66,utRho01
trpA,2634678,2634678,2634444,234,1210,utRho01
trpC,2639888,2639888,2639570,318,80,utRho01
trpL,5292432,5292432,5292328,104,0,utRho01
trpR,9265408,9265520,9265408,112,134,utRho01
trpS,7027394,7027394,7027276,118,1088,utRho01
trpT,7893560,7893914,7893560,354,121108,utRho01
trxA,7931294,7931522,7931294,228,950,utRho01
trxB,1864156,1864156,1864100,56,64,utRho01
trxC,5437350,5437470,5437350,120,376,utRho01
tsaD,6421256,6421256,6421086,170,0,utRho01
tsgA,6985038,6985136,6985038,98,110,utRho01
tsr,9182824,9183314,9182824,490,156,utRho01
tsx,864490,864490,864026,464,566,utRho01
ttcA,2823970,2823970,2823896,74,3960,utRho01
ttdA,6412848,6412926,6412848,78,0,utRho01
ttdR,6412760,6412760,6412512,248,0,utRho01
tufA,6943448,6943448,6942658,790,160226,utRho01
tus,3368346,3368518,3368346,172,46,utRho01
tusA,7218040,7218040,7217992,48,56,utRho01
tusB,6950218,6950218,6949930,288,870,utRho01
tynA,2902996,2902996,2902698,298,0,utRho01
typA,8116460,8116814,8116460,354,8114,utRho01
tyrB,8534164,8534228,8534164,64,1872,utRho01
tyrP,3979004,3979362,3979004,358,32,utRho01
tyrR,2773384,2773440,2773384,56,26,utRho01
tyrS,3434566,3434566,3434444,122,8,utRho01
tyrT,2575330,2575330,2575244,86,98,utRho01
uacT,6062378,6062734,6062378,356,0,utRho01
ubiC,8504886,8505012,8504886,126,160,utRho01
ubiD,8049618,8049976,8049618,358,2462,utRho01
ubiE,8037494,8037710,8037494,216,172,utRho01
ubiG,4679078,4679134,4679078,56,4,utRho01
ucpA,5089342,5089342,5089246,96,0,utRho01
udp,8032782,8032862,8032782,80,138,utRho01
ugd,4199470,4199470,4199226,244,20,utRho01
ugpB,7184852,7184852,7184650,202,144,utRho01
ugpQ,7176600,7176600,7176226,374,0,utRho01
uhpT,7694396,7694396,7694334,62,52,utRho01
uidA,3392304,3392304,3392142,162,0,utRho01
uidC,3386012,3386012,3385702,310,0,utRho01
uidR,3394150,3394150,3394104,46,112,utRho01
ulaA,8839854,8839960,8839854,106,190,utRho01
ulaG,8839350,8839350,8839250,100,0,utRho01
ulaR,8837124,8837124,8836906,218,38,utRho01
umpG,5741372,5741372,5740548,824,152,utRho01
umpH,1400704,1400704,1400652,52,56,utRho01
umuD,2461476,2461534,2461476,58,0,utRho01
ung,5433476,5433508,5433476,32,26,utRho01
uof,2843316,2843316,2842900,416,10740,utRho01
upp,5241818,5241818,5241744,74,412,utRho01
usg,4873780,4873780,4873298,482,318,utRho01
ushA,1009772,1009828,1009772,56,0,utRho01
uspA,7279966,7280222,7279966,256,884,utRho01
uspB,7279696,7279696,7279440,256,898,utRho01
uspC,3959172,3959506,3959172,334,4,utRho01
uspE,2797318,2797318,2797244,74,48,utRho01
uspF,2871282,2871282,2871238,44,66,utRho01
uspG,1283806,1283806,1283734,72,504,utRho01
uvrA,8547872,8547872,8547742,130,416,utRho01
uvrB,1626304,1627052,1626304,748,2222,utRho01
uvrC,3989758,3989758,3989412,346,474,utRho01
uvrD,7995814,7995966,7995814,152,136,utRho01
uvrY,3990812,3990812,3990718,94,28,utRho01
uxaB,3221474,3221474,3221360,114,38,utRho01
uxaC,6489714,6489714,6489482,232,0,utRho01
uxuA,9103036,9103272,9103036,236,116,utRho01
uxuR,9108916,9109152,9108916,236,8,utRho01
valS,8967854,8967854,8967674,180,468,utRho01
valU,5041848,5041862,5041848,14,14,utRho01
valV,3492830,3492870,3492830,40,10,utRho01
ves,3649968,3649968,3649874,94,0,utRho01
waaA,7616512,7617080,7616512,568,688,utRho01
waaH,7580298,7580298,7580162,136,60,utRho01
waaQ,7616476,7616476,7616196,280,142,utRho01
waaU,7598996,7598996,7598624,372,310,utRho01
waaY,7602272,7602272,7601930,342,7096,utRho01
wbbH,4214888,4214888,4214452,436,7248,utRho01
wbbK,4209212,4209212,4209018,194,374,utRho01
wcaM,4231868,4231868,4231792,76,56,utRho01
wrbA,2135516,2135516,2135416,100,0,utRho01
wza,4275166,4275166,4274486,680,0,utRho01
wzxC,4240674,4240674,4240316,358,0,utRho01
wzzB,4196950,4196950,4196602,348,336,utRho01
xanP,7657642,7657890,7657642,248,0,utRho01
xanQ,6048520,6048702,6048520,182,0,utRho01
xapA,5049820,5049820,5049756,64,0,utRho01
xapR,10090252,10090252,10089908,344,68,utRho01
xdhA,6000514,6000690,6000514,176,160,utRho01
xerD,6079702,6079702,6079486,216,84,utRho01
xseA,5268394,5268464,5268394,70,758,utRho01
xseB,882746,882746,882686,60,332,utRho01
xthA,3664798,3664856,3664798,58,12,utRho01
xylA,7461614,7461614,7461530,84,204,utRho01
xylE,8484540,8484540,8484508,32,0,utRho01
xylF,7462138,7462262,7462138,124,0,utRho01
xylR,7469812,7469958,7469812,146,0,utRho01
yaaA,13230,13230,12918,312,100,utRho01
yaaI,23876,23876,23572,304,56,utRho01
yaaJ,16034,16034,15918,116,204,utRho01
yaaU,91184,91614,91184,430,0,utRho01
yaaW,23084,23084,22712,372,60,utRho01
yaaX,10060,10468,10060,408,128,utRho01
yabI,142542,142702,142542,160,12,utRho01
yacC,273880,273880,273834,46,4944,utRho01
yacH,262932,262932,262520,412,80,utRho01
yacL,268678,268776,268678,98,4,utRho01
yadD,293796,293936,293796,140,20,utRho01
yadE,289930,290162,289930,232,758,utRho01
yadN,314110,314110,313766,344,42,utRho01
yadS,355572,355572,355248,324,268,utRho01
yadV,312470,312470,312402,68,2,utRho01
yaeF,434270,434270,434006,264,110,utRho01
yaeP,428374,428374,428250,124,12,utRho01
yaeQ,428176,428582,428176,406,64,utRho01
yaeR,423716,423754,423716,38,0,utRho01
yafC,462166,462166,461762,404,450,utRho01
yafD,462128,462244,462128,116,312,utRho01
yafK,491986,491986,491610,376,2686,utRho01
yafL,493282,493424,493282,142,56,utRho01
yafN,503938,504010,503938,72,0,utRho01
yafS,469568,469632,469568,64,378,utRho01
yafT,474470,474670,474470,200,12,utRho01
yafV,480432,480432,480378,54,54,utRho01
yafZ,536052,536052,536010,42,152,utRho01
yagE,564446,564556,564446,110,2,utRho01
yagG,570414,570790,570414,376,20,utRho01
yagI,578384,578384,578324,60,26,utRho01
yagK,586236,586236,585896,340,110,utRho01
yagL,588062,588062,587836,226,0,utRho01
yagN,591342,591342,591158,184,954,utRho01
yahA,663746,664742,663746,996,492,utRho01
yahC,670136,670136,670044,92,0,utRho01
yahE,671478,671850,671478,372,0,utRho01
yahM,690504,690808,690504,304,80,utRho01
yahN,692872,692872,692674,198,62,utRho01
yahO,692864,692968,692864,104,10,utRho01
yaiE,816296,816354,816296,58,78,utRho01
yaiI,811396,811528,811396,132,0,utRho01
yaiO,761946,761946,761684,262,8,utRho01
yaiP,767970,767970,767870,100,0,utRho01
yaiS,769660,769660,769232,428,0,utRho01
yaiV,788922,788922,788922,0,0,utRho01
yaiY,799094,799094,798666,428,586,utRho01
yaiZ,798888,799186,798888,298,1242,utRho01
yajC,854410,854574,854410,164,1900,utRho01
yajD,860938,861210,860938,272,690,utRho01
yajI,866068,866068,865702,366,194,utRho01
yajL,887496,887496,887282,214,270,utRho01
yajQ,889316,889366,889316,50,32,utRho01
yajR,893374,893374,893332,42,724,utRho01
ybaB,987418,988152,987418,734,2688,utRho01
ybaL,1006590,1006590,1006476,114,122,utRho01
ybaM,980648,980648,980542,106,1086,utRho01
ybaN,981436,981764,981436,328,376,utRho01
ybaO,936704,936766,936704,62,0,utRho01
ybaP,1016568,1016568,1016160,408,1370,utRho01
ybaQ,1016348,1016436,1016348,88,134,utRho01
ybaS,1023146,1023282,1023146,136,76,utRho01
ybaV,927504,927874,927504,370,84,utRho01
ybaY,950490,950758,950490,268,24,utRho01
ybbB,1062724,1062724,1062452,272,46,utRho01
ybbJ,1030154,1030154,1029718,436,1034,utRho01
ybbL,1031784,1031838,1031784,54,34,utRho01
ybbN,1037136,1037136,1036558,578,1336,utRho01
ybbO,1038658,1038658,1038298,360,1526,utRho01
ybbY,1080718,1081130,1080718,412,0,utRho01
ybcH,1176140,1176140,1175962,178,78,utRho01
ybcI,1113264,1113264,1113106,158,1198,utRho01
ybcJ,1114050,1114050,1113746,304,200,utRho01
ybcK,1137502,1137804,1137502,302,22,utRho01
ybcL,1141690,1141786,1141690,96,0,utRho01
ybcN,1144628,1144932,1144628,304,0,utRho01
ybcQ,1147548,1147912,1147548,364,0,utRho01
ybcW,1159610,1159760,1159610,150,0,utRho01
ybdD,1263982,1264364,1263982,382,134,utRho01
ybdF,1212106,1212106,1211772,334,236,utRho01
ybdH,1267048,1267048,1266954,94,8,utRho01
ybdJ,1212822,1212822,1212398,424,72,utRho01
ybdK,1215122,1215122,1214766,356,160,utRho01
ybdL,1267114,1267172,1267114,58,30,utRho01
ybdM,1271110,1271110,1270752,358,160,utRho01
ybdN,1273372,1273372,1273138,234,26,utRho01
ybdR,1283844,1284176,1283844,332,756,utRho01
ybeD,1325412,1325412,1325284,128,116,utRho01
ybeF,1323090,1323090,1322756,334,16,utRho01
ybeL,1349986,1350036,1349986,50,36,utRho01
ybeQ,1353412,1353412,1353094,318,2,utRho01
ybeR,1353120,1353422,1353120,302,2,utRho01
ybeT,1358832,1358832,1358812,20,0,utRho01
ybeU,1358924,1359016,1358924,92,0,utRho01
ybeZ,1386938,1386938,1386834,104,2632,utRho01
ybfA,1458074,1458268,1458074,194,18,utRho01
ybfE,1423878,1423878,1423796,82,708,utRho01
ybfF,1425692,1425692,1425604,88,706,utRho01
ybfH,1433282,1433282,1433194,88,0,utRho01
ybgA,1477840,1478002,1477840,162,0,utRho01
ybgC,1549288,1549504,1549288,216,14,utRho01
ybgD,1505916,1505916,1505590,326,522,utRho01
ybgI,1485238,1485654,1485238,416,0,utRho01
ybgO,1498370,1498370,1497964,406,42,utRho01
ybgS,1570992,1570992,1570634,358,24,utRho01
ybhA,1597184,1597184,1596862,322,134,utRho01
ybhB,1616070,1616070,1615818,252,320,utRho01
ybhC,1614642,1614642,1614562,80,842,utRho01
ybhD,1601418,1601418,1601276,142,0,utRho01
ybhH,1601104,1601518,1601104,414,42,utRho01
ybhK,1633384,1633384,1633294,90,10,utRho01
ybhM,1641556,1641586,1641556,30,0,utRho01
ybhN,1645296,1645296,1644996,300,82,utRho01
ybhQ,1649202,1649260,1649202,58,76,utRho01
ybiA,1665920,1665920,1665900,20,0,utRho01
ybiI,1676968,1676968,1676912,56,146,utRho01
ybiO,1691328,1691328,1690960,368,350,utRho01
ybiP,1705252,1705252,1705194,58,2032,utRho01
ybiS,1711572,1711572,1711488,84,958,utRho01
ybiT,1711894,1711926,1711894,32,0,utRho01
ybiU,1718212,1718212,1718122,90,28,utRho01
ybiV,1720176,1720176,1720056,120,0,utRho01
ybiW,1725566,1725566,1725212,354,52,utRho01
ybiX,1678548,1678548,1678414,134,1518,utRho01
ybjC,1781784,1781826,1781784,42,0,utRho01
ybjE,1830154,1830154,1829714,440,200,utRho01
ybjG,1767016,1767016,1766776,240,866,utRho01
ybjL,1779882,1779882,1779638,244,172,utRho01
ybjM,1779770,1780178,1779770,408,100,utRho01
ybjO,1795704,1795978,1795704,274,4,utRho01
ybjP,1809046,1809046,1808934,112,0,utRho01
ybjQ,1809034,1809186,1809034,152,12,utRho01
ybjS,1813796,1813796,1813506,290,232,utRho01
ybjX,1838206,1838206,1838168,38,0,utRho01
ycaD,1891438,1891742,1891438,304,0,utRho01
ycaI,1928210,1928640,1928210,430,416,utRho01
ycaK,1899094,1899336,1899094,242,0,utRho01
ycaL,1920264,1920528,1920264,264,28,utRho01
ycaM,1894240,1894458,1894240,218,0,utRho01
ycaR,1941284,1941346,1941284,62,2482,utRho01
ycbB,1961862,1962094,1961862,232,94,utRho01
ycbJ,1943344,1943504,1943344,160,10,utRho01
ycbK,1966046,1966150,1966046,104,496,utRho01
ycbZ,2036920,2036920,2036598,322,100,utRho01
yccA,2062886,2062886,2062836,50,734,utRho01
yccF,2048730,2048730,2048696,34,0,utRho01
yccS,2047988,2047988,2047766,222,52,utRho01
yccT,2055674,2055674,2055546,128,20,utRho01
yccX,2059960,2060128,2059960,168,278,utRho01
ycdT,2185682,2185752,2185682,70,0,utRho01
ycdU,2191266,2191686,2191266,420,0,utRho01
ycdZ,2200504,2200592,2200504,88,44,utRho01
yceA,2233544,2233614,2233544,70,178,utRho01
yceD,2293298,2293588,2293298,290,4366,utRho01
yceF,2293522,2293522,2293190,332,2766,utRho01
yceH,2252154,2252314,2252154,160,440,utRho01
yceI,2237282,2237282,2236952,330,122,utRho01
yceJ,2238142,2238142,2238092,50,136,utRho01
yceM,2253208,2253612,2253208,404,132,utRho01
yceO,2239264,2239264,2238894,370,362,utRho01
yceQ,2288760,2289004,2288760,244,9498,utRho01
ycfD,2376540,2376540,2376480,60,546,utRho01
ycfJ,2334814,2335198,2334814,384,1240,utRho01
ycfS,2340834,2340834,2340748,86,0,utRho01
ycfT,2350658,2350658,2350330,328,18,utRho01
ycfZ,2362760,2362760,2362534,226,614,utRho01
ycgB,2474570,2474570,2474482,88,0,utRho01
ycgG,2434614,2434656,2434614,42,38,utRho01
ycgJ,2452956,2453200,2452956,244,34,utRho01
ycgL,2455218,2455362,2455218,144,58,utRho01
ycgN,2457366,2457660,2457366,294,92,utRho01
ycgR,2489112,2489112,2489054,58,0,utRho01
ycgV,2512222,2512222,2511904,318,288,utRho01
ycgX,2426568,2426568,2426214,354,23172,utRho01
ycgY,2490166,2490320,2490166,154,6,utRho01
ycgZ,2431504,2431578,2431504,74,44,utRho01
ychE,2596904,2597196,2596904,292,112,utRho01
ychF,2515764,2515764,2515624,140,186,utRho01
ychH,2517476,2517582,2517476,106,520,utRho01
ychJ,2578354,2578354,2578264,90,12,utRho01
ychN,2547310,2547310,2547198,112,132,utRho01
ychO,2547520,2547850,2547520,330,288,utRho01
ychQ,2533798,2533848,2533798,50,34,utRho01
yciA,2624828,2624828,2624492,336,214,utRho01
yciB,2626110,2626110,2625780,330,3658,utRho01
yciC,2627396,2627396,2627326,70,34,utRho01
yciE,2630794,2630794,2630448,346,4,utRho01
yciG,5264368,5264368,5264140,228,0,utRho01
yciI,2621784,2621784,2621730,54,4,utRho01
yciN,2661606,2661606,2661336,270,156,utRho01
yciS,2680270,2680486,2680270,216,184,utRho01
yciT,2689088,2689088,2688692,396,620,utRho01
yciU,2614718,2614718,2614300,418,4658,utRho01
yciV,2646376,2646440,2646376,64,0,utRho01
yciW,2700472,2700472,2700214,258,598,utRho01
yciZ,2689276,2689276,2689218,58,370,utRho01
ycjD,2703792,2703792,2703520,272,144,utRho01
ycjG,2777748,2777860,2777748,112,78,utRho01
ycjM,2740006,2740432,2740006,426,92,utRho01
ycjW,2767982,2767982,2767922,60,80,utRho01
ycjX,2768138,2768234,2768138,96,146,utRho01
ycjY,5568288,5568288,5567460,828,100,utRho01
ydaE,2836438,2836438,2836016,422,20,utRho01
ydaN,2816048,2816100,2816048,52,20,utRho01
ydaS,2840340,2840730,2840340,390,290,utRho01
ydbC,2948376,2948442,2948376,66,0,utRho01
ydbD,2950132,2950288,2950132,156,0,utRho01
ydbH,2885800,2886102,2885800,302,0,utRho01
ydbJ,2881712,2882116,2881712,404,90,utRho01
ydbK,2881692,2881692,2881568,124,38,utRho01
ydcA,2983294,2983354,2983294,60,12,utRho01
ydcF,2974404,2974470,2974404,66,38,utRho01
ydcI,2990268,2990268,2990142,126,40,utRho01
ydcJ,2990266,2990576,2990266,310,0,utRho01
ydcK,3001280,3001280,3000898,382,0,utRho01
ydcL,3004646,3004914,3004646,268,4,utRho01
ydcN,3012308,3012344,3012308,36,0,utRho01
ydcP,3013508,3013562,3013508,54,8,utRho01
ydcR,3019956,3020006,3019956,50,0,utRho01
ydcS,3022906,3023308,3022906,402,76,utRho01
ydcX,3034442,3034778,3034442,336,72,utRho01
ydcY,3035220,3035296,3035220,76,146,utRho01
ydcZ,3036750,3036750,3036662,88,268,utRho01
yddB,3155332,3155332,3155238,94,38,utRho01
yddE,3071738,3071738,3071716,22,0,utRho01
yddG,3094410,3094410,3094338,72,0,utRho01
yddJ,3089732,3089732,3089438,294,0,utRho01
yddW,3137704,3137704,3137646,58,10,utRho01
ydeA,3233910,3234056,3233910,146,224,utRho01
ydeE,3242528,3242664,3242528,136,0,utRho01
ydeI,3249118,3249118,3248994,124,0,utRho01
ydeJ,3249376,3249546,3249376,170,0,utRho01
ydeN,3165458,3165458,3165048,410,0,utRho01
ydeP,3173328,3173328,3172972,356,0,utRho01
ydeR,3176596,3176596,3176592,4,0,utRho01
ydfA,3296872,3297016,3296872,144,86,utRho01
ydfG,3254982,3255034,3254982,52,2,utRho01
ydfH,3256652,3256704,3256652,52,130,utRho01
ydfK,3265446,3266144,3265446,698,57910,utRho01
ydgA,3379588,3379704,3379588,116,48,utRho01
ydgC,3364124,3364124,3364060,64,92,utRho01
ydgD,3343906,3343920,3343906,14,78,utRho01
ydgH,3356754,3356854,3356754,100,106,utRho01
ydgJ,3408798,3408798,3408616,182,14,utRho01
ydgK,3410414,3410500,3410414,86,244,utRho01
ydhB,3479618,3479618,3479596,22,0,utRho01
ydhC,3479698,3479822,3479698,124,0,utRho01
ydhF,3451310,3451310,3451264,46,14,utRho01
ydhI,3441996,3442050,3441996,54,0,utRho01
ydhL,3451864,3451864,3451840,24,50,utRho01
ydhQ,3492404,3492404,3492254,150,0,utRho01
ydhS,3494136,3494262,3494136,126,564,utRho01
ydhT,3499138,3499138,3499118,20,0,utRho01
ydhY,3509284,3509284,3508954,330,0,utRho01
ydhZ,3510418,3510418,3510282,136,0,utRho01
ydiE,3579206,3579226,3579206,20,44,utRho01
ydiH,3530582,3530582,3530406,176,10,utRho01
ydiM,3541852,3542142,3541852,290,0,utRho01
ydiN,3544818,3545024,3544818,206,0,utRho01
ydiP,3558656,3558656,3558602,54,0,utRho01
ydiU,3582508,3582508,3582488,20,36,utRho01
ydiV,3584174,3584174,3584040,134,66,utRho01
ydiY,3612500,3612500,3612166,334,18,utRho01
ydjA,3697400,3697400,3697352,48,52,utRho01
ydjE,3708082,3708082,3707958,124,0,utRho01
ydjF,3709848,3709848,3709708,140,0,utRho01
ydjM,3620340,3620422,3620340,82,0,utRho01
ydjO,3626696,3626696,3626288,408,0,utRho01
ydjX,3666434,3666802,3666434,368,1952,utRho01
yeaE,3731448,3731448,3731272,176,132,utRho01
yeaG,3733530,3733816,3733530,286,0,utRho01
yeaI,3740486,3740770,3740486,284,0,utRho01
yeaJ,3743874,3744082,3743874,208,146,utRho01
yeaL,3748646,3748704,3748646,58,572,utRho01
yeaM,3751296,3751296,3751152,144,0,utRho01
yeaN,3750926,3751346,3750926,420,60,utRho01
yeaO,3753554,3753818,3753554,264,118,utRho01
yeaP,3755314,3755430,3755314,116,1136,utRho01
yeaQ,3758780,3758780,3758510,270,144,utRho01
yeaR,3759988,3759988,3759896,92,92,utRho01
yeaY,3781122,3781122,3781064,58,110,utRho01
yebB,3892220,3892502,3892220,282,0,utRho01
yebC,3896370,3896370,3896302,68,26,utRho01
yebE,3859464,3859464,3859414,50,416,utRho01
yebG,3861530,3861530,3861494,36,16,utRho01
yebK,3873180,3873304,3873180,124,0,utRho01
yebQ,3820314,3820552,3820314,238,8,utRho01
yebS,3832238,3832516,3832238,278,10,utRho01
yebV,3843430,3843560,3843430,130,32,utRho01
yebW,3843914,3844242,3843914,328,1648,utRho01
yecC,3995646,3995646,3995628,18,10,utRho01
yecD,3901272,3901664,3901272,392,34,utRho01
yecF,3991434,3991636,3991434,202,206,utRho01
yecH,3979304,3979304,3978980,324,34,utRho01
yecJ,3975604,3975604,3975516,88,22,utRho01
yecM,3919968,3919968,3919692,276,32,utRho01
yecR,3976400,3976444,3976400,44,54,utRho01
yecT,3923862,3923944,3923862,82,278,utRho01
yedD,4016522,4016522,4016180,342,66,utRho01
yedE,4016310,4016554,4016310,244,82,utRho01
yedI,4058922,4058922,4058732,190,0,utRho01
yedJ,4066446,4066446,4066158,288,56,utRho01
yedV,4076404,4076404,4076304,100,112,utRho01
yedX,4077680,4077912,4077680,232,26,utRho01
yedY,4078572,4078956,4078572,384,56,utRho01
yeeA,4161322,4161322,4161182,140,12,utRho01
yeeE,4171104,4171104,4171050,54,0,utRho01
yeeJ,4089526,4089822,4089526,296,612,utRho01
yeeN,4113508,4113716,4113508,208,30,utRho01
yeeO,4119444,4119444,4119692,248,16,utRho01
yeeX,4158834,4158834,4158722,112,512,utRho01
yeeZ,4178422,4178422,4178256,166,54,utRho01
yefM,4179466,4179466,4179426,40,16,utRho01
yegD,4295288,4295348,4295288,60,66,utRho01
yegH,4275726,4275804,4275726,78,0,utRho01
yegI,4302154,4302154,4301970,184,0,utRho01
yegJ,4302032,4302370,4302032,338,20,utRho01
yegQ,4331182,4331336,4331182,154,10,utRho01
yegR,4336698,4336698,4336612,86,0,utRho01
yegS,4337086,4337424,4337086,338,64,utRho01
yegT,4357562,4357642,4357562,80,0,utRho01
yegX,4367640,4367640,4367302,338,24,utRho01
yehA,4376944,4376944,4376828,116,2,utRho01
yehE,4385818,4385818,4385592,226,2,utRho01
yehK,4407568,4407944,4407568,376,16,utRho01
yehL,4408804,4409192,4408804,388,0,utRho01
yeiB,4486146,4486146,4485934,212,28,utRho01
yeiE,4499422,4499422,4499236,186,0,utRho01
yeiG,4487776,4487820,4487776,44,452,utRho01
yeiH,4499332,4499434,4499332,102,16,utRho01
yeiI,4503306,4503400,4503306,94,144,utRho01
yeiL,4510580,4510710,4510580,130,0,utRho01
yeiP,4530834,4530900,4530834,66,664,utRho01
yeiQ,4532328,4532490,4532328,162,100,utRho01
yeiR,4535484,4535658,4535484,174,80,utRho01
yeiW,4530840,4530840,4530590,250,978,utRho01
yejA,4544624,4544728,4544624,104,86,utRho01
yejG,4556892,4556892,4556474,418,5934,utRho01
yejH,4561244,4561264,4561244,20,2,utRho01
yejK,4568218,4568218,4567894,324,482,utRho01
yejO,4578352,4578352,4577800,552,148,utRho01
yfaD,4713380,4713808,4713380,428,272,utRho01
yfaE,4696676,4697028,4696676,352,1666,utRho01
yfaL,4688568,4688568,4688338,230,0,utRho01
yfaP,4656398,4656398,4656286,112,12,utRho01
yfaU,4717892,4717892,4717690,202,0,utRho01
yfaY,4727310,4727310,4727266,44,86,utRho01
yfaZ,4728744,4728744,4728550,194,4,utRho01
yfbK,4771810,4771810,4771444,366,34,utRho01
yfbL,4771500,4771720,4771500,220,34,utRho01
yfbN,4777174,4777174,4776852,322,0,utRho01
yfbO,4776916,4777162,4776916,246,0,utRho01
yfbP,4777990,4778232,4777990,242,918,utRho01
yfbR,4817662,4817724,4817662,62,68,utRho01
yfcI,4847424,4847424,4847078,346,66,utRho01
yfcJ,4880482,4880482,4880240,242,178,utRho01
yfcL,4888502,4888502,4888338,164,82,utRho01
yfcV,4911642,4911642,4911292,350,0,utRho01
yfcZ,4921958,4921958,4921868,90,96,utRho01
yfdF,4925604,4926024,4925604,420,604,utRho01
yfdG,4935474,4935710,4935474,236,20,utRho01
yfdP,4946844,4947040,4946844,196,0,utRho01
yfdX,4988866,4988866,4988804,62,4,utRho01
yfdY,4990672,4990672,4990584,88,20,utRho01
yfeA,5035784,5035784,5035664,120,42560,utRho01
yfeC,5036668,5036934,5036668,266,228,utRho01
yfeH,5053818,5053892,5053818,74,0,utRho01
yfeK,5074630,5074684,5074630,54,12,utRho01
yfeO,5018906,5019260,5018906,354,260,utRho01
yfeR,5054078,5054078,5053712,366,24,utRho01
yfeX,5101356,5101356,5101090,266,0,utRho01
yfeY,5102486,5102486,5102432,54,34,utRho01
yfeZ,5103842,5103842,5103452,390,32,utRho01
yffO,5123804,5124222,5123804,418,30,utRho01
yffQ,5126778,5127154,5126778,376,56,utRho01
yffS,5128800,5128986,5128800,186,66,utRho01
yfgC,5232052,5232188,5232052,136,0,utRho01
yfgF,5258062,5258062,5257876,186,44,utRho01
yfgG,5258170,5258580,5258170,410,304,utRho01
yfgH,5259344,5259584,5259344,240,34,utRho01
yfgM,5278866,5278866,5278566,300,712,utRho01
yfhH,5397414,5397518,5397414,104,32,utRho01
yfhM,5304648,5304648,5304574,74,62,utRho01
yfhR,5328408,5328726,5328408,318,5960,utRho01
yfiC,5425610,5425610,5425528,82,6,utRho01
yfiE,5430688,5430688,5430640,48,0,utRho01
yfiL,5482630,5482720,5482630,90,0,utRho01
yfiM,5448066,5448358,5448066,292,23296,utRho01
yfiR,5483354,5483750,5483354,396,236,utRho01
yfjH,5517326,5517326,5517200,126,0,utRho01
yfjI,5517710,5517970,5517710,260,84,utRho01
yfjJ,5521014,5521094,5521014,80,0,utRho01
yfjM,5531970,5531970,5531552,418,974,utRho01
yfjP,5535080,5535420,5535080,340,184,utRho01
yfjW,5546570,5546636,5546570,66,0,utRho01
yfjX,5551776,5551838,5551776,62,0,utRho01
ygaC,5601180,5601180,5599988,1192,1486,utRho01
ygaM,5600242,5600292,5600242,50,274,utRho01
ygaU,5593628,5593628,5593572,56,50,utRho01
ygaZ,5619190,5619234,5619190,44,1328,utRho01
ygbA,5713656,5713656,5713612,44,0,utRho01
ygbE,5746784,5746784,5746674,110,192,utRho01
ygbI,5722882,5722882,5722528,354,70,utRho01
ygbK,5724394,5724670,5724394,276,40,utRho01
ygbL,5727074,5727186,5727074,112,2,utRho01
ygbN,5729814,5730202,5729814,388,14,utRho01
ygcG,5811210,5811422,5811210,212,62,utRho01
ygcN,5785144,5785314,5785144,170,28,utRho01
ygcU,5799214,5799214,5798836,378,0,utRho01
ygcW,5800942,5800942,5800546,396,0,utRho01
ygdD,5883442,5883442,5883262,180,92,utRho01
ygdG,5861746,5861930,5861746,184,596,utRho01
ygdI,5886526,5886526,5886290,236,116,utRho01
ygdQ,5940784,5940840,5940784,56,0,utRho01
ygdR,5942494,5942542,5942494,48,34,utRho01
ygeA,5961606,5961606,5961270,336,0,utRho01
ygeH,5983758,5984188,5983758,430,0,utRho01
ygeI,5987162,5987276,5987162,114,0,utRho01
ygeR,6000078,6000078,5999782,296,588,utRho01
ygeV,6011694,6011694,6011572,122,0,utRho01
ygeW,6012234,6012524,6012234,290,0,utRho01
ygfB,6110946,6110946,6110888,58,72,utRho01
ygfK,6031984,6032120,6031984,136,0,utRho01
ygfS,6058328,6058328,6058024,304,0,utRho01
ygfZ,6082564,6082626,6082564,62,210,utRho01
yggC,6149512,6149512,6149378,134,0,utRho01
yggE,6136370,6136370,6136160,210,2,utRho01
yggI,6179176,6179510,6179176,334,280,utRho01
yggL,6204508,6204508,6204266,242,4,utRho01
yggM,6199514,6199514,6199130,384,314,utRho01
yggN,6203596,6203596,6203246,350,0,utRho01
yggX,18623958,18624558,18623958,600,744,utRho01
yghA,6298966,6299324,6298966,358,30,utRho01
yghB,6307058,6307126,6307058,68,56,utRho01
yghD,6222614,6222614,6222252,362,172,utRho01
yghF,6225798,6225798,6225840,42,0,utRho01
yghJ,6238640,6238640,6238224,416,0,utRho01
yghQ,6265186,6265186,6264816,370,0,utRho01
yghT,6267830,6268262,6267830,432,0,utRho01
yghU,6277400,6277454,6277400,54,2,utRho01
yghW,6293506,6293506,6293474,32,16,utRho01
yghZ,6295562,6295794,6295562,232,60,utRho01
ygiD,6365122,6365122,6364868,254,446,utRho01
ygiH,6409066,6409388,6409066,322,10,utRho01
ygiL,6370622,6370828,6370622,206,0,utRho01
ygiM,6402084,6402414,6402084,330,184,utRho01
ygiN,6346156,6346284,6346156,128,1008,utRho01
ygiQ,6322620,6322620,6322292,328,938,utRho01
ygiS,6335462,6335462,6335436,26,18,utRho01
ygiV,6338582,6338582,6338462,120,18,utRho01
ygiW,6339774,6339774,6339352,422,30,utRho01
ygiZ,6344506,6344506,6344422,84,0,utRho01
ygjH,6442528,6442528,6442494,34,0,utRho01
ygjI,6452140,6452468,6452140,328,0,utRho01
ygjQ,6472730,6473080,6472730,350,208,utRho01
ygjR,6474564,6474586,6474564,22,34,utRho01
ygjV,6483638,6483638,6483488,150,8,utRho01
yhaB,6535632,6535708,6535632,76,46,utRho01
yhaH,6504498,6504608,6504498,110,10,utRho01
yhaI,6505400,6505822,6505400,422,2,utRho01
yhaJ,6508560,6508560,6508428,132,92,utRho01
yhaK,6508538,6508638,6508538,100,102,utRho01
yhbQ,6599878,6599932,6599878,54,102,utRho01
yhbT,6602736,6602736,6602552,184,34,utRho01
yhbU,6602558,6602970,6602558,412,34,utRho01
yhbX,6643302,6643302,6643226,76,0,utRho01
yhbY,6655518,6655580,6655518,62,2244,utRho01
yhcA,6723956,6724224,6723956,268,0,utRho01
yhcB,6760364,6760382,6760364,18,234,utRho01
yhcC,6708470,6708470,6708100,370,654,utRho01
yhcF,6733440,6733852,6733440,412,140,utRho01
yhcH,6739124,6739124,6738956,168,82,utRho01
yhcM,6760312,6760312,6759994,318,156,utRho01
yhcN,6770812,6771076,6770812,264,1168,utRho01
yhcO,6772606,6772606,6772258,348,0,utRho01
yhdH,6806560,6806968,6806560,408,224,utRho01
yhdJ,6823234,6823306,6823234,72,0,utRho01
yhdN,6879092,6879092,6879018,74,2966,utRho01
yhdT,6814702,6814750,6814702,48,554,utRho01
yhdU,6824994,6825242,6824994,248,136,utRho01
yhdV,6836392,6836780,6836392,388,0,utRho01
yhdW,6837944,6838298,6837944,354,36,utRho01
yheO,6953082,6953082,6952880,202,1586,utRho01
yheV,6957970,6957970,6957584,386,198,utRho01
yhfA,6971902,6971902,6971636,266,114,utRho01
yhfG,6983294,6983294,6983240,54,248,utRho01
yhfL,6998622,6998896,6998622,274,60,utRho01
yhfY,7023244,7023244,7022844,400,0,utRho01
yhgA,7086294,7086334,7086294,40,0,utRho01
yhgE,7065176,7065176,7064878,298,150,utRho01
yhgF,7074352,7074770,7074352,418,1652,utRho01
yhhA,7173458,7173886,7173458,428,8,utRho01
yhhI,7248346,7248756,7248346,410,0,utRho01
yhhJ,7253696,7253696,7253606,90,10,utRho01
yhhM,7211588,7211588,7211220,368,346,utRho01
yhhN,7211150,7211502,7211150,352,320,utRho01
yhhQ,7218238,7218434,7218238,196,870,utRho01
yhhT,7223682,7223730,7223682,48,2,utRho01
yhhX,7162032,7162032,7161610,422,1172,utRho01
yhhY,7162222,7162276,7162222,54,0,utRho01
yhhZ,7163516,7163726,7163516,210,0,utRho01
yhiD,7312220,7312220,7311804,416,2724,utRho01
yhiJ,7265190,7265190,7265180,10,0,utRho01
yhiM,7269270,7269682,7269270,412,216,utRho01
yhiN,7275000,7275000,7274820,180,150,utRho01
yhjA,7338522,7338522,7338376,146,0,utRho01
yhjB,7344090,7344090,7343788,302,32,utRho01
yhjC,7344272,7344684,7344272,412,0,utRho01
yhjD,7346660,7346724,7346660,64,0,utRho01
yhjE,7349274,7349572,7349274,298,48,utRho01
yhjG,7356824,7356824,7356730,94,0,utRho01
yhjH,7358458,7358458,7358374,84,12,utRho01
yhjJ,7364032,7364032,7363880,152,80,utRho01
yhjK,7371296,7371296,7371158,138,16,utRho01
yhjR,7392750,7392750,7392370,380,26,utRho01
yhjV,7400796,7401126,7400796,330,1060,utRho01
yhjX,7424194,7424194,7424014,180,24,utRho01
yhjY,7425966,7425966,7425868,98,24,utRho01
yiaB,7455654,7455654,7455496,158,0,utRho01
yiaD,7432712,7433094,7432712,382,98,utRho01
yiaF,7438194,7438194,7438088,106,36,utRho01
yiaG,7438862,7438956,7438862,94,100,utRho01
yiaJ,7485236,7485236,7485064,172,0,utRho01
yiaK,7485348,7485466,7485348,118,0,utRho01
yiaT,7503924,7503924,7503736,188,0,utRho01
yiaU,7503792,7503984,7503792,192,0,utRho01
yiaY,7515856,7515856,7515654,202,80,utRho01
yibF,7523950,7523950,7523910,40,0,utRho01
yibG,7536128,7536354,7536128,226,2,utRho01
yibL,7553194,7553330,7553194,136,206,utRho01
yibN,7570112,7570112,7570030,82,276,utRho01
yibT,7552848,7552848,7552760,88,24,utRho01
yicC,7633290,7633352,7633290,62,82,utRho01
yicH,7660862,7660914,7660862,52,26,utRho01
yicJ,7673328,7673328,7671858,1470,710,utRho01
yicN,7685018,7685018,7684804,214,2,utRho01
yicO,7687914,7687914,7687578,336,0,utRho01
yicR,15250308,15250308,15250236,72,0,utRho01
yidB,7755230,7755230,7754930,300,12,utRho01
yidE,7732780,7732780,7732546,234,2,utRho01
yidF,7711580,7711580,7711222,358,134,utRho01
yidQ,7735088,7735456,7735088,368,470,utRho01
yidR,7738824,7738824,7738618,206,0,utRho01
yieE,7787658,7787738,7787658,80,416,utRho01
yieH,7793314,7793548,7793314,234,0,utRho01
yieK,7798928,7798928,7798786,142,0,utRho01
yifB,7900350,7900350,7899998,352,358,utRho01
yifL,7988984,7989044,7988984,60,182,utRho01
yigF,8005750,8005750,8005598,152,56,utRho01
yigI,8009448,8009448,8009394,54,0,utRho01
yigM,8022100,8022152,8022100,52,88,utRho01
yihA,8101970,8101970,8101458,512,198,utRho01
yihD,8084098,8084138,8084098,40,90,utRho01
yihF,8088110,8088398,8088110,288,0,utRho01
yihG,8093304,8093304,8093204,100,56,utRho01
yihI,8102616,8102694,8102616,78,0,utRho01
yihL,8120506,8120894,8120506,388,50,utRho01
yihN,8124332,8124494,8124332,162,0,utRho01
yihO,8131942,8131942,8131532,410,96,utRho01
yihQ,8138892,8138892,8138552,340,0,utRho01
yihV,8147064,8147478,8147064,414,8,utRho01
yihX,8151096,8151106,8151096,10,78,utRho01
yiiE,8158192,8158582,8158192,390,0,utRho01
yiiF,8159124,8159502,8159124,378,32,utRho01
yiiG,8173762,8174004,8173762,242,0,utRho01
yiiM,8205506,8205644,8205506,138,42,utRho01
yiiQ,8224624,8224624,8224428,196,32,utRho01
yiiS,8225738,8225934,8225738,196,12,utRho01
yijE,8272178,8272216,8272178,38,36,utRho01
yijF,8275728,8275728,8275314,414,38,utRho01
yijO,8296858,8296858,8296634,224,8,utRho01
yjaA,8426240,8426468,8426240,228,114164,utRho01
yjaB,8428312,8428312,8428246,66,690,utRho01
yjaG,8398746,8399008,8398746,262,1420,utRho01
yjaH,8401022,8401132,8401022,110,124,utRho01
yjaZ,8379506,8379572,8379506,66,4,utRho01
yjbB,8455204,8455462,8455204,258,0,utRho01
yjbE,16943432,16943624,16943432,192,0,utRho01
yjbL,8520318,8520642,8520318,324,0,utRho01
yjbQ,8540428,8540476,8540428,48,0,utRho01
yjcB,8550328,8550328,8550082,246,9468,utRho01
yjcC,8550836,8550942,8550836,106,106,utRho01
yjcD,8556628,8556958,8556628,330,52,utRho01
yjcE,8559658,8559960,8559658,302,40,utRho01
yjcF,8566212,8566212,8566150,62,0,utRho01
yjcO,8594660,8594660,8594250,410,0,utRho01
yjdA,8654128,8654270,8654128,142,14,utRho01
yjdC,8726660,8726660,8726616,44,0,utRho01
yjdK,8704780,8705168,8704780,388,160,utRho01
yjdL,8713034,8713034,8712822,212,14,utRho01
yjdM,8653672,8653672,8653468,204,160,utRho01
yjeF,8787354,8788132,8787354,778,11196,utRho01
yjeI,8745522,8745618,8745522,96,2,utRho01
yjeJ,8748806,8748806,8748468,338,68,utRho01
yjeV,8785472,8785784,8785472,312,396,utRho01
yjfP,8833512,8833904,8833512,392,32,utRho01
yjfY,8849656,8849656,8849582,74,30,utRho01
yjfZ,8855052,8855052,8854844,208,0,utRho01
yjgA,8916162,8916162,8915730,432,176,utRho01
yjgL,8950802,8950874,8950802,72,0,utRho01
yjgM,8959342,8959342,8959074,268,0,utRho01
yjgN,8959132,8959460,8959132,328,0,utRho01
yjgR,8980170,8980170,8980126,44,164,utRho01
yjgZ,9002116,9002520,9002116,404,576,utRho01
yjhB,9007764,9008116,9007764,352,4,utRho01
yjhG,9048452,9048452,9048188,264,392,utRho01
yjhU,9041080,9041080,9040648,432,418,utRho01
yjiA,9178096,9178096,9177730,366,218,utRho01
yjiJ,9125364,9125364,9125350,14,0,utRho01
yjiK,9127270,9127270,9127422,152,146,utRho01
yjiL,9129604,9129604,9129378,226,0,utRho01
yjiS,9143410,9143502,9143410,92,0,utRho01
yjiY,9182734,9182734,9182558,176,10,utRho01
yjjA,9200674,9200674,9200378,296,342,utRho01
yjjB,18408708,18408708,18407800,908,104,utRho01
yjjJ,9243314,9243538,9243314,224,26,utRho01
yjjK,9261132,9261132,9261044,88,172,utRho01
yjjL,9189764,9189764,9189444,320,0,utRho01
yjjM,9191894,9191894,9191702,192,0,utRho01
yjjP,9206068,9206068,9205716,352,88,utRho01
yjjQ,9206638,9206954,9206638,316,84,utRho01
yjjX,9267798,9267798,9267490,308,534,utRho01
yjjY,9280716,9280804,9280716,88,456,utRho01
yjjZ,9211554,9211608,9211554,54,1208,utRho01
yjtD,9281676,9281884,9281676,208,2,utRho01
ykfB,532454,532454,532174,280,324,utRho01
ykfI,527636,527636,527338,298,18,utRho01
ykgB,637050,637050,636638,412,0,utRho01
ykgC,640430,640430,640002,428,0,utRho01
ykgD,640232,640454,640232,222,0,utRho01
ykgE,642962,643216,642962,254,40,utRho01
ykgJ,608524,608524,608364,160,154,utRho01
ykgL,623878,624224,623878,346,128,utRho01
ykgM,625610,625610,625554,56,8,utRho01
ykgR,626570,626570,626484,86,0,utRho01
ylaC,958576,958576,958502,74,1396,utRho01
yliE,1745938,1745958,1745938,20,0,utRho01
ymcE,2103660,2103694,2103660,34,868,utRho01
ymdA,2210450,2210828,2210450,378,244,utRho01
ymdB,2211428,2211640,2211428,212,114,utRho01
ymfD,2395322,2395322,2395064,258,172,utRho01
ymfI,2402880,2402994,2402880,114,0,utRho01
ymfJ,2404518,2404518,2404168,350,122,utRho01
ymfK,2406176,2406176,2405866,310,108,utRho01
ymfT,2405766,2406048,2405766,282,108,utRho01
ymgE,2489110,2489456,2489110,346,80,utRho01
ymgF,2437628,2437966,2437628,338,0,utRho01
ymiA,2670112,2670320,2670112,208,106,utRho01
ymjA,2715620,2715620,2715336,284,576,utRho01
ynaI,2791946,2791946,2791844,102,0,utRho01
ynaK,2850438,2850754,2850438,316,42,utRho01
ynbA,2954924,2955242,2954924,318,0,utRho01
yncD,3046552,3046552,3046130,422,196,utRho01
yncE,3046454,3046614,3046454,160,0,utRho01
yncG,3052456,3052494,3052456,38,28,utRho01
yncL,3034492,3034492,3034388,104,4,utRho01
yneE,3218364,3218364,3218044,320,82,utRho01
yneF,3223748,3223748,3223708,40,0,utRho01
yneJ,3229560,3229608,3229560,48,110,utRho01
yneK,3231100,3231526,3231100,426,0,utRho01
yneM,3245176,3245292,3245176,116,294,utRho01
ynfA,3311398,3311398,3311346,52,28,utRho01
ynfB,3311418,3311616,3311418,198,240,utRho01
ynfC,3315094,3315094,3314914,180,0,utRho01
ynfD,3314828,3315130,3314828,302,0,utRho01
ynfE,3316006,3316138,3316006,132,14,utRho01
ynfK,3334670,3334670,3334438,232,228,utRho01
ynfL,3339304,3339304,3339184,120,0,utRho01
ynfM,3339260,3339398,3339260,138,50,utRho01
ynfN,3276598,3276598,3276218,380,2202,utRho01
ynfO,3273454,3273512,3273454,58,18,utRho01
ynhG,3517890,3517890,3517450,440,520,utRho01
yniA,3615158,3615592,3615158,434,80,utRho01
yniB,3618526,3618526,3618466,60,0,utRho01
yniC,3618652,3618760,3618652,108,0,utRho01
yniD,3610202,3610330,3610202,128,0,utRho01
ynjE,3678880,3678934,3678880,54,42,utRho01
ynjF,3683222,3683222,3682806,416,10,utRho01
ynjH,3684376,3684376,3684270,106,24,utRho01
ynjI,3690022,3690022,3689742,280,0,utRho01
yoaB,3786642,3786734,3786642,92,206,utRho01
yoaC,3787932,3788146,3787932,214,310,utRho01
yoaE,3803544,3803544,3803170,374,134,utRho01
yoaF,3755444,3755444,3755064,380,1258,utRho01
yoaH,3789866,3789866,3789462,404,518,utRho01
yobB,3850418,3850880,3850418,462,1012,utRho01
yobF,3815586,3815586,3815182,404,218,utRho01
yobH,3817800,3817850,3817800,50,50,utRho01
yodB,4084352,4084736,4084352,384,88,utRho01
yodC,4057008,4057008,4056740,268,28,utRho01
yohC,4451358,4451358,4451262,96,16,utRho01
yohD,4451526,4451602,4451526,76,8,utRho01
yohJ,4460986,4461248,4460986,262,36,utRho01
yohO,4431172,4431314,4431172,142,84,utRho01
yojI,4617282,4617282,4617230,52,0,utRho01
ypdI,4988988,4989396,4988988,408,108,utRho01
ypfG,5165786,5165786,5165554,232,0,utRho01
ypfM,5182140,5182140,5181732,408,30,utRho01
yphB,5349590,5349590,5349376,214,42,utRho01
ypjA,5565644,5565644,5565452,192,56,utRho01
ypjB,5569636,5569636,5568858,778,0,utRho01
ypjD,5495860,5495774,5495860,86,0,utRho01
yqaE,5594170,5594170,5594056,114,120,utRho01
yqcA,5846100,5846100,5845968,132,60,utRho01
yqcE,5800944,5801184,5800944,240,0,utRho01
yqeC,6030468,6030468,6030114,354,0,utRho01
yqeF,5971618,5971618,5971184,434,48,utRho01
yqeG,5971438,5971694,5971438,256,26,utRho01
yqeH,5975016,5975072,5975016,56,0,utRho01
yqeI,5976688,5977004,5976688,316,0,utRho01
yqeK,5981140,5981140,5980720,420,12,utRho01
yqfA,6086728,6086728,6086296,432,904,utRho01
yqgA,6219042,6219106,6219042,64,0,utRho01
yqgB,6172500,6172500,6172102,398,1964,utRho01
yqgE,6185768,6185874,6185768,106,490,utRho01
yqhA,6299150,6299150,6298942,208,30,utRho01
yqhC,6310768,6310768,6310436,332,74,utRho01
yqhD,6310604,6310710,6310604,106,72,utRho01
yqhH,6316842,6317254,6316842,412,650,utRho01
yqiC,6369662,6369680,6369662,18,54,utRho01
yqiJ,6384108,6384416,6384108,308,216,utRho01
yqjA,6495096,6495546,6495096,450,10398,utRho01
yqjF,6500932,6501124,6500932,192,40,utRho01
yqjG,6501948,6502048,6501948,100,0,utRho01
yqjH,6433078,6433078,6432982,96,44,utRho01
yqjI,6433506,6433558,6433506,52,0,utRho01
yraH,6574552,6574852,6574552,300,0,utRho01
yraP,6592144,6592818,6592144,674,296,utRho01
yraQ,6596414,6596414,6596276,138,0,utRho01
yraR,6598024,6598024,6597692,332,34,utRho01
yrbG,13360844,13361100,13360844,256,224,utRho01
yrbL,6696842,6696904,6696842,62,858,utRho01
yrbN,6616172,6616172,6615866,306,22678,utRho01
yrdB,6860176,6860176,6860046,130,378,utRho01
yrfF,7052548,7052938,7052548,390,320,utRho01
yrhB,7169440,7169518,7169440,78,0,utRho01
ysaB,7451804,7451804,7451424,380,26,utRho01
ysgA,8032686,8032686,8032338,348,254,utRho01
ytfB,8857638,8857638,8857434,204,106,utRho01
ytfE,8864018,8864018,8863966,52,30,utRho01
ytfF,8866296,8866296,8866130,166,90,utRho01
ytfH,8868164,8868226,8868164,62,0,utRho01
ytfI,8875234,8875414,8875234,180,32,utRho01
ytfJ,8878572,8878572,8878524,48,0,utRho01
ytfK,8879022,8879174,8879022,152,192,utRho01
ytfL,8882642,8882642,8882430,212,150,utRho01
ytfQ,8899634,8899924,8899634,290,152,utRho01
ytjB,9249598,9249598,9249578,20,20,utRho01
yzfA,8896588,8896588,8896490,98,68,utRho01
zapA,6111102,6111224,6111102,122,6998,utRho01
zapB,8236772,8237030,8236772,258,130,utRho01
zapC,2011700,2011904,2011700,204,44,utRho01
zinT,4082692,4082750,4082692,58,0,utRho01
zipA,5062814,5062814,5062466,348,56,utRho01
zitB,1569716,1569716,1569646,70,0,utRho01
zntA,7212844,7212902,7212844,58,108,utRho01
zntR,6878336,6878336,6878260,76,30,utRho01
znuA,3885322,3885322,3885166,156,0,utRho01
znuC,3885268,3885324,3885268,56,0,utRho01
zraP,8403424,8403424,8403376,48,20,utRho01
zraS,8403810,8403852,8403810,42,0,utRho01
zupT,6364866,6365100,6364866,234,446,utRho01
zur,8520282,8520282,8520006,276,1736,utRho01
zwf,3872752,3872752,3872628,124,98,utRho01
C0343,2818676,2818728,2818676,52,0,utRho02
aaeB,6776526,6776526,6776376,150,0,utRho02
aaeR,6778762,6779040,6778762,278,126,utRho02
aaeX,6778860,6778860,6778674,186,254,utRho02
aat,1854920,1854920,1854864,56,12,utRho02
accA,416822,417242,416822,420,2200,utRho02
accB,6810280,6810872,6810280,592,12592,utRho02
accD,4868030,4868030,4867852,178,584,utRho02
aceB,8430804,8430956,8430804,152,0,utRho02
aceE,245938,246034,245938,96,716,utRho02
ackA,4826918,4826940,4826918,22,2808,utRho02
acnA,2670848,2671662,2670848,814,874,utRho02
acnB,263038,263230,263038,192,1892,utRho02
acpP,2303148,2303230,2303148,82,374,utRho02
acpS,5402324,5402324,5401996,328,282,utRho02
acrA,971396,971396,971238,158,536,utRho02
acrB,969370,969370,968806,564,2146,utRho02
acrD,5174950,5175190,5174950,240,24,utRho02
acrE,6827404,6827728,6827404,324,4,utRho02
acrR,971398,971522,971398,124,314,utRho02
acrZ,1589502,1589546,1589502,44,90,utRho02
acs,8575190,8575190,8574742,448,20,utRho02
actP,8569870,8569870,8569804,66,0,utRho02
ada,4620854,4620854,4620810,44,0,utRho02
add,3404404,3404466,3404404,62,58,utRho02
ade,7687802,7687928,7687802,126,0,utRho02
adhE,2596826,2596826,2596242,584,132,utRho02
adhP,3107988,3107988,3107676,312,1022,utRho02
adiA,8681112,8681112,8681042,70,0,utRho02
adiC,8674404,8674404,8674062,342,4,utRho02
adiY,8676084,8676084,8675858,226,0,utRho02
adk,994278,994350,994278,72,92,utRho02
adrA,807374,807406,807374,32,0,utRho02
aer,6438240,6438240,6438152,88,48,utRho02
aes,1000102,1000102,999946,156,24,utRho02
agaR,6557406,6557406,6557330,76,0,utRho02
agaS,6563778,6563952,6563778,174,0,utRho02
agp,2131118,2131170,2131118,52,0,utRho02
agrA,7296126,7296126,7296126,0,0,utRho02
agrB,7296588,7296588,7296588,0,0,utRho02
ahpC,1277386,1277890,1277386,504,1648,utRho02
ahpF,1278004,1279506,1278004,1502,60080,utRho02
ahr,8992698,8992698,8992418,280,0,utRho02
aidB,8828494,8828550,8828494,56,0,utRho02
ais,4731512,4731512,4731240,272,0,utRho02
alaA,4814816,4815122,4814816,306,44,utRho02
alaC,4996798,4996798,4996590,208,32,utRho02
alaE,5598140,5598328,5598140,188,296,utRho02
alaS,5644180,5644180,5644022,158,2292,utRho02
alaW,5036612,5036612,5036462,150,0,utRho02
aldA,2976380,2976464,2976380,84,116,utRho02
aldB,7513070,7513070,7513022,48,0,utRho02
alkA,4295118,4295118,4295080,38,124,utRho02
alkB,4618890,4618890,4618682,208,112,utRho02
allA,1064780,1064902,1064780,122,0,utRho02
allD,1092822,1092822,1092726,96,0,utRho02
allE,1088112,1088112,1088092,20,110,utRho02
allS,1064600,1064600,1064442,158,0,utRho02
alr,8531178,8531564,8531178,386,3596,utRho02
alsE,8617334,8617334,8616956,378,16,utRho02
alsK,8615990,8615990,8615598,392,342,utRho02
alx,6476740,6477160,6476740,420,8,utRho02
amiA,5104482,5104704,5104482,222,6,utRho02
amiC,5898378,5898378,5898020,358,10,utRho02
amn,4110062,4110122,4110062,60,0,utRho02
ampC,8758006,8758006,8757888,118,0,utRho02
ampD,237362,237466,237362,104,54,utRho02
ampG,907372,907372,907090,282,602,utRho02
ampH,792726,792726,792574,152,40,utRho02
amyA,4012230,4012312,4012230,82,78,utRho02
anmK,3439346,3439346,3439204,142,0,utRho02
ansB,6201580,6201580,6201456,124,178,utRho02
ansP,3052040,3052040,3051960,80,386,utRho02
apaG,104068,104068,103212,856,9550,utRho02
apaH,102586,102586,102444,142,6478,utRho02
apbE,4623188,4623188,4623068,120,50,utRho02
appA,2081198,2081234,2081198,36,0,utRho02
appC,2075420,2075480,2075420,60,0,utRho02
appY,1167134,1167362,1167134,228,0,utRho02
apt,982620,982824,982620,204,450,utRho02
aqpZ,1832424,1832424,1832094,330,4,utRho02
araB,140150,140150,140096,54,0,utRho02
araC,140482,140774,140482,292,0,utRho02
araE,5964416,5964416,5964364,52,0,utRho02
araF,3972476,3972476,3972256,220,0,utRho02
araH,3967120,3967120,3967086,34,0,utRho02
araJ,825058,825058,824962,96,152,utRho02
arcA,9281602,9281602,9280612,990,12920,utRho02
arcB,6706098,6706098,6706050,48,0,utRho02
arcZ,6701154,6701154,6701154,0,0,utRho02
arfA,6877346,6877346,6877298,48,770,utRho02
argA,5898312,5898484,5898312,172,0,utRho02
argC,8309770,8310002,8309770,232,64,utRho02
argD,6980442,6980442,6980360,82,0,utRho02
argE,8310156,8310156,8309694,462,84,utRho02
argF,580680,580680,580610,70,0,utRho02
argG,6637124,6637274,6637124,150,0,utRho02
argI,8956688,8956688,8956622,66,2,utRho02
argO,6137672,6137672,6137616,56,372,utRho02
argP,6119460,6119506,6119460,46,0,utRho02
argR,6769204,6769406,6769204,202,80,utRho02
argS,3920002,3920124,3920002,122,0,utRho02
argT,4855698,4855698,4855582,116,336,utRho02
argU,1129406,1129446,1129406,40,16,utRho02
argW,4932616,4932618,4932616,2,0,utRho02
argX,7964728,7964750,7964728,22,0,utRho02
aroF,5482402,5482402,5482300,102,0,utRho02
aroG,1571182,1571266,1571182,84,40,utRho02
aroH,3576636,3576870,3576636,234,462,utRho02
aroK,7038760,7038760,7038128,632,2476,utRho02
aroL,812560,812810,812560,250,112,utRho02
aroP,243342,243342,243102,240,0,utRho02
arpA,8445382,8445382,8444974,408,296,utRho02
arrS,7316108,7316108,7316108,0,0,utRho02
arsR,7297024,7297056,7297024,32,2,utRho02
artJ,1801252,1801252,1801150,102,60,utRho02
artP,1807686,1807686,1807468,218,4,utRho02
ascF,5678858,5679048,5678858,190,0,utRho02
ascG,5678574,5678574,5678528,46,0,utRho02
aslB,7965562,7965916,7965562,354,49752,utRho02
asnA,7854258,7854310,7854258,52,34,utRho02
asnB,1398444,1398444,1398354,90,1162,utRho02
asnC,23562186,23562186,23562018,168,0,utRho02
asnS,1978088,1978088,1977970,118,12350,utRho02
asnT,4089082,4089098,4089082,16,8,utRho02
asnU,4119690,4119702,4119690,12,0,utRho02
asnV,4124504,4124520,4124504,16,0,utRho02
aspA,17473728,17473728,17473308,420,64,utRho02
aspC,1971486,1971486,1971418,68,510,utRho02
aspS,3901402,3901402,3901044,358,104,utRho02
aspT,7893560,7893744,7893560,184,101626,utRho02
aspV,473826,473862,473826,36,8,utRho02
asr,3342654,3342752,3342654,98,82,utRho02
astC,3664088,3664088,3663964,124,0,utRho02
astE,3654138,3654138,3653846,292,0,utRho02
atoD,4646824,4646894,4646824,70,0,utRho02
atpB,7844540,7844540,7844102,438,1096,utRho02
atpC,7832118,7832118,7831944,174,1504,utRho02
atpI,7845050,7845050,7844880,170,82,utRho02
avtA,7479348,7479410,7479348,62,326,utRho02
azoR,2965982,2965982,2965720,262,224,utRho02
azuC,3976002,3976002,3975918,84,106,utRho02
bacA,6408350,6408350,6408262,88,4,utRho02
bamA,394052,395856,394052,1804,1488,utRho02
bamB,5277950,5277950,5277304,646,2390,utRho02
bamC,5198028,5198028,5197730,298,1498,utRho02
bamD,5471922,5472292,5471922,370,9314,utRho02
bamE,5506972,5507210,5506972,238,444,utRho02
basS,8666954,8666954,8666544,410,322,utRho02
bax,7474468,7474468,7474354,114,168,utRho02
bcp,5200874,5200956,5200874,82,1800,utRho02
bcsB,7385346,7385346,7385214,132,0,utRho02
bcsE,7392644,7392916,7392644,272,150,utRho02
bdcA,8948128,8948128,8948106,22,70,utRho02
bdcR,8948192,8948248,8948192,56,0,utRho02
bdm,3112680,3112680,3112560,120,0,utRho02
betA,654522,654522,654494,28,192,utRho02
betI,658722,658722,658668,54,50,utRho02
betT,658842,658926,658842,84,50,utRho02
bfr,6933498,6933498,6933450,48,0,utRho02
bglG,23440182,23440182,23439402,780,0,utRho02
bglX,4444240,4444240,4443978,262,0,utRho02
bhsA,2337962,2338146,2337962,184,152,utRho02
bioA,1618584,1618584,1618514,70,26,utRho02
bioB,1618604,1618688,1618604,84,4,utRho02
bioH,7089716,7089716,7089688,28,0,utRho02
bisC,7433026,7433026,7432788,238,140,utRho02
blc,8755490,8755490,8755444,46,22,utRho02
blr,3409024,3409102,3409024,78,0,utRho02
bluF,2431226,2431226,2430950,276,2724,utRho02
bluR,2428226,2428226,2428118,108,0,utRho02
bolA,908698,908944,908698,246,0,utRho02
borD,1157842,1157842,1157786,56,4,utRho02
brnQ,838976,839182,838976,206,3166,utRho02
bssR,1756492,1756496,1756492,4,0,utRho02
bssS,2242116,2242116,2241910,206,954,utRho02
btuB,8326798,8327278,8326798,480,3832,utRho02
cadB,8720212,8720212,8720062,150,40,utRho02
cadC,8723926,8723926,8723868,58,0,utRho02
caiE,70998,70998,70742,256,0,utRho02
caiF,68436,68600,68436,164,0,utRho02
caiT,84074,84074,83862,212,0,utRho02
can,285406,285406,285340,66,96,utRho02
carA,59102,59302,59102,200,66,utRho02
carB,61550,61634,61550,84,86,utRho02
cas2,5757830,5757830,5757706,124,0,utRho02
casA,5768638,5768638,5768276,362,0,utRho02
cbl,4121882,4121882,4121828,54,0,utRho02
cbpA,2128074,2128074,2127550,524,862,utRho02
cbrA,7738628,7738754,7738628,126,0,utRho02
cbrB,7794958,7795012,7794958,54,34,utRho02
ccmH,4585242,4585242,4584820,422,220,utRho02
cdaR,364894,364926,364894,32,22,utRho02
cdd,4463638,4463688,4463638,50,94,utRho02
cdh,8219814,8219860,8219814,46,0,utRho02
cdsA,391110,391354,391110,244,2630,utRho02
cedA,3627484,3627484,3627326,158,62,utRho02
cfa,3482402,3482826,3482402,424,598,utRho02
chaC,2544844,2544972,2544844,128,0,utRho02
chbB,3643452,3643452,3643238,214,0,utRho02
chbG,3634624,3634624,3634270,354,0,utRho02
cheW,3946924,3946924,3946678,246,240,utRho02
chiA,6939792,6939792,6939706,86,0,utRho02
chiP,1416472,1416668,1416472,196,42,utRho02
cho,3646984,3647030,3646984,46,0,utRho02
chpS,8896804,8896894,8896804,90,0,utRho02
cirA,4493884,4493884,4493538,346,842,utRho02
citC,1304078,1304078,1303712,366,0,utRho02
citT,1293264,1293264,1293160,104,0,utRho02
clcA,350104,350214,350104,110,44,utRho02
clpA,1846160,1846528,1846160,368,4,utRho02
clpB,5468410,5468410,5468346,64,38,utRho02
clpP,913154,913354,913154,200,718,utRho02
clpS,1845500,1845826,1845500,326,76,utRho02
clpX,914404,914852,914404,448,1750,utRho02
clsA,2617346,2617346,2617290,56,86,utRho02
clsC,2212584,2212710,2212584,126,342,utRho02
cmk,1922330,1922402,1922330,72,202,utRho02
cnu,3409522,3409898,3409522,376,1000,utRho02
coaA,8350214,8350214,8350052,162,1152,utRho02
cobC,1340092,1340092,1339814,278,828,utRho02
cobT,4129202,4129202,4128934,268,36,utRho02
cobU,4131944,4131944,4131528,416,534,utRho02
codB,709768,709844,709768,76,2,utRho02
comR,2337726,2337726,2337664,62,0,utRho02
copA,1022822,1022822,1022758,64,0,utRho02
corA,8002388,8002852,8002388,464,5530,utRho02
cpdB,8873258,8873258,8873130,128,48,utRho02
cptB,6082198,6082198,6082140,58,56,utRho02
cpxA,8210202,8210202,8209950,252,1162,utRho02
cpxP,8211570,8211640,8211570,70,116,utRho02
cpxR,8211372,8211372,8211340,32,40,utRho02
cra,175894,176056,175894,162,52,utRho02
crcB,1316016,1316016,1315876,140,118,utRho02
creA,9270486,9271042,9270486,556,706,utRho02
creD,9276320,9276356,9276320,36,28,utRho02
crl,515620,515658,515620,38,1848,utRho02
crp,6971906,6972240,6971906,334,5510,utRho02
crr,5070960,5071668,5070960,708,8470,utRho02
csdA,5886414,5886674,5886414,260,242,utRho02
csgB,2207718,2207902,2207718,184,0,utRho02
csgD,2206688,2206688,2206392,296,0,utRho02
csgG,2203510,2203510,2203368,142,38,utRho02
csiD,5577854,5577970,5577854,116,0,utRho02
csiE,5330802,5330870,5330802,68,0,utRho02
csiR,5590942,5591348,5590942,406,0,utRho02
cspA,7439778,7440098,7439778,320,500838,utRho02
cspB,3283430,3283430,3283108,322,792,utRho02
cspC,3815018,3815018,3814870,148,422,utRho02
cspD,1845352,1845352,1845180,172,442,utRho02
cspE,1314294,1314584,1314294,290,166,utRho02
cspF,3283380,3283710,3283380,330,44,utRho02
cspG,2102610,2102922,2102610,312,284208,utRho02
cspH,2102746,2102746,2102350,396,676,utRho02
cspI,3277624,3277624,3277334,290,836,utRho02
csrA,5638746,5638746,5638292,454,2122,utRho02
csrB,5849048,5849048,5849048,0,0,utRho02
csrC,8102072,8102072,8102072,0,0,utRho02
csrD,6806850,6806850,6806664,186,226,utRho02
cstA,1259710,1259788,1259710,78,48,utRho02
cueO,274090,274166,274090,76,0,utRho02
cueR,1027948,1027986,1027948,38,44,utRho02
curA,3037784,3038054,3037784,270,124,utRho02
cusC,1191146,1191200,1191146,54,0,utRho02
cusR,1190924,1190924,1190886,38,0,utRho02
cutA,8730784,8730784,8730712,72,196,utRho02
cutC,3918534,3918534,3917920,614,30,utRho02
cvpA,4861600,4861600,4861526,74,14,utRho02
cvrA,2484328,2484328,2484142,186,116,utRho02
cyaA,7981548,7982306,7981548,758,2170,utRho02
cyaR,4334228,4334224,4334228,4,14,utRho02
cyaY,7988166,7988166,7988118,48,104,utRho02
cybB,2981522,2981804,2981522,282,106,utRho02
cycA,8859560,8859728,8859560,168,606,utRho02
cydA,1542340,1542916,1542340,576,68,utRho02
cydC,1858800,1858800,1858390,410,68,utRho02
cydD,1862062,1862062,1861924,138,44,utRho02
cydX,1548300,1548392,1548300,92,478,utRho02
cynR,717418,717418,717380,38,50,utRho02
cynT,1435092,1435196,1435092,104,0,utRho02
cyoA,903306,903306,903220,86,2464,utRho02
cyoE,895540,895540,895410,130,578,utRho02
cysB,2667576,2667710,2667576,134,412,utRho02
cysC,5748056,5748056,5747984,72,12,utRho02
cysD,5752736,5752736,5752658,78,0,utRho02
cysE,7565362,7565362,7565124,238,560,utRho02
cysG,6995508,6995656,6995508,148,88,utRho02
cysJ,5783928,5783928,5783796,132,1898,utRho02
cysK,5064688,5064818,5064688,130,136,utRho02
cysP,5087114,5087114,5087056,58,424,utRho02
cysS,1109154,1109222,1109154,68,140,utRho02
cysT,3984100,3984100,3983974,126,106,utRho02
cysZ,5062766,5062926,5062766,160,376,utRho02
cytR,8249018,8249018,8248912,106,190,utRho02
dacA,1328002,1328002,1327926,76,50,utRho02
dacB,6657714,6657926,6657714,212,2,utRho02
dacC,1761306,1761454,1761306,148,0,utRho02
dadA,2475018,2475142,2475018,124,0,utRho02
dam,7032504,7032504,7031826,678,1984,utRho02
damX,7035200,7035200,7034612,588,338,utRho02
dapA,5199568,5199568,5199520,48,0,utRho02
dapB,56576,56748,56576,172,70,utRho02
dapD,371954,371954,371894,60,142,utRho02
dapE,5183120,5183214,5183120,94,260,utRho02
dcp,3254844,3254844,3254760,84,8,utRho02
dcrB,7219534,7219910,7219534,376,114,utRho02
dctA,7366996,7366996,7366894,102,1366,utRho02
dcuA,8733686,8733686,8733546,140,0,utRho02
dcuB,8698182,8698182,8697488,694,70,utRho02
dcuC,1312166,1312166,1311936,230,0,utRho02
dcuD,6749166,6749738,6749166,572,2,utRho02
dcuR,8701130,8701130,8700068,1062,436,utRho02
dcuS,8703370,8703370,8703324,46,110,utRho02
dcyD,3999016,3999016,3998960,56,0,utRho02
ddpX,3126498,3126498,3126152,346,0,utRho02
deaD,6615818,6615818,6615720,98,7948,utRho02
dedA,4869880,4869880,4869482,398,11724,utRho02
dedD,4863750,4863750,4863368,382,42,utRho02
def,6867300,6867380,6867300,80,414,utRho02
degP,361690,361768,361690,78,36,utRho02
degQ,6761308,6761486,6761308,178,5960,utRho02
deoB,9239134,9239206,9239134,72,0,utRho02
deoC,9233358,9234646,9233358,1288,152,utRho02
dfp,7625406,7625462,7625406,56,48,utRho02
dgcZ,3247758,3247758,3247700,58,0,utRho02
dgkA,8512914,8513274,8512914,360,220,utRho02
dgt,358392,358474,358392,82,0,utRho02
dhaK,2501888,2501888,2501676,212,4,utRho02
dhaR,2502006,2502132,2502006,126,22,utRho02
dicB,3299194,3299218,3299194,24,0,utRho02
dicC,3295752,3295752,3295700,52,0,utRho02
dinB,501760,501796,501760,36,0,utRho02
dinD,7635398,7635520,7635398,122,374,utRho02
dinG,1666146,1666140,1666146,6,0,utRho02
dinI,2243018,2243018,2242974,44,50,utRho02
dinJ,493230,493230,493004,226,42,utRho02
dinQ,7295964,7295964,7295576,388,1778,utRho02
djlA,114536,114728,114536,192,0,utRho02
dkgA,6313142,6313246,6313142,104,112,utRho02
dkgB,458196,458334,458196,138,808,utRho02
dksA,321502,321502,321208,294,412,utRho02
dld,4444164,4444370,4444164,206,0,utRho02
dmlA,3763424,3763824,3763424,400,0,utRho02
dmlR,3763710,3763710,3763618,92,0,utRho02
dmsA,1881646,1881918,1881646,272,0,utRho02
dnaA,7767922,7767922,7767458,464,8388,utRho02
dnaB,8528566,8528628,8528566,62,158,utRho02
dnaK,24096,24326,24096,230,488,utRho02
dnaN,7765466,7765466,7764642,824,2134,utRho02
dnaQ,471868,472134,471868,266,914,utRho02
dnaT,18406460,18406460,18406068,392,308,utRho02
dnaX,984112,984184,984112,72,776,utRho02
dosP,3131486,3131486,3131466,20,0,utRho02
dpiB,1303968,1304470,1303968,502,0,utRho02
dppA,7415740,7415740,7415410,330,984,utRho02
dps,1697900,1697900,1697822,78,30,utRho02
dsbA,8086754,8086836,8086754,82,3030,utRho02
dsbB,2466294,2466294,2466060,234,0,utRho02
dsbC,6079266,6079266,6077644,1622,1290,utRho02
dsbG,1277600,1277600,1277146,454,1008,utRho02
dsdA,4958242,4958404,4958242,162,2,utRho02
dsdC,4955492,4955492,4955258,234,0,utRho02
dsdX,4955642,4955694,4955642,52,0,utRho02
dsrA,4050626,4050626,4050626,0,0,utRho02
dsrB,4049686,4049686,4049646,40,36,utRho02
dtpD,1485340,1485340,1485112,228,30,utRho02
dusA,8523200,8523338,8523200,138,5306,utRho02
dusB,6820492,6820560,6820492,68,188,utRho02
dusC,4460790,4460790,4460770,20,0,utRho02
dut,7627704,7627864,7627704,160,1802,utRho02
dxr,386670,387042,386670,372,1118,utRho02
ebgA,6445102,6445266,6445102,164,50,utRho02
ebgR,6442874,6442932,6442874,58,48,utRho02
ecnB,8753018,8753106,8753018,88,300,utRho02
eco,4607594,4607810,4607594,216,22,utRho02
ecpA,621594,621594,621342,252,0,utRho02
ecpB,620238,620238,620052,186,0,utRho02
ecpR,622964,622964,622672,292,0,utRho02
eda,3866218,3866218,3865512,706,188,utRho02
edd,3869426,3869426,3869208,218,96,utRho02
efeO,2164308,2164486,2164308,178,134,utRho02
efeU_1,2162614,2162712,2162614,98,72,utRho02
efp,8751134,8751398,8751134,264,8714,utRho02
elaA,4763372,4763372,4763086,286,0,utRho02
elaD,4765308,4765426,4765308,118,4,utRho02
elfA,1995530,1995736,1995530,206,0,utRho02
elfD,1996642,1996980,1996642,338,0,utRho02
emrD,7707690,7707844,7707690,154,50,utRho02
emrK,4966896,4966896,4966678,218,0,utRho02
emrY,4964668,4964668,4964352,316,0,utRho02
emtA,2486250,2486360,2486250,110,0,utRho02
endA,12361100,12361388,12361100,288,16,utRho02
eno,5817692,5817692,5815882,1810,6212,utRho02
entC,1249662,1249770,1249662,108,46,utRho02
entD,1220508,1220508,1220158,350,278,utRho02
entH,1258584,1258600,1258584,16,72,utRho02
entS,1244506,1244600,1244506,94,30,utRho02
envR,6827266,6827266,6826930,336,0,utRho02
epd,12295292,12295292,12294764,528,264,utRho02
epmA,8765236,8765286,8765236,50,32,utRho02
epmB,8751406,8751406,8751314,92,5000,utRho02
eptB,7421162,7421162,7420950,212,422,utRho02
eptC,8300622,8300622,8300530,92,390,utRho02
erfK,4126708,4126708,4126646,62,1328,utRho02
erpA,353122,353220,353122,98,0,utRho02
esrE,8039956,8039956,8039956,0,0,utRho02
essD,1153746,1154796,1153746,1050,274,utRho02
etk,2088606,2088606,2088420,186,84,utRho02
evgA,4967262,4967510,4967262,248,0,utRho02
exbB,6304028,6304028,6303968,60,46,utRho02
exbD,6302780,6302780,6302486,294,114,utRho02
exuR,6493016,6493304,6493016,288,164,utRho02
exuT,6490004,6490208,6490004,204,0,utRho02
fabA,2032996,2032996,2032940,56,278,utRho02
fabB,4883282,4883282,4883210,72,68,utRho02
fabH,2297032,2297518,2297032,486,3788,utRho02
fabI,2702236,2702236,2702078,158,14,utRho02
fadB,8062026,8062026,8061942,84,0,utRho02
fadD,3779614,3779614,3779492,122,0,utRho02
fadE,486812,486812,486606,206,44,utRho02
fadH,6463248,6463330,6463248,82,22,utRho02
fadI,4921022,4921022,4920938,84,0,utRho02
fadL,4922410,4922600,4922410,190,24,utRho02
fadM,928720,928804,928720,84,84,utRho02
fadR,2469810,2469876,2469810,66,0,utRho02
fbaB,4357334,4357334,4357128,206,0,utRho02
fdhE,8162722,8162722,8162456,266,890,utRho02
fdhF,8598814,8598814,8598732,82,0,utRho02
fdnG,3094744,3094802,3094744,58,0,utRho02
fdrA,1093012,1093360,1093012,348,0,utRho02
feaB,2894994,2895038,2894994,44,0,utRho02
feaR,2894734,2894734,2894566,168,0,utRho02
fecA,9033454,9033454,9033354,100,346,utRho02
fecE,9023288,9023288,9022914,374,8416,utRho02
fecI,9036564,9036564,9036470,94,178,utRho02
feoA,7080114,7080326,7080114,212,260,utRho02
fepA,1225334,1225334,1224988,346,132,utRho02
fepB,1249454,1249454,1249020,434,924,utRho02
fepD,1244468,1244468,1244378,90,0,utRho02
fes,1225374,1225630,1225374,256,308,utRho02
ffh,5495706,5495706,5495590,116,2552,utRho02
ffs,952576,952848,952576,272,68,utRho02
fhuA,334884,334968,334884,84,288,utRho02
fhuE,2323294,2323294,2323102,192,300,utRho02
fhuF,9211504,9211504,9211326,178,3712,utRho02
fic,6983296,6983296,6982926,370,404,utRho02
fieF,8212864,8212938,8212864,74,48,utRho02
fimA,9085388,9086230,9085388,842,202,utRho02
fimB,9081334,9081914,9081334,580,662,utRho02
fimE,9083742,9084074,9083742,332,20,utRho02
fimZ,1129214,1129214,1128960,254,182,utRho02
fiu,1683296,1683296,1683062,234,178,utRho02
fixA,84650,84806,84650,156,0,utRho02
fkpA,6955050,6955050,6954838,212,8636,utRho02
fldA,2846084,2846084,2845860,224,4516,utRho02
fldB,6079644,6079710,6079644,66,54,utRho02
flgA,2261770,2261770,2261726,44,16,utRho02
flgB,2261986,2262036,2261986,50,0,utRho02
flgK,2276702,2276756,2276702,54,2286,utRho02
flgM,2260330,2260330,2260256,74,788,utRho02
flgN,2259828,2259828,2259660,168,414,utRho02
flhB,3932432,3932432,3932382,50,204,utRho02
flhC,3955864,3955864,3955688,176,126,utRho02
flhD,3957154,3957154,3956394,760,848,utRho02
fliA,4003638,4003638,4003578,60,64,utRho02
fliC,4007352,4007352,4007212,140,72,utRho02
fliD,4007634,4007744,4007634,110,194,utRho02
fliE,4026186,4026186,4026028,158,0,utRho02
fliF,4026292,4026458,4026292,166,564,utRho02
fliL,4039168,4039236,4039168,68,120,utRho02
flk,4875824,4875900,4875824,76,0,utRho02
flu,4142634,4143078,4142634,444,0,utRho02
flxA,3292776,3292810,3292776,34,0,utRho02
fnr,2799104,2799104,2799052,52,126,utRho02
fnrS,2818258,2818258,2818258,0,0,utRho02
focA,1909628,1909628,1908932,696,810,utRho02
folA,99598,99646,99598,48,26,utRho02
folB,6409296,6409296,6409178,118,0,utRho02
folD,1115562,1115562,1115482,80,94,utRho02
folE,4487696,4487696,4487304,392,4644,utRho02
fpr,8228998,8228998,8228944,54,44,utRho02
frc,4986878,4986878,4986508,370,0,utRho02
frdA,8764824,8764824,8764636,188,194,utRho02
frdD,8758948,8758948,8758732,216,210,utRho02
fre,8052886,8053054,8052886,168,1858,utRho02
frlA,6999518,6999820,6999518,302,0,utRho02
frr,385624,385744,385624,120,1024,utRho02
frsA,513004,513054,513004,50,148,utRho02
fruB,4527194,4527194,4526990,204,0,utRho02
frvR,8179804,8179804,8179710,94,0,utRho02
fryA,5008986,5008986,5008970,16,0,utRho02
fsaA,1727060,1727284,1727060,224,2,utRho02
fsr,1009710,1009710,1009392,318,276,utRho02
ftnA,3977364,3977432,3977364,68,0,utRho02
ftnB,3973550,3973850,3973550,300,136,utRho02
ftsA,207122,207964,207122,842,1368,utRho02
ftsB,5745802,5745802,5745640,162,214,utRho02
ftsH,6654204,6654204,6653870,334,1844,utRho02
ftsK,1865858,1866448,1865858,590,2816,utRho02
ftsL,181376,182064,181376,688,2294,utRho02
ftsP,6325732,6325732,6325338,394,608,utRho02
ftsQ,205484,206310,205484,826,970,utRho02
ftsX,7204512,7204512,7204172,340,1642,utRho02
ftsZ,209272,210610,209272,1338,92,utRho02
fucA,5867708,5867708,5867376,332,0,utRho02
fucP,5868238,5868470,5868238,232,0,utRho02
fumA,6753760,6753760,6753508,252,1248,utRho02
fumB,8694696,8694696,8694652,44,0,utRho02
fumC,3373418,3373418,3373176,242,0,utRho02
fur,2842892,2842892,2842584,308,9232,utRho02
fusA,6947370,6947370,6947028,342,24336,utRho02
fxsA,8737206,8737328,8737206,122,86,utRho02
gabD,5581824,5582546,5581824,722,780,utRho02
gadA,7335214,7335214,7335160,54,0,utRho02
gadB,3144144,3144144,3144090,54,0,utRho02
gadC,3141168,3141168,3140978,190,60,utRho02
gadE,7315600,7316732,7315600,1132,0,utRho02
gadW,7329562,7329562,7329236,326,0,utRho02
gadX,14663356,14663356,14663240,116,0,utRho02
gadY,7329728,7329728,7329728,0,0,utRho02
galE,1584354,1584354,1584110,244,44,utRho02
galF,4228702,4228702,4228654,48,24,utRho02
galM,1577796,1577796,1577674,122,232,utRho02
galP,6176510,6176568,6176510,58,0,utRho02
galR,5953138,5953198,5953138,60,94,utRho02
galS,4483420,4483420,4483336,84,0,utRho02
galU,2582810,2582914,2582810,104,356,utRho02
gapA,3724480,3725542,3724480,1062,3584,utRho02
garP,6549868,6549868,6549814,54,0,utRho02
gatY,4354468,4354468,4354408,60,0,utRho02
gatZ,4352864,4352864,4352642,222,6278,utRho02
gcd,282558,282558,282450,108,180,utRho02
gcl,1067814,1067832,1067814,18,0,utRho02
gcvA,5885278,5885278,5885134,144,62,utRho02
gcvB,5885392,5885392,5885392,0,0,utRho02
gcvR,5199758,5199812,5199758,54,352,utRho02
gcvT,6101544,6101544,6101334,210,752,utRho02
gdhA,3684616,3684742,3684616,126,0,utRho02
gfcA,2099668,2099668,2099488,180,628,utRho02
gfcD,2096236,2096236,2095890,346,26,utRho02
ghrA,2195648,2195772,2195648,124,504,utRho02
ghrB,7434378,7434620,7434378,242,750,utRho02
glcA,6242728,6242728,6242558,170,26,utRho02
glcC,6256412,6256544,6256412,132,0,utRho02
glcD,6256152,6256152,6256042,110,0,utRho02
gldA,8278092,8278092,8278070,22,0,utRho02
glgA,7136784,7136784,7136066,718,354,utRho02
glgB,7147314,7147314,7147004,310,290,utRho02
glgC,7139142,7139142,7138656,486,176,utRho02
glgP,7133546,7133546,7133162,384,180,utRho02
glgS,6384024,6384024,6383878,146,0,utRho02
glgX,7142838,7142838,7142638,200,54,utRho02
glk,5018922,5018922,5018852,70,4,utRho02
glmS,7827622,7827622,7827336,286,6320,utRho02
glmU,7830652,7830652,7830400,252,462,utRho02
glmY,10765360,10765360,10765360,0,0,utRho02
glmZ,7972864,7972864,7972864,0,0,utRho02
glnA,16232888,16232888,16232136,752,288,utRho02
glnB,5375052,5375052,5374816,236,108,utRho02
glnD,377310,377310,377300,10,16,utRho02
glnE,6399602,6399602,6399282,320,128,utRho02
glnH,1696396,1696396,1696008,388,0,utRho02
glnK,945112,945196,945112,84,0,utRho02
glnL,8112742,8112742,8112678,64,60,utRho02
glnQ,1693262,1693262,1692926,336,426,utRho02
glnS,1411998,1412186,1411998,188,458,utRho02
gloA,3455602,3455674,3455602,72,30,utRho02
gloB,469852,469852,469564,288,880,utRho02
glpA,4705166,4705294,4705166,128,0,utRho02
glpD,7123942,7124026,7123942,84,0,utRho02
glpE,7123698,7123698,7123646,52,124,utRho02
glpF,8236322,8236322,8236180,142,170,utRho02
glpG,7122960,7122960,7122904,56,338,utRho02
glpR,7121782,7121782,7121210,572,170,utRho02
glpT,4704902,4704902,4704748,154,30,utRho02
glpX,8231212,8231212,8231158,54,3314,utRho02
glrK,5382246,5382246,5382196,50,396,utRho02
gltA,1509534,1509534,1508936,598,17182,utRho02
gltB,6709018,6709264,6709018,246,240,utRho02
gltI,1375792,1375792,1375494,298,1950,utRho02
gltP,8588536,8588962,8588536,426,2352,utRho02
gltS,7657382,7657382,7657330,52,334,utRho02
gltX,5041568,5041568,5041344,224,72,utRho02
gluQ,320286,320286,320224,62,220,utRho02
glyA,5371148,5371148,5371014,134,40,utRho02
glyQ,7450708,7450708,7450636,72,556,utRho02
glyS,7448990,7448990,7448794,196,1578,utRho02
glyU,5998128,5998128,5998114,14,0,utRho02
glyV,8784626,8784720,8784626,94,258,utRho02
glyW,3984360,3984360,3984234,126,70,utRho02
gmhB,445612,445666,445612,54,0,utRho02
gmk,7642776,7642856,7642776,80,150,utRho02
gmr,2693686,2693686,2693484,202,78,utRho02
gnd,4202648,4202648,4202536,112,774,utRho02
gnsB,3275692,3275692,3275564,128,120,utRho02
gntK,14310580,14310580,14310368,212,1380,utRho02
gntP,9102668,9102668,9102592,76,0,utRho02
gntR,7157760,7157760,7157452,308,196,utRho02
gntT,7092810,7093118,7092810,308,86,utRho02
gntU,7154170,7154170,7154122,48,0,utRho02
gntX,7089334,7089764,7089334,430,76,utRho02
gor,7292224,7292598,7292224,374,524,utRho02
gpmA,1575340,1575340,1575190,150,0,utRho02
gpmM,7570374,7570520,7570374,146,0,utRho02
gpsA,7567620,7567620,7567322,298,5162,utRho02
gpt,511828,511954,511828,126,534,utRho02
grcA,5433046,5433046,5432898,148,138,utRho02
greA,6657728,6657728,6657430,298,1778,utRho02
greB,7073488,7073624,7073488,136,54,utRho02
groL,8741566,8742050,8741566,484,820,utRho02
groS,8741232,8741376,8741232,144,362,utRho02
grpE,5501494,5501494,5501416,78,248,utRho02
grxA,1781552,1781552,1781506,46,0,utRho02
grxB,2248206,2248206,2248108,98,118,utRho02
grxC,7569152,7569152,7568884,268,3648,utRho02
grxD,3468324,3468324,3468202,122,6374,utRho02
gspA,6911268,6911268,6910796,472,142,utRho02
gspC,6910964,6911156,6910964,192,68,utRho02
gss,6277220,6277220,6277044,176,40,utRho02
gstA,3428654,3428754,3428654,100,0,utRho02
gstB,1761038,1761038,1760960,78,0,utRho02
guaB,5268214,5268214,5268140,74,68,utRho02
gudD,5839026,5839026,5838770,256,92,utRho02
gyrA,4678914,4678914,4678840,74,24,utRho02
gyrB,7760300,7760300,7760238,62,530,utRho02
hcaE,5337964,5338064,5337964,100,0,utRho02
hcaR,5337928,5337928,5337792,136,0,utRho02
hcaT,5336106,5336106,5335692,414,0,utRho02
hchA,4071260,4071670,4071260,410,0,utRho02
hcp,1828258,1828258,1827628,630,30,utRho02
hcr,1824400,1824400,1824300,100,0,utRho02
hdeA,7313582,7313582,7313480,102,0,utRho02
hdeD,7313920,7313990,7313920,70,0,utRho02
hdfR,7896320,7896320,7895934,386,562,utRho02
hdhA,3396244,3396244,3396080,164,112,utRho02
helD,2048876,2048942,2048876,66,0,utRho02
hemA,2527166,2527428,2527166,262,240,utRho02
hemB,779722,779722,779454,268,98,utRho02
hemF,5106410,5106450,5106410,40,0,utRho02
hemH,996062,996110,996062,48,102,utRho02
hemL,349882,349882,349764,118,2,utRho02
hemN,8103886,8104090,8103886,204,78,utRho02
hepA,127176,127176,126528,648,4330,utRho02
hflD,2385372,2385372,2385262,110,1684,utRho02
hfq,8799602,8800576,8799602,974,2178,utRho02
hha,961006,961006,960616,390,434,utRho02
hicA,3018442,3018572,3018442,130,0,utRho02
higA,6468682,6468682,6468288,394,142,utRho02
higB,6468960,6468960,6468910,50,2,utRho02
hinT,2323642,2323770,2323642,128,58,utRho02
hipB,3184964,3184964,3184884,80,0,utRho02
hisB,4186720,4186936,4186720,216,502,utRho02
hisJ,4853674,4853674,4853576,98,78,utRho02
hisL,8359856,8359984,8359856,128,728,utRho02
hisS,5281284,5281284,5281150,134,342,utRho02
hlpA,400910,400964,400910,54,64,utRho02
hlyE,2460932,2460932,2460788,144,0,utRho02
hmp,5371594,5371670,5371594,76,0,utRho02
hns,2585916,2585916,2585844,72,980,utRho02
hofM,7045856,7045856,7045502,354,0,utRho02
hokA,7441620,7441620,7441200,420,5430,utRho02
hokC,33902,33902,33806,96,98,utRho02
hokE,1215462,1215672,1215462,210,0,utRho02
holC,8968546,8968546,8968560,14,590,utRho02
holD,9215562,9215606,9215562,44,30,utRho02
holE,3850040,3850216,3850040,176,1190,utRho02
hpt,282720,282862,282720,142,150,utRho02
hrpB,324150,324210,324150,60,34,utRho02
hscB,5319048,5319048,5318934,114,1484,utRho02
hscC,1367188,1367188,1366786,402,268,utRho02
hsdS,9163004,9163004,9162924,80,0,utRho02
hslJ,2883560,2883560,2883486,74,98,utRho02
hslO,7059344,7059548,7059344,204,7674,utRho02
hslR,7058220,7058696,7058220,476,2274,utRho02
hslV,8244708,8244708,8244574,134,12,utRho02
hsrA,7881412,7881412,7881224,188,278,utRho02
htgA,21286,21660,21286,374,416,utRho02
htpG,989634,990240,989634,606,8884,utRho02
htpX,3825236,3825236,3825152,84,0,utRho02
htrE,311036,311036,310852,184,38,utRho02
htrL,7587668,7587668,7587366,302,16,utRho02
hupA,8400352,8400562,8400352,210,202,utRho02
hupB,1845220,1845804,1845220,584,584,utRho02
hyaA,2063968,2064278,2063968,310,0,utRho02
hybO,6292726,6292726,6292522,204,564,utRho02
hycA,5700922,5700922,5700870,52,0,utRho02
hycI,5686204,5686204,5686086,118,130,utRho02
hydN,5676264,5676264,5676210,54,0,utRho02
hyfA,5202342,5202402,5202342,60,0,utRho02
hypA,11402508,11402588,11402508,80,0,utRho02
hypB,11403356,11404004,11403356,648,0,utRho02
hypF,5676210,5676210,5674850,1360,608,utRho02
hypT,9116634,9116634,9116578,56,0,utRho02
hyuA,6019660,6020056,6019660,396,78,utRho02
iaaA,1733074,1733136,1733074,62,0,utRho02
iadA,9119074,9119074,9119052,22,46,utRho02
iap,5753072,5753162,5753072,90,36,utRho02
ibaG,6673966,6673966,6673606,360,80,utRho02
ibpA,7735036,7735036,7734844,192,304,utRho02
ibpB,7733962,7733962,7733794,168,234,utRho02
icd,2389922,2390246,2389922,324,564,utRho02
iclR,8447304,8447304,8447256,48,82,utRho02
idi,6065876,6066130,6065876,254,0,utRho02
idnD,8988870,8988870,8988812,58,0,utRho02
idnK,8989194,8989246,8989194,52,0,utRho02
ihfA,3591442,3591442,3591104,338,1024,utRho02
ihfB,1927498,1927656,1927498,158,1470,utRho02
ileS,43666,44782,43666,1116,5608,utRho02
ileX,6431194,6431196,6431194,2,50,utRho02
ilvA,15820940,15821324,15820940,384,80,utRho02
ilvC,7915824,7915940,7915824,116,0,utRho02
ilvE,15809552,15809936,15809552,384,624,utRho02
ilvI,170840,171260,170840,420,0,utRho02
ilvL,23701308,23701932,23701308,624,12,utRho02
ilvY,7915734,7915734,7915640,94,0,utRho02
inaA,4698998,4698998,4698944,54,160,utRho02
infA,1853370,1853370,1852886,484,4664,utRho02
infC,3602692,3602692,3601276,1416,9616,utRho02
insA-5,3958452,3958452,3958430,22,0,utRho02
insA-7,9036758,9037054,9036758,296,238,utRho02
insC-5,6372080,6372284,6372080,204,252,utRho02
insEF-2,785238,785238,785820,582,700,utRho02
insEF-4,2190310,2190310,2190892,582,670,utRho02
insG,9007098,9007098,9006862,236,20,utRho02
insH-1,550596,550596,550234,362,236,utRho02
insH-11,7306538,7306538,7306396,142,32,utRho02
insH-2,1151548,1151548,1151506,42,262,utRho02
insH-3,1378444,1378444,1378026,418,434,utRho02
insH-4,2791942,2792152,2791942,210,42,utRho02
insH-5,2857852,2857852,2857452,400,0,utRho02
insH-6,4135022,4135022,4134642,380,114,utRho02
insH-7,4206186,4206186,4205822,364,8136,utRho02
insH-9,6260050,6260356,6260050,306,42,utRho02
insI-3,9017372,9017372,9017234,138,62,utRho02
insJ,7441188,7441360,7441188,172,2556,utRho02
insK,7442130,7442308,7442130,178,0,utRho02
insL-1,30760,30890,30760,130,740,utRho02
insL-2,1216112,1216130,1216112,18,78,utRho02
insL-3,5028644,5028662,5028644,18,102,utRho02
insN-1,540452,540484,540452,32,0,utRho02
intD,1132202,1132202,1131956,246,62,utRho02
intR,2826520,2826520,2826470,50,0,utRho02
intS,4933026,4933090,4933026,64,1272,utRho02
intZ,5117386,5117542,5117386,156,164,utRho02
iraD,9113152,9113986,9113152,834,0,utRho02
iraM,2424246,2424246,2424006,240,14,utRho02
iraP,802638,802772,802638,134,0,utRho02
iscA,5319924,5319924,5319772,152,1700,utRho02
iscR,5324398,5324398,5324262,136,28260,utRho02
iscX,5313834,5313834,5313472,362,3472,utRho02
ispF,5743968,5743968,5743560,408,1490,utRho02
ispG,5283908,5283908,5283608,300,1108,utRho02
ispU,389568,389806,389568,238,380,utRho02
isrA,2811502,2811502,2811618,116,0,utRho02
istr-1,7706384,7706384,7706384,0,0,utRho02
istr-2,7706514,7706514,7706514,0,0,utRho02
ivbL,15412092,15412092,15411952,140,496,utRho02
ivy,480638,480686,480638,48,0,utRho02
katE,3627628,3627734,3627628,106,20,utRho02
katG,8267624,8267670,8267624,46,40,utRho02
kbaZ,6557732,6557828,6557732,96,0,utRho02
kbl,7585154,7585154,7585102,52,386,utRho02
kch,2621046,2621046,2620538,508,0,utRho02
kdgR,3820506,3820506,3820198,308,40,utRho02
kdpE,1443788,1443788,1443466,322,250,utRho02
kdpF,1457698,1457698,1457642,56,0,utRho02
kdsA,2535708,2536330,2535708,622,3338,utRho02
kdsC,6683438,6684546,6683438,1108,3932,utRho02
kduI,5968388,5968388,5968248,140,364,utRho02
kefF,94160,94492,94160,332,64,utRho02
kgtP,5451624,5451624,5451492,132,1796,utRho02
kup,7862206,7862632,7862206,426,80,utRho02
lacI,735076,735076,735020,56,0,utRho02
lacZ,1465508,1465508,1465220,288,852,utRho02
ldcA,2486394,2486394,2486160,234,0,utRho02
ldhA,2885830,2885830,2885686,144,0,utRho02
ldrA,2538954,2538954,2538550,404,1664,utRho02
ldrB,2540024,2540024,2539620,404,694,utRho02
ldrC,2541092,2541092,2540690,402,1596,utRho02
ldrD,7400544,7400544,7400174,370,2304,utRho02
lepA,5414392,5414392,5414248,144,184,utRho02
lepB,5410928,5410928,5410618,310,696,utRho02
leuD,159188,159188,158906,282,68,utRho02
leuE,3761600,3761600,3761518,82,0,utRho02
leuL,168048,168048,167416,632,34,utRho02
leuO,168308,168736,168308,428,176,utRho02
leuQ,9212864,9212864,9212802,62,0,utRho02
leuU,6644556,6644556,6644316,240,6052,utRho02
leuV,9212546,9212546,9212330,216,730,utRho02
leuX,8992772,8992810,8992772,38,36,utRho02
lexA,8514174,8514230,8514174,56,172,utRho02
lhr,3456706,3458174,3456706,1468,3852,utRho02
ligA,5060402,5060402,5060352,50,0,utRho02
ligB,7642576,7642576,7642340,236,0,utRho02
lipA,1320602,1320602,1320432,170,8,utRho02
lipB,1324802,1324802,1324556,246,2860,utRho02
lit,2397032,2397390,2397032,358,64,utRho02
livJ,7199524,7199524,7199316,208,3892,utRho02
livK,7195510,7195510,7195120,390,0,utRho02
lldP,7554578,7554798,7554578,220,804,utRho02
lnt,1381968,1381968,1381762,206,382,utRho02
loiP,6163784,6163826,6163784,42,0,utRho02
lolA,1874656,1874738,1874656,82,992,utRho02
lolB,2527112,2527112,2527000,112,44,utRho02
lolC,2350748,2350854,2350748,106,28,utRho02
lon,917630,917776,917630,146,1090,utRho02
lpcA,486936,487086,486936,150,0,utRho02
lpd,255434,255824,255434,390,3908,utRho02
lplA,9248476,9248476,9248234,242,1380,utRho02
lplT,5947878,5947878,5947724,154,0,utRho02
lpoA,6586422,6586800,6586422,378,480,utRho02
lpp,3514592,3514842,3514592,250,300,utRho02
lptA,6686598,6686760,6686598,162,958,utRho02
lptB,6686792,6687888,6686792,1096,2312,utRho02
lptD,114672,114672,114218,454,3738,utRho02
lptF,8972244,8972436,8972244,192,40,utRho02
lpxC,213016,213114,213016,98,27696,utRho02
lpxD,401920,401942,401920,22,0,utRho02
lpxL,2233418,2233418,2233164,254,294,utRho02
lpxM,3880456,3880456,3880386,70,60,utRho02
lpxP,4991156,4991290,4991156,134,746,utRho02
lrhA,4813312,4813312,4813282,30,36,utRho02
lrp,1864656,1865190,1864656,534,942,utRho02
lspA,50028,50414,50028,386,492,utRho02
lsrA,3202920,3202980,3202920,60,0,utRho02
lsrR,3202514,3202514,3202482,32,0,utRho02
ltaE,1818640,1818640,1818588,52,0,utRho02
luxS,5630130,5630130,5629466,664,2212,utRho02
lysA,5957902,5957902,5957798,104,0,utRho02
lysC,8467232,8467232,8466466,766,532,utRho02
lysP,4497120,4497120,4497064,56,88,utRho02
lysR,5957900,5958042,5957900,142,0,utRho02
lysT,1561028,1561108,1561028,80,216,utRho02
lysU,8709610,8709610,8709434,176,0,utRho02
macB,1840188,1840694,1840188,506,32,utRho02
maeA,3111484,3111484,3111338,146,3906,utRho02
mak,820236,820288,820236,52,0,utRho02
malE,8492928,8492928,8492838,90,2,utRho02
malI,3398456,3398456,3398360,96,0,utRho02
malK,8493472,8493568,8493472,96,0,utRho02
malP,7105020,7105020,7104946,74,136,utRho02
malQ,7100798,7100798,7100140,658,300,utRho02
malS,14949880,14949988,14949880,108,0,utRho02
malT,7106048,7106170,7106048,122,0,utRho02
malX,3398626,3398710,3398626,84,0,utRho02
malZ,1689980,1690072,1689980,92,2564,utRho02
manA,3377102,3377152,3377102,50,40,utRho02
manX,3803866,3804096,3803866,230,154,utRho02
marC,3237882,3237882,3237816,66,36,utRho02
marR,3238186,3238240,3238186,54,0,utRho02
matP,2036918,2036970,2036918,52,188,utRho02
mazE,5822736,5822736,5822678,58,0,utRho02
mazG,5821720,5821720,5821370,350,3092,utRho02
mcbA,1684306,1684306,1684112,194,2,utRho02
mcbR,3040192,3040524,3040192,332,0,utRho02
mcrA,2420278,2420692,2420278,414,0,utRho02
mcrC,9156124,9156124,9155916,208,130,utRho02
mdaB,6344814,6345060,6344814,246,0,utRho02
mdfA,1767138,1767346,1767138,208,0,utRho02
mdh,6768940,6768940,6768536,404,68,utRho02
mdoB,9198988,9198988,9198882,106,890,utRho02
mdoD,2993290,2993712,2993290,422,0,utRho02
mdoG,2218514,2218670,2218514,156,220,utRho02
mdtA,4307958,4308032,4307958,74,108,utRho02
mdtE,7318168,7318464,7318168,296,24,utRho02
mdtK,3486538,3486914,3486538,376,192,utRho02
mdtP,8602472,8602472,8602060,412,66,utRho02
melA,8683774,8683822,8683774,48,0,utRho02
melR,8683300,8683300,8683256,44,36,utRho02
menA,8240812,8240812,8240698,114,38,utRho02
menB,4753774,4753774,4753638,136,468,utRho02
mepH,3468714,3468870,3468714,156,0,utRho02
mepM,3883666,3883666,3883270,396,1386,utRho02
mepS,4539840,4539958,4539840,118,968,utRho02
metA,8428318,8428560,8428318,242,684,utRho02
metB,8257272,8257344,8257272,72,804,utRho02
metC,6304150,6304472,6304150,322,86,utRho02
metE,8025768,8026106,8025768,338,216,utRho02
metF,8265092,8265232,8265092,140,138,utRho02
metG,4388538,4388600,4388538,62,70,utRho02
metH,8447010,8447656,8447010,646,9656,utRho02
metJ,8257116,8257116,8256790,326,76,utRho02
metK,6173154,6173412,6173154,258,388,utRho02
metN,445428,445428,445290,138,104,utRho02
metR,8025710,8025710,8025632,78,0,utRho02
metT,1394326,1394326,1394266,60,382,utRho02
metY,19910250,19910250,19909734,516,9282,utRho02
metZ,11789528,11789548,11789528,20,40,utRho02
mfd,2348056,2348056,2347928,128,100,utRho02
mglA,4478782,4478782,4478578,204,6,utRho02
mglB,4481132,4481132,4480696,436,1050,utRho02
mglC,4475918,4475918,4475506,412,50,utRho02
mgrB,3817584,3817584,3817532,52,6,utRho02
mgrR,3245828,3245828,3245828,0,0,utRho02
mgsA,2054082,2054082,2054030,52,40,utRho02
mgtL,8934560,8934862,8934560,302,94,utRho02
mhpA,737038,737222,737038,184,0,utRho02
mhpR,737072,737072,736840,232,0,utRho02
mhpT,750772,750918,750772,146,0,utRho02
miaA,8797964,8798504,8797964,540,1564,utRho02
micA,5629604,5629604,5629604,0,0,utRho02
micC,2874242,2874238,2874242,4,0,utRho02
micF,4626168,4626168,4626168,0,0,utRho02
micM,1014408,1014408,1014408,0,0,utRho02
minE,2449422,2449422,2449090,332,778,utRho02
mioC,7852950,7852950,7852910,40,110,utRho02
mipA,3733012,3733012,3732944,68,3804,utRho02
mlaA,4930270,4930270,4930014,256,54,utRho02
mlc,3337206,3337206,3337128,78,0,utRho02
mlrA,4429498,4429732,4429498,234,14,utRho02
mltA,5894546,5894546,5894356,190,70,utRho02
mltD,468050,468050,467910,140,110,utRho02
mltF,5391534,5391602,5391534,68,0,utRho02
mmuP,550238,550650,550238,412,244,utRho02
mngA,1531622,1531968,1531622,346,0,utRho02
mngR,1531852,1531852,1531750,102,0,utRho02
mnmG,7851348,7851348,7851266,82,8114,utRho02
mntH,5025470,5025470,5025412,58,74,utRho02
mntP,3810918,3811376,3810918,458,1036,utRho02
mntR,1706160,1706366,1706160,206,0,utRho02
mntS,1706128,1706128,1705994,134,0,utRho02
moaA,1633654,1634088,1633654,434,1172,utRho02
moaB,1635954,1636110,1635954,156,976,utRho02
mobA,8084242,8084242,8083998,244,386,utRho02
mocA,6030112,6030320,6030112,208,46,utRho02
modA,1589990,1590178,1589990,188,256,utRho02
moeA,1732788,1732788,1732728,60,150,utRho02
mokB,2984610,2984610,2984258,352,926,utRho02
molR_1,4392888,4392948,4392888,60,374,utRho02
motA,3954604,3954604,3954278,326,0,utRho02
mpaA,2781278,2781278,2781196,82,78,utRho02
mpl,8911456,8911570,8911456,114,0,utRho02
mppA,2786108,2786454,2786108,346,2,utRho02
mprA,5621494,5621540,5621494,46,380,utRho02
mqo,4613848,4613848,4613508,340,728,utRho02
mqsA,6336742,6336742,6336492,250,74,utRho02
mqsR,6337306,6337306,6337088,218,208,utRho02
mraZ,179192,179268,179192,76,4,utRho02
mrcA,7045652,7045742,7045652,90,0,utRho02
mrcB,329442,329460,329442,18,0,utRho02
mreB,13605424,13605424,13604348,1076,2552,utRho02
mreD,6798166,6798166,6797750,416,276,utRho02
mrp,4388360,4388360,4388336,24,62,utRho02
mscK,972984,973072,972984,88,0,utRho02
mscL,6876002,6876048,6876002,46,358,utRho02
mscS,6139742,6139742,6139614,128,94,utRho02
msrA,8884522,8884522,8884352,170,152,utRho02
msrB,3725168,3725168,3724858,310,0,utRho02
msyB,2228426,2228426,2228362,64,204,utRho02
mtfA,4087236,4087302,4087236,66,242,utRho02
mtgA,6699662,6699662,6699618,44,290,utRho02
mtlA,30177504,30178248,30177504,744,840,utRho02
mtn,358366,358366,358306,60,0,utRho02
mtr,6611864,6611864,6611634,230,170,utRho02
mug,6430992,6430992,6430946,46,0,utRho02
murQ,5091466,5091546,5091466,80,0,utRho02
murR,5091586,5091586,5091218,368,56,utRho02
mutH,5939164,5939324,5939164,160,518,utRho02
mutL,8794092,8794824,8794092,732,1378,utRho02
mutM,7622554,7622554,7622304,250,2118,utRho02
mutS,5714038,5714186,5714038,148,276,utRho02
mutY,18617466,18618078,18617466,612,0,utRho02
nac,4123956,4123956,4123866,90,0,utRho02
nadA,1564122,1564170,1564122,48,52,utRho02
nadB,5420714,5420840,5420714,126,66,utRho02
nadC,237326,237326,237290,36,134,utRho02
nadE,3644604,3644916,3644604,312,44,utRho02
nadK,5501526,5501662,5501526,136,200,utRho02
nagA,1406350,1406350,1405502,848,2528,utRho02
nagB,1407416,1407416,1407222,194,32,utRho02
nagC,1404016,1404016,1403188,828,282,utRho02
nagE,1407680,1407888,1407680,208,118,utRho02
nagK,2357080,2357186,2357080,106,64,utRho02
nanA,6747240,6747240,6747152,88,108,utRho02
nanC,9079856,9079856,9079002,854,60,utRho02
nanR,6749406,6749406,6748978,428,16,utRho02
nanS,9075406,9075406,9075188,218,0,utRho02
napF,4607390,4607390,4606994,396,0,utRho02
narG,2559614,2559728,2559614,114,34,utRho02
narK,2555642,2555914,2555642,272,0,utRho02
narP,4580844,4581000,4580844,156,24,utRho02
narQ,5171154,5171462,5171154,308,0,utRho02
narU,3088326,3088326,3088120,206,0,utRho02
narW,3077374,3077374,3074618,2756,24,utRho02
narX,2555554,2555554,2555236,318,20,utRho02
narZ,3085380,3085380,3085180,200,0,utRho02
ndh,2331984,2332170,2331984,186,208,utRho02
ndk,5289920,5289920,5289728,192,590,utRho02
nemR,6904084,6904092,6904084,8,44,utRho02
nepI,7683542,7683542,7683478,64,176,utRho02
nfo,4501612,4501680,4501612,68,70,utRho02
nfsB,1210906,1210906,1210848,58,88,utRho02
nfuA,7090916,7091248,7090916,332,884,utRho02
nhaA,34634,34978,34634,344,176,utRho02
nhaB,2469534,2469534,2469434,100,0,utRho02
nhoA,3067926,3068048,3067926,122,0,utRho02
nikA,7226878,7227334,7226878,456,2822,utRho02
nikR,7237074,7237176,7237074,102,158,utRho02
nirB,6987974,6988022,6987974,48,154,utRho02
nlpA,7680034,7680034,7679986,48,0,utRho02
nlpC,3585654,3585654,3585462,192,72,utRho02
nlpD,5737658,5737658,5737506,152,116,utRho02
nlpI,6618080,6618080,6617848,232,98,utRho02
nmpC,1153740,1153740,1153650,90,12,utRho02
nohA,3273206,3273206,3272734,472,0,utRho02
norR,5664614,5664614,5664578,36,0,utRho02
norV,5664878,5664952,5664878,74,0,utRho02
nrdA,4689510,4689730,4689510,220,12202,utRho02
nrdD,8925676,8925676,8925320,356,2378,utRho02
nrdH,5601312,5601446,5601312,134,1076,utRho02
nrdR,865954,866004,865954,50,12,utRho02
nrfA,8575342,8575528,8575342,186,0,utRho02
nsrR,8812088,8812380,8812088,292,53212,utRho02
nudB,3897348,3897348,3897264,84,0,utRho02
nudC,8393428,8393806,8393428,378,288,utRho02
nudE,7052658,7052658,7052298,360,7158,utRho02
nudG,3682876,3682980,3682876,104,0,utRho02
nudI,4729050,4729108,4729050,58,0,utRho02
nudJ,2388874,2388874,2388576,298,1248,utRho02
nuoA,4810670,4810670,4810144,526,2356,utRho02
nuoN,4783434,4783434,4783010,424,1826,utRho02
nupC,5026018,5026084,5026018,66,0,utRho02
nupG,6211302,6211428,6211302,126,16,utRho02
ogrK,4335096,4335096,4335040,56,0,utRho02
ogt,2800568,2800568,2800472,96,0,utRho02
ohsC,5401036,5401040,5401036,4,0,utRho02
ompA,2040382,2040382,2040106,276,21752,utRho02
ompC,4625774,4625774,4625498,276,100,utRho02
ompF,1974184,1974184,1973964,220,172,utRho02
ompL,8128958,8128958,8128590,368,0,utRho02
ompN,2874158,2874158,2873786,372,0,utRho02
ompR,7073510,7073510,7073168,342,300,utRho02
ompT,1171330,1171330,1171266,64,72,utRho02
ompW,2627982,2628040,2627982,58,0,utRho02
ompX,1700418,1700900,1700418,482,1596,utRho02
omrA,5952378,5952378,5952378,0,0,utRho02
omrB,5952770,5952770,5952770,0,0,utRho02
oppA,2602170,2602364,2602170,194,23176,utRho02
orn,8783168,8783208,8783168,40,0,utRho02
osmB,2686952,2686952,2686656,296,208,utRho02
osmC,3113192,3113250,3113192,58,60,utRho02
osmE,3644566,3644566,3644512,54,70,utRho02
osmF,4439046,4439046,4438962,84,644,utRho02
osmY,9222306,9222792,9222306,486,238,utRho02
otsA,3963302,3963302,3963224,78,60,utRho02
otsB,3964930,3964930,3964774,156,4,utRho02
oxc,4984288,4984288,4983900,388,92,utRho02
oxyR,8316914,8316980,8316914,66,0,utRho02
oxyS,8316788,8316788,8316788,0,0,utRho02
paaA,2907730,2907854,2907730,124,0,utRho02
paaX,2927018,2927078,2927018,60,0,utRho02
paaZ,2907340,2907340,2907284,56,0,utRho02
pabA,6981702,6981702,6981658,44,0,utRho02
pabB,3789256,3789610,3789256,354,0,utRho02
pabC,2306186,2306600,2306186,414,194,utRho02
pagP,1313052,1313114,1313052,62,0,utRho02
panB,299260,299260,299202,58,128,utRho02
panC,297840,297840,297590,250,186,utRho02
panD,293490,293490,293388,102,92,utRho02
panZ,7195656,7195968,7195656,312,0,utRho02
parC,6332060,6332060,6331946,114,162,utRho02
patA,6438916,6438988,6438916,72,0,utRho02
patD,3030830,3031156,3030830,326,0,utRho02
pbpC,5294986,5294986,5294650,336,0,utRho02
pbpG,4450132,4450132,4449740,392,248,utRho02
pck,7065358,7065636,7065358,278,2106,utRho02
pcnB,318782,318782,318252,530,704,utRho02
pdhR,244068,244184,244068,116,222,utRho02
pdxB,4875768,4875768,4875702,66,0,utRho02
pdxH,3436068,3436068,3436014,54,358,utRho02
pdxJ,5403626,5403626,5403458,168,188,utRho02
pdxK,5074638,5074638,5074474,164,0,utRho02
pepA,8972278,8972278,8971902,376,160,utRho02
pepD,511618,511618,511432,186,4394,utRho02
pepN,1981182,1981244,1981182,62,16,utRho02
pepQ,8062294,8062322,8062294,28,0,utRho02
pepT,2371646,2371688,2371646,42,46,utRho02
pfkA,8214948,8215104,8214948,156,288,utRho02
pfkB,3612646,3612740,3612646,94,0,utRho02
pflA,1902456,1902456,1902160,296,18,utRho02
pflB,1907850,1907850,1907108,742,926,utRho02
pflD,8287716,8287990,8287716,274,0,utRho02
pgaA,2185046,2185046,2184578,468,0,utRho02
pgi,8467444,8467516,8467444,72,34,utRho02
pgk,12291428,12291428,12290488,940,5276,utRho02
pgl,1597078,1597172,1597078,94,64,utRho02
pgpB,2678324,2678660,2678324,336,90,utRho02
pgpC,5397276,5397276,5397100,176,60,utRho02
pgrR,2783744,2783982,2783744,238,0,utRho02
pheL,5475158,5475198,5475158,40,0,utRho02
pheM,7197204,7197204,7197080,124,152,utRho02
pheP,1203858,1203918,1203858,60,0,utRho02
pheU,8725254,8725254,8725252,2,0,utRho02
pheV,6220730,6220732,6220730,2,10,utRho02
phnC,8650412,8650412,8650330,82,0,utRho02
phoA,803414,803494,803414,80,2,utRho02
phoB,834202,834284,834202,82,0,utRho02
phoE,520316,520316,520200,116,6,utRho02
phoH,2169730,2169984,2169730,254,624,utRho02
phoP,2381016,2381016,2380894,122,1232,utRho02
phoQ,2379880,2379880,2379552,328,1300,utRho02
phoU,7815330,7815330,7815156,174,0,utRho02
phr,1478842,1479014,1478842,172,0,utRho02
pinE,2419054,2419370,2419054,316,0,utRho02
pinQ,3267168,3267244,3267168,76,1176,utRho02
pinR,2867424,2867424,2867348,76,1450,utRho02
pitA,7275224,7275284,7275224,60,0,utRho02
pitB,6272806,6272806,6272742,64,0,utRho02
pka,5439862,5439906,5439862,44,0,utRho02
plaP,4174476,4174476,4174124,352,994,utRho02
pldA,8009628,8009724,8009628,96,90,utRho02
pldB,8018028,8018340,8018028,312,366,utRho02
plsB,8513196,8513196,8512932,264,162,utRho02
pmbA,8915890,8915918,8915890,28,64,utRho02
pmrD,4747148,4747148,4747076,72,0,utRho02
pncB,1980828,1980828,1980712,116,0,utRho02
pncC,5648788,5648788,5648692,96,0,utRho02
pnp,6622652,6622652,6622336,316,120,utRho02
pntA,3355950,3355950,3355806,144,0,utRho02
pntB,3353096,3353096,3352720,376,0,utRho02
polA,8093880,8093932,8093880,52,326,utRho02
polB,131606,131606,131560,46,0,utRho02
potD,2365700,2365700,2365658,42,0,utRho02
potE,1436688,1436688,1436530,158,0,utRho02
potF,1787268,1787568,1787268,300,188,utRho02
poxB,1822152,1822152,1822098,54,28,utRho02
ppa,8899372,8899372,8899304,68,114,utRho02
ppc,8306380,8306380,8306196,184,742,utRho02
ppdA,5928440,5928440,5928354,86,1544,utRho02
ppdD,235410,235410,235098,312,710,utRho02
pphA,3846770,3846770,3845938,832,2238,utRho02
pphB,5719474,5719520,5719474,46,0,utRho02
ppiA,6984898,6984898,6984594,304,20,utRho02
ppiC,7919682,7919682,7919626,56,74,utRho02
ppiD,923638,923830,923638,192,1204,utRho02
ppk,5245748,5246088,5245748,340,386,utRho02
pppA,6228958,6228958,6228704,254,30,utRho02
ppsA,3574322,3574322,3574224,98,8,utRho02
ppsR,3574678,3574890,3574678,212,0,utRho02
pptA,3065716,3066104,3065716,388,8,utRho02
pqiA,2023318,2024002,2023318,684,138,utRho02
prc,3830054,3830054,3829632,422,22264,utRho02
preT,4467978,4468066,4467978,88,78,utRho02
prfC,9218688,9218828,9218688,140,1140,utRho02
prkB,6968622,6968980,6968622,358,1350,utRho02
prlC,7290476,7290476,7290364,112,46,utRho02
prlF,6553944,6554004,6553944,60,0,utRho02
proB,520432,520776,520432,344,490,utRho02
proC,811372,811372,811288,84,0,utRho02
proK,7417388,7417388,7417384,4,0,utRho02
proL,4572414,4572422,4572414,8,0,utRho02
proP,8660640,8661004,8660640,364,7014,utRho02
proS,437674,437674,437550,124,594,utRho02
proV,5609126,5609630,5609126,504,20,utRho02
prpB,697292,697364,697292,72,0,utRho02
prpR,696942,696942,696886,56,0,utRho02
prs,2524354,2524354,2523750,604,57028,utRho02
psd,8781276,8781276,8780720,556,5668,utRho02
psiE,8480600,8480650,8480600,50,0,utRho02
pspA,2736076,2736158,2736076,82,0,utRho02
pspF,2736080,2736080,2735824,256,0,utRho02
pspG,8525632,8525680,8525632,48,32,utRho02
pssA,5445156,5445454,5445156,298,2194,utRho02
pstB,7817112,7817112,7816732,380,94,utRho02
pstC,7821084,7821084,7820796,288,0,utRho02
pstS,23469408,23469408,23469150,258,180,utRho02
psuG,4517114,4517114,4516734,380,48,utRho02
psuT,4514992,4514992,4514670,322,0,utRho02
pth,2517084,2517084,2517026,58,10,utRho02
ptrA,5918022,5918022,5917768,254,0,utRho02
ptrB,3857730,3857730,3857678,52,4570,utRho02
ptsG,2315252,2315738,2315252,486,2274,utRho02
ptsH,5066996,5067528,5066996,532,3546,utRho02
purA,8809328,8809374,8809328,46,70,utRho02
purC,5195562,5195562,5195236,326,96,utRho02
purD,8411972,8411972,8411862,110,106,utRho02
purE,1106284,1106284,1106200,84,1042,utRho02
purH,8415254,8415254,8415064,190,144,utRho02
purL,5391178,5391178,5391086,92,176,utRho02
purM,5242306,5242394,5242306,88,0,utRho02
purR,3475378,3475688,3475378,310,838,utRho02
purT,3861438,3861762,3861438,324,26,utRho02
purU,2577512,2577512,2577248,264,1166,utRho02
putA,2157850,2157850,2157764,86,0,utRho02
putP,2158336,2158610,2158336,274,98,utRho02
puuA,2721936,2721936,2721816,120,0,utRho02
puuC,2725456,2725486,2725456,30,0,utRho02
puuD,2722104,2722240,2722104,136,0,utRho02
puuP,2718746,2718746,2718374,372,1300,utRho02
pykA,3874988,3875298,3874988,310,100,utRho02
pykF,3510934,3511396,3510934,462,1666,utRho02
pyrC,2245286,2245286,2245214,72,292,utRho02
pyrD,2009464,2009536,2009464,72,56,utRho02
pyrE,7631970,7631970,7631536,434,0,utRho02
pyrF,2683740,2683842,2683740,102,706,utRho02
pyrG,5819594,5819594,5819332,262,2886,utRho02
pyrH,383624,383710,383624,86,2318,utRho02
pyrL,8945490,8945490,8945066,424,300,utRho02
qmcA,1031646,1031646,1031546,100,4,utRho02
qor,8528608,8528608,8528462,146,164,utRho02
qseB,6339502,6339656,6339502,154,40,utRho02
queA,849970,850022,849970,52,794,utRho02
queE,5811212,5811212,5810836,376,80,utRho02
queF,5850642,5850696,5850642,54,12,utRho02
queG,8788184,8788184,8788134,50,954,utRho02
racC,2835630,2835630,2835526,104,0,utRho02
racR,2840898,2840898,2840482,416,56,utRho02
raiA,5474208,5474308,5474208,100,216,utRho02
rarD,8008594,8008594,8008356,238,340,utRho02
ravA,7862256,7862256,7862186,70,40,utRho02
rayT,495088,495274,495088,186,40,utRho02
rbn,4763162,4763216,4763162,54,0,utRho02
rbsD,7866644,7866702,7866644,58,0,utRho02
rcnA,4371654,4371834,4371654,180,6,utRho02
rcnB,4373768,4373920,4373768,152,6,utRho02
rcnR,4371806,4371806,4371592,214,6,utRho02
rcsA,4047672,4047936,4047672,264,206,utRho02
rcsB,4631390,4632354,4631390,964,1412,utRho02
rcsC,4640162,4640162,4639656,506,534,utRho02
rcsD,4626904,4626976,4626904,72,34,utRho02
rdgB,6193240,6193362,6193240,122,472,utRho02
rdlA,2538646,2538646,2538646,0,0,utRho02
rdlB,2539712,2539716,2539712,4,0,utRho02
rdlC,2540782,2540786,2540782,4,0,utRho02
rdlD,7400272,7400272,7400272,0,0,utRho02
rdoA,8084782,8084830,8084782,48,70,utRho02
recA,11295276,11295276,11295076,200,1864,utRho02
recC,5925014,5925014,5924856,158,238,utRho02
recF,7763722,7763722,7762442,1280,16080,utRho02
recN,5503518,5503590,5503518,72,0,utRho02
recQ,8011666,8011728,8011666,62,0,utRho02
relA,5828554,5828554,5827302,1252,1060,utRho02
relB,3291806,3291806,3291744,62,0,utRho02
rem,3289950,3289950,3289804,146,84,utRho02
rep,7921294,7921354,7921294,60,88,utRho02
rfaD,7587730,7587974,7587730,244,402,utRho02
rfaE,6393852,6393852,6393506,346,4,utRho02
rfaH,8049930,8049930,8049642,288,1306,utRho02
rfbX,4219436,4219436,4219168,268,3164,utRho02
rfe,7935600,7935832,7935600,232,390,utRho02
rhaB,8194944,8194944,8194896,48,0,utRho02
rhaD,8188770,8188770,8188544,226,0,utRho02
rhaS,8195422,8195472,8195422,50,0,utRho02
rhaT,8201132,8201132,8201050,82,48,utRho02
rhlE,1661566,1661744,1661566,178,878,utRho02
rhoL,47593944,47594772,47593944,828,460824,utRho02
rhsB,7238006,7238384,7238006,378,96,utRho02
rhsC,1458758,1459166,1458758,408,0,utRho02
rhsD,1046132,1046522,1046132,390,0,utRho02
rhtA,1700608,1700608,1700194,414,82,utRho02
rhtC,8015478,8015514,8015478,36,2604,utRho02
ribA,2678468,2678468,2678320,148,90,utRho02
ribC,3486916,3486916,3486484,432,194,utRho02
ribE,869008,869294,869008,286,9074,utRho02
ribF,42766,42814,42766,48,202,utRho02
ridA,8941892,8941892,8941826,66,116,utRho02
rihA,1369204,1369204,1368824,380,592,utRho02
rihB,4510504,4510504,4510372,132,0,utRho02
rimJ,2251044,2251124,2251044,80,0,utRho02
rimK,1783752,1783934,1783752,182,330,utRho02
rimL,2997486,2997876,2997486,390,20,utRho02
rimO,1756140,1756140,1756070,70,0,utRho02
rimP,6636350,6636350,6636012,338,1516,utRho02
rlmA,3814172,3814172,3814120,52,284,utRho02
rlmD,5830086,5830086,5830000,86,68,utRho02
rlmE,6655520,6655520,6655328,192,3774,utRho02
rlmF,1684384,1684664,1684384,280,2,utRho02
rlmG,6471784,6471784,6471750,34,10,utRho02
rlmI,2060002,2060002,2059938,64,66,utRho02
rlmJ,7290700,7290770,7290700,70,270,utRho02
rlmL,2015344,2015688,2015344,344,472,utRho02
rlpA,1330444,1330444,1330380,64,236,utRho02
rluA,120900,120900,120692,208,560,utRho02
rluF,8460324,8460708,8460324,384,118,utRho02
rmf,2031006,2031430,2031006,424,1858,utRho02
rna,1290068,1290068,1290006,62,0,utRho02
rnb,2698258,2698258,2697824,434,2990,utRho02
rnc,10816892,10816892,10816252,640,12380,utRho02
rnd,3776122,3776122,3775982,140,430,utRho02
rne,2289746,2289746,2288734,1012,10200,utRho02
rnhA,472082,472082,472004,78,354,utRho02
rnk,1288360,1288360,1287934,426,154,utRho02
rnlA,5531788,5531836,5531788,48,112,utRho02
rnlB,5533414,5533968,5533414,554,3124,utRho02
rnpB,19623552,19623552,19623552,0,0,utRho02
rob,9270706,9270706,9270620,86,76,utRho02
rodZ,5285868,5285868,5285688,180,196,utRho02
rpe,7030306,7030306,7030118,188,124,utRho02
rph,15266320,15266320,15266196,124,20,utRho02
rpiA,6118706,6118706,6118650,56,0,utRho02
rpiB,8626514,8626700,8626514,186,48,utRho02
rpiR,8626274,8626274,8625982,292,0,utRho02
rplJ,8359246,8359992,8359246,746,12528,utRho02
rplK,8356708,8356894,8356708,186,930,utRho02
rplM,6757344,6757344,6757302,42,15222,utRho02
rplN,6896444,6896444,6896298,146,7784,utRho02
rplS,5489284,5489284,5489060,224,15628,utRho02
rplT,7199052,7199052,7198996,56,1452,utRho02
rplU,6667036,6667036,6666902,134,160,utRho02
rplY,4564866,4565034,4564866,168,218,utRho02
rpmA,6666450,6666450,6666238,212,1186,utRho02
rpmB,15247980,15247980,15246696,1284,143264,utRho02
rpmE,8253816,8254026,8253816,210,834,utRho02
rpmF,2294676,2294734,2294676,58,72738,utRho02
rpmH,7768130,7768672,7768130,542,9384,utRho02
rpmI,3600854,3600854,3599998,856,19424,utRho02
rpoB,8362126,8362490,8362126,364,1234,utRho02
rpoD,6424946,6426094,6424946,1148,24614,utRho02
rpoE,5420372,5420372,5420024,348,0,utRho02
rpoH,7202006,7202006,7201566,440,29660,utRho02
rpoN,6689324,6689434,6689324,110,110,utRho02
rpoS,5736236,5736236,5735102,1134,4274,utRho02
rpoZ,7644154,7644212,7644154,58,1464,utRho02
rppH,5937986,5937986,5937954,32,0,utRho02
rprA,3540744,3540744,3540744,0,0,utRho02
rpsA,1923434,1923990,1923434,556,210096,utRho02
rpsF,8850050,8850236,8850050,186,50442,utRho02
rpsI,6756580,6756580,6756414,166,11880,utRho02
rpsJ,6906884,6906884,6906540,344,16334,utRho02
rpsL,6949242,6949242,6949104,138,190,utRho02
rpsM,6885130,6885130,6884942,188,3382,utRho02
rpsO,13247144,13247144,13246736,408,2912,utRho02
rpsP,5492508,5492508,5492370,138,154,utRho02
rpsT,42420,42420,42156,264,1662,utRho02
rpsU,12842584,12843124,12842584,540,1772,utRho02
rraA,8238716,8238716,8238660,56,196,utRho02
rraB,8956768,8956946,8956768,178,0,utRho02
rrsA,8070478,8071062,8070478,584,9206,utRho02
rrsB,16665468,16666636,16665468,1168,19820,utRho02
rrsC,7883032,7883616,7883032,584,9944,utRho02
rrsD,6858094,6858094,6857524,570,308,utRho02
rrsE,8415726,8416294,8415726,568,1838,utRho02
rrsG,5462896,5462896,5462314,582,8150,utRho02
rrsH,446970,447542,446970,572,2212,utRho02
rsd,8393908,8393908,8393616,292,198,utRho02
rseA,5419264,5419264,5418808,456,826,utRho02
rseP,392940,393092,392940,152,154,utRho02
rseX,4067298,4067298,4067298,0,0,utRho02
rsfS,1338144,1338144,1338072,72,374,utRho02
rsgA,8783132,8783132,8783018,114,116,utRho02
rsmA,105176,105176,104860,316,5486,utRho02
rsmB,6869982,6870414,6869982,432,546,utRho02
rsmC,9215736,9215736,9215400,336,692,utRho02
rsmD,7208594,7208786,7208594,192,64,utRho02
rsmE,6182036,6182268,6182036,232,140,utRho02
rsmG,7847512,7847512,7847360,152,4062,utRho02
rsmH,180020,180188,180020,168,612,utRho02
rsmI,6587106,6587106,6586670,436,1496,utRho02
rssA,2578212,2578412,2578212,200,782,utRho02
rssB,2580440,2580484,2580440,44,282,utRho02
rstA,3364276,3364300,3364276,24,0,utRho02
rsuA,4561096,4561096,4560966,130,506,utRho02
rsxA,3411510,3411534,3411510,24,112,utRho02
rtcA,7114004,7114004,7113698,306,44,utRho02
rtcB,7116214,7116214,7116158,56,0,utRho02
rtn,4541356,4541452,4541356,96,122,utRho02
rutA,2148052,2148052,2148022,30,0,utRho02
rutG,2140090,2140090,2139678,412,0,utRho02
rutR,2148226,2148484,2148226,258,2,utRho02
ruvA,7784096,7784096,7783904,192,0,utRho02
ruvB,7782176,7782176,7781424,752,440,utRho02
ruvC,3894878,3894878,3894752,126,24,utRho02
rybB,1776114,1776114,1776114,0,0,utRho02
rydB,3529860,3529860,3529322,538,48,utRho02
rydC,2983012,2983012,2983012,0,0,utRho02
ryfA,5307398,5307710,5307398,312,90,utRho02
ryfD,5468590,5468590,5468590,0,0,utRho02
ryhB,7162032,7162032,7162032,0,0,utRho02
ryjA,8556132,8556132,8556132,0,0,utRho02
ryjB,9055954,9055954,9055954,0,0,utRho02
sad,3229598,3229598,3229406,192,124,utRho02
safA,3168056,3168056,3167918,138,0,utRho02
sanA,4465368,4465756,4465368,388,244,utRho02
sapF,2705314,2705314,2705268,46,378,utRho02
sbcB,4165456,4165512,4165456,56,112,utRho02
sbcC,831694,831694,831506,188,202,utRho02
sbcD,833954,833954,833904,50,40,utRho02
sbmA,793106,793278,793106,172,52,utRho02
sbmC,4162650,4162650,4162524,126,0,utRho02
sdaA,3793618,3793864,3793618,246,120,utRho02
sdaC,5856070,5856458,5856070,388,886,utRho02
sdhC,1509916,1510354,1509916,438,24662,utRho02
sdhD,1510808,1511120,1510808,312,8308,utRho02
sdiA,3993834,3993834,3993664,170,56,utRho02
secE,8354354,8354716,8354354,362,444,utRho02
secG,6645180,6645180,6645010,170,3724,utRho02
selA,7522594,7522594,7522498,96,938,utRho02
selB,7519850,7519850,7519722,128,100,utRho02
selC,7672396,7672444,7672396,48,102,utRho02
selD,3696058,3696058,3696016,42,5570,utRho02
seqA,1425884,1425974,1425884,90,470,utRho02
serA,6117098,6117098,6116820,278,46,utRho02
serB,9249712,9249790,9249712,78,110,utRho02
serC,3830380,3830612,3830380,232,0,utRho02
serS,1878730,1878856,1878730,126,3324,utRho02
serT,2063438,2063438,2063424,14,0,utRho02
serU,4087124,4087124,4087114,10,28,utRho02
serV,5637394,5637394,5637290,104,156,utRho02
serW,1852014,1852014,1851942,72,202,utRho02
serX,2195352,2195352,2195304,48,16,utRho02
setB,4527426,4527726,4527426,300,0,utRho02
setC,7673488,7673906,7673488,418,34,utRho02
sfmA,1116124,1116424,1116124,300,0,utRho02
sfmC,1117606,1117948,1117606,342,0,utRho02
sfsA,323030,323030,322972,58,436,utRho02
sfsB,6669592,6669818,6669592,226,694,utRho02
sgrR,154676,154676,154598,78,40,utRho02
sgrS,154734,154734,154734,0,0,utRho02
shiA,4107068,4107286,4107068,218,4,utRho02
sibA,4306622,4306622,4306622,0,0,utRho02
sibB,4307292,4307292,4307292,0,0,utRho02
sibC,6113702,6113702,6113702,0,0,utRho02
sibD,6389730,6389730,6389730,0,0,utRho02
sibE,6390480,6390480,6390480,0,0,utRho02
sixA,4913998,4913998,4913624,374,56,utRho02
slp,7307872,7307922,7307872,50,0,utRho02
slt,9261400,9261466,9261400,66,64,utRho02
slyA,3442028,3442028,3441648,380,122,utRho02
slyB,3439496,3439752,3439496,256,286,utRho02
slyD,6957398,6957398,6956994,404,36,utRho02
slyX,6954862,6955280,6954862,418,9108,utRho02
smf,6867372,6867372,6867120,252,530,utRho02
smpB,5509534,5509792,5509534,258,1418,utRho02
smrA,2811872,2811958,2811872,86,258,utRho02
smrB,4896872,4897212,4896872,340,140,utRho02
smtA,1946808,1947074,1946808,266,12,utRho02
sodA,8201518,8201620,8201518,102,8292,utRho02
sodB,3470646,3470756,3470646,110,0,utRho02
sodC,3449358,3449358,3449310,48,0,utRho02
sohB,2658568,2658664,2658568,96,104,utRho02
sokB,2984232,2984238,2984232,6,52,utRho02
solA,2241218,2241218,2241172,46,4,utRho02
soxR,8554894,8554938,8554894,44,0,utRho02
soxS,8554846,8554846,8554766,80,0,utRho02
speA,6172096,6172096,6171822,274,462,utRho02
speB,6167892,6167892,6167594,298,118,utRho02
speC,6218350,6218350,6218310,40,28,utRho02
spf,8099798,8099798,8099798,0,0,utRho02
sppA,3697422,3697674,3697422,252,36,utRho02
spy,3651376,3651376,3651250,126,0,utRho02
sra,3112092,3112092,3111926,166,0,utRho02
sraB,2293178,2293178,2293178,0,0,utRho02
sraC,3846132,3846132,3846132,0,0,utRho02
srlA,5651582,5651664,5651582,82,10,utRho02
srlR,5657720,5658094,5657720,374,84,utRho02
srmB,5425752,5425792,5425752,40,124,utRho02
sroA,151216,151216,151216,0,0,utRho02
sroG,6369436,6369436,6369436,0,0,utRho02
sroH,8380974,8380974,8380974,0,0,utRho02
ssb,8548022,8548250,8548022,228,218,utRho02
sseA,5304782,5304988,5304782,206,5314,utRho02
sspA,6755138,6755138,6754840,298,1306,utRho02
ssrA,5511014,5511186,5511014,172,256,utRho02
ssrS,12223036,12223932,12223036,896,3968,utRho02
sstT,6479726,6479888,6479726,162,266,utRho02
ssuB,1988282,1988282,1988088,194,2,utRho02
ssuE,1995126,1995126,1995024,102,0,utRho02
sthA,8321604,8321604,8321580,24,2068,utRho02
stpA,5597156,5597156,5596990,166,142,utRho02
sucA,3034344,3034824,3034344,480,1848,utRho02
sufA,3528836,3528836,3528772,64,60,utRho02
sufE,3518962,3518962,3518580,382,960,utRho02
sugE,8753588,8753750,8753588,162,608,utRho02
sulA,2041894,2041894,2041838,56,404,utRho02
syd,5850738,5850738,5850560,178,12,utRho02
symE,9159834,9159834,9159680,154,60,utRho02
symR,9159670,9159670,9159670,0,0,utRho02
tabA,8949566,8949724,8949566,158,0,utRho02
talA,5157140,5157332,5157140,192,0,utRho02
talB,16382,16476,16382,94,6246,utRho02
tam,3214442,3214692,3214442,250,0,utRho02
tamA,8884540,8884764,8884540,224,10,utRho02
tar,3945432,3945432,3945382,50,0,utRho02
tas,5943138,5943194,5943138,56,260,utRho02
tatA,16087636,16087780,16087636,144,452,utRho02
tatE,1317742,1317894,1317742,152,0,utRho02
tauA,770410,770464,770410,54,0,utRho02
tdcA,6534186,6534186,6534130,56,0,utRho02
tdcG,6519652,6519652,6519298,354,0,utRho02
tdcR,6534380,6534760,6534380,380,130,utRho02
tdk,2586986,2587054,2586986,68,140,utRho02
tehA,3001072,3001146,3001072,74,0,utRho02
tesA,1039898,1039898,1039530,368,276,utRho02
tesB,950402,950402,950322,80,0,utRho02
tfaE,2418532,2418532,2418238,294,62,utRho02
tfaQ,3269912,3269912,3269770,142,26,utRho02
tff,379424,379256,379424,168,0,utRho02
tgt,852110,852274,852110,164,110,utRho02
thiD,4369346,4369346,4369032,314,0,utRho02
thiI,882936,883098,882936,162,598,utRho02
thiM,4370902,4370902,4370602,300,906,utRho02
thiQ,146170,146170,145854,316,596,utRho02
thrL,592,760,592,168,1380,utRho02
thrS,7210932,7210932,7210280,652,4120,utRho02
thrU,8350762,8350776,8350762,14,0,utRho02
thrV,6847414,6847414,6847310,104,177612,utRho02
thrW,525682,525742,525682,60,1248,utRho02
thyA,5930696,5930696,5930310,386,3352,utRho02
tig,909986,910266,909986,280,862,utRho02
tisB,7706674,7707106,7706674,432,424,utRho02
tktA,6163414,6163414,6163270,144,76,utRho02
tktB,5158616,5159272,5158616,656,652,utRho02
tldD,6784368,6784368,6784056,312,136,utRho02
tmcA,5191876,5191876,5191718,158,0,utRho02
tnaC,15553644,15553740,15553644,96,156,utRho02
tolB,1555074,1555480,1555074,406,1010,utRho02
tolC,6356008,6356230,6356008,222,720,utRho02
tomB,961588,961588,961416,172,7882,utRho02
tonB,2622108,2622178,2622108,70,0,utRho02
topA,2661578,2662096,2661578,518,1496,utRho02
torC,2116112,2116168,2116112,56,62,utRho02
torR,2115968,2115968,2115908,60,62,utRho02
torS,2112364,2112364,2112356,8,0,utRho02
torT,2112414,2112522,2112414,108,0,utRho02
tpiA,8223138,8223138,8223014,124,56,utRho02
tppB,3425342,3425538,3425342,196,5134,utRho02
tpr,2574376,2574376,2574376,0,0,utRho02
tpx,2777688,2777688,2777622,66,1122,utRho02
tqsA,3347780,3347826,3347780,46,0,utRho02
treA,2494850,2494850,2494752,98,136,utRho02
treB,8932420,8932420,8932360,60,80,utRho02
treF,7339102,7339184,7339102,82,168,utRho02
treR,8934694,8934694,8934492,202,0,utRho02
trg,2984878,2984940,2984878,62,208,utRho02
trkG,2847342,2847564,2847342,222,0,utRho02
trmA,8326590,8326590,8326540,50,328,utRho02
trpA,2634678,2634678,2634444,234,856,utRho02
trpC,2639888,2639888,2639570,318,296,utRho02
trpL,5292432,5292432,5292328,104,0,utRho02
trpR,9265408,9265520,9265408,112,360,utRho02
trpS,7027394,7027394,7027276,118,1430,utRho02
trpT,7893560,7893914,7893560,354,102272,utRho02
trxA,7931294,7931522,7931294,228,842,utRho02
trxB,1864156,1864156,1864100,56,0,utRho02
trxC,5437350,5437470,5437350,120,342,utRho02
tsaD,6421256,6421256,6421086,170,40,utRho02
tsgA,6985038,6985136,6985038,98,0,utRho02
tsr,9182824,9183314,9182824,490,50,utRho02
tsx,864490,864490,864026,464,870,utRho02
ttcA,2823970,2823970,2823896,74,3614,utRho02
ttdA,6412848,6412926,6412848,78,0,utRho02
ttdR,6412760,6412760,6412512,248,0,utRho02
tufA,6943448,6943448,6942658,790,156748,utRho02
tus,3368346,3368518,3368346,172,20,utRho02
tusA,7218040,7218040,7217992,48,96,utRho02
tusB,6950218,6950218,6949930,288,1094,utRho02
tynA,2902996,2902996,2902698,298,0,utRho02
typA,8116460,8116814,8116460,354,8586,utRho02
tyrB,8534164,8534228,8534164,64,2040,utRho02
tyrP,3979004,3979362,3979004,358,0,utRho02
tyrR,2773384,2773440,2773384,56,0,utRho02
tyrS,3434566,3434566,3434444,122,0,utRho02
tyrT,2575330,2575330,2575244,86,114,utRho02
uacT,6062378,6062734,6062378,356,54,utRho02
ubiC,8504886,8505012,8504886,126,298,utRho02
ubiD,8049618,8049976,8049618,358,1356,utRho02
ubiE,8037494,8037710,8037494,216,124,utRho02
ubiG,4679078,4679134,4679078,56,26,utRho02
ucpA,5089342,5089342,5089246,96,0,utRho02
udp,8032782,8032862,8032782,80,64,utRho02
ugd,4199470,4199470,4199226,244,6,utRho02
ugpB,7184852,7184852,7184650,202,164,utRho02
ugpQ,7176600,7176600,7176226,374,0,utRho02
uhpT,7694396,7694396,7694334,62,0,utRho02
uidA,3392304,3392304,3392142,162,26,utRho02
uidC,3386012,3386012,3385702,310,0,utRho02
uidR,3394150,3394150,3394104,46,134,utRho02
ulaA,8839854,8839960,8839854,106,0,utRho02
ulaG,8839350,8839350,8839250,100,50,utRho02
ulaR,8837124,8837124,8836906,218,96,utRho02
umpG,5741372,5741372,5740548,824,160,utRho02
umpH,1400704,1400704,1400652,52,46,utRho02
umuD,2461476,2461534,2461476,58,0,utRho02
ung,5433476,5433508,5433476,32,44,utRho02
uof,2843316,2843316,2842900,416,9288,utRho02
upp,5241818,5241818,5241744,74,56,utRho02
usg,4873780,4873780,4873298,482,608,utRho02
ushA,1009772,1009828,1009772,56,0,utRho02
uspA,7279966,7280222,7279966,256,1150,utRho02
uspB,7279696,7279696,7279440,256,768,utRho02
uspC,3959172,3959506,3959172,334,0,utRho02
uspE,2797318,2797318,2797244,74,204,utRho02
uspF,2871282,2871282,2871238,44,0,utRho02
uspG,1283806,1283806,1283734,72,728,utRho02
uvrA,8547872,8547872,8547742,130,288,utRho02
uvrB,1626304,1627052,1626304,748,2124,utRho02
uvrC,3989758,3989758,3989412,346,80,utRho02
uvrD,7995814,7995966,7995814,152,206,utRho02
uvrY,3990812,3990812,3990718,94,58,utRho02
uxaB,3221474,3221474,3221360,114,64,utRho02
uxaC,6489714,6489714,6489482,232,60,utRho02
uxuA,9103036,9103272,9103036,236,104,utRho02
uxuR,9108916,9109152,9108916,236,40,utRho02
valS,8967854,8967854,8967674,180,854,utRho02
valU,5041848,5041862,5041848,14,8,utRho02
valV,3492830,3492870,3492830,40,0,utRho02
ves,3649968,3649968,3649874,94,2,utRho02
waaA,7616512,7617080,7616512,568,538,utRho02
waaH,7580298,7580298,7580162,136,0,utRho02
waaQ,7616476,7616476,7616196,280,116,utRho02
waaU,7598996,7598996,7598624,372,292,utRho02
waaY,7602272,7602272,7601930,342,8156,utRho02
wbbH,4214888,4214888,4214452,436,7494,utRho02
wbbK,4209212,4209212,4209018,194,354,utRho02
wcaM,4231868,4231868,4231792,76,0,utRho02
wrbA,2135516,2135516,2135416,100,10,utRho02
wza,4275166,4275166,4274486,680,0,utRho02
wzxC,4240674,4240674,4240316,358,120,utRho02
wzzB,4196950,4196950,4196602,348,358,utRho02
xanP,7657642,7657890,7657642,248,10,utRho02
xanQ,6048520,6048702,6048520,182,16,utRho02
xapA,5049820,5049820,5049756,64,0,utRho02
xapR,10090252,10090252,10089908,344,0,utRho02
xdhA,6000514,6000690,6000514,176,84,utRho02
xerD,6079702,6079702,6079486,216,128,utRho02
xseA,5268394,5268464,5268394,70,626,utRho02
xseB,882746,882746,882686,60,162,utRho02
xthA,3664798,3664856,3664798,58,0,utRho02
xylA,7461614,7461614,7461530,84,160,utRho02
xylE,8484540,8484540,8484508,32,0,utRho02
xylF,7462138,7462262,7462138,124,0,utRho02
xylR,7469812,7469958,7469812,146,0,utRho02
yaaA,13230,13230,12918,312,74,utRho02
yaaI,23876,23876,23572,304,0,utRho02
yaaJ,16034,16034,15918,116,308,utRho02
yaaU,91184,91614,91184,430,0,utRho02
yaaW,23084,23084,22712,372,0,utRho02
yaaX,10060,10468,10060,408,158,utRho02
yabI,142542,142702,142542,160,0,utRho02
yacC,273880,273880,273834,46,5434,utRho02
yacH,262932,262932,262520,412,0,utRho02
yacL,268678,268776,268678,98,40,utRho02
yadD,293796,293936,293796,140,0,utRho02
yadE,289930,290162,289930,232,428,utRho02
yadN,314110,314110,313766,344,98,utRho02
yadS,355572,355572,355248,324,684,utRho02
yadV,312470,312470,312402,68,0,utRho02
yaeF,434270,434270,434006,264,24,utRho02
yaeP,428374,428374,428250,124,332,utRho02
yaeQ,428176,428582,428176,406,382,utRho02
yaeR,423716,423754,423716,38,96,utRho02
yafC,462166,462166,461762,404,516,utRho02
yafD,462128,462244,462128,116,168,utRho02
yafK,491986,491986,491610,376,3442,utRho02
yafL,493282,493424,493282,142,50,utRho02
yafN,503938,504010,503938,72,2,utRho02
yafS,469568,469632,469568,64,224,utRho02
yafT,474470,474670,474470,200,0,utRho02
yafV,480432,480432,480378,54,94,utRho02
yafZ,536052,536052,536010,42,28,utRho02
yagE,564446,564556,564446,110,30,utRho02
yagG,570414,570790,570414,376,0,utRho02
yagI,578384,578384,578324,60,0,utRho02
yagK,586236,586236,585896,340,4,utRho02
yagL,588062,588062,587836,226,24,utRho02
yagN,591342,591342,591158,184,1516,utRho02
yahA,663746,664742,663746,996,290,utRho02
yahC,670136,670136,670044,92,0,utRho02
yahE,671478,671850,671478,372,84,utRho02
yahM,690504,690808,690504,304,124,utRho02
yahN,692872,692872,692674,198,0,utRho02
yahO,692864,692968,692864,104,0,utRho02
yaiE,816296,816354,816296,58,100,utRho02
yaiI,811396,811528,811396,132,0,utRho02
yaiO,761946,761946,761684,262,0,utRho02
yaiP,767970,767970,767870,100,0,utRho02
yaiS,769660,769660,769232,428,0,utRho02
yaiV,788922,788922,788922,0,0,utRho02
yaiY,799094,799094,798666,428,856,utRho02
yaiZ,798888,799186,798888,298,1488,utRho02
yajC,854410,854574,854410,164,1586,utRho02
yajD,860938,861210,860938,272,658,utRho02
yajI,866068,866068,865702,366,310,utRho02
yajL,887496,887496,887282,214,342,utRho02
yajQ,889316,889366,889316,50,24,utRho02
yajR,893374,893374,893332,42,430,utRho02
ybaB,987418,988152,987418,734,2330,utRho02
ybaL,1006590,1006590,1006476,114,38,utRho02
ybaM,980648,980648,980542,106,2002,utRho02
ybaN,981436,981764,981436,328,212,utRho02
ybaO,936704,936766,936704,62,0,utRho02
ybaP,1016568,1016568,1016160,408,1370,utRho02
ybaQ,1016348,1016436,1016348,88,68,utRho02
ybaS,1023146,1023282,1023146,136,0,utRho02
ybaV,927504,927874,927504,370,40,utRho02
ybaY,950490,950758,950490,268,92,utRho02
ybbB,1062724,1062724,1062452,272,2,utRho02
ybbJ,1030154,1030154,1029718,436,1022,utRho02
ybbL,1031784,1031838,1031784,54,0,utRho02
ybbN,1037136,1037136,1036558,578,1530,utRho02
ybbO,1038658,1038658,1038298,360,1416,utRho02
ybbY,1080718,1081130,1080718,412,70,utRho02
ybcH,1176140,1176140,1175962,178,0,utRho02
ybcI,1113264,1113264,1113106,158,1140,utRho02
ybcJ,1114050,1114050,1113746,304,464,utRho02
ybcK,1137502,1137804,1137502,302,0,utRho02
ybcL,1141690,1141786,1141690,96,0,utRho02
ybcN,1144628,1144932,1144628,304,0,utRho02
ybcQ,1147548,1147912,1147548,364,2,utRho02
ybcW,1159610,1159760,1159610,150,0,utRho02
ybdD,1263982,1264364,1263982,382,266,utRho02
ybdF,1212106,1212106,1211772,334,218,utRho02
ybdH,1267048,1267048,1266954,94,38,utRho02
ybdJ,1212822,1212822,1212398,424,4,utRho02
ybdK,1215122,1215122,1214766,356,274,utRho02
ybdL,1267114,1267172,1267114,58,0,utRho02
ybdM,1271110,1271110,1270752,358,504,utRho02
ybdN,1273372,1273372,1273138,234,2,utRho02
ybdR,1283844,1284176,1283844,332,648,utRho02
ybeD,1325412,1325412,1325284,128,168,utRho02
ybeF,1323090,1323090,1322756,334,80,utRho02
ybeL,1349986,1350036,1349986,50,0,utRho02
ybeQ,1353412,1353412,1353094,318,0,utRho02
ybeR,1353120,1353422,1353120,302,0,utRho02
ybeT,1358832,1358832,1358812,20,0,utRho02
ybeU,1358924,1359016,1358924,92,0,utRho02
ybeZ,1386938,1386938,1386834,104,4024,utRho02
ybfA,1458074,1458268,1458074,194,36,utRho02
ybfE,1423878,1423878,1423796,82,322,utRho02
ybfF,1425692,1425692,1425604,88,698,utRho02
ybfH,1433282,1433282,1433194,88,0,utRho02
ybgA,1477840,1478002,1477840,162,0,utRho02
ybgC,1549288,1549504,1549288,216,42,utRho02
ybgD,1505916,1505916,1505590,326,422,utRho02
ybgI,1485238,1485654,1485238,416,0,utRho02
ybgO,1498370,1498370,1497964,406,76,utRho02
ybgS,1570992,1570992,1570634,358,16,utRho02
ybhA,1597184,1597184,1596862,322,112,utRho02
ybhB,1616070,1616070,1615818,252,132,utRho02
ybhC,1614642,1614642,1614562,80,1030,utRho02
ybhD,1601418,1601418,1601276,142,0,utRho02
ybhH,1601104,1601518,1601104,414,0,utRho02
ybhK,1633384,1633384,1633294,90,32,utRho02
ybhM,1641556,1641586,1641556,30,0,utRho02
ybhN,1645296,1645296,1644996,300,0,utRho02
ybhQ,1649202,1649260,1649202,58,138,utRho02
ybiA,1665920,1665920,1665900,20,0,utRho02
ybiI,1676968,1676968,1676912,56,186,utRho02
ybiO,1691328,1691328,1690960,368,86,utRho02
ybiP,1705252,1705252,1705194,58,2714,utRho02
ybiS,1711572,1711572,1711488,84,644,utRho02
ybiT,1711894,1711926,1711894,32,0,utRho02
ybiU,1718212,1718212,1718122,90,0,utRho02
ybiV,1720176,1720176,1720056,120,0,utRho02
ybiW,1725566,1725566,1725212,354,68,utRho02
ybiX,1678548,1678548,1678414,134,1746,utRho02
ybjC,1781784,1781826,1781784,42,0,utRho02
ybjE,1830154,1830154,1829714,440,196,utRho02
ybjG,1767016,1767016,1766776,240,1252,utRho02
ybjL,1779882,1779882,1779638,244,196,utRho02
ybjM,1779770,1780178,1779770,408,270,utRho02
ybjO,1795704,1795978,1795704,274,2,utRho02
ybjP,1809046,1809046,1808934,112,0,utRho02
ybjQ,1809034,1809186,1809034,152,0,utRho02
ybjS,1813796,1813796,1813506,290,298,utRho02
ybjX,1838206,1838206,1838168,38,0,utRho02
ycaD,1891438,1891742,1891438,304,0,utRho02
ycaI,1928210,1928640,1928210,430,292,utRho02
ycaK,1899094,1899336,1899094,242,0,utRho02
ycaL,1920264,1920528,1920264,264,0,utRho02
ycaM,1894240,1894458,1894240,218,0,utRho02
ycaR,1941284,1941346,1941284,62,1874,utRho02
ycbB,1961862,1962094,1961862,232,60,utRho02
ycbJ,1943344,1943504,1943344,160,0,utRho02
ycbK,1966046,1966150,1966046,104,554,utRho02
ycbZ,2036920,2036920,2036598,322,198,utRho02
yccA,2062886,2062886,2062836,50,1030,utRho02
yccF,2048730,2048730,2048696,34,32,utRho02
yccS,2047988,2047988,2047766,222,40,utRho02
yccT,2055674,2055674,2055546,128,138,utRho02
yccX,2059960,2060128,2059960,168,356,utRho02
ycdT,2185682,2185752,2185682,70,0,utRho02
ycdU,2191266,2191686,2191266,420,0,utRho02
ycdZ,2200504,2200592,2200504,88,106,utRho02
yceA,2233544,2233614,2233544,70,96,utRho02
yceD,2293298,2293588,2293298,290,4804,utRho02
yceF,2293522,2293522,2293190,332,2824,utRho02
yceH,2252154,2252314,2252154,160,780,utRho02
yceI,2237282,2237282,2236952,330,138,utRho02
yceJ,2238142,2238142,2238092,50,288,utRho02
yceM,2253208,2253612,2253208,404,20,utRho02
yceO,2239264,2239264,2238894,370,94,utRho02
yceQ,2288760,2289004,2288760,244,8458,utRho02
ycfD,2376540,2376540,2376480,60,100,utRho02
ycfJ,2334814,2335198,2334814,384,1500,utRho02
ycfS,2340834,2340834,2340748,86,0,utRho02
ycfT,2350658,2350658,2350330,328,84,utRho02
ycfZ,2362760,2362760,2362534,226,578,utRho02
ycgB,2474570,2474570,2474482,88,0,utRho02
ycgG,2434614,2434656,2434614,42,4,utRho02
ycgJ,2452956,2453200,2452956,244,44,utRho02
ycgL,2455218,2455362,2455218,144,0,utRho02
ycgN,2457366,2457660,2457366,294,142,utRho02
ycgR,2489112,2489112,2489054,58,0,utRho02
ycgV,2512222,2512222,2511904,318,328,utRho02
ycgX,2426568,2426568,2426214,354,27396,utRho02
ycgY,2490166,2490320,2490166,154,36,utRho02
ycgZ,2431504,2431578,2431504,74,0,utRho02
ychE,2596904,2597196,2596904,292,216,utRho02
ychF,2515764,2515764,2515624,140,0,utRho02
ychH,2517476,2517582,2517476,106,600,utRho02
ychJ,2578354,2578354,2578264,90,0,utRho02
ychN,2547310,2547310,2547198,112,74,utRho02
ychO,2547520,2547850,2547520,330,412,utRho02
ychQ,2533798,2533848,2533798,50,60,utRho02
yciA,2624828,2624828,2624492,336,342,utRho02
yciB,2626110,2626110,2625780,330,3430,utRho02
yciC,2627396,2627396,2627326,70,62,utRho02
yciE,2630794,2630794,2630448,346,0,utRho02
yciG,5264368,5264368,5264140,228,0,utRho02
yciI,2621784,2621784,2621730,54,0,utRho02
yciN,2661606,2661606,2661336,270,136,utRho02
yciS,2680270,2680486,2680270,216,132,utRho02
yciT,2689088,2689088,2688692,396,226,utRho02
yciU,2614718,2614718,2614300,418,5222,utRho02
yciV,2646376,2646440,2646376,64,0,utRho02
yciW,2700472,2700472,2700214,258,1118,utRho02
yciZ,2689276,2689276,2689218,58,212,utRho02
ycjD,2703792,2703792,2703520,272,32,utRho02
ycjG,2777748,2777860,2777748,112,98,utRho02
ycjM,2740006,2740432,2740006,426,56,utRho02
ycjW,2767982,2767982,2767922,60,110,utRho02
ycjX,2768138,2768234,2768138,96,0,utRho02
ycjY,5568288,5568288,5567460,828,44,utRho02
ydaE,2836438,2836438,2836016,422,66,utRho02
ydaN,2816048,2816100,2816048,52,0,utRho02
ydaS,2840340,2840730,2840340,390,320,utRho02
ydbC,2948376,2948442,2948376,66,0,utRho02
ydbD,2950132,2950288,2950132,156,60,utRho02
ydbH,2885800,2886102,2885800,302,0,utRho02
ydbJ,2881712,2882116,2881712,404,124,utRho02
ydbK,2881692,2881692,2881568,124,70,utRho02
ydcA,2983294,2983354,2983294,60,10,utRho02
ydcF,2974404,2974470,2974404,66,44,utRho02
ydcI,2990268,2990268,2990142,126,46,utRho02
ydcJ,2990266,2990576,2990266,310,0,utRho02
ydcK,3001280,3001280,3000898,382,0,utRho02
ydcL,3004646,3004914,3004646,268,106,utRho02
ydcN,3012308,3012344,3012308,36,2,utRho02
ydcP,3013508,3013562,3013508,54,24,utRho02
ydcR,3019956,3020006,3019956,50,0,utRho02
ydcS,3022906,3023308,3022906,402,0,utRho02
ydcX,3034442,3034778,3034442,336,384,utRho02
ydcY,3035220,3035296,3035220,76,172,utRho02
ydcZ,3036750,3036750,3036662,88,232,utRho02
yddB,3155332,3155332,3155238,94,0,utRho02
yddE,3071738,3071738,3071716,22,0,utRho02
yddG,3094410,3094410,3094338,72,0,utRho02
yddJ,3089732,3089732,3089438,294,0,utRho02
yddW,3137704,3137704,3137646,58,0,utRho02
ydeA,3233910,3234056,3233910,146,398,utRho02
ydeE,3242528,3242664,3242528,136,0,utRho02
ydeI,3249118,3249118,3248994,124,0,utRho02
ydeJ,3249376,3249546,3249376,170,4,utRho02
ydeN,3165458,3165458,3165048,410,0,utRho02
ydeP,3173328,3173328,3172972,356,0,utRho02
ydeR,3176596,3176596,3176592,4,0,utRho02
ydfA,3296872,3297016,3296872,144,258,utRho02
ydfG,3254982,3255034,3254982,52,0,utRho02
ydfH,3256652,3256704,3256652,52,346,utRho02
ydfK,3265446,3266144,3265446,698,63712,utRho02
ydgA,3379588,3379704,3379588,116,0,utRho02
ydgC,3364124,3364124,3364060,64,260,utRho02
ydgD,3343906,3343920,3343906,14,0,utRho02
ydgH,3356754,3356854,3356754,100,50,utRho02
ydgJ,3408798,3408798,3408616,182,18,utRho02
ydgK,3410414,3410500,3410414,86,252,utRho02
ydhB,3479618,3479618,3479596,22,0,utRho02
ydhC,3479698,3479822,3479698,124,0,utRho02
ydhF,3451310,3451310,3451264,46,0,utRho02
ydhI,3441996,3442050,3441996,54,0,utRho02
ydhL,3451864,3451864,3451840,24,2,utRho02
ydhQ,3492404,3492404,3492254,150,0,utRho02
ydhS,3494136,3494262,3494136,126,602,utRho02
ydhT,3499138,3499138,3499118,20,0,utRho02
ydhY,3509284,3509284,3508954,330,44,utRho02
ydhZ,3510418,3510418,3510282,136,0,utRho02
ydiE,3579206,3579226,3579206,20,0,utRho02
ydiH,3530582,3530582,3530406,176,88,utRho02
ydiM,3541852,3542142,3541852,290,0,utRho02
ydiN,3544818,3545024,3544818,206,0,utRho02
ydiP,3558656,3558656,3558602,54,0,utRho02
ydiU,3582508,3582508,3582488,20,64,utRho02
ydiV,3584174,3584174,3584040,134,68,utRho02
ydiY,3612500,3612500,3612166,334,72,utRho02
ydjA,3697400,3697400,3697352,48,30,utRho02
ydjE,3708082,3708082,3707958,124,0,utRho02
ydjF,3709848,3709848,3709708,140,0,utRho02
ydjM,3620340,3620422,3620340,82,0,utRho02
ydjO,3626696,3626696,3626288,408,0,utRho02
ydjX,3666434,3666802,3666434,368,2484,utRho02
yeaE,3731448,3731448,3731272,176,120,utRho02
yeaG,3733530,3733816,3733530,286,0,utRho02
yeaI,3740486,3740770,3740486,284,0,utRho02
yeaJ,3743874,3744082,3743874,208,352,utRho02
yeaL,3748646,3748704,3748646,58,166,utRho02
yeaM,3751296,3751296,3751152,144,0,utRho02
yeaN,3750926,3751346,3750926,420,22,utRho02
yeaO,3753554,3753818,3753554,264,0,utRho02
yeaP,3755314,3755430,3755314,116,666,utRho02
yeaQ,3758780,3758780,3758510,270,96,utRho02
yeaR,3759988,3759988,3759896,92,72,utRho02
yeaY,3781122,3781122,3781064,58,120,utRho02
yebB,3892220,3892502,3892220,282,0,utRho02
yebC,3896370,3896370,3896302,68,38,utRho02
yebE,3859464,3859464,3859414,50,438,utRho02
yebG,3861530,3861530,3861494,36,0,utRho02
yebK,3873180,3873304,3873180,124,134,utRho02
yebQ,3820314,3820552,3820314,238,40,utRho02
yebS,3832238,3832516,3832238,278,28,utRho02
yebV,3843430,3843560,3843430,130,0,utRho02
yebW,3843914,3844242,3843914,328,1570,utRho02
yecC,3995646,3995646,3995628,18,0,utRho02
yecD,3901272,3901664,3901272,392,0,utRho02
yecF,3991434,3991636,3991434,202,290,utRho02
yecH,3979304,3979304,3978980,324,2,utRho02
yecJ,3975604,3975604,3975516,88,0,utRho02
yecM,3919968,3919968,3919692,276,68,utRho02
yecR,3976400,3976444,3976400,44,20,utRho02
yecT,3923862,3923944,3923862,82,268,utRho02
yedD,4016522,4016522,4016180,342,126,utRho02
yedE,4016310,4016554,4016310,244,146,utRho02
yedI,4058922,4058922,4058732,190,76,utRho02
yedJ,4066446,4066446,4066158,288,30,utRho02
yedV,4076404,4076404,4076304,100,96,utRho02
yedX,4077680,4077912,4077680,232,0,utRho02
yedY,4078572,4078956,4078572,384,0,utRho02
yeeA,4161322,4161322,4161182,140,136,utRho02
yeeE,4171104,4171104,4171050,54,0,utRho02
yeeJ,4089526,4089822,4089526,296,606,utRho02
yeeN,4113508,4113716,4113508,208,34,utRho02
yeeO,4119444,4119444,4119692,248,0,utRho02
yeeX,4158834,4158834,4158722,112,340,utRho02
yeeZ,4178422,4178422,4178256,166,0,utRho02
yefM,4179466,4179466,4179426,40,0,utRho02
yegD,4295288,4295348,4295288,60,122,utRho02
yegH,4275726,4275804,4275726,78,68,utRho02
yegI,4302154,4302154,4301970,184,0,utRho02
yegJ,4302032,4302370,4302032,338,0,utRho02
yegQ,4331182,4331336,4331182,154,0,utRho02
yegR,4336698,4336698,4336612,86,0,utRho02
yegS,4337086,4337424,4337086,338,0,utRho02
yegT,4357562,4357642,4357562,80,36,utRho02
yegX,4367640,4367640,4367302,338,58,utRho02
yehA,4376944,4376944,4376828,116,0,utRho02
yehE,4385818,4385818,4385592,226,0,utRho02
yehK,4407568,4407944,4407568,376,84,utRho02
yehL,4408804,4409192,4408804,388,0,utRho02
yeiB,4486146,4486146,4485934,212,124,utRho02
yeiE,4499422,4499422,4499236,186,0,utRho02
yeiG,4487776,4487820,4487776,44,412,utRho02
yeiH,4499332,4499434,4499332,102,44,utRho02
yeiI,4503306,4503400,4503306,94,62,utRho02
yeiL,4510580,4510710,4510580,130,0,utRho02
yeiP,4530834,4530900,4530834,66,734,utRho02
yeiQ,4532328,4532490,4532328,162,40,utRho02
yeiR,4535484,4535658,4535484,174,50,utRho02
yeiW,4530840,4530840,4530590,250,1066,utRho02
yejA,4544624,4544728,4544624,104,2,utRho02
yejG,4556892,4556892,4556474,418,5646,utRho02
yejH,4561244,4561264,4561244,20,0,utRho02
yejK,4568218,4568218,4567894,324,116,utRho02
yejO,4578352,4578352,4577800,552,336,utRho02
yfaD,4713380,4713808,4713380,428,258,utRho02
yfaE,4696676,4697028,4696676,352,3694,utRho02
yfaL,4688568,4688568,4688338,230,0,utRho02
yfaP,4656398,4656398,4656286,112,12,utRho02
yfaU,4717892,4717892,4717690,202,0,utRho02
yfaY,4727310,4727310,4727266,44,0,utRho02
yfaZ,4728744,4728744,4728550,194,0,utRho02
yfbK,4771810,4771810,4771444,366,0,utRho02
yfbL,4771500,4771720,4771500,220,0,utRho02
yfbN,4777174,4777174,4776852,322,0,utRho02
yfbO,4776916,4777162,4776916,246,0,utRho02
yfbP,4777990,4778232,4777990,242,916,utRho02
yfbR,4817662,4817724,4817662,62,56,utRho02
yfcI,4847424,4847424,4847078,346,12,utRho02
yfcJ,4880482,4880482,4880240,242,252,utRho02
yfcL,4888502,4888502,4888338,164,50,utRho02
yfcV,4911642,4911642,4911292,350,0,utRho02
yfcZ,4921958,4921958,4921868,90,86,utRho02
yfdF,4925604,4926024,4925604,420,578,utRho02
yfdG,4935474,4935710,4935474,236,98,utRho02
yfdP,4946844,4947040,4946844,196,0,utRho02
yfdX,4988866,4988866,4988804,62,0,utRho02
yfdY,4990672,4990672,4990584,88,0,utRho02
yfeA,5035784,5035784,5035664,120,53058,utRho02
yfeC,5036668,5036934,5036668,266,234,utRho02
yfeH,5053818,5053892,5053818,74,10,utRho02
yfeK,5074630,5074684,5074630,54,0,utRho02
yfeO,5018906,5019260,5018906,354,328,utRho02
yfeR,5054078,5054078,5053712,366,56,utRho02
yfeX,5101356,5101356,5101090,266,0,utRho02
yfeY,5102486,5102486,5102432,54,0,utRho02
yfeZ,5103842,5103842,5103452,390,62,utRho02
yffO,5123804,5124222,5123804,418,0,utRho02
yffQ,5126778,5127154,5126778,376,0,utRho02
yffS,5128800,5128986,5128800,186,132,utRho02
yfgC,5232052,5232188,5232052,136,4,utRho02
yfgF,5258062,5258062,5257876,186,4,utRho02
yfgG,5258170,5258580,5258170,410,448,utRho02
yfgH,5259344,5259584,5259344,240,80,utRho02
yfgM,5278866,5278866,5278566,300,686,utRho02
yfhH,5397414,5397518,5397414,104,68,utRho02
yfhM,5304648,5304648,5304574,74,18,utRho02
yfhR,5328408,5328726,5328408,318,7032,utRho02
yfiC,5425610,5425610,5425528,82,0,utRho02
yfiE,5430688,5430688,5430640,48,0,utRho02
yfiL,5482630,5482720,5482630,90,0,utRho02
yfiM,5448066,5448358,5448066,292,23930,utRho02
yfiR,5483354,5483750,5483354,396,626,utRho02
yfjH,5517326,5517326,5517200,126,0,utRho02
yfjI,5517710,5517970,5517710,260,0,utRho02
yfjJ,5521014,5521094,5521014,80,0,utRho02
yfjM,5531970,5531970,5531552,418,1202,utRho02
yfjP,5535080,5535420,5535080,340,148,utRho02
yfjW,5546570,5546636,5546570,66,0,utRho02
yfjX,5551776,5551838,5551776,62,0,utRho02
ygaC,5601180,5601180,5599988,1192,1456,utRho02
ygaM,5600242,5600292,5600242,50,322,utRho02
ygaU,5593628,5593628,5593572,56,60,utRho02
ygaZ,5619190,5619234,5619190,44,1630,utRho02
ygbA,5713656,5713656,5713612,44,0,utRho02
ygbE,5746784,5746784,5746674,110,222,utRho02
ygbI,5722882,5722882,5722528,354,44,utRho02
ygbK,5724394,5724670,5724394,276,16,utRho02
ygbL,5727074,5727186,5727074,112,0,utRho02
ygbN,5729814,5730202,5729814,388,150,utRho02
ygcG,5811210,5811422,5811210,212,40,utRho02
ygcN,5785144,5785314,5785144,170,310,utRho02
ygcU,5799214,5799214,5798836,378,40,utRho02
ygcW,5800942,5800942,5800546,396,0,utRho02
ygdD,5883442,5883442,5883262,180,122,utRho02
ygdG,5861746,5861930,5861746,184,736,utRho02
ygdI,5886526,5886526,5886290,236,228,utRho02
ygdQ,5940784,5940840,5940784,56,0,utRho02
ygdR,5942494,5942542,5942494,48,156,utRho02
ygeA,5961606,5961606,5961270,336,0,utRho02
ygeH,5983758,5984188,5983758,430,0,utRho02
ygeI,5987162,5987276,5987162,114,2,utRho02
ygeR,6000078,6000078,5999782,296,486,utRho02
ygeV,6011694,6011694,6011572,122,0,utRho02
ygeW,6012234,6012524,6012234,290,0,utRho02
ygfB,6110946,6110946,6110888,58,26,utRho02
ygfK,6031984,6032120,6031984,136,0,utRho02
ygfS,6058328,6058328,6058024,304,12,utRho02
ygfZ,6082564,6082626,6082564,62,100,utRho02
yggC,6149512,6149512,6149378,134,188,utRho02
yggE,6136370,6136370,6136160,210,34,utRho02
yggI,6179176,6179510,6179176,334,164,utRho02
yggL,6204508,6204508,6204266,242,64,utRho02
yggM,6199514,6199514,6199130,384,314,utRho02
yggN,6203596,6203596,6203246,350,0,utRho02
yggX,18623958,18624558,18623958,600,1332,utRho02
yghA,6298966,6299324,6298966,358,22,utRho02
yghB,6307058,6307126,6307058,68,0,utRho02
yghD,6222614,6222614,6222252,362,202,utRho02
yghF,6225798,6225798,6225840,42,0,utRho02
yghJ,6238640,6238640,6238224,416,0,utRho02
yghQ,6265186,6265186,6264816,370,76,utRho02
yghT,6267830,6268262,6267830,432,0,utRho02
yghU,6277400,6277454,6277400,54,90,utRho02
yghW,6293506,6293506,6293474,32,16,utRho02
yghZ,6295562,6295794,6295562,232,0,utRho02
ygiD,6365122,6365122,6364868,254,258,utRho02
ygiH,6409066,6409388,6409066,322,0,utRho02
ygiL,6370622,6370828,6370622,206,66,utRho02
ygiM,6402084,6402414,6402084,330,240,utRho02
ygiN,6346156,6346284,6346156,128,870,utRho02
ygiQ,6322620,6322620,6322292,328,1128,utRho02
ygiS,6335462,6335462,6335436,26,0,utRho02
ygiV,6338582,6338582,6338462,120,40,utRho02
ygiW,6339774,6339774,6339352,422,78,utRho02
ygiZ,6344506,6344506,6344422,84,26,utRho02
ygjH,6442528,6442528,6442494,34,0,utRho02
ygjI,6452140,6452468,6452140,328,0,utRho02
ygjQ,6472730,6473080,6472730,350,304,utRho02
ygjR,6474564,6474586,6474564,22,36,utRho02
ygjV,6483638,6483638,6483488,150,90,utRho02
yhaB,6535632,6535708,6535632,76,0,utRho02
yhaH,6504498,6504608,6504498,110,2,utRho02
yhaI,6505400,6505822,6505400,422,60,utRho02
yhaJ,6508560,6508560,6508428,132,70,utRho02
yhaK,6508538,6508638,6508538,100,58,utRho02
yhbQ,6599878,6599932,6599878,54,58,utRho02
yhbT,6602736,6602736,6602552,184,0,utRho02
yhbU,6602558,6602970,6602558,412,0,utRho02
yhbX,6643302,6643302,6643226,76,0,utRho02
yhbY,6655518,6655580,6655518,62,2410,utRho02
yhcA,6723956,6724224,6723956,268,0,utRho02
yhcB,6760364,6760382,6760364,18,120,utRho02
yhcC,6708470,6708470,6708100,370,584,utRho02
yhcF,6733440,6733852,6733440,412,86,utRho02
yhcH,6739124,6739124,6738956,168,28,utRho02
yhcM,6760312,6760312,6759994,318,118,utRho02
yhcN,6770812,6771076,6770812,264,976,utRho02
yhcO,6772606,6772606,6772258,348,0,utRho02
yhdH,6806560,6806968,6806560,408,330,utRho02
yhdJ,6823234,6823306,6823234,72,0,utRho02
yhdN,6879092,6879092,6879018,74,3572,utRho02
yhdT,6814702,6814750,6814702,48,364,utRho02
yhdU,6824994,6825242,6824994,248,132,utRho02
yhdV,6836392,6836780,6836392,388,0,utRho02
yhdW,6837944,6838298,6837944,354,0,utRho02
yheO,6953082,6953082,6952880,202,1576,utRho02
yheV,6957970,6957970,6957584,386,76,utRho02
yhfA,6971902,6971902,6971636,266,20,utRho02
yhfG,6983294,6983294,6983240,54,280,utRho02
yhfL,6998622,6998896,6998622,274,18,utRho02
yhfY,7023244,7023244,7022844,400,82,utRho02
yhgA,7086294,7086334,7086294,40,0,utRho02
yhgE,7065176,7065176,7064878,298,126,utRho02
yhgF,7074352,7074770,7074352,418,2688,utRho02
yhhA,7173458,7173886,7173458,428,78,utRho02
yhhI,7248346,7248756,7248346,410,0,utRho02
yhhJ,7253696,7253696,7253606,90,30,utRho02
yhhM,7211588,7211588,7211220,368,512,utRho02
yhhN,7211150,7211502,7211150,352,516,utRho02
yhhQ,7218238,7218434,7218238,196,854,utRho02
yhhT,7223682,7223730,7223682,48,2,utRho02
yhhX,7162032,7162032,7161610,422,1808,utRho02
yhhY,7162222,7162276,7162222,54,74,utRho02
yhhZ,7163516,7163726,7163516,210,0,utRho02
yhiD,7312220,7312220,7311804,416,2682,utRho02
yhiJ,7265190,7265190,7265180,10,0,utRho02
yhiM,7269270,7269682,7269270,412,240,utRho02
yhiN,7275000,7275000,7274820,180,144,utRho02
yhjA,7338522,7338522,7338376,146,0,utRho02
yhjB,7344090,7344090,7343788,302,106,utRho02
yhjC,7344272,7344684,7344272,412,0,utRho02
yhjD,7346660,7346724,7346660,64,0,utRho02
yhjE,7349274,7349572,7349274,298,214,utRho02
yhjG,7356824,7356824,7356730,94,0,utRho02
yhjH,7358458,7358458,7358374,84,70,utRho02
yhjJ,7364032,7364032,7363880,152,134,utRho02
yhjK,7371296,7371296,7371158,138,108,utRho02
yhjR,7392750,7392750,7392370,380,136,utRho02
yhjV,7400796,7401126,7400796,330,1454,utRho02
yhjX,7424194,7424194,7424014,180,0,utRho02
yhjY,7425966,7425966,7425868,98,0,utRho02
yiaB,7455654,7455654,7455496,158,0,utRho02
yiaD,7432712,7433094,7432712,382,156,utRho02
yiaF,7438194,7438194,7438088,106,40,utRho02
yiaG,7438862,7438956,7438862,94,160,utRho02
yiaJ,7485236,7485236,7485064,172,0,utRho02
yiaK,7485348,7485466,7485348,118,0,utRho02
yiaT,7503924,7503924,7503736,188,0,utRho02
yiaU,7503792,7503984,7503792,192,0,utRho02
yiaY,7515856,7515856,7515654,202,102,utRho02
yibF,7523950,7523950,7523910,40,4,utRho02
yibG,7536128,7536354,7536128,226,0,utRho02
yibL,7553194,7553330,7553194,136,130,utRho02
yibN,7570112,7570112,7570030,82,230,utRho02
yibT,7552848,7552848,7552760,88,164,utRho02
yicC,7633290,7633352,7633290,62,76,utRho02
yicH,7660862,7660914,7660862,52,20,utRho02
yicJ,7673328,7673328,7671858,1470,1010,utRho02
yicN,7685018,7685018,7684804,214,0,utRho02
yicO,7687914,7687914,7687578,336,0,utRho02
yicR,15250308,15250308,15250236,72,0,utRho02
yidB,7755230,7755230,7754930,300,2,utRho02
yidE,7732780,7732780,7732546,234,0,utRho02
yidF,7711580,7711580,7711222,358,388,utRho02
yidQ,7735088,7735456,7735088,368,550,utRho02
yidR,7738824,7738824,7738618,206,0,utRho02
yieE,7787658,7787738,7787658,80,298,utRho02
yieH,7793314,7793548,7793314,234,0,utRho02
yieK,7798928,7798928,7798786,142,0,utRho02
yifB,7900350,7900350,7899998,352,440,utRho02
yifL,7988984,7989044,7988984,60,532,utRho02
yigF,8005750,8005750,8005598,152,52,utRho02
yigI,8009448,8009448,8009394,54,0,utRho02
yigM,8022100,8022152,8022100,52,104,utRho02
yihA,8101970,8101970,8101458,512,72,utRho02
yihD,8084098,8084138,8084098,40,100,utRho02
yihF,8088110,8088398,8088110,288,0,utRho02
yihG,8093304,8093304,8093204,100,0,utRho02
yihI,8102616,8102694,8102616,78,24,utRho02
yihL,8120506,8120894,8120506,388,0,utRho02
yihN,8124332,8124494,8124332,162,4,utRho02
yihO,8131942,8131942,8131532,410,48,utRho02
yihQ,8138892,8138892,8138552,340,0,utRho02
yihV,8147064,8147478,8147064,414,48,utRho02
yihX,8151096,8151106,8151096,10,8,utRho02
yiiE,8158192,8158582,8158192,390,36,utRho02
yiiF,8159124,8159502,8159124,378,116,utRho02
yiiG,8173762,8174004,8173762,242,0,utRho02
yiiM,8205506,8205644,8205506,138,22,utRho02
yiiQ,8224624,8224624,8224428,196,0,utRho02
yiiS,8225738,8225934,8225738,196,64,utRho02
yijE,8272178,8272216,8272178,38,0,utRho02
yijF,8275728,8275728,8275314,414,80,utRho02
yijO,8296858,8296858,8296634,224,4,utRho02
yjaA,8426240,8426468,8426240,228,99432,utRho02
yjaB,8428312,8428312,8428246,66,986,utRho02
yjaG,8398746,8399008,8398746,262,1954,utRho02
yjaH,8401022,8401132,8401022,110,264,utRho02
yjaZ,8379506,8379572,8379506,66,30,utRho02
yjbB,8455204,8455462,8455204,258,0,utRho02
yjbE,16943432,16943624,16943432,192,76,utRho02
yjbL,8520318,8520642,8520318,324,0,utRho02
yjbQ,8540428,8540476,8540428,48,74,utRho02
yjcB,8550328,8550328,8550082,246,9026,utRho02
yjcC,8550836,8550942,8550836,106,266,utRho02
yjcD,8556628,8556958,8556628,330,52,utRho02
yjcE,8559658,8559960,8559658,302,0,utRho02
yjcF,8566212,8566212,8566150,62,0,utRho02
yjcO,8594660,8594660,8594250,410,56,utRho02
yjdA,8654128,8654270,8654128,142,0,utRho02
yjdC,8726660,8726660,8726616,44,68,utRho02
yjdK,8704780,8705168,8704780,388,104,utRho02
yjdL,8713034,8713034,8712822,212,18,utRho02
yjdM,8653672,8653672,8653468,204,58,utRho02
yjeF,8787354,8788132,8787354,778,10740,utRho02
yjeI,8745522,8745618,8745522,96,0,utRho02
yjeJ,8748806,8748806,8748468,338,36,utRho02
yjeV,8785472,8785784,8785472,312,782,utRho02
yjfP,8833512,8833904,8833512,392,0,utRho02
yjfY,8849656,8849656,8849582,74,0,utRho02
yjfZ,8855052,8855052,8854844,208,64,utRho02
yjgA,8916162,8916162,8915730,432,296,utRho02
yjgL,8950802,8950874,8950802,72,0,utRho02
yjgM,8959342,8959342,8959074,268,0,utRho02
yjgN,8959132,8959460,8959132,328,0,utRho02
yjgR,8980170,8980170,8980126,44,136,utRho02
yjgZ,9002116,9002520,9002116,404,838,utRho02
yjhB,9007764,9008116,9007764,352,84,utRho02
yjhG,9048452,9048452,9048188,264,860,utRho02
yjhU,9041080,9041080,9040648,432,312,utRho02
yjiA,9178096,9178096,9177730,366,468,utRho02
yjiJ,9125364,9125364,9125350,14,0,utRho02
yjiK,9127270,9127270,9127422,152,70,utRho02
yjiL,9129604,9129604,9129378,226,0,utRho02
yjiS,9143410,9143502,9143410,92,0,utRho02
yjiY,9182734,9182734,9182558,176,30,utRho02
yjjA,9200674,9200674,9200378,296,734,utRho02
yjjB,18408708,18408708,18407800,908,40,utRho02
yjjJ,9243314,9243538,9243314,224,48,utRho02
yjjK,9261132,9261132,9261044,88,60,utRho02
yjjL,9189764,9189764,9189444,320,0,utRho02
yjjM,9191894,9191894,9191702,192,0,utRho02
yjjP,9206068,9206068,9205716,352,52,utRho02
yjjQ,9206638,9206954,9206638,316,212,utRho02
yjjX,9267798,9267798,9267490,308,628,utRho02
yjjY,9280716,9280804,9280716,88,794,utRho02
yjjZ,9211554,9211608,9211554,54,2008,utRho02
yjtD,9281676,9281884,9281676,208,0,utRho02
ykfB,532454,532454,532174,280,232,utRho02
ykfI,527636,527636,527338,298,2,utRho02
ykgB,637050,637050,636638,412,0,utRho02
ykgC,640430,640430,640002,428,0,utRho02
ykgD,640232,640454,640232,222,0,utRho02
ykgE,642962,643216,642962,254,4,utRho02
ykgJ,608524,608524,608364,160,12,utRho02
ykgL,623878,624224,623878,346,28,utRho02
ykgM,625610,625610,625554,56,0,utRho02
ykgR,626570,626570,626484,86,0,utRho02
ylaC,958576,958576,958502,74,1166,utRho02
yliE,1745938,1745958,1745938,20,0,utRho02
ymcE,2103660,2103694,2103660,34,714,utRho02
ymdA,2210450,2210828,2210450,378,48,utRho02
ymdB,2211428,2211640,2211428,212,108,utRho02
ymfD,2395322,2395322,2395064,258,138,utRho02
ymfI,2402880,2402994,2402880,114,0,utRho02
ymfJ,2404518,2404518,2404168,350,84,utRho02
ymfK,2406176,2406176,2405866,310,188,utRho02
ymfT,2405766,2406048,2405766,282,224,utRho02
ymgE,2489110,2489456,2489110,346,32,utRho02
ymgF,2437628,2437966,2437628,338,0,utRho02
ymiA,2670112,2670320,2670112,208,308,utRho02
ymjA,2715620,2715620,2715336,284,450,utRho02
ynaI,2791946,2791946,2791844,102,0,utRho02
ynaK,2850438,2850754,2850438,316,128,utRho02
ynbA,2954924,2955242,2954924,318,0,utRho02
yncD,3046552,3046552,3046130,422,184,utRho02
yncE,3046454,3046614,3046454,160,0,utRho02
yncG,3052456,3052494,3052456,38,0,utRho02
yncL,3034492,3034492,3034388,104,178,utRho02
yneE,3218364,3218364,3218044,320,0,utRho02
yneF,3223748,3223748,3223708,40,0,utRho02
yneJ,3229560,3229608,3229560,48,62,utRho02
yneK,3231100,3231526,3231100,426,0,utRho02
yneM,3245176,3245292,3245176,116,178,utRho02
ynfA,3311398,3311398,3311346,52,0,utRho02
ynfB,3311418,3311616,3311418,198,156,utRho02
ynfC,3315094,3315094,3314914,180,0,utRho02
ynfD,3314828,3315130,3314828,302,0,utRho02
ynfE,3316006,3316138,3316006,132,0,utRho02
ynfK,3334670,3334670,3334438,232,132,utRho02
ynfL,3339304,3339304,3339184,120,0,utRho02
ynfM,3339260,3339398,3339260,138,46,utRho02
ynfN,3276598,3276598,3276218,380,2268,utRho02
ynfO,3273454,3273512,3273454,58,0,utRho02
ynhG,3517890,3517890,3517450,440,774,utRho02
yniA,3615158,3615592,3615158,434,0,utRho02
yniB,3618526,3618526,3618466,60,90,utRho02
yniC,3618652,3618760,3618652,108,0,utRho02
yniD,3610202,3610330,3610202,128,0,utRho02
ynjE,3678880,3678934,3678880,54,0,utRho02
ynjF,3683222,3683222,3682806,416,126,utRho02
ynjH,3684376,3684376,3684270,106,0,utRho02
ynjI,3690022,3690022,3689742,280,44,utRho02
yoaB,3786642,3786734,3786642,92,76,utRho02
yoaC,3787932,3788146,3787932,214,336,utRho02
yoaE,3803544,3803544,3803170,374,308,utRho02
yoaF,3755444,3755444,3755064,380,822,utRho02
yoaH,3789866,3789866,3789462,404,302,utRho02
yobB,3850418,3850880,3850418,462,844,utRho02
yobF,3815586,3815586,3815182,404,192,utRho02
yobH,3817800,3817850,3817800,50,304,utRho02
yodB,4084352,4084736,4084352,384,0,utRho02
yodC,4057008,4057008,4056740,268,24,utRho02
yohC,4451358,4451358,4451262,96,0,utRho02
yohD,4451526,4451602,4451526,76,72,utRho02
yohJ,4460986,4461248,4460986,262,36,utRho02
yohO,4431172,4431314,4431172,142,0,utRho02
yojI,4617282,4617282,4617230,52,0,utRho02
ypdI,4988988,4989396,4988988,408,58,utRho02
ypfG,5165786,5165786,5165554,232,136,utRho02
ypfM,5182140,5182140,5181732,408,16,utRho02
yphB,5349590,5349590,5349376,214,76,utRho02
ypjA,5565644,5565644,5565452,192,30,utRho02
ypjB,5569636,5569636,5568858,778,0,utRho02
ypjD,5495860,5495774,5495860,86,0,utRho02
yqaE,5594170,5594170,5594056,114,124,utRho02
yqcA,5846100,5846100,5845968,132,116,utRho02
yqcE,5800944,5801184,5800944,240,0,utRho02
yqeC,6030468,6030468,6030114,354,92,utRho02
yqeF,5971618,5971618,5971184,434,70,utRho02
yqeG,5971438,5971694,5971438,256,110,utRho02
yqeH,5975016,5975072,5975016,56,2,utRho02
yqeI,5976688,5977004,5976688,316,0,utRho02
yqeK,5981140,5981140,5980720,420,0,utRho02
yqfA,6086728,6086728,6086296,432,240,utRho02
yqgA,6219042,6219106,6219042,64,0,utRho02
yqgB,6172500,6172500,6172102,398,2272,utRho02
yqgE,6185768,6185874,6185768,106,556,utRho02
yqhA,6299150,6299150,6298942,208,18,utRho02
yqhC,6310768,6310768,6310436,332,96,utRho02
yqhD,6310604,6310710,6310604,106,96,utRho02
yqhH,6316842,6317254,6316842,412,402,utRho02
yqiC,6369662,6369680,6369662,18,52,utRho02
yqiJ,6384108,6384416,6384108,308,500,utRho02
yqjA,6495096,6495546,6495096,450,12204,utRho02
yqjF,6500932,6501124,6500932,192,84,utRho02
yqjG,6501948,6502048,6501948,100,0,utRho02
yqjH,6433078,6433078,6432982,96,0,utRho02
yqjI,6433506,6433558,6433506,52,0,utRho02
yraH,6574552,6574852,6574552,300,4,utRho02
yraP,6592144,6592818,6592144,674,282,utRho02
yraQ,6596414,6596414,6596276,138,0,utRho02
yraR,6598024,6598024,6597692,332,12,utRho02
yrbG,13360844,13361100,13360844,256,96,utRho02
yrbL,6696842,6696904,6696842,62,694,utRho02
yrbN,6616172,6616172,6615866,306,23192,utRho02
yrdB,6860176,6860176,6860046,130,234,utRho02
yrfF,7052548,7052938,7052548,390,240,utRho02
yrhB,7169440,7169518,7169440,78,0,utRho02
ysaB,7451804,7451804,7451424,380,0,utRho02
ysgA,8032686,8032686,8032338,348,202,utRho02
ytfB,8857638,8857638,8857434,204,152,utRho02
ytfE,8864018,8864018,8863966,52,0,utRho02
ytfF,8866296,8866296,8866130,166,16,utRho02
ytfH,8868164,8868226,8868164,62,0,utRho02
ytfI,8875234,8875414,8875234,180,0,utRho02
ytfJ,8878572,8878572,8878524,48,0,utRho02
ytfK,8879022,8879174,8879022,152,126,utRho02
ytfL,8882642,8882642,8882430,212,70,utRho02
ytfQ,8899634,8899924,8899634,290,312,utRho02
ytjB,9249598,9249598,9249578,20,2,utRho02
yzfA,8896588,8896588,8896490,98,38,utRho02
zapA,6111102,6111224,6111102,122,8170,utRho02
zapB,8236772,8237030,8236772,258,494,utRho02
zapC,2011700,2011904,2011700,204,156,utRho02
zinT,4082692,4082750,4082692,58,0,utRho02
zipA,5062814,5062814,5062466,348,72,utRho02
zitB,1569716,1569716,1569646,70,0,utRho02
zntA,7212844,7212902,7212844,58,30,utRho02
zntR,6878336,6878336,6878260,76,0,utRho02
znuA,3885322,3885322,3885166,156,0,utRho02
znuC,3885268,3885324,3885268,56,0,utRho02
zraP,8403424,8403424,8403376,48,68,utRho02
zraS,8403810,8403852,8403810,42,0,utRho02
zupT,6364866,6365100,6364866,234,258,utRho02
zur,8520282,8520282,8520006,276,1242,utRho02
zwf,3872752,3872752,3872628,124,38,utRho02
C0343,2818676,2818728,2818676,52,0,utRho03
aaeB,6776526,6776526,6776376,150,0,utRho03
aaeR,6778762,6779040,6778762,278,164,utRho03
aaeX,6778860,6778860,6778674,186,134,utRho03
aat,1854920,1854920,1854864,56,16,utRho03
accA,416822,417242,416822,420,2004,utRho03
accB,6810280,6810872,6810280,592,8436,utRho03
accD,4868030,4868030,4867852,178,788,utRho03
aceB,8430804,8430956,8430804,152,42,utRho03
aceE,245938,246034,245938,96,444,utRho03
ackA,4826918,4826940,4826918,22,1902,utRho03
acnA,2670848,2671662,2670848,814,596,utRho03
acnB,263038,263230,263038,192,740,utRho03
acpP,2303148,2303230,2303148,82,186,utRho03
acpS,5402324,5402324,5401996,328,238,utRho03
acrA,971396,971396,971238,158,242,utRho03
acrB,969370,969370,968806,564,2280,utRho03
acrD,5174950,5175190,5174950,240,8,utRho03
acrE,6827404,6827728,6827404,324,14,utRho03
acrR,971398,971522,971398,124,242,utRho03
acrZ,1589502,1589546,1589502,44,0,utRho03
acs,8575190,8575190,8574742,448,102,utRho03
actP,8569870,8569870,8569804,66,0,utRho03
ada,4620854,4620854,4620810,44,0,utRho03
add,3404404,3404466,3404404,62,60,utRho03
ade,7687802,7687928,7687802,126,18,utRho03
adhE,2596826,2596826,2596242,584,10,utRho03
adhP,3107988,3107988,3107676,312,558,utRho03
adiA,8681112,8681112,8681042,70,60,utRho03
adiC,8674404,8674404,8674062,342,0,utRho03
adiY,8676084,8676084,8675858,226,0,utRho03
adk,994278,994350,994278,72,104,utRho03
adrA,807374,807406,807374,32,0,utRho03
aer,6438240,6438240,6438152,88,20,utRho03
aes,1000102,1000102,999946,156,76,utRho03
agaR,6557406,6557406,6557330,76,0,utRho03
agaS,6563778,6563952,6563778,174,0,utRho03
agp,2131118,2131170,2131118,52,0,utRho03
agrA,7296126,7296126,7296126,0,0,utRho03
agrB,7296588,7296588,7296588,0,0,utRho03
ahpC,1277386,1277890,1277386,504,818,utRho03
ahpF,1278004,1279506,1278004,1502,43410,utRho03
ahr,8992698,8992698,8992418,280,8,utRho03
aidB,8828494,8828550,8828494,56,0,utRho03
ais,4731512,4731512,4731240,272,12,utRho03
alaA,4814816,4815122,4814816,306,10,utRho03
alaC,4996798,4996798,4996590,208,0,utRho03
alaE,5598140,5598328,5598140,188,78,utRho03
alaS,5644180,5644180,5644022,158,1514,utRho03
alaW,5036612,5036612,5036462,150,0,utRho03
aldA,2976380,2976464,2976380,84,134,utRho03
aldB,7513070,7513070,7513022,48,0,utRho03
alkA,4295118,4295118,4295080,38,84,utRho03
alkB,4618890,4618890,4618682,208,34,utRho03
allA,1064780,1064902,1064780,122,0,utRho03
allD,1092822,1092822,1092726,96,0,utRho03
allE,1088112,1088112,1088092,20,102,utRho03
allS,1064600,1064600,1064442,158,0,utRho03
alr,8531178,8531564,8531178,386,3198,utRho03
alsE,8617334,8617334,8616956,378,36,utRho03
alsK,8615990,8615990,8615598,392,46,utRho03
alx,6476740,6477160,6476740,420,0,utRho03
amiA,5104482,5104704,5104482,222,4,utRho03
amiC,5898378,5898378,5898020,358,22,utRho03
amn,4110062,4110122,4110062,60,0,utRho03
ampC,8758006,8758006,8757888,118,0,utRho03
ampD,237362,237466,237362,104,128,utRho03
ampG,907372,907372,907090,282,768,utRho03
ampH,792726,792726,792574,152,4,utRho03
amyA,4012230,4012312,4012230,82,18,utRho03
anmK,3439346,3439346,3439204,142,32,utRho03
ansB,6201580,6201580,6201456,124,24,utRho03
ansP,3052040,3052040,3051960,80,162,utRho03
apaG,104068,104068,103212,856,6052,utRho03
apaH,102586,102586,102444,142,5646,utRho03
apbE,4623188,4623188,4623068,120,30,utRho03
appA,2081198,2081234,2081198,36,0,utRho03
appC,2075420,2075480,2075420,60,0,utRho03
appY,1167134,1167362,1167134,228,0,utRho03
apt,982620,982824,982620,204,206,utRho03
aqpZ,1832424,1832424,1832094,330,8,utRho03
araB,140150,140150,140096,54,0,utRho03
araC,140482,140774,140482,292,4,utRho03
araE,5964416,5964416,5964364,52,0,utRho03
araF,3972476,3972476,3972256,220,0,utRho03
araH,3967120,3967120,3967086,34,12,utRho03
araJ,825058,825058,824962,96,24,utRho03
arcA,9281602,9281602,9280612,990,7026,utRho03
arcB,6706098,6706098,6706050,48,0,utRho03
arcZ,6701154,6701154,6701154,0,0,utRho03
arfA,6877346,6877346,6877298,48,374,utRho03
argA,5898312,5898484,5898312,172,28,utRho03
argC,8309770,8310002,8309770,232,104,utRho03
argD,6980442,6980442,6980360,82,48,utRho03
argE,8310156,8310156,8309694,462,116,utRho03
argF,580680,580680,580610,70,0,utRho03
argG,6637124,6637274,6637124,150,84,utRho03
argI,8956688,8956688,8956622,66,0,utRho03
argO,6137672,6137672,6137616,56,486,utRho03
argP,6119460,6119506,6119460,46,0,utRho03
argR,6769204,6769406,6769204,202,8,utRho03
argS,3920002,3920124,3920002,122,0,utRho03
argT,4855698,4855698,4855582,116,48,utRho03
argU,1129406,1129446,1129406,40,8,utRho03
argW,4932616,4932618,4932616,2,0,utRho03
argX,7964728,7964750,7964728,22,76,utRho03
aroF,5482402,5482402,5482300,102,10,utRho03
aroG,1571182,1571266,1571182,84,24,utRho03
aroH,3576636,3576870,3576636,234,424,utRho03
aroK,7038760,7038760,7038128,632,2166,utRho03
aroL,812560,812810,812560,250,102,utRho03
aroP,243342,243342,243102,240,0,utRho03
arpA,8445382,8445382,8444974,408,354,utRho03
arrS,7316108,7316108,7316108,0,0,utRho03
arsR,7297024,7297056,7297024,32,10,utRho03
artJ,1801252,1801252,1801150,102,0,utRho03
artP,1807686,1807686,1807468,218,10,utRho03
ascF,5678858,5679048,5678858,190,0,utRho03
ascG,5678574,5678574,5678528,46,0,utRho03
aslB,7965562,7965916,7965562,354,39644,utRho03
asnA,7854258,7854310,7854258,52,24,utRho03
asnB,1398444,1398444,1398354,90,926,utRho03
asnC,23562186,23562186,23562018,168,12,utRho03
asnS,1978088,1978088,1977970,118,10004,utRho03
asnT,4089082,4089098,4089082,16,30,utRho03
asnU,4119690,4119702,4119690,12,4,utRho03
asnV,4124504,4124520,4124504,16,4,utRho03
aspA,17473728,17473728,17473308,420,312,utRho03
aspC,1971486,1971486,1971418,68,166,utRho03
aspS,3901402,3901402,3901044,358,140,utRho03
aspT,7893560,7893744,7893560,184,49892,utRho03
aspV,473826,473862,473826,36,14,utRho03
asr,3342654,3342752,3342654,98,56,utRho03
astC,3664088,3664088,3663964,124,0,utRho03
astE,3654138,3654138,3653846,292,12,utRho03
atoD,4646824,4646894,4646824,70,32,utRho03
atpB,7844540,7844540,7844102,438,744,utRho03
atpC,7832118,7832118,7831944,174,1118,utRho03
atpI,7845050,7845050,7844880,170,48,utRho03
avtA,7479348,7479410,7479348,62,390,utRho03
azoR,2965982,2965982,2965720,262,254,utRho03
azuC,3976002,3976002,3975918,84,50,utRho03
bacA,6408350,6408350,6408262,88,36,utRho03
bamA,394052,395856,394052,1804,1286,utRho03
bamB,5277950,5277950,5277304,646,1834,utRho03
bamC,5198028,5198028,5197730,298,714,utRho03
bamD,5471922,5472292,5471922,370,6026,utRho03
bamE,5506972,5507210,5506972,238,436,utRho03
basS,8666954,8666954,8666544,410,352,utRho03
bax,7474468,7474468,7474354,114,82,utRho03
bcp,5200874,5200956,5200874,82,1106,utRho03
bcsB,7385346,7385346,7385214,132,0,utRho03
bcsE,7392644,7392916,7392644,272,56,utRho03
bdcA,8948128,8948128,8948106,22,130,utRho03
bdcR,8948192,8948248,8948192,56,22,utRho03
bdm,3112680,3112680,3112560,120,0,utRho03
betA,654522,654522,654494,28,386,utRho03
betI,658722,658722,658668,54,0,utRho03
betT,658842,658926,658842,84,8,utRho03
bfr,6933498,6933498,6933450,48,4,utRho03
bglG,23440182,23440182,23439402,780,0,utRho03
bglX,4444240,4444240,4443978,262,0,utRho03
bhsA,2337962,2338146,2337962,184,148,utRho03
bioA,1618584,1618584,1618514,70,0,utRho03
bioB,1618604,1618688,1618604,84,0,utRho03
bioH,7089716,7089716,7089688,28,4,utRho03
bisC,7433026,7433026,7432788,238,6,utRho03
blc,8755490,8755490,8755444,46,8,utRho03
blr,3409024,3409102,3409024,78,198,utRho03
bluF,2431226,2431226,2430950,276,2656,utRho03
bluR,2428226,2428226,2428118,108,12,utRho03
bolA,908698,908944,908698,246,0,utRho03
borD,1157842,1157842,1157786,56,42,utRho03
brnQ,838976,839182,838976,206,3110,utRho03
bssR,1756492,1756496,1756492,4,0,utRho03
bssS,2242116,2242116,2241910,206,290,utRho03
btuB,8326798,8327278,8326798,480,3380,utRho03
cadB,8720212,8720212,8720062,150,0,utRho03
cadC,8723926,8723926,8723868,58,0,utRho03
caiE,70998,70998,70742,256,20,utRho03
caiF,68436,68600,68436,164,2,utRho03
caiT,84074,84074,83862,212,0,utRho03
can,285406,285406,285340,66,84,utRho03
carA,59102,59302,59102,200,60,utRho03
carB,61550,61634,61550,84,30,utRho03
cas2,5757830,5757830,5757706,124,22,utRho03
casA,5768638,5768638,5768276,362,0,utRho03
cbl,4121882,4121882,4121828,54,18,utRho03
cbpA,2128074,2128074,2127550,524,100,utRho03
cbrA,7738628,7738754,7738628,126,0,utRho03
cbrB,7794958,7795012,7794958,54,42,utRho03
ccmH,4585242,4585242,4584820,422,144,utRho03
cdaR,364894,364926,364894,32,30,utRho03
cdd,4463638,4463688,4463638,50,114,utRho03
cdh,8219814,8219860,8219814,46,14,utRho03
cdsA,391110,391354,391110,244,2014,utRho03
cedA,3627484,3627484,3627326,158,182,utRho03
cfa,3482402,3482826,3482402,424,392,utRho03
chaC,2544844,2544972,2544844,128,34,utRho03
chbB,3643452,3643452,3643238,214,0,utRho03
chbG,3634624,3634624,3634270,354,0,utRho03
cheW,3946924,3946924,3946678,246,216,utRho03
chiA,6939792,6939792,6939706,86,0,utRho03
chiP,1416472,1416668,1416472,196,6,utRho03
cho,3646984,3647030,3646984,46,52,utRho03
chpS,8896804,8896894,8896804,90,26,utRho03
cirA,4493884,4493884,4493538,346,330,utRho03
citC,1304078,1304078,1303712,366,0,utRho03
citT,1293264,1293264,1293160,104,0,utRho03
clcA,350104,350214,350104,110,114,utRho03
clpA,1846160,1846528,1846160,368,38,utRho03
clpB,5468410,5468410,5468346,64,68,utRho03
clpP,913154,913354,913154,200,612,utRho03
clpS,1845500,1845826,1845500,326,36,utRho03
clpX,914404,914852,914404,448,1172,utRho03
clsA,2617346,2617346,2617290,56,68,utRho03
clsC,2212584,2212710,2212584,126,452,utRho03
cmk,1922330,1922402,1922330,72,92,utRho03
cnu,3409522,3409898,3409522,376,548,utRho03
coaA,8350214,8350214,8350052,162,820,utRho03
cobC,1340092,1340092,1339814,278,534,utRho03
cobT,4129202,4129202,4128934,268,48,utRho03
cobU,4131944,4131944,4131528,416,304,utRho03
codB,709768,709844,709768,76,0,utRho03
comR,2337726,2337726,2337664,62,0,utRho03
copA,1022822,1022822,1022758,64,16,utRho03
corA,8002388,8002852,8002388,464,4338,utRho03
cpdB,8873258,8873258,8873130,128,0,utRho03
cptB,6082198,6082198,6082140,58,118,utRho03
cpxA,8210202,8210202,8209950,252,524,utRho03
cpxP,8211570,8211640,8211570,70,6,utRho03
cpxR,8211372,8211372,8211340,32,70,utRho03
cra,175894,176056,175894,162,0,utRho03
crcB,1316016,1316016,1315876,140,88,utRho03
creA,9270486,9271042,9270486,556,428,utRho03
creD,9276320,9276356,9276320,36,16,utRho03
crl,515620,515658,515620,38,1878,utRho03
crp,6971906,6972240,6971906,334,3068,utRho03
crr,5070960,5071668,5070960,708,4966,utRho03
csdA,5886414,5886674,5886414,260,92,utRho03
csgB,2207718,2207902,2207718,184,0,utRho03
csgD,2206688,2206688,2206392,296,28,utRho03
csgG,2203510,2203510,2203368,142,46,utRho03
csiD,5577854,5577970,5577854,116,2,utRho03
csiE,5330802,5330870,5330802,68,36,utRho03
csiR,5590942,5591348,5590942,406,0,utRho03
cspA,7439778,7440098,7439778,320,415148,utRho03
cspB,3283430,3283430,3283108,322,386,utRho03
cspC,3815018,3815018,3814870,148,304,utRho03
cspD,1845352,1845352,1845180,172,332,utRho03
cspE,1314294,1314584,1314294,290,106,utRho03
cspF,3283380,3283710,3283380,330,208,utRho03
cspG,2102610,2102922,2102610,312,167892,utRho03
cspH,2102746,2102746,2102350,396,364,utRho03
cspI,3277624,3277624,3277334,290,268,utRho03
csrA,5638746,5638746,5638292,454,870,utRho03
csrB,5849048,5849048,5849048,0,0,utRho03
csrC,8102072,8102072,8102072,0,0,utRho03
csrD,6806850,6806850,6806664,186,74,utRho03
cstA,1259710,1259788,1259710,78,16,utRho03
cueO,274090,274166,274090,76,0,utRho03
cueR,1027948,1027986,1027948,38,2,utRho03
curA,3037784,3038054,3037784,270,36,utRho03
cusC,1191146,1191200,1191146,54,22,utRho03
cusR,1190924,1190924,1190886,38,0,utRho03
cutA,8730784,8730784,8730712,72,122,utRho03
cutC,3918534,3918534,3917920,614,54,utRho03
cvpA,4861600,4861600,4861526,74,88,utRho03
cvrA,2484328,2484328,2484142,186,144,utRho03
cyaA,7981548,7982306,7981548,758,1018,utRho03
cyaR,4334228,4334224,4334228,4,0,utRho03
cyaY,7988166,7988166,7988118,48,32,utRho03
cybB,2981522,2981804,2981522,282,152,utRho03
cycA,8859560,8859728,8859560,168,516,utRho03
cydA,1542340,1542916,1542340,576,142,utRho03
cydC,1858800,1858800,1858390,410,54,utRho03
cydD,1862062,1862062,1861924,138,60,utRho03
cydX,1548300,1548392,1548300,92,242,utRho03
cynR,717418,717418,717380,38,0,utRho03
cynT,1435092,1435196,1435092,104,0,utRho03
cyoA,903306,903306,903220,86,1978,utRho03
cyoE,895540,895540,895410,130,486,utRho03
cysB,2667576,2667710,2667576,134,346,utRho03
cysC,5748056,5748056,5747984,72,0,utRho03
cysD,5752736,5752736,5752658,78,0,utRho03
cysE,7565362,7565362,7565124,238,266,utRho03
cysG,6995508,6995656,6995508,148,8,utRho03
cysJ,5783928,5783928,5783796,132,1270,utRho03
cysK,5064688,5064818,5064688,130,62,utRho03
cysP,5087114,5087114,5087056,58,150,utRho03
cysS,1109154,1109222,1109154,68,98,utRho03
cysT,3984100,3984100,3983974,126,92,utRho03
cysZ,5062766,5062926,5062766,160,224,utRho03
cytR,8249018,8249018,8248912,106,78,utRho03
dacA,1328002,1328002,1327926,76,122,utRho03
dacB,6657714,6657926,6657714,212,0,utRho03
dacC,1761306,1761454,1761306,148,0,utRho03
dadA,2475018,2475142,2475018,124,0,utRho03
dam,7032504,7032504,7031826,678,1124,utRho03
damX,7035200,7035200,7034612,588,290,utRho03
dapA,5199568,5199568,5199520,48,0,utRho03
dapB,56576,56748,56576,172,28,utRho03
dapD,371954,371954,371894,60,142,utRho03
dapE,5183120,5183214,5183120,94,160,utRho03
dcp,3254844,3254844,3254760,84,22,utRho03
dcrB,7219534,7219910,7219534,376,94,utRho03
dctA,7366996,7366996,7366894,102,566,utRho03
dcuA,8733686,8733686,8733546,140,16,utRho03
dcuB,8698182,8698182,8697488,694,180,utRho03
dcuC,1312166,1312166,1311936,230,0,utRho03
dcuD,6749166,6749738,6749166,572,2,utRho03
dcuR,8701130,8701130,8700068,1062,470,utRho03
dcuS,8703370,8703370,8703324,46,34,utRho03
dcyD,3999016,3999016,3998960,56,0,utRho03
ddpX,3126498,3126498,3126152,346,0,utRho03
deaD,6615818,6615818,6615720,98,5110,utRho03
dedA,4869880,4869880,4869482,398,10790,utRho03
dedD,4863750,4863750,4863368,382,98,utRho03
def,6867300,6867380,6867300,80,22,utRho03
degP,361690,361768,361690,78,124,utRho03
degQ,6761308,6761486,6761308,178,4354,utRho03
deoB,9239134,9239206,9239134,72,0,utRho03
deoC,9233358,9234646,9233358,1288,94,utRho03
dfp,7625406,7625462,7625406,56,38,utRho03
dgcZ,3247758,3247758,3247700,58,0,utRho03
dgkA,8512914,8513274,8512914,360,238,utRho03
dgt,358392,358474,358392,82,12,utRho03
dhaK,2501888,2501888,2501676,212,134,utRho03
dhaR,2502006,2502132,2502006,126,8,utRho03
dicB,3299194,3299218,3299194,24,0,utRho03
dicC,3295752,3295752,3295700,52,0,utRho03
dinB,501760,501796,501760,36,18,utRho03
dinD,7635398,7635520,7635398,122,526,utRho03
dinG,1666146,1666140,1666146,6,12,utRho03
dinI,2243018,2243018,2242974,44,28,utRho03
dinJ,493230,493230,493004,226,72,utRho03
dinQ,7295964,7295964,7295576,388,1726,utRho03
djlA,114536,114728,114536,192,36,utRho03
dkgA,6313142,6313246,6313142,104,44,utRho03
dkgB,458196,458334,458196,138,658,utRho03
dksA,321502,321502,321208,294,160,utRho03
dld,4444164,4444370,4444164,206,12,utRho03
dmlA,3763424,3763824,3763424,400,0,utRho03
dmlR,3763710,3763710,3763618,92,0,utRho03
dmsA,1881646,1881918,1881646,272,146,utRho03
dnaA,7767922,7767922,7767458,464,5716,utRho03
dnaB,8528566,8528628,8528566,62,196,utRho03
dnaK,24096,24326,24096,230,212,utRho03
dnaN,7765466,7765466,7764642,824,2032,utRho03
dnaQ,471868,472134,471868,266,978,utRho03
dnaT,18406460,18406460,18406068,392,376,utRho03
dnaX,984112,984184,984112,72,536,utRho03
dosP,3131486,3131486,3131466,20,0,utRho03
dpiB,1303968,1304470,1303968,502,20,utRho03
dppA,7415740,7415740,7415410,330,682,utRho03
dps,1697900,1697900,1697822,78,30,utRho03
dsbA,8086754,8086836,8086754,82,2550,utRho03
dsbB,2466294,2466294,2466060,234,56,utRho03
dsbC,6079266,6079266,6077644,1622,1200,utRho03
dsbG,1277600,1277600,1277146,454,376,utRho03
dsdA,4958242,4958404,4958242,162,62,utRho03
dsdC,4955492,4955492,4955258,234,0,utRho03
dsdX,4955642,4955694,4955642,52,4,utRho03
dsrA,4050626,4050626,4050626,0,0,utRho03
dsrB,4049686,4049686,4049646,40,114,utRho03
dtpD,1485340,1485340,1485112,228,128,utRho03
dusA,8523200,8523338,8523200,138,3610,utRho03
dusB,6820492,6820560,6820492,68,240,utRho03
dusC,4460790,4460790,4460770,20,0,utRho03
dut,7627704,7627864,7627704,160,1434,utRho03
dxr,386670,387042,386670,372,622,utRho03
ebgA,6445102,6445266,6445102,164,12,utRho03
ebgR,6442874,6442932,6442874,58,48,utRho03
ecnB,8753018,8753106,8753018,88,78,utRho03
eco,4607594,4607810,4607594,216,100,utRho03
ecpA,621594,621594,621342,252,26,utRho03
ecpB,620238,620238,620052,186,0,utRho03
ecpR,622964,622964,622672,292,0,utRho03
eda,3866218,3866218,3865512,706,184,utRho03
edd,3869426,3869426,3869208,218,28,utRho03
efeO,2164308,2164486,2164308,178,126,utRho03
efeU_1,2162614,2162712,2162614,98,58,utRho03
efp,8751134,8751398,8751134,264,8228,utRho03
elaA,4763372,4763372,4763086,286,64,utRho03
elaD,4765308,4765426,4765308,118,68,utRho03
elfA,1995530,1995736,1995530,206,0,utRho03
elfD,1996642,1996980,1996642,338,0,utRho03
emrD,7707690,7707844,7707690,154,18,utRho03
emrK,4966896,4966896,4966678,218,0,utRho03
emrY,4964668,4964668,4964352,316,0,utRho03
emtA,2486250,2486360,2486250,110,4,utRho03
endA,12361100,12361388,12361100,288,0,utRho03
eno,5817692,5817692,5815882,1810,4604,utRho03
entC,1249662,1249770,1249662,108,0,utRho03
entD,1220508,1220508,1220158,350,16,utRho03
entH,1258584,1258600,1258584,16,80,utRho03
entS,1244506,1244600,1244506,94,42,utRho03
envR,6827266,6827266,6826930,336,0,utRho03
epd,12295292,12295292,12294764,528,200,utRho03
epmA,8765236,8765286,8765236,50,34,utRho03
epmB,8751406,8751406,8751314,92,4574,utRho03
eptB,7421162,7421162,7420950,212,0,utRho03
eptC,8300622,8300622,8300530,92,200,utRho03
erfK,4126708,4126708,4126646,62,1522,utRho03
erpA,353122,353220,353122,98,24,utRho03
esrE,8039956,8039956,8039956,0,0,utRho03
essD,1153746,1154796,1153746,1050,208,utRho03
etk,2088606,2088606,2088420,186,0,utRho03
evgA,4967262,4967510,4967262,248,40,utRho03
exbB,6304028,6304028,6303968,60,12,utRho03
exbD,6302780,6302780,6302486,294,250,utRho03
exuR,6493016,6493304,6493016,288,124,utRho03
exuT,6490004,6490208,6490004,204,0,utRho03
fabA,2032996,2032996,2032940,56,154,utRho03
fabB,4883282,4883282,4883210,72,6,utRho03
fabH,2297032,2297518,2297032,486,4322,utRho03
fabI,2702236,2702236,2702078,158,70,utRho03
fadB,8062026,8062026,8061942,84,0,utRho03
fadD,3779614,3779614,3779492,122,0,utRho03
fadE,486812,486812,486606,206,46,utRho03
fadH,6463248,6463330,6463248,82,0,utRho03
fadI,4921022,4921022,4920938,84,80,utRho03
fadL,4922410,4922600,4922410,190,26,utRho03
fadM,928720,928804,928720,84,18,utRho03
fadR,2469810,2469876,2469810,66,48,utRho03
fbaB,4357334,4357334,4357128,206,0,utRho03
fdhE,8162722,8162722,8162456,266,880,utRho03
fdhF,8598814,8598814,8598732,82,0,utRho03
fdnG,3094744,3094802,3094744,58,0,utRho03
fdrA,1093012,1093360,1093012,348,0,utRho03
feaB,2894994,2895038,2894994,44,0,utRho03
feaR,2894734,2894734,2894566,168,28,utRho03
fecA,9033454,9033454,9033354,100,392,utRho03
fecE,9023288,9023288,9022914,374,6872,utRho03
fecI,9036564,9036564,9036470,94,66,utRho03
feoA,7080114,7080326,7080114,212,240,utRho03
fepA,1225334,1225334,1224988,346,68,utRho03
fepB,1249454,1249454,1249020,434,308,utRho03
fepD,1244468,1244468,1244378,90,0,utRho03
fes,1225374,1225630,1225374,256,466,utRho03
ffh,5495706,5495706,5495590,116,2112,utRho03
ffs,952576,952848,952576,272,0,utRho03
fhuA,334884,334968,334884,84,376,utRho03
fhuE,2323294,2323294,2323102,192,208,utRho03
fhuF,9211504,9211504,9211326,178,2770,utRho03
fic,6983296,6983296,6982926,370,438,utRho03
fieF,8212864,8212938,8212864,74,66,utRho03
fimA,9085388,9086230,9085388,842,138,utRho03
fimB,9081334,9081914,9081334,580,1108,utRho03
fimE,9083742,9084074,9083742,332,50,utRho03
fimZ,1129214,1129214,1128960,254,32,utRho03
fiu,1683296,1683296,1683062,234,202,utRho03
fixA,84650,84806,84650,156,0,utRho03
fkpA,6955050,6955050,6954838,212,6962,utRho03
fldA,2846084,2846084,2845860,224,3836,utRho03
fldB,6079644,6079710,6079644,66,144,utRho03
flgA,2261770,2261770,2261726,44,62,utRho03
flgB,2261986,2262036,2261986,50,18,utRho03
flgK,2276702,2276756,2276702,54,1810,utRho03
flgM,2260330,2260330,2260256,74,448,utRho03
flgN,2259828,2259828,2259660,168,178,utRho03
flhB,3932432,3932432,3932382,50,132,utRho03
flhC,3955864,3955864,3955688,176,136,utRho03
flhD,3957154,3957154,3956394,760,898,utRho03
fliA,4003638,4003638,4003578,60,48,utRho03
fliC,4007352,4007352,4007212,140,112,utRho03
fliD,4007634,4007744,4007634,110,206,utRho03
fliE,4026186,4026186,4026028,158,0,utRho03
fliF,4026292,4026458,4026292,166,484,utRho03
fliL,4039168,4039236,4039168,68,156,utRho03
flk,4875824,4875900,4875824,76,66,utRho03
flu,4142634,4143078,4142634,444,142,utRho03
flxA,3292776,3292810,3292776,34,58,utRho03
fnr,2799104,2799104,2799052,52,28,utRho03
fnrS,2818258,2818258,2818258,0,0,utRho03
focA,1909628,1909628,1908932,696,508,utRho03
folA,99598,99646,99598,48,8,utRho03
folB,6409296,6409296,6409178,118,0,utRho03
folD,1115562,1115562,1115482,80,238,utRho03
folE,4487696,4487696,4487304,392,2902,utRho03
fpr,8228998,8228998,8228944,54,0,utRho03
frc,4986878,4986878,4986508,370,0,utRho03
frdA,8764824,8764824,8764636,188,134,utRho03
frdD,8758948,8758948,8758732,216,180,utRho03
fre,8052886,8053054,8052886,168,1820,utRho03
frlA,6999518,6999820,6999518,302,0,utRho03
frr,385624,385744,385624,120,702,utRho03
frsA,513004,513054,513004,50,158,utRho03
fruB,4527194,4527194,4526990,204,0,utRho03
frvR,8179804,8179804,8179710,94,0,utRho03
fryA,5008986,5008986,5008970,16,6,utRho03
fsaA,1727060,1727284,1727060,224,12,utRho03
fsr,1009710,1009710,1009392,318,80,utRho03
ftnA,3977364,3977432,3977364,68,0,utRho03
ftnB,3973550,3973850,3973550,300,0,utRho03
ftsA,207122,207964,207122,842,950,utRho03
ftsB,5745802,5745802,5745640,162,76,utRho03
ftsH,6654204,6654204,6653870,334,1202,utRho03
ftsK,1865858,1866448,1865858,590,2220,utRho03
ftsL,181376,182064,181376,688,1526,utRho03
ftsP,6325732,6325732,6325338,394,408,utRho03
ftsQ,205484,206310,205484,826,694,utRho03
ftsX,7204512,7204512,7204172,340,494,utRho03
ftsZ,209272,210610,209272,1338,96,utRho03
fucA,5867708,5867708,5867376,332,4,utRho03
fucP,5868238,5868470,5868238,232,0,utRho03
fumA,6753760,6753760,6753508,252,956,utRho03
fumB,8694696,8694696,8694652,44,0,utRho03
fumC,3373418,3373418,3373176,242,0,utRho03
fur,2842892,2842892,2842584,308,8180,utRho03
fusA,6947370,6947370,6947028,342,21464,utRho03
fxsA,8737206,8737328,8737206,122,122,utRho03
gabD,5581824,5582546,5581824,722,584,utRho03
gadA,7335214,7335214,7335160,54,0,utRho03
gadB,3144144,3144144,3144090,54,0,utRho03
gadC,3141168,3141168,3140978,190,48,utRho03
gadE,7315600,7316732,7315600,1132,38,utRho03
gadW,7329562,7329562,7329236,326,6,utRho03
gadX,14663356,14663356,14663240,116,0,utRho03
gadY,7329728,7329728,7329728,0,0,utRho03
galE,1584354,1584354,1584110,244,16,utRho03
galF,4228702,4228702,4228654,48,180,utRho03
galM,1577796,1577796,1577674,122,482,utRho03
galP,6176510,6176568,6176510,58,0,utRho03
galR,5953138,5953198,5953138,60,38,utRho03
galS,4483420,4483420,4483336,84,0,utRho03
galU,2582810,2582914,2582810,104,222,utRho03
gapA,3724480,3725542,3724480,1062,2670,utRho03
garP,6549868,6549868,6549814,54,0,utRho03
gatY,4354468,4354468,4354408,60,0,utRho03
gatZ,4352864,4352864,4352642,222,3826,utRho03
gcd,282558,282558,282450,108,18,utRho03
gcl,1067814,1067832,1067814,18,0,utRho03
gcvA,5885278,5885278,5885134,144,0,utRho03
gcvB,5885392,5885392,5885392,0,0,utRho03
gcvR,5199758,5199812,5199758,54,14,utRho03
gcvT,6101544,6101544,6101334,210,444,utRho03
gdhA,3684616,3684742,3684616,126,0,utRho03
gfcA,2099668,2099668,2099488,180,440,utRho03
gfcD,2096236,2096236,2095890,346,62,utRho03
ghrA,2195648,2195772,2195648,124,216,utRho03
ghrB,7434378,7434620,7434378,242,390,utRho03
glcA,6242728,6242728,6242558,170,52,utRho03
glcC,6256412,6256544,6256412,132,0,utRho03
glcD,6256152,6256152,6256042,110,4,utRho03
gldA,8278092,8278092,8278070,22,6,utRho03
glgA,7136784,7136784,7136066,718,232,utRho03
glgB,7147314,7147314,7147004,310,166,utRho03
glgC,7139142,7139142,7138656,486,44,utRho03
glgP,7133546,7133546,7133162,384,132,utRho03
glgS,6384024,6384024,6383878,146,0,utRho03
glgX,7142838,7142838,7142638,200,0,utRho03
glk,5018922,5018922,5018852,70,88,utRho03
glmS,7827622,7827622,7827336,286,6460,utRho03
glmU,7830652,7830652,7830400,252,510,utRho03
glmY,10765360,10765360,10765360,0,0,utRho03
glmZ,7972864,7972864,7972864,0,0,utRho03
glnA,16232888,16232888,16232136,752,252,utRho03
glnB,5375052,5375052,5374816,236,110,utRho03
glnD,377310,377310,377300,10,0,utRho03
glnE,6399602,6399602,6399282,320,138,utRho03
glnH,1696396,1696396,1696008,388,38,utRho03
glnK,945112,945196,945112,84,18,utRho03
glnL,8112742,8112742,8112678,64,22,utRho03
glnQ,1693262,1693262,1692926,336,204,utRho03
glnS,1411998,1412186,1411998,188,266,utRho03
gloA,3455602,3455674,3455602,72,70,utRho03
gloB,469852,469852,469564,288,758,utRho03
glpA,4705166,4705294,4705166,128,0,utRho03
glpD,7123942,7124026,7123942,84,8,utRho03
glpE,7123698,7123698,7123646,52,82,utRho03
glpF,8236322,8236322,8236180,142,88,utRho03
glpG,7122960,7122960,7122904,56,322,utRho03
glpR,7121782,7121782,7121210,572,202,utRho03
glpT,4704902,4704902,4704748,154,42,utRho03
glpX,8231212,8231212,8231158,54,3066,utRho03
glrK,5382246,5382246,5382196,50,238,utRho03
gltA,1509534,1509534,1508936,598,15186,utRho03
gltB,6709018,6709264,6709018,246,518,utRho03
gltI,1375792,1375792,1375494,298,1126,utRho03
gltP,8588536,8588962,8588536,426,1440,utRho03
gltS,7657382,7657382,7657330,52,238,utRho03
gltX,5041568,5041568,5041344,224,102,utRho03
gluQ,320286,320286,320224,62,0,utRho03
glyA,5371148,5371148,5371014,134,18,utRho03
glyQ,7450708,7450708,7450636,72,192,utRho03
glyS,7448990,7448990,7448794,196,1264,utRho03
glyU,5998128,5998128,5998114,14,2,utRho03
glyV,8784626,8784720,8784626,94,238,utRho03
glyW,3984360,3984360,3984234,126,0,utRho03
gmhB,445612,445666,445612,54,14,utRho03
gmk,7642776,7642856,7642776,80,92,utRho03
gmr,2693686,2693686,2693484,202,206,utRho03
gnd,4202648,4202648,4202536,112,774,utRho03
gnsB,3275692,3275692,3275564,128,110,utRho03
gntK,14310580,14310580,14310368,212,704,utRho03
gntP,9102668,9102668,9102592,76,30,utRho03
gntR,7157760,7157760,7157452,308,304,utRho03
gntT,7092810,7093118,7092810,308,62,utRho03
gntU,7154170,7154170,7154122,48,0,utRho03
gntX,7089334,7089764,7089334,430,54,utRho03
gor,7292224,7292598,7292224,374,1304,utRho03
gpmA,1575340,1575340,1575190,150,0,utRho03
gpmM,7570374,7570520,7570374,146,0,utRho03
gpsA,7567620,7567620,7567322,298,5258,utRho03
gpt,511828,511954,511828,126,372,utRho03
grcA,5433046,5433046,5432898,148,74,utRho03
greA,6657728,6657728,6657430,298,1592,utRho03
greB,7073488,7073624,7073488,136,36,utRho03
groL,8741566,8742050,8741566,484,922,utRho03
groS,8741232,8741376,8741232,144,152,utRho03
grpE,5501494,5501494,5501416,78,242,utRho03
grxA,1781552,1781552,1781506,46,0,utRho03
grxB,2248206,2248206,2248108,98,164,utRho03
grxC,7569152,7569152,7568884,268,3636,utRho03
grxD,3468324,3468324,3468202,122,4858,utRho03
gspA,6911268,6911268,6910796,472,14,utRho03
gspC,6910964,6911156,6910964,192,0,utRho03
gss,6277220,6277220,6277044,176,46,utRho03
gstA,3428654,3428754,3428654,100,0,utRho03
gstB,1761038,1761038,1760960,78,0,utRho03
guaB,5268214,5268214,5268140,74,2,utRho03
gudD,5839026,5839026,5838770,256,0,utRho03
gyrA,4678914,4678914,4678840,74,58,utRho03
gyrB,7760300,7760300,7760238,62,252,utRho03
hcaE,5337964,5338064,5337964,100,68,utRho03
hcaR,5337928,5337928,5337792,136,70,utRho03
hcaT,5336106,5336106,5335692,414,20,utRho03
hchA,4071260,4071670,4071260,410,0,utRho03
hcp,1828258,1828258,1827628,630,20,utRho03
hcr,1824400,1824400,1824300,100,6,utRho03
hdeA,7313582,7313582,7313480,102,0,utRho03
hdeD,7313920,7313990,7313920,70,0,utRho03
hdfR,7896320,7896320,7895934,386,444,utRho03
hdhA,3396244,3396244,3396080,164,26,utRho03
helD,2048876,2048942,2048876,66,0,utRho03
hemA,2527166,2527428,2527166,262,186,utRho03
hemB,779722,779722,779454,268,44,utRho03
hemF,5106410,5106450,5106410,40,0,utRho03
hemH,996062,996110,996062,48,176,utRho03
hemL,349882,349882,349764,118,108,utRho03
hemN,8103886,8104090,8103886,204,0,utRho03
hepA,127176,127176,126528,648,3942,utRho03
hflD,2385372,2385372,2385262,110,1080,utRho03
hfq,8799602,8800576,8799602,974,2512,utRho03
hha,961006,961006,960616,390,332,utRho03
hicA,3018442,3018572,3018442,130,0,utRho03
higA,6468682,6468682,6468288,394,44,utRho03
higB,6468960,6468960,6468910,50,0,utRho03
hinT,2323642,2323770,2323642,128,14,utRho03
hipB,3184964,3184964,3184884,80,0,utRho03
hisB,4186720,4186936,4186720,216,626,utRho03
hisJ,4853674,4853674,4853576,98,54,utRho03
hisL,8359856,8359984,8359856,128,668,utRho03
hisS,5281284,5281284,5281150,134,248,utRho03
hlpA,400910,400964,400910,54,128,utRho03
hlyE,2460932,2460932,2460788,144,2,utRho03
hmp,5371594,5371670,5371594,76,2,utRho03
hns,2585916,2585916,2585844,72,1554,utRho03
hofM,7045856,7045856,7045502,354,4,utRho03
hokA,7441620,7441620,7441200,420,4844,utRho03
hokC,33902,33902,33806,96,160,utRho03
hokE,1215462,1215672,1215462,210,0,utRho03
holC,8968546,8968546,8968560,14,634,utRho03
holD,9215562,9215606,9215562,44,0,utRho03
holE,3850040,3850216,3850040,176,948,utRho03
hpt,282720,282862,282720,142,126,utRho03
hrpB,324150,324210,324150,60,34,utRho03
hscB,5319048,5319048,5318934,114,938,utRho03
hscC,1367188,1367188,1366786,402,160,utRho03
hsdS,9163004,9163004,9162924,80,0,utRho03
hslJ,2883560,2883560,2883486,74,20,utRho03
hslO,7059344,7059548,7059344,204,5286,utRho03
hslR,7058220,7058696,7058220,476,870,utRho03
hslV,8244708,8244708,8244574,134,84,utRho03
hsrA,7881412,7881412,7881224,188,226,utRho03
htgA,21286,21660,21286,374,654,utRho03
htpG,989634,990240,989634,606,7604,utRho03
htpX,3825236,3825236,3825152,84,12,utRho03
htrE,311036,311036,310852,184,68,utRho03
htrL,7587668,7587668,7587366,302,188,utRho03
hupA,8400352,8400562,8400352,210,84,utRho03
hupB,1845220,1845804,1845220,584,172,utRho03
hyaA,2063968,2064278,2063968,310,4,utRho03
hybO,6292726,6292726,6292522,204,670,utRho03
hycA,5700922,5700922,5700870,52,0,utRho03
hycI,5686204,5686204,5686086,118,38,utRho03
hydN,5676264,5676264,5676210,54,0,utRho03
hyfA,5202342,5202402,5202342,60,0,utRho03
hypA,11402508,11402588,11402508,80,0,utRho03
hypB,11403356,11404004,11403356,648,336,utRho03
hypF,5676210,5676210,5674850,1360,650,utRho03
hypT,9116634,9116634,9116578,56,0,utRho03
hyuA,6019660,6020056,6019660,396,20,utRho03
iaaA,1733074,1733136,1733074,62,0,utRho03
iadA,9119074,9119074,9119052,22,2,utRho03
iap,5753072,5753162,5753072,90,4,utRho03
ibaG,6673966,6673966,6673606,360,220,utRho03
ibpA,7735036,7735036,7734844,192,124,utRho03
ibpB,7733962,7733962,7733794,168,160,utRho03
icd,2389922,2390246,2389922,324,180,utRho03
iclR,8447304,8447304,8447256,48,144,utRho03
idi,6065876,6066130,6065876,254,0,utRho03
idnD,8988870,8988870,8988812,58,0,utRho03
idnK,8989194,8989246,8989194,52,0,utRho03
ihfA,3591442,3591442,3591104,338,808,utRho03
ihfB,1927498,1927656,1927498,158,1128,utRho03
ileS,43666,44782,43666,1116,3008,utRho03
ileX,6431194,6431196,6431194,2,0,utRho03
ilvA,15820940,15821324,15820940,384,68,utRho03
ilvC,7915824,7915940,7915824,116,38,utRho03
ilvE,15809552,15809936,15809552,384,612,utRho03
ilvI,170840,171260,170840,420,0,utRho03
ilvL,23701308,23701932,23701308,624,150,utRho03
ilvY,7915734,7915734,7915640,94,0,utRho03
inaA,4698998,4698998,4698944,54,100,utRho03
infA,1853370,1853370,1852886,484,2910,utRho03
infC,3602692,3602692,3601276,1416,5440,utRho03
insA-5,3958452,3958452,3958430,22,18,utRho03
insA-7,9036758,9037054,9036758,296,74,utRho03
insC-5,6372080,6372284,6372080,204,190,utRho03
insEF-2,785238,785238,785820,582,458,utRho03
insEF-4,2190310,2190310,2190892,582,340,utRho03
insG,9007098,9007098,9006862,236,14,utRho03
insH-1,550596,550596,550234,362,60,utRho03
insH-11,7306538,7306538,7306396,142,90,utRho03
insH-2,1151548,1151548,1151506,42,202,utRho03
insH-3,1378444,1378444,1378026,418,178,utRho03
insH-4,2791942,2792152,2791942,210,90,utRho03
insH-5,2857852,2857852,2857452,400,0,utRho03
insH-6,4135022,4135022,4134642,380,132,utRho03
insH-7,4206186,4206186,4205822,364,9458,utRho03
insH-9,6260050,6260356,6260050,306,92,utRho03
insI-3,9017372,9017372,9017234,138,0,utRho03
insJ,7441188,7441360,7441188,172,2022,utRho03
insK,7442130,7442308,7442130,178,32,utRho03
insL-1,30760,30890,30760,130,410,utRho03
insL-2,1216112,1216130,1216112,18,6,utRho03
insL-3,5028644,5028662,5028644,18,114,utRho03
insN-1,540452,540484,540452,32,0,utRho03
intD,1132202,1132202,1131956,246,106,utRho03
intR,2826520,2826520,2826470,50,0,utRho03
intS,4933026,4933090,4933026,64,664,utRho03
intZ,5117386,5117542,5117386,156,108,utRho03
iraD,9113152,9113986,9113152,834,28,utRho03
iraM,2424246,2424246,2424006,240,50,utRho03
iraP,802638,802772,802638,134,0,utRho03
iscA,5319924,5319924,5319772,152,1778,utRho03
iscR,5324398,5324398,5324262,136,22774,utRho03
iscX,5313834,5313834,5313472,362,2614,utRho03
ispF,5743968,5743968,5743560,408,1540,utRho03
ispG,5283908,5283908,5283608,300,812,utRho03
ispU,389568,389806,389568,238,244,utRho03
isrA,2811502,2811502,2811618,116,0,utRho03
istr-1,7706384,7706384,7706384,0,0,utRho03
istr-2,7706514,7706514,7706514,0,0,utRho03
ivbL,15412092,15412092,15411952,140,344,utRho03
ivy,480638,480686,480638,48,0,utRho03
katE,3627628,3627734,3627628,106,48,utRho03
katG,8267624,8267670,8267624,46,84,utRho03
kbaZ,6557732,6557828,6557732,96,0,utRho03
kbl,7585154,7585154,7585102,52,534,utRho03
kch,2621046,2621046,2620538,508,0,utRho03
kdgR,3820506,3820506,3820198,308,16,utRho03
kdpE,1443788,1443788,1443466,322,114,utRho03
kdpF,1457698,1457698,1457642,56,0,utRho03
kdsA,2535708,2536330,2535708,622,3410,utRho03
kdsC,6683438,6684546,6683438,1108,3526,utRho03
kduI,5968388,5968388,5968248,140,542,utRho03
kefF,94160,94492,94160,332,26,utRho03
kgtP,5451624,5451624,5451492,132,1502,utRho03
kup,7862206,7862632,7862206,426,102,utRho03
lacI,735076,735076,735020,56,0,utRho03
lacZ,1465508,1465508,1465220,288,272,utRho03
ldcA,2486394,2486394,2486160,234,4,utRho03
ldhA,2885830,2885830,2885686,144,0,utRho03
ldrA,2538954,2538954,2538550,404,1468,utRho03
ldrB,2540024,2540024,2539620,404,690,utRho03
ldrC,2541092,2541092,2540690,402,1036,utRho03
ldrD,7400544,7400544,7400174,370,1308,utRho03
lepA,5414392,5414392,5414248,144,182,utRho03
lepB,5410928,5410928,5410618,310,666,utRho03
leuD,159188,159188,158906,282,0,utRho03
leuE,3761600,3761600,3761518,82,0,utRho03
leuL,168048,168048,167416,632,14,utRho03
leuO,168308,168736,168308,428,0,utRho03
leuQ,9212864,9212864,9212802,62,0,utRho03
leuU,6644556,6644556,6644316,240,4206,utRho03
leuV,9212546,9212546,9212330,216,796,utRho03
leuX,8992772,8992810,8992772,38,0,utRho03
lexA,8514174,8514230,8514174,56,44,utRho03
lhr,3456706,3458174,3456706,1468,2654,utRho03
ligA,5060402,5060402,5060352,50,0,utRho03
ligB,7642576,7642576,7642340,236,8,utRho03
lipA,1320602,1320602,1320432,170,298,utRho03
lipB,1324802,1324802,1324556,246,1924,utRho03
lit,2397032,2397390,2397032,358,108,utRho03
livJ,7199524,7199524,7199316,208,3008,utRho03
livK,7195510,7195510,7195120,390,74,utRho03
lldP,7554578,7554798,7554578,220,618,utRho03
lnt,1381968,1381968,1381762,206,482,utRho03
loiP,6163784,6163826,6163784,42,42,utRho03
lolA,1874656,1874738,1874656,82,784,utRho03
lolB,2527112,2527112,2527000,112,74,utRho03
lolC,2350748,2350854,2350748,106,0,utRho03
lon,917630,917776,917630,146,910,utRho03
lpcA,486936,487086,486936,150,0,utRho03
lpd,255434,255824,255434,390,3754,utRho03
lplA,9248476,9248476,9248234,242,634,utRho03
lplT,5947878,5947878,5947724,154,26,utRho03
lpoA,6586422,6586800,6586422,378,276,utRho03
lpp,3514592,3514842,3514592,250,98,utRho03
lptA,6686598,6686760,6686598,162,1530,utRho03
lptB,6686792,6687888,6686792,1096,1958,utRho03
lptD,114672,114672,114218,454,3872,utRho03
lptF,8972244,8972436,8972244,192,26,utRho03
lpxC,213016,213114,213016,98,24290,utRho03
lpxD,401920,401942,401920,22,20,utRho03
lpxL,2233418,2233418,2233164,254,84,utRho03
lpxM,3880456,3880456,3880386,70,170,utRho03
lpxP,4991156,4991290,4991156,134,554,utRho03
lrhA,4813312,4813312,4813282,30,24,utRho03
lrp,1864656,1865190,1864656,534,776,utRho03
lspA,50028,50414,50028,386,676,utRho03
lsrA,3202920,3202980,3202920,60,2,utRho03
lsrR,3202514,3202514,3202482,32,0,utRho03
ltaE,1818640,1818640,1818588,52,0,utRho03
luxS,5630130,5630130,5629466,664,1280,utRho03
lysA,5957902,5957902,5957798,104,0,utRho03
lysC,8467232,8467232,8466466,766,484,utRho03
lysP,4497120,4497120,4497064,56,46,utRho03
lysR,5957900,5958042,5957900,142,0,utRho03
lysT,1561028,1561108,1561028,80,100,utRho03
lysU,8709610,8709610,8709434,176,48,utRho03
macB,1840188,1840694,1840188,506,196,utRho03
maeA,3111484,3111484,3111338,146,2704,utRho03
mak,820236,820288,820236,52,0,utRho03
malE,8492928,8492928,8492838,90,0,utRho03
malI,3398456,3398456,3398360,96,12,utRho03
malK,8493472,8493568,8493472,96,0,utRho03
malP,7105020,7105020,7104946,74,168,utRho03
malQ,7100798,7100798,7100140,658,308,utRho03
malS,14949880,14949988,14949880,108,0,utRho03
malT,7106048,7106170,7106048,122,56,utRho03
malX,3398626,3398710,3398626,84,0,utRho03
malZ,1689980,1690072,1689980,92,2152,utRho03
manA,3377102,3377152,3377102,50,20,utRho03
manX,3803866,3804096,3803866,230,0,utRho03
marC,3237882,3237882,3237816,66,96,utRho03
marR,3238186,3238240,3238186,54,28,utRho03
matP,2036918,2036970,2036918,52,70,utRho03
mazE,5822736,5822736,5822678,58,22,utRho03
mazG,5821720,5821720,5821370,350,3166,utRho03
mcbA,1684306,1684306,1684112,194,14,utRho03
mcbR,3040192,3040524,3040192,332,38,utRho03
mcrA,2420278,2420692,2420278,414,64,utRho03
mcrC,9156124,9156124,9155916,208,42,utRho03
mdaB,6344814,6345060,6344814,246,0,utRho03
mdfA,1767138,1767346,1767138,208,0,utRho03
mdh,6768940,6768940,6768536,404,192,utRho03
mdoB,9198988,9198988,9198882,106,700,utRho03
mdoD,2993290,2993712,2993290,422,22,utRho03
mdoG,2218514,2218670,2218514,156,156,utRho03
mdtA,4307958,4308032,4307958,74,150,utRho03
mdtE,7318168,7318464,7318168,296,4,utRho03
mdtK,3486538,3486914,3486538,376,142,utRho03
mdtP,8602472,8602472,8602060,412,122,utRho03
melA,8683774,8683822,8683774,48,0,utRho03
melR,8683300,8683300,8683256,44,10,utRho03
menA,8240812,8240812,8240698,114,0,utRho03
menB,4753774,4753774,4753638,136,212,utRho03
mepH,3468714,3468870,3468714,156,2,utRho03
mepM,3883666,3883666,3883270,396,768,utRho03
mepS,4539840,4539958,4539840,118,624,utRho03
metA,8428318,8428560,8428318,242,336,utRho03
metB,8257272,8257344,8257272,72,626,utRho03
metC,6304150,6304472,6304150,322,322,utRho03
metE,8025768,8026106,8025768,338,88,utRho03
metF,8265092,8265232,8265092,140,36,utRho03
metG,4388538,4388600,4388538,62,132,utRho03
metH,8447010,8447656,8447010,646,6584,utRho03
metJ,8257116,8257116,8256790,326,158,utRho03
metK,6173154,6173412,6173154,258,130,utRho03
metN,445428,445428,445290,138,18,utRho03
metR,8025710,8025710,8025632,78,0,utRho03
metT,1394326,1394326,1394266,60,52,utRho03
metY,19910250,19910250,19909734,516,9858,utRho03
metZ,11789528,11789548,11789528,20,0,utRho03
mfd,2348056,2348056,2347928,128,136,utRho03
mglA,4478782,4478782,4478578,204,2,utRho03
mglB,4481132,4481132,4480696,436,512,utRho03
mglC,4475918,4475918,4475506,412,0,utRho03
mgrB,3817584,3817584,3817532,52,0,utRho03
mgrR,3245828,3245828,3245828,0,0,utRho03
mgsA,2054082,2054082,2054030,52,6,utRho03
mgtL,8934560,8934862,8934560,302,16,utRho03
mhpA,737038,737222,737038,184,20,utRho03
mhpR,737072,737072,736840,232,20,utRho03
mhpT,750772,750918,750772,146,0,utRho03
miaA,8797964,8798504,8797964,540,946,utRho03
micA,5629604,5629604,5629604,0,0,utRho03
micC,2874242,2874238,2874242,4,0,utRho03
micF,4626168,4626168,4626168,0,0,utRho03
micM,1014408,1014408,1014408,0,0,utRho03
minE,2449422,2449422,2449090,332,716,utRho03
mioC,7852950,7852950,7852910,40,76,utRho03
mipA,3733012,3733012,3732944,68,2386,utRho03
mlaA,4930270,4930270,4930014,256,10,utRho03
mlc,3337206,3337206,3337128,78,74,utRho03
mlrA,4429498,4429732,4429498,234,18,utRho03
mltA,5894546,5894546,5894356,190,44,utRho03
mltD,468050,468050,467910,140,48,utRho03
mltF,5391534,5391602,5391534,68,0,utRho03
mmuP,550238,550650,550238,412,60,utRho03
mngA,1531622,1531968,1531622,346,48,utRho03
mngR,1531852,1531852,1531750,102,40,utRho03
mnmG,7851348,7851348,7851266,82,7820,utRho03
mntH,5025470,5025470,5025412,58,14,utRho03
mntP,3810918,3811376,3810918,458,694,utRho03
mntR,1706160,1706366,1706160,206,0,utRho03
mntS,1706128,1706128,1705994,134,92,utRho03
moaA,1633654,1634088,1633654,434,910,utRho03
moaB,1635954,1636110,1635954,156,668,utRho03
mobA,8084242,8084242,8083998,244,546,utRho03
mocA,6030112,6030320,6030112,208,0,utRho03
modA,1589990,1590178,1589990,188,102,utRho03
moeA,1732788,1732788,1732728,60,94,utRho03
mokB,2984610,2984610,2984258,352,694,utRho03
molR_1,4392888,4392948,4392888,60,186,utRho03
motA,3954604,3954604,3954278,326,82,utRho03
mpaA,2781278,2781278,2781196,82,20,utRho03
mpl,8911456,8911570,8911456,114,0,utRho03
mppA,2786108,2786454,2786108,346,20,utRho03
mprA,5621494,5621540,5621494,46,288,utRho03
mqo,4613848,4613848,4613508,340,878,utRho03
mqsA,6336742,6336742,6336492,250,120,utRho03
mqsR,6337306,6337306,6337088,218,294,utRho03
mraZ,179192,179268,179192,76,0,utRho03
mrcA,7045652,7045742,7045652,90,0,utRho03
mrcB,329442,329460,329442,18,0,utRho03
mreB,13605424,13605424,13604348,1076,1280,utRho03
mreD,6798166,6798166,6797750,416,164,utRho03
mrp,4388360,4388360,4388336,24,12,utRho03
mscK,972984,973072,972984,88,192,utRho03
mscL,6876002,6876048,6876002,46,230,utRho03
mscS,6139742,6139742,6139614,128,92,utRho03
msrA,8884522,8884522,8884352,170,96,utRho03
msrB,3725168,3725168,3724858,310,0,utRho03
msyB,2228426,2228426,2228362,64,348,utRho03
mtfA,4087236,4087302,4087236,66,272,utRho03
mtgA,6699662,6699662,6699618,44,228,utRho03
mtlA,30177504,30178248,30177504,744,600,utRho03
mtn,358366,358366,358306,60,74,utRho03
mtr,6611864,6611864,6611634,230,34,utRho03
mug,6430992,6430992,6430946,46,72,utRho03
murQ,5091466,5091546,5091466,80,0,utRho03
murR,5091586,5091586,5091218,368,40,utRho03
mutH,5939164,5939324,5939164,160,764,utRho03
mutL,8794092,8794824,8794092,732,938,utRho03
mutM,7622554,7622554,7622304,250,1044,utRho03
mutS,5714038,5714186,5714038,148,244,utRho03
mutY,18617466,18618078,18617466,612,504,utRho03
nac,4123956,4123956,4123866,90,4,utRho03
nadA,1564122,1564170,1564122,48,0,utRho03
nadB,5420714,5420840,5420714,126,48,utRho03
nadC,237326,237326,237290,36,16,utRho03
nadE,3644604,3644916,3644604,312,12,utRho03
nadK,5501526,5501662,5501526,136,158,utRho03
nagA,1406350,1406350,1405502,848,1920,utRho03
nagB,1407416,1407416,1407222,194,14,utRho03
nagC,1404016,1404016,1403188,828,128,utRho03
nagE,1407680,1407888,1407680,208,30,utRho03
nagK,2357080,2357186,2357080,106,106,utRho03
nanA,6747240,6747240,6747152,88,10,utRho03
nanC,9079856,9079856,9079002,854,0,utRho03
nanR,6749406,6749406,6748978,428,136,utRho03
nanS,9075406,9075406,9075188,218,0,utRho03
napF,4607390,4607390,4606994,396,0,utRho03
narG,2559614,2559728,2559614,114,28,utRho03
narK,2555642,2555914,2555642,272,2,utRho03
narP,4580844,4581000,4580844,156,8,utRho03
narQ,5171154,5171462,5171154,308,0,utRho03
narU,3088326,3088326,3088120,206,0,utRho03
narW,3077374,3077374,3074618,2756,16,utRho03
narX,2555554,2555554,2555236,318,2,utRho03
narZ,3085380,3085380,3085180,200,0,utRho03
ndh,2331984,2332170,2331984,186,106,utRho03
ndk,5289920,5289920,5289728,192,302,utRho03
nemR,6904084,6904092,6904084,8,0,utRho03
nepI,7683542,7683542,7683478,64,220,utRho03
nfo,4501612,4501680,4501612,68,90,utRho03
nfsB,1210906,1210906,1210848,58,26,utRho03
nfuA,7090916,7091248,7090916,332,404,utRho03
nhaA,34634,34978,34634,344,76,utRho03
nhaB,2469534,2469534,2469434,100,58,utRho03
nhoA,3067926,3068048,3067926,122,0,utRho03
nikA,7226878,7227334,7226878,456,2984,utRho03
nikR,7237074,7237176,7237074,102,76,utRho03
nirB,6987974,6988022,6987974,48,44,utRho03
nlpA,7680034,7680034,7679986,48,0,utRho03
nlpC,3585654,3585654,3585462,192,124,utRho03
nlpD,5737658,5737658,5737506,152,112,utRho03
nlpI,6618080,6618080,6617848,232,2,utRho03
nmpC,1153740,1153740,1153650,90,0,utRho03
nohA,3273206,3273206,3272734,472,0,utRho03
norR,5664614,5664614,5664578,36,0,utRho03
norV,5664878,5664952,5664878,74,0,utRho03
nrdA,4689510,4689730,4689510,220,12032,utRho03
nrdD,8925676,8925676,8925320,356,1392,utRho03
nrdH,5601312,5601446,5601312,134,780,utRho03
nrdR,865954,866004,865954,50,42,utRho03
nrfA,8575342,8575528,8575342,186,12,utRho03
nsrR,8812088,8812380,8812088,292,50290,utRho03
nudB,3897348,3897348,3897264,84,0,utRho03
nudC,8393428,8393806,8393428,378,66,utRho03
nudE,7052658,7052658,7052298,360,4858,utRho03
nudG,3682876,3682980,3682876,104,0,utRho03
nudI,4729050,4729108,4729050,58,0,utRho03
nudJ,2388874,2388874,2388576,298,1386,utRho03
nuoA,4810670,4810670,4810144,526,1840,utRho03
nuoN,4783434,4783434,4783010,424,1420,utRho03
nupC,5026018,5026084,5026018,66,16,utRho03
nupG,6211302,6211428,6211302,126,4,utRho03
ogrK,4335096,4335096,4335040,56,0,utRho03
ogt,2800568,2800568,2800472,96,164,utRho03
ohsC,5401036,5401040,5401036,4,0,utRho03
ompA,2040382,2040382,2040106,276,15868,utRho03
ompC,4625774,4625774,4625498,276,94,utRho03
ompF,1974184,1974184,1973964,220,78,utRho03
ompL,8128958,8128958,8128590,368,0,utRho03
ompN,2874158,2874158,2873786,372,6,utRho03
ompR,7073510,7073510,7073168,342,22,utRho03
ompT,1171330,1171330,1171266,64,160,utRho03
ompW,2627982,2628040,2627982,58,0,utRho03
ompX,1700418,1700900,1700418,482,842,utRho03
omrA,5952378,5952378,5952378,0,0,utRho03
omrB,5952770,5952770,5952770,0,0,utRho03
oppA,2602170,2602364,2602170,194,18146,utRho03
orn,8783168,8783208,8783168,40,20,utRho03
osmB,2686952,2686952,2686656,296,88,utRho03
osmC,3113192,3113250,3113192,58,62,utRho03
osmE,3644566,3644566,3644512,54,14,utRho03
osmF,4439046,4439046,4438962,84,254,utRho03
osmY,9222306,9222792,9222306,486,212,utRho03
otsA,3963302,3963302,3963224,78,12,utRho03
otsB,3964930,3964930,3964774,156,60,utRho03
oxc,4984288,4984288,4983900,388,22,utRho03
oxyR,8316914,8316980,8316914,66,54,utRho03
oxyS,8316788,8316788,8316788,0,0,utRho03
paaA,2907730,2907854,2907730,124,0,utRho03
paaX,2927018,2927078,2927018,60,0,utRho03
paaZ,2907340,2907340,2907284,56,0,utRho03
pabA,6981702,6981702,6981658,44,0,utRho03
pabB,3789256,3789610,3789256,354,216,utRho03
pabC,2306186,2306600,2306186,414,274,utRho03
pagP,1313052,1313114,1313052,62,18,utRho03
panB,299260,299260,299202,58,200,utRho03
panC,297840,297840,297590,250,192,utRho03
panD,293490,293490,293388,102,120,utRho03
panZ,7195656,7195968,7195656,312,64,utRho03
parC,6332060,6332060,6331946,114,112,utRho03
patA,6438916,6438988,6438916,72,30,utRho03
patD,3030830,3031156,3030830,326,0,utRho03
pbpC,5294986,5294986,5294650,336,0,utRho03
pbpG,4450132,4450132,4449740,392,36,utRho03
pck,7065358,7065636,7065358,278,1592,utRho03
pcnB,318782,318782,318252,530,760,utRho03
pdhR,244068,244184,244068,116,136,utRho03
pdxB,4875768,4875768,4875702,66,6,utRho03
pdxH,3436068,3436068,3436014,54,218,utRho03
pdxJ,5403626,5403626,5403458,168,138,utRho03
pdxK,5074638,5074638,5074474,164,58,utRho03
pepA,8972278,8972278,8971902,376,190,utRho03
pepD,511618,511618,511432,186,2922,utRho03
pepN,1981182,1981244,1981182,62,42,utRho03
pepQ,8062294,8062322,8062294,28,40,utRho03
pepT,2371646,2371688,2371646,42,0,utRho03
pfkA,8214948,8215104,8214948,156,184,utRho03
pfkB,3612646,3612740,3612646,94,0,utRho03
pflA,1902456,1902456,1902160,296,54,utRho03
pflB,1907850,1907850,1907108,742,584,utRho03
pflD,8287716,8287990,8287716,274,0,utRho03
pgaA,2185046,2185046,2184578,468,0,utRho03
pgi,8467444,8467516,8467444,72,4,utRho03
pgk,12291428,12291428,12290488,940,4332,utRho03
pgl,1597078,1597172,1597078,94,4,utRho03
pgpB,2678324,2678660,2678324,336,96,utRho03
pgpC,5397276,5397276,5397100,176,0,utRho03
pgrR,2783744,2783982,2783744,238,50,utRho03
pheL,5475158,5475198,5475158,40,2,utRho03
pheM,7197204,7197204,7197080,124,52,utRho03
pheP,1203858,1203918,1203858,60,0,utRho03
pheU,8725254,8725254,8725252,2,0,utRho03
pheV,6220730,6220732,6220730,2,0,utRho03
phnC,8650412,8650412,8650330,82,0,utRho03
phoA,803414,803494,803414,80,0,utRho03
phoB,834202,834284,834202,82,14,utRho03
phoE,520316,520316,520200,116,20,utRho03
phoH,2169730,2169984,2169730,254,590,utRho03
phoP,2381016,2381016,2380894,122,1412,utRho03
phoQ,2379880,2379880,2379552,328,1298,utRho03
phoU,7815330,7815330,7815156,174,112,utRho03
phr,1478842,1479014,1478842,172,0,utRho03
pinE,2419054,2419370,2419054,316,38,utRho03
pinQ,3267168,3267244,3267168,76,1156,utRho03
pinR,2867424,2867424,2867348,76,1254,utRho03
pitA,7275224,7275284,7275224,60,4,utRho03
pitB,6272806,6272806,6272742,64,0,utRho03
pka,5439862,5439906,5439862,44,0,utRho03
plaP,4174476,4174476,4174124,352,522,utRho03
pldA,8009628,8009724,8009628,96,44,utRho03
pldB,8018028,8018340,8018028,312,362,utRho03
plsB,8513196,8513196,8512932,264,158,utRho03
pmbA,8915890,8915918,8915890,28,0,utRho03
pmrD,4747148,4747148,4747076,72,0,utRho03
pncB,1980828,1980828,1980712,116,38,utRho03
pncC,5648788,5648788,5648692,96,0,utRho03
pnp,6622652,6622652,6622336,316,114,utRho03
pntA,3355950,3355950,3355806,144,0,utRho03
pntB,3353096,3353096,3352720,376,0,utRho03
polA,8093880,8093932,8093880,52,68,utRho03
polB,131606,131606,131560,46,0,utRho03
potD,2365700,2365700,2365658,42,22,utRho03
potE,1436688,1436688,1436530,158,0,utRho03
potF,1787268,1787568,1787268,300,18,utRho03
poxB,1822152,1822152,1822098,54,0,utRho03
ppa,8899372,8899372,8899304,68,164,utRho03
ppc,8306380,8306380,8306196,184,336,utRho03
ppdA,5928440,5928440,5928354,86,1268,utRho03
ppdD,235410,235410,235098,312,310,utRho03
pphA,3846770,3846770,3845938,832,1946,utRho03
pphB,5719474,5719520,5719474,46,0,utRho03
ppiA,6984898,6984898,6984594,304,82,utRho03
ppiC,7919682,7919682,7919626,56,126,utRho03
ppiD,923638,923830,923638,192,810,utRho03
ppk,5245748,5246088,5245748,340,590,utRho03
pppA,6228958,6228958,6228704,254,0,utRho03
ppsA,3574322,3574322,3574224,98,0,utRho03
ppsR,3574678,3574890,3574678,212,0,utRho03
pptA,3065716,3066104,3065716,388,62,utRho03
pqiA,2023318,2024002,2023318,684,270,utRho03
prc,3830054,3830054,3829632,422,19602,utRho03
preT,4467978,4468066,4467978,88,96,utRho03
prfC,9218688,9218828,9218688,140,862,utRho03
prkB,6968622,6968980,6968622,358,1126,utRho03
prlC,7290476,7290476,7290364,112,206,utRho03
prlF,6553944,6554004,6553944,60,152,utRho03
proB,520432,520776,520432,344,162,utRho03
proC,811372,811372,811288,84,8,utRho03
proK,7417388,7417388,7417384,4,0,utRho03
proL,4572414,4572422,4572414,8,8,utRho03
proP,8660640,8661004,8660640,364,5202,utRho03
proS,437674,437674,437550,124,388,utRho03
proV,5609126,5609630,5609126,504,8,utRho03
prpB,697292,697364,697292,72,0,utRho03
prpR,696942,696942,696886,56,0,utRho03
prs,2524354,2524354,2523750,604,48392,utRho03
psd,8781276,8781276,8780720,556,3024,utRho03
psiE,8480600,8480650,8480600,50,0,utRho03
pspA,2736076,2736158,2736076,82,0,utRho03
pspF,2736080,2736080,2735824,256,0,utRho03
pspG,8525632,8525680,8525632,48,0,utRho03
pssA,5445156,5445454,5445156,298,1280,utRho03
pstB,7817112,7817112,7816732,380,0,utRho03
pstC,7821084,7821084,7820796,288,0,utRho03
pstS,23469408,23469408,23469150,258,252,utRho03
psuG,4517114,4517114,4516734,380,96,utRho03
psuT,4514992,4514992,4514670,322,0,utRho03
pth,2517084,2517084,2517026,58,0,utRho03
ptrA,5918022,5918022,5917768,254,0,utRho03
ptrB,3857730,3857730,3857678,52,3490,utRho03
ptsG,2315252,2315738,2315252,486,1758,utRho03
ptsH,5066996,5067528,5066996,532,2364,utRho03
purA,8809328,8809374,8809328,46,0,utRho03
purC,5195562,5195562,5195236,326,0,utRho03
purD,8411972,8411972,8411862,110,22,utRho03
purE,1106284,1106284,1106200,84,986,utRho03
purH,8415254,8415254,8415064,190,10,utRho03
purL,5391178,5391178,5391086,92,280,utRho03
purM,5242306,5242394,5242306,88,0,utRho03
purR,3475378,3475688,3475378,310,636,utRho03
purT,3861438,3861762,3861438,324,58,utRho03
purU,2577512,2577512,2577248,264,732,utRho03
putA,2157850,2157850,2157764,86,0,utRho03
putP,2158336,2158610,2158336,274,302,utRho03
puuA,2721936,2721936,2721816,120,0,utRho03
puuC,2725456,2725486,2725456,30,0,utRho03
puuD,2722104,2722240,2722104,136,0,utRho03
puuP,2718746,2718746,2718374,372,604,utRho03
pykA,3874988,3875298,3874988,310,226,utRho03
pykF,3510934,3511396,3510934,462,1226,utRho03
pyrC,2245286,2245286,2245214,72,264,utRho03
pyrD,2009464,2009536,2009464,72,18,utRho03
pyrE,7631970,7631970,7631536,434,86,utRho03
pyrF,2683740,2683842,2683740,102,368,utRho03
pyrG,5819594,5819594,5819332,262,2416,utRho03
pyrH,383624,383710,383624,86,1356,utRho03
pyrL,8945490,8945490,8945066,424,78,utRho03
qmcA,1031646,1031646,1031546,100,0,utRho03
qor,8528608,8528608,8528462,146,178,utRho03
qseB,6339502,6339656,6339502,154,28,utRho03
queA,849970,850022,849970,52,530,utRho03
queE,5811212,5811212,5810836,376,56,utRho03
queF,5850642,5850696,5850642,54,0,utRho03
queG,8788184,8788184,8788134,50,648,utRho03
racC,2835630,2835630,2835526,104,0,utRho03
racR,2840898,2840898,2840482,416,88,utRho03
raiA,5474208,5474308,5474208,100,124,utRho03
rarD,8008594,8008594,8008356,238,290,utRho03
ravA,7862256,7862256,7862186,70,32,utRho03
rayT,495088,495274,495088,186,4,utRho03
rbn,4763162,4763216,4763162,54,2,utRho03
rbsD,7866644,7866702,7866644,58,54,utRho03
rcnA,4371654,4371834,4371654,180,0,utRho03
rcnB,4373768,4373920,4373768,152,20,utRho03
rcnR,4371806,4371806,4371592,214,8,utRho03
rcsA,4047672,4047936,4047672,264,218,utRho03
rcsB,4631390,4632354,4631390,964,1512,utRho03
rcsC,4640162,4640162,4639656,506,494,utRho03
rcsD,4626904,4626976,4626904,72,342,utRho03
rdgB,6193240,6193362,6193240,122,572,utRho03
rdlA,2538646,2538646,2538646,0,0,utRho03
rdlB,2539712,2539716,2539712,4,0,utRho03
rdlC,2540782,2540786,2540782,4,0,utRho03
rdlD,7400272,7400272,7400272,0,0,utRho03
rdoA,8084782,8084830,8084782,48,76,utRho03
recA,11295276,11295276,11295076,200,1052,utRho03
recC,5925014,5925014,5924856,158,24,utRho03
recF,7763722,7763722,7762442,1280,10626,utRho03
recN,5503518,5503590,5503518,72,22,utRho03
recQ,8011666,8011728,8011666,62,30,utRho03
relA,5828554,5828554,5827302,1252,292,utRho03
relB,3291806,3291806,3291744,62,0,utRho03
rem,3289950,3289950,3289804,146,0,utRho03
rep,7921294,7921354,7921294,60,54,utRho03
rfaD,7587730,7587974,7587730,244,374,utRho03
rfaE,6393852,6393852,6393506,346,4,utRho03
rfaH,8049930,8049930,8049642,288,1534,utRho03
rfbX,4219436,4219436,4219168,268,2854,utRho03
rfe,7935600,7935832,7935600,232,80,utRho03
rhaB,8194944,8194944,8194896,48,0,utRho03
rhaD,8188770,8188770,8188544,226,0,utRho03
rhaS,8195422,8195472,8195422,50,0,utRho03
rhaT,8201132,8201132,8201050,82,18,utRho03
rhlE,1661566,1661744,1661566,178,450,utRho03
rhoL,47593944,47594772,47593944,828,363060,utRho03
rhsB,7238006,7238384,7238006,378,94,utRho03
rhsC,1458758,1459166,1458758,408,0,utRho03
rhsD,1046132,1046522,1046132,390,0,utRho03
rhtA,1700608,1700608,1700194,414,148,utRho03
rhtC,8015478,8015514,8015478,36,2310,utRho03
ribA,2678468,2678468,2678320,148,52,utRho03
ribC,3486916,3486916,3486484,432,142,utRho03
ribE,869008,869294,869008,286,6498,utRho03
ribF,42766,42814,42766,48,56,utRho03
ridA,8941892,8941892,8941826,66,44,utRho03
rihA,1369204,1369204,1368824,380,372,utRho03
rihB,4510504,4510504,4510372,132,0,utRho03
rimJ,2251044,2251124,2251044,80,0,utRho03
rimK,1783752,1783934,1783752,182,230,utRho03
rimL,2997486,2997876,2997486,390,106,utRho03
rimO,1756140,1756140,1756070,70,38,utRho03
rimP,6636350,6636350,6636012,338,1110,utRho03
rlmA,3814172,3814172,3814120,52,226,utRho03
rlmD,5830086,5830086,5830000,86,42,utRho03
rlmE,6655520,6655520,6655328,192,2150,utRho03
rlmF,1684384,1684664,1684384,280,42,utRho03
rlmG,6471784,6471784,6471750,34,24,utRho03
rlmI,2060002,2060002,2059938,64,40,utRho03
rlmJ,7290700,7290770,7290700,70,190,utRho03
rlmL,2015344,2015688,2015344,344,1326,utRho03
rlpA,1330444,1330444,1330380,64,134,utRho03
rluA,120900,120900,120692,208,312,utRho03
rluF,8460324,8460708,8460324,384,102,utRho03
rmf,2031006,2031430,2031006,424,1546,utRho03
rna,1290068,1290068,1290006,62,0,utRho03
rnb,2698258,2698258,2697824,434,2742,utRho03
rnc,10816892,10816892,10816252,640,10656,utRho03
rnd,3776122,3776122,3775982,140,256,utRho03
rne,2289746,2289746,2288734,1012,10958,utRho03
rnhA,472082,472082,472004,78,336,utRho03
rnk,1288360,1288360,1287934,426,140,utRho03
rnlA,5531788,5531836,5531788,48,230,utRho03
rnlB,5533414,5533968,5533414,554,2274,utRho03
rnpB,19623552,19623552,19623552,0,0,utRho03
rob,9270706,9270706,9270620,86,0,utRho03
rodZ,5285868,5285868,5285688,180,170,utRho03
rpe,7030306,7030306,7030118,188,100,utRho03
rph,15266320,15266320,15266196,124,64,utRho03
rpiA,6118706,6118706,6118650,56,0,utRho03
rpiB,8626514,8626700,8626514,186,0,utRho03
rpiR,8626274,8626274,8625982,292,4,utRho03
rplJ,8359246,8359992,8359246,746,11414,utRho03
rplK,8356708,8356894,8356708,186,610,utRho03
rplM,6757344,6757344,6757302,42,8784,utRho03
rplN,6896444,6896444,6896298,146,5570,utRho03
rplS,5489284,5489284,5489060,224,16534,utRho03
rplT,7199052,7199052,7198996,56,524,utRho03
rplU,6667036,6667036,6666902,134,158,utRho03
rplY,4564866,4565034,4564866,168,154,utRho03
rpmA,6666450,6666450,6666238,212,1180,utRho03
rpmB,15247980,15247980,15246696,1284,107880,utRho03
rpmE,8253816,8254026,8253816,210,710,utRho03
rpmF,2294676,2294734,2294676,58,38934,utRho03
rpmH,7768130,7768672,7768130,542,5532,utRho03
rpmI,3600854,3600854,3599998,856,11396,utRho03
rpoB,8362126,8362490,8362126,364,1100,utRho03
rpoD,6424946,6426094,6424946,1148,19102,utRho03
rpoE,5420372,5420372,5420024,348,0,utRho03
rpoH,7202006,7202006,7201566,440,20040,utRho03
rpoN,6689324,6689434,6689324,110,10,utRho03
rpoS,5736236,5736236,5735102,1134,3178,utRho03
rpoZ,7644154,7644212,7644154,58,734,utRho03
rppH,5937986,5937986,5937954,32,24,utRho03
rprA,3540744,3540744,3540744,0,0,utRho03
rpsA,1923434,1923990,1923434,556,158508,utRho03
rpsF,8850050,8850236,8850050,186,34242,utRho03
rpsI,6756580,6756580,6756414,166,8490,utRho03
rpsJ,6906884,6906884,6906540,344,8810,utRho03
rpsL,6949242,6949242,6949104,138,228,utRho03
rpsM,6885130,6885130,6884942,188,2304,utRho03
rpsO,13247144,13247144,13246736,408,1580,utRho03
rpsP,5492508,5492508,5492370,138,218,utRho03
rpsT,42420,42420,42156,264,514,utRho03
rpsU,12842584,12843124,12842584,540,1484,utRho03
rraA,8238716,8238716,8238660,56,160,utRho03
rraB,8956768,8956946,8956768,178,0,utRho03
rrsA,8070478,8071062,8070478,584,6568,utRho03
rrsB,16665468,16666636,16665468,1168,14756,utRho03
rrsC,7883032,7883616,7883032,584,7424,utRho03
rrsD,6858094,6858094,6857524,570,536,utRho03
rrsE,8415726,8416294,8415726,568,1196,utRho03
rrsG,5462896,5462896,5462314,582,5596,utRho03
rrsH,446970,447542,446970,572,1162,utRho03
rsd,8393908,8393908,8393616,292,82,utRho03
rseA,5419264,5419264,5418808,456,544,utRho03
rseP,392940,393092,392940,152,40,utRho03
rseX,4067298,4067298,4067298,0,0,utRho03
rsfS,1338144,1338144,1338072,72,498,utRho03
rsgA,8783132,8783132,8783018,114,0,utRho03
rsmA,105176,105176,104860,316,3116,utRho03
rsmB,6869982,6870414,6869982,432,254,utRho03
rsmC,9215736,9215736,9215400,336,698,utRho03
rsmD,7208594,7208786,7208594,192,68,utRho03
rsmE,6182036,6182268,6182036,232,244,utRho03
rsmG,7847512,7847512,7847360,152,2560,utRho03
rsmH,180020,180188,180020,168,336,utRho03
rsmI,6587106,6587106,6586670,436,568,utRho03
rssA,2578212,2578412,2578212,200,430,utRho03
rssB,2580440,2580484,2580440,44,298,utRho03
rstA,3364276,3364300,3364276,24,58,utRho03
rsuA,4561096,4561096,4560966,130,412,utRho03
rsxA,3411510,3411534,3411510,24,22,utRho03
rtcA,7114004,7114004,7113698,306,16,utRho03
rtcB,7116214,7116214,7116158,56,0,utRho03
rtn,4541356,4541452,4541356,96,216,utRho03
rutA,2148052,2148052,2148022,30,0,utRho03
rutG,2140090,2140090,2139678,412,0,utRho03
rutR,2148226,2148484,2148226,258,2,utRho03
ruvA,7784096,7784096,7783904,192,24,utRho03
ruvB,7782176,7782176,7781424,752,716,utRho03
ruvC,3894878,3894878,3894752,126,0,utRho03
rybB,1776114,1776114,1776114,0,0,utRho03
rydB,3529860,3529860,3529322,538,90,utRho03
rydC,2983012,2983012,2983012,0,0,utRho03
ryfA,5307398,5307710,5307398,312,0,utRho03
ryfD,5468590,5468590,5468590,0,0,utRho03
ryhB,7162032,7162032,7162032,0,0,utRho03
ryjA,8556132,8556132,8556132,0,0,utRho03
ryjB,9055954,9055954,9055954,0,0,utRho03
sad,3229598,3229598,3229406,192,136,utRho03
safA,3168056,3168056,3167918,138,12,utRho03
sanA,4465368,4465756,4465368,388,98,utRho03
sapF,2705314,2705314,2705268,46,100,utRho03
sbcB,4165456,4165512,4165456,56,18,utRho03
sbcC,831694,831694,831506,188,102,utRho03
sbcD,833954,833954,833904,50,12,utRho03
sbmA,793106,793278,793106,172,90,utRho03
sbmC,4162650,4162650,4162524,126,0,utRho03
sdaA,3793618,3793864,3793618,246,32,utRho03
sdaC,5856070,5856458,5856070,388,430,utRho03
sdhC,1509916,1510354,1509916,438,21294,utRho03
sdhD,1510808,1511120,1510808,312,5142,utRho03
sdiA,3993834,3993834,3993664,170,0,utRho03
secE,8354354,8354716,8354354,362,398,utRho03
secG,6645180,6645180,6645010,170,1786,utRho03
selA,7522594,7522594,7522498,96,438,utRho03
selB,7519850,7519850,7519722,128,90,utRho03
selC,7672396,7672444,7672396,48,2,utRho03
selD,3696058,3696058,3696016,42,4298,utRho03
seqA,1425884,1425974,1425884,90,592,utRho03
serA,6117098,6117098,6116820,278,54,utRho03
serB,9249712,9249790,9249712,78,0,utRho03
serC,3830380,3830612,3830380,232,0,utRho03
serS,1878730,1878856,1878730,126,2554,utRho03
serT,2063438,2063438,2063424,14,0,utRho03
serU,4087124,4087124,4087114,10,6,utRho03
serV,5637394,5637394,5637290,104,156,utRho03
serW,1852014,1852014,1851942,72,252,utRho03
serX,2195352,2195352,2195304,48,2,utRho03
setB,4527426,4527726,4527426,300,0,utRho03
setC,7673488,7673906,7673488,418,18,utRho03
sfmA,1116124,1116424,1116124,300,0,utRho03
sfmC,1117606,1117948,1117606,342,0,utRho03
sfsA,323030,323030,322972,58,334,utRho03
sfsB,6669592,6669818,6669592,226,190,utRho03
sgrR,154676,154676,154598,78,44,utRho03
sgrS,154734,154734,154734,0,0,utRho03
shiA,4107068,4107286,4107068,218,124,utRho03
sibA,4306622,4306622,4306622,0,0,utRho03
sibB,4307292,4307292,4307292,0,0,utRho03
sibC,6113702,6113702,6113702,0,0,utRho03
sibD,6389730,6389730,6389730,0,0,utRho03
sibE,6390480,6390480,6390480,0,0,utRho03
sixA,4913998,4913998,4913624,374,0,utRho03
slp,7307872,7307922,7307872,50,36,utRho03
slt,9261400,9261466,9261400,66,114,utRho03
slyA,3442028,3442028,3441648,380,202,utRho03
slyB,3439496,3439752,3439496,256,72,utRho03
slyD,6957398,6957398,6956994,404,252,utRho03
slyX,6954862,6955280,6954862,418,7170,utRho03
smf,6867372,6867372,6867120,252,36,utRho03
smpB,5509534,5509792,5509534,258,1428,utRho03
smrA,2811872,2811958,2811872,86,136,utRho03
smrB,4896872,4897212,4896872,340,6,utRho03
smtA,1946808,1947074,1946808,266,64,utRho03
sodA,8201518,8201620,8201518,102,5428,utRho03
sodB,3470646,3470756,3470646,110,0,utRho03
sodC,3449358,3449358,3449310,48,0,utRho03
sohB,2658568,2658664,2658568,96,0,utRho03
sokB,2984232,2984238,2984232,6,16,utRho03
solA,2241218,2241218,2241172,46,14,utRho03
soxR,8554894,8554938,8554894,44,0,utRho03
soxS,8554846,8554846,8554766,80,0,utRho03
speA,6172096,6172096,6171822,274,300,utRho03
speB,6167892,6167892,6167594,298,64,utRho03
speC,6218350,6218350,6218310,40,20,utRho03
spf,8099798,8099798,8099798,0,0,utRho03
sppA,3697422,3697674,3697422,252,2,utRho03
spy,3651376,3651376,3651250,126,0,utRho03
sra,3112092,3112092,3111926,166,68,utRho03
sraB,2293178,2293178,2293178,0,0,utRho03
sraC,3846132,3846132,3846132,0,0,utRho03
srlA,5651582,5651664,5651582,82,0,utRho03
srlR,5657720,5658094,5657720,374,550,utRho03
srmB,5425752,5425792,5425752,40,160,utRho03
sroA,151216,151216,151216,0,0,utRho03
sroG,6369436,6369436,6369436,0,0,utRho03
sroH,8380974,8380974,8380974,0,0,utRho03
ssb,8548022,8548250,8548022,228,104,utRho03
sseA,5304782,5304988,5304782,206,3896,utRho03
sspA,6755138,6755138,6754840,298,838,utRho03
ssrA,5511014,5511186,5511014,172,200,utRho03
ssrS,12223036,12223932,12223036,896,1408,utRho03
sstT,6479726,6479888,6479726,162,44,utRho03
ssuB,1988282,1988282,1988088,194,0,utRho03
ssuE,1995126,1995126,1995024,102,0,utRho03
sthA,8321604,8321604,8321580,24,1796,utRho03
stpA,5597156,5597156,5596990,166,58,utRho03
sucA,3034344,3034824,3034344,480,1780,utRho03
sufA,3528836,3528836,3528772,64,52,utRho03
sufE,3518962,3518962,3518580,382,1148,utRho03
sugE,8753588,8753750,8753588,162,520,utRho03
sulA,2041894,2041894,2041838,56,426,utRho03
syd,5850738,5850738,5850560,178,104,utRho03
symE,9159834,9159834,9159680,154,208,utRho03
symR,9159670,9159670,9159670,0,0,utRho03
tabA,8949566,8949724,8949566,158,0,utRho03
talA,5157140,5157332,5157140,192,28,utRho03
talB,16382,16476,16382,94,6514,utRho03
tam,3214442,3214692,3214442,250,34,utRho03
tamA,8884540,8884764,8884540,224,54,utRho03
tar,3945432,3945432,3945382,50,0,utRho03
tas,5943138,5943194,5943138,56,210,utRho03
tatA,16087636,16087780,16087636,144,500,utRho03
tatE,1317742,1317894,1317742,152,70,utRho03
tauA,770410,770464,770410,54,0,utRho03
tdcA,6534186,6534186,6534130,56,0,utRho03
tdcG,6519652,6519652,6519298,354,0,utRho03
tdcR,6534380,6534760,6534380,380,0,utRho03
tdk,2586986,2587054,2586986,68,44,utRho03
tehA,3001072,3001146,3001072,74,0,utRho03
tesA,1039898,1039898,1039530,368,238,utRho03
tesB,950402,950402,950322,80,16,utRho03
tfaE,2418532,2418532,2418238,294,0,utRho03
tfaQ,3269912,3269912,3269770,142,26,utRho03
tff,379424,379256,379424,168,22,utRho03
tgt,852110,852274,852110,164,60,utRho03
thiD,4369346,4369346,4369032,314,32,utRho03
thiI,882936,883098,882936,162,324,utRho03
thiM,4370902,4370902,4370602,300,452,utRho03
thiQ,146170,146170,145854,316,416,utRho03
thrL,592,760,592,168,1244,utRho03
thrS,7210932,7210932,7210280,652,4116,utRho03
thrU,8350762,8350776,8350762,14,0,utRho03
thrV,6847414,6847414,6847310,104,73028,utRho03
thrW,525682,525742,525682,60,792,utRho03
thyA,5930696,5930696,5930310,386,2796,utRho03
tig,909986,910266,909986,280,372,utRho03
tisB,7706674,7707106,7706674,432,606,utRho03
tktA,6163414,6163414,6163270,144,52,utRho03
tktB,5158616,5159272,5158616,656,390,utRho03
tldD,6784368,6784368,6784056,312,14,utRho03
tmcA,5191876,5191876,5191718,158,0,utRho03
tnaC,15553644,15553740,15553644,96,332,utRho03
tolB,1555074,1555480,1555074,406,648,utRho03
tolC,6356008,6356230,6356008,222,558,utRho03
tomB,961588,961588,961416,172,7792,utRho03
tonB,2622108,2622178,2622108,70,0,utRho03
topA,2661578,2662096,2661578,518,1556,utRho03
torC,2116112,2116168,2116112,56,104,utRho03
torR,2115968,2115968,2115908,60,6,utRho03
torS,2112364,2112364,2112356,8,0,utRho03
torT,2112414,2112522,2112414,108,0,utRho03
tpiA,8223138,8223138,8223014,124,64,utRho03
tppB,3425342,3425538,3425342,196,4950,utRho03
tpr,2574376,2574376,2574376,0,0,utRho03
tpx,2777688,2777688,2777622,66,820,utRho03
tqsA,3347780,3347826,3347780,46,0,utRho03
treA,2494850,2494850,2494752,98,148,utRho03
treB,8932420,8932420,8932360,60,46,utRho03
treF,7339102,7339184,7339102,82,100,utRho03
treR,8934694,8934694,8934492,202,0,utRho03
trg,2984878,2984940,2984878,62,34,utRho03
trkG,2847342,2847564,2847342,222,0,utRho03
trmA,8326590,8326590,8326540,50,142,utRho03
trpA,2634678,2634678,2634444,234,692,utRho03
trpC,2639888,2639888,2639570,318,176,utRho03
trpL,5292432,5292432,5292328,104,0,utRho03
trpR,9265408,9265520,9265408,112,156,utRho03
trpS,7027394,7027394,7027276,118,1080,utRho03
trpT,7893560,7893914,7893560,354,50300,utRho03
trxA,7931294,7931522,7931294,228,814,utRho03
trxB,1864156,1864156,1864100,56,128,utRho03
trxC,5437350,5437470,5437350,120,324,utRho03
tsaD,6421256,6421256,6421086,170,112,utRho03
tsgA,6985038,6985136,6985038,98,62,utRho03
tsr,9182824,9183314,9182824,490,262,utRho03
tsx,864490,864490,864026,464,716,utRho03
ttcA,2823970,2823970,2823896,74,2994,utRho03
ttdA,6412848,6412926,6412848,78,0,utRho03
ttdR,6412760,6412760,6412512,248,0,utRho03
tufA,6943448,6943448,6942658,790,123496,utRho03
tus,3368346,3368518,3368346,172,90,utRho03
tusA,7218040,7218040,7217992,48,126,utRho03
tusB,6950218,6950218,6949930,288,1080,utRho03
tynA,2902996,2902996,2902698,298,0,utRho03
typA,8116460,8116814,8116460,354,8048,utRho03
tyrB,8534164,8534228,8534164,64,1722,utRho03
tyrP,3979004,3979362,3979004,358,68,utRho03
tyrR,2773384,2773440,2773384,56,58,utRho03
tyrS,3434566,3434566,3434444,122,0,utRho03
tyrT,2575330,2575330,2575244,86,42,utRho03
uacT,6062378,6062734,6062378,356,44,utRho03
ubiC,8504886,8505012,8504886,126,72,utRho03
ubiD,8049618,8049976,8049618,358,1640,utRho03
ubiE,8037494,8037710,8037494,216,104,utRho03
ubiG,4679078,4679134,4679078,56,0,utRho03
ucpA,5089342,5089342,5089246,96,0,utRho03
udp,8032782,8032862,8032782,80,72,utRho03
ugd,4199470,4199470,4199226,244,0,utRho03
ugpB,7184852,7184852,7184650,202,204,utRho03
ugpQ,7176600,7176600,7176226,374,36,utRho03
uhpT,7694396,7694396,7694334,62,58,utRho03
uidA,3392304,3392304,3392142,162,0,utRho03
uidC,3386012,3386012,3385702,310,0,utRho03
uidR,3394150,3394150,3394104,46,46,utRho03
ulaA,8839854,8839960,8839854,106,118,utRho03
ulaG,8839350,8839350,8839250,100,0,utRho03
ulaR,8837124,8837124,8836906,218,34,utRho03
umpG,5741372,5741372,5740548,824,34,utRho03
umpH,1400704,1400704,1400652,52,28,utRho03
umuD,2461476,2461534,2461476,58,0,utRho03
ung,5433476,5433508,5433476,32,18,utRho03
uof,2843316,2843316,2842900,416,8496,utRho03
upp,5241818,5241818,5241744,74,186,utRho03
usg,4873780,4873780,4873298,482,96,utRho03
ushA,1009772,1009828,1009772,56,0,utRho03
uspA,7279966,7280222,7279966,256,1070,utRho03
uspB,7279696,7279696,7279440,256,1088,utRho03
uspC,3959172,3959506,3959172,334,0,utRho03
uspE,2797318,2797318,2797244,74,18,utRho03
uspF,2871282,2871282,2871238,44,68,utRho03
uspG,1283806,1283806,1283734,72,504,utRho03
uvrA,8547872,8547872,8547742,130,232,utRho03
uvrB,1626304,1627052,1626304,748,1286,utRho03
uvrC,3989758,3989758,3989412,346,76,utRho03
uvrD,7995814,7995966,7995814,152,228,utRho03
uvrY,3990812,3990812,3990718,94,54,utRho03
uxaB,3221474,3221474,3221360,114,0,utRho03
uxaC,6489714,6489714,6489482,232,6,utRho03
uxuA,9103036,9103272,9103036,236,34,utRho03
uxuR,9108916,9109152,9108916,236,40,utRho03
valS,8967854,8967854,8967674,180,614,utRho03
valU,5041848,5041862,5041848,14,0,utRho03
valV,3492830,3492870,3492830,40,0,utRho03
ves,3649968,3649968,3649874,94,26,utRho03
waaA,7616512,7617080,7616512,568,686,utRho03
waaH,7580298,7580298,7580162,136,0,utRho03
waaQ,7616476,7616476,7616196,280,134,utRho03
waaU,7598996,7598996,7598624,372,278,utRho03
waaY,7602272,7602272,7601930,342,7462,utRho03
wbbH,4214888,4214888,4214452,436,9902,utRho03
wbbK,4209212,4209212,4209018,194,394,utRho03
wcaM,4231868,4231868,4231792,76,0,utRho03
wrbA,2135516,2135516,2135416,100,0,utRho03
wza,4275166,4275166,4274486,680,0,utRho03
wzxC,4240674,4240674,4240316,358,0,utRho03
wzzB,4196950,4196950,4196602,348,192,utRho03
xanP,7657642,7657890,7657642,248,30,utRho03
xanQ,6048520,6048702,6048520,182,0,utRho03
xapA,5049820,5049820,5049756,64,0,utRho03
xapR,10090252,10090252,10089908,344,0,utRho03
xdhA,6000514,6000690,6000514,176,74,utRho03
xerD,6079702,6079702,6079486,216,204,utRho03
xseA,5268394,5268464,5268394,70,512,utRho03
xseB,882746,882746,882686,60,310,utRho03
xthA,3664798,3664856,3664798,58,0,utRho03
xylA,7461614,7461614,7461530,84,142,utRho03
xylE,8484540,8484540,8484508,32,0,utRho03
xylF,7462138,7462262,7462138,124,0,utRho03
xylR,7469812,7469958,7469812,146,0,utRho03
yaaA,13230,13230,12918,312,158,utRho03
yaaI,23876,23876,23572,304,92,utRho03
yaaJ,16034,16034,15918,116,178,utRho03
yaaU,91184,91614,91184,430,0,utRho03
yaaW,23084,23084,22712,372,0,utRho03
yaaX,10060,10468,10060,408,250,utRho03
yabI,142542,142702,142542,160,4,utRho03
yacC,273880,273880,273834,46,3446,utRho03
yacH,262932,262932,262520,412,124,utRho03
yacL,268678,268776,268678,98,44,utRho03
yadD,293796,293936,293796,140,0,utRho03
yadE,289930,290162,289930,232,432,utRho03
yadN,314110,314110,313766,344,52,utRho03
yadS,355572,355572,355248,324,250,utRho03
yadV,312470,312470,312402,68,0,utRho03
yaeF,434270,434270,434006,264,18,utRho03
yaeP,428374,428374,428250,124,46,utRho03
yaeQ,428176,428582,428176,406,148,utRho03
yaeR,423716,423754,423716,38,0,utRho03
yafC,462166,462166,461762,404,202,utRho03
yafD,462128,462244,462128,116,106,utRho03
yafK,491986,491986,491610,376,2764,utRho03
yafL,493282,493424,493282,142,72,utRho03
yafN,503938,504010,503938,72,14,utRho03
yafS,469568,469632,469568,64,332,utRho03
yafT,474470,474670,474470,200,8,utRho03
yafV,480432,480432,480378,54,22,utRho03
yafZ,536052,536052,536010,42,6,utRho03
yagE,564446,564556,564446,110,0,utRho03
yagG,570414,570790,570414,376,0,utRho03
yagI,578384,578384,578324,60,24,utRho03
yagK,586236,586236,585896,340,38,utRho03
yagL,588062,588062,587836,226,2,utRho03
yagN,591342,591342,591158,184,1596,utRho03
yahA,663746,664742,663746,996,330,utRho03
yahC,670136,670136,670044,92,24,utRho03
yahE,671478,671850,671478,372,20,utRho03
yahM,690504,690808,690504,304,72,utRho03
yahN,692872,692872,692674,198,8,utRho03
yahO,692864,692968,692864,104,2,utRho03
yaiE,816296,816354,816296,58,22,utRho03
yaiI,811396,811528,811396,132,0,utRho03
yaiO,761946,761946,761684,262,0,utRho03
yaiP,767970,767970,767870,100,0,utRho03
yaiS,769660,769660,769232,428,20,utRho03
yaiV,788922,788922,788922,0,0,utRho03
yaiY,799094,799094,798666,428,300,utRho03
yaiZ,798888,799186,798888,298,850,utRho03
yajC,854410,854574,854410,164,1426,utRho03
yajD,860938,861210,860938,272,690,utRho03
yajI,866068,866068,865702,366,256,utRho03
yajL,887496,887496,887282,214,168,utRho03
yajQ,889316,889366,889316,50,36,utRho03
yajR,893374,893374,893332,42,328,utRho03
ybaB,987418,988152,987418,734,2878,utRho03
ybaL,1006590,1006590,1006476,114,72,utRho03
ybaM,980648,980648,980542,106,756,utRho03
ybaN,981436,981764,981436,328,396,utRho03
ybaO,936704,936766,936704,62,0,utRho03
ybaP,1016568,1016568,1016160,408,954,utRho03
ybaQ,1016348,1016436,1016348,88,78,utRho03
ybaS,1023146,1023282,1023146,136,26,utRho03
ybaV,927504,927874,927504,370,40,utRho03
ybaY,950490,950758,950490,268,148,utRho03
ybbB,1062724,1062724,1062452,272,0,utRho03
ybbJ,1030154,1030154,1029718,436,316,utRho03
ybbL,1031784,1031838,1031784,54,0,utRho03
ybbN,1037136,1037136,1036558,578,936,utRho03
ybbO,1038658,1038658,1038298,360,1014,utRho03
ybbY,1080718,1081130,1080718,412,44,utRho03
ybcH,1176140,1176140,1175962,178,44,utRho03
ybcI,1113264,1113264,1113106,158,844,utRho03
ybcJ,1114050,1114050,1113746,304,192,utRho03
ybcK,1137502,1137804,1137502,302,28,utRho03
ybcL,1141690,1141786,1141690,96,0,utRho03
ybcN,1144628,1144932,1144628,304,0,utRho03
ybcQ,1147548,1147912,1147548,364,2,utRho03
ybcW,1159610,1159760,1159610,150,0,utRho03
ybdD,1263982,1264364,1263982,382,64,utRho03
ybdF,1212106,1212106,1211772,334,72,utRho03
ybdH,1267048,1267048,1266954,94,36,utRho03
ybdJ,1212822,1212822,1212398,424,0,utRho03
ybdK,1215122,1215122,1214766,356,270,utRho03
ybdL,1267114,1267172,1267114,58,0,utRho03
ybdM,1271110,1271110,1270752,358,24,utRho03
ybdN,1273372,1273372,1273138,234,0,utRho03
ybdR,1283844,1284176,1283844,332,636,utRho03
ybeD,1325412,1325412,1325284,128,210,utRho03
ybeF,1323090,1323090,1322756,334,282,utRho03
ybeL,1349986,1350036,1349986,50,58,utRho03
ybeQ,1353412,1353412,1353094,318,0,utRho03
ybeR,1353120,1353422,1353120,302,0,utRho03
ybeT,1358832,1358832,1358812,20,0,utRho03
ybeU,1358924,1359016,1358924,92,4,utRho03
ybeZ,1386938,1386938,1386834,104,2600,utRho03
ybfA,1458074,1458268,1458074,194,78,utRho03
ybfE,1423878,1423878,1423796,82,228,utRho03
ybfF,1425692,1425692,1425604,88,670,utRho03
ybfH,1433282,1433282,1433194,88,0,utRho03
ybgA,1477840,1478002,1477840,162,4,utRho03
ybgC,1549288,1549504,1549288,216,28,utRho03
ybgD,1505916,1505916,1505590,326,452,utRho03
ybgI,1485238,1485654,1485238,416,0,utRho03
ybgO,1498370,1498370,1497964,406,24,utRho03
ybgS,1570992,1570992,1570634,358,0,utRho03
ybhA,1597184,1597184,1596862,322,78,utRho03
ybhB,1616070,1616070,1615818,252,100,utRho03
ybhC,1614642,1614642,1614562,80,592,utRho03
ybhD,1601418,1601418,1601276,142,0,utRho03
ybhH,1601104,1601518,1601104,414,0,utRho03
ybhK,1633384,1633384,1633294,90,30,utRho03
ybhM,1641556,1641586,1641556,30,0,utRho03
ybhN,1645296,1645296,1644996,300,60,utRho03
ybhQ,1649202,1649260,1649202,58,68,utRho03
ybiA,1665920,1665920,1665900,20,10,utRho03
ybiI,1676968,1676968,1676912,56,92,utRho03
ybiO,1691328,1691328,1690960,368,96,utRho03
ybiP,1705252,1705252,1705194,58,1296,utRho03
ybiS,1711572,1711572,1711488,84,426,utRho03
ybiT,1711894,1711926,1711894,32,0,utRho03
ybiU,1718212,1718212,1718122,90,34,utRho03
ybiV,1720176,1720176,1720056,120,0,utRho03
ybiW,1725566,1725566,1725212,354,32,utRho03
ybiX,1678548,1678548,1678414,134,1926,utRho03
ybjC,1781784,1781826,1781784,42,0,utRho03
ybjE,1830154,1830154,1829714,440,32,utRho03
ybjG,1767016,1767016,1766776,240,824,utRho03
ybjL,1779882,1779882,1779638,244,230,utRho03
ybjM,1779770,1780178,1779770,408,134,utRho03
ybjO,1795704,1795978,1795704,274,0,utRho03
ybjP,1809046,1809046,1808934,112,0,utRho03
ybjQ,1809034,1809186,1809034,152,0,utRho03
ybjS,1813796,1813796,1813506,290,140,utRho03
ybjX,1838206,1838206,1838168,38,40,utRho03
ycaD,1891438,1891742,1891438,304,0,utRho03
ycaI,1928210,1928640,1928210,430,216,utRho03
ycaK,1899094,1899336,1899094,242,20,utRho03
ycaL,1920264,1920528,1920264,264,12,utRho03
ycaM,1894240,1894458,1894240,218,48,utRho03
ycaR,1941284,1941346,1941284,62,1980,utRho03
ycbB,1961862,1962094,1961862,232,0,utRho03
ycbJ,1943344,1943504,1943344,160,24,utRho03
ycbK,1966046,1966150,1966046,104,208,utRho03
ycbZ,2036920,2036920,2036598,322,60,utRho03
yccA,2062886,2062886,2062836,50,390,utRho03
yccF,2048730,2048730,2048696,34,0,utRho03
yccS,2047988,2047988,2047766,222,14,utRho03
yccT,2055674,2055674,2055546,128,32,utRho03
yccX,2059960,2060128,2059960,168,242,utRho03
ycdT,2185682,2185752,2185682,70,0,utRho03
ycdU,2191266,2191686,2191266,420,0,utRho03
ycdZ,2200504,2200592,2200504,88,212,utRho03
yceA,2233544,2233614,2233544,70,156,utRho03
yceD,2293298,2293588,2293298,290,4474,utRho03
yceF,2293522,2293522,2293190,332,2630,utRho03
yceH,2252154,2252314,2252154,160,346,utRho03
yceI,2237282,2237282,2236952,330,138,utRho03
yceJ,2238142,2238142,2238092,50,14,utRho03
yceM,2253208,2253612,2253208,404,52,utRho03
yceO,2239264,2239264,2238894,370,378,utRho03
yceQ,2288760,2289004,2288760,244,9190,utRho03
ycfD,2376540,2376540,2376480,60,352,utRho03
ycfJ,2334814,2335198,2334814,384,790,utRho03
ycfS,2340834,2340834,2340748,86,32,utRho03
ycfT,2350658,2350658,2350330,328,24,utRho03
ycfZ,2362760,2362760,2362534,226,434,utRho03
ycgB,2474570,2474570,2474482,88,26,utRho03
ycgG,2434614,2434656,2434614,42,0,utRho03
ycgJ,2452956,2453200,2452956,244,30,utRho03
ycgL,2455218,2455362,2455218,144,0,utRho03
ycgN,2457366,2457660,2457366,294,44,utRho03
ycgR,2489112,2489112,2489054,58,28,utRho03
ycgV,2512222,2512222,2511904,318,112,utRho03
ycgX,2426568,2426568,2426214,354,20606,utRho03
ycgY,2490166,2490320,2490166,154,0,utRho03
ycgZ,2431504,2431578,2431504,74,0,utRho03
ychE,2596904,2597196,2596904,292,12,utRho03
ychF,2515764,2515764,2515624,140,0,utRho03
ychH,2517476,2517582,2517476,106,568,utRho03
ychJ,2578354,2578354,2578264,90,60,utRho03
ychN,2547310,2547310,2547198,112,126,utRho03
ychO,2547520,2547850,2547520,330,264,utRho03
ychQ,2533798,2533848,2533798,50,136,utRho03
yciA,2624828,2624828,2624492,336,348,utRho03
yciB,2626110,2626110,2625780,330,3862,utRho03
yciC,2627396,2627396,2627326,70,0,utRho03
yciE,2630794,2630794,2630448,346,4,utRho03
yciG,5264368,5264368,5264140,228,0,utRho03
yciI,2621784,2621784,2621730,54,48,utRho03
yciN,2661606,2661606,2661336,270,38,utRho03
yciS,2680270,2680486,2680270,216,20,utRho03
yciT,2689088,2689088,2688692,396,538,utRho03
yciU,2614718,2614718,2614300,418,3990,utRho03
yciV,2646376,2646440,2646376,64,0,utRho03
yciW,2700472,2700472,2700214,258,538,utRho03
yciZ,2689276,2689276,2689218,58,388,utRho03
ycjD,2703792,2703792,2703520,272,74,utRho03
ycjG,2777748,2777860,2777748,112,160,utRho03
ycjM,2740006,2740432,2740006,426,12,utRho03
ycjW,2767982,2767982,2767922,60,42,utRho03
ycjX,2768138,2768234,2768138,96,0,utRho03
ycjY,5568288,5568288,5567460,828,164,utRho03
ydaE,2836438,2836438,2836016,422,0,utRho03
ydaN,2816048,2816100,2816048,52,0,utRho03
ydaS,2840340,2840730,2840340,390,240,utRho03
ydbC,2948376,2948442,2948376,66,0,utRho03
ydbD,2950132,2950288,2950132,156,14,utRho03
ydbH,2885800,2886102,2885800,302,2,utRho03
ydbJ,2881712,2882116,2881712,404,132,utRho03
ydbK,2881692,2881692,2881568,124,34,utRho03
ydcA,2983294,2983354,2983294,60,10,utRho03
ydcF,2974404,2974470,2974404,66,38,utRho03
ydcI,2990268,2990268,2990142,126,16,utRho03
ydcJ,2990266,2990576,2990266,310,2,utRho03
ydcK,3001280,3001280,3000898,382,0,utRho03
ydcL,3004646,3004914,3004646,268,0,utRho03
ydcN,3012308,3012344,3012308,36,6,utRho03
ydcP,3013508,3013562,3013508,54,68,utRho03
ydcR,3019956,3020006,3019956,50,0,utRho03
ydcS,3022906,3023308,3022906,402,8,utRho03
ydcX,3034442,3034778,3034442,336,332,utRho03
ydcY,3035220,3035296,3035220,76,150,utRho03
ydcZ,3036750,3036750,3036662,88,138,utRho03
yddB,3155332,3155332,3155238,94,20,utRho03
yddE,3071738,3071738,3071716,22,0,utRho03
yddG,3094410,3094410,3094338,72,0,utRho03
yddJ,3089732,3089732,3089438,294,0,utRho03
yddW,3137704,3137704,3137646,58,2,utRho03
ydeA,3233910,3234056,3233910,146,244,utRho03
ydeE,3242528,3242664,3242528,136,0,utRho03
ydeI,3249118,3249118,3248994,124,0,utRho03
ydeJ,3249376,3249546,3249376,170,0,utRho03
ydeN,3165458,3165458,3165048,410,0,utRho03
ydeP,3173328,3173328,3172972,356,0,utRho03
ydeR,3176596,3176596,3176592,4,0,utRho03
ydfA,3296872,3297016,3296872,144,68,utRho03
ydfG,3254982,3255034,3254982,52,0,utRho03
ydfH,3256652,3256704,3256652,52,42,utRho03
ydfK,3265446,3266144,3265446,698,55892,utRho03
ydgA,3379588,3379704,3379588,116,24,utRho03
ydgC,3364124,3364124,3364060,64,70,utRho03
ydgD,3343906,3343920,3343906,14,84,utRho03
ydgH,3356754,3356854,3356754,100,26,utRho03
ydgJ,3408798,3408798,3408616,182,132,utRho03
ydgK,3410414,3410500,3410414,86,102,utRho03
ydhB,3479618,3479618,3479596,22,0,utRho03
ydhC,3479698,3479822,3479698,124,6,utRho03
ydhF,3451310,3451310,3451264,46,24,utRho03
ydhI,3441996,3442050,3441996,54,0,utRho03
ydhL,3451864,3451864,3451840,24,0,utRho03
ydhQ,3492404,3492404,3492254,150,6,utRho03
ydhS,3494136,3494262,3494136,126,340,utRho03
ydhT,3499138,3499138,3499118,20,0,utRho03
ydhY,3509284,3509284,3508954,330,0,utRho03
ydhZ,3510418,3510418,3510282,136,0,utRho03
ydiE,3579206,3579226,3579206,20,36,utRho03
ydiH,3530582,3530582,3530406,176,16,utRho03
ydiM,3541852,3542142,3541852,290,0,utRho03
ydiN,3544818,3545024,3544818,206,0,utRho03
ydiP,3558656,3558656,3558602,54,0,utRho03
ydiU,3582508,3582508,3582488,20,76,utRho03
ydiV,3584174,3584174,3584040,134,146,utRho03
ydiY,3612500,3612500,3612166,334,42,utRho03
ydjA,3697400,3697400,3697352,48,0,utRho03
ydjE,3708082,3708082,3707958,124,0,utRho03
ydjF,3709848,3709848,3709708,140,0,utRho03
ydjM,3620340,3620422,3620340,82,0,utRho03
ydjO,3626696,3626696,3626288,408,0,utRho03
ydjX,3666434,3666802,3666434,368,1248,utRho03
yeaE,3731448,3731448,3731272,176,92,utRho03
yeaG,3733530,3733816,3733530,286,0,utRho03
yeaI,3740486,3740770,3740486,284,0,utRho03
yeaJ,3743874,3744082,3743874,208,58,utRho03
yeaL,3748646,3748704,3748646,58,484,utRho03
yeaM,3751296,3751296,3751152,144,0,utRho03
yeaN,3750926,3751346,3750926,420,0,utRho03
yeaO,3753554,3753818,3753554,264,124,utRho03
yeaP,3755314,3755430,3755314,116,1084,utRho03
yeaQ,3758780,3758780,3758510,270,118,utRho03
yeaR,3759988,3759988,3759896,92,16,utRho03
yeaY,3781122,3781122,3781064,58,136,utRho03
yebB,3892220,3892502,3892220,282,0,utRho03
yebC,3896370,3896370,3896302,68,24,utRho03
yebE,3859464,3859464,3859414,50,478,utRho03
yebG,3861530,3861530,3861494,36,40,utRho03
yebK,3873180,3873304,3873180,124,12,utRho03
yebQ,3820314,3820552,3820314,238,34,utRho03
yebS,3832238,3832516,3832238,278,78,utRho03
yebV,3843430,3843560,3843430,130,0,utRho03
yebW,3843914,3844242,3843914,328,1402,utRho03
yecC,3995646,3995646,3995628,18,0,utRho03
yecD,3901272,3901664,3901272,392,64,utRho03
yecF,3991434,3991636,3991434,202,160,utRho03
yecH,3979304,3979304,3978980,324,148,utRho03
yecJ,3975604,3975604,3975516,88,12,utRho03
yecM,3919968,3919968,3919692,276,20,utRho03
yecR,3976400,3976444,3976400,44,96,utRho03
yecT,3923862,3923944,3923862,82,100,utRho03
yedD,4016522,4016522,4016180,342,34,utRho03
yedE,4016310,4016554,4016310,244,40,utRho03
yedI,4058922,4058922,4058732,190,0,utRho03
yedJ,4066446,4066446,4066158,288,56,utRho03
yedV,4076404,4076404,4076304,100,34,utRho03
yedX,4077680,4077912,4077680,232,0,utRho03
yedY,4078572,4078956,4078572,384,0,utRho03
yeeA,4161322,4161322,4161182,140,76,utRho03
yeeE,4171104,4171104,4171050,54,0,utRho03
yeeJ,4089526,4089822,4089526,296,536,utRho03
yeeN,4113508,4113716,4113508,208,16,utRho03
yeeO,4119444,4119444,4119692,248,0,utRho03
yeeX,4158834,4158834,4158722,112,150,utRho03
yeeZ,4178422,4178422,4178256,166,16,utRho03
yefM,4179466,4179466,4179426,40,96,utRho03
yegD,4295288,4295348,4295288,60,92,utRho03
yegH,4275726,4275804,4275726,78,22,utRho03
yegI,4302154,4302154,4301970,184,26,utRho03
yegJ,4302032,4302370,4302032,338,0,utRho03
yegQ,4331182,4331336,4331182,154,34,utRho03
yegR,4336698,4336698,4336612,86,0,utRho03
yegS,4337086,4337424,4337086,338,0,utRho03
yegT,4357562,4357642,4357562,80,0,utRho03
yegX,4367640,4367640,4367302,338,32,utRho03
yehA,4376944,4376944,4376828,116,0,utRho03
yehE,4385818,4385818,4385592,226,44,utRho03
yehK,4407568,4407944,4407568,376,0,utRho03
yehL,4408804,4409192,4408804,388,0,utRho03
yeiB,4486146,4486146,4485934,212,76,utRho03
yeiE,4499422,4499422,4499236,186,0,utRho03
yeiG,4487776,4487820,4487776,44,372,utRho03
yeiH,4499332,4499434,4499332,102,6,utRho03
yeiI,4503306,4503400,4503306,94,124,utRho03
yeiL,4510580,4510710,4510580,130,0,utRho03
yeiP,4530834,4530900,4530834,66,500,utRho03
yeiQ,4532328,4532490,4532328,162,46,utRho03
yeiR,4535484,4535658,4535484,174,26,utRho03
yeiW,4530840,4530840,4530590,250,560,utRho03
yejA,4544624,4544728,4544624,104,120,utRho03
yejG,4556892,4556892,4556474,418,4448,utRho03
yejH,4561244,4561264,4561244,20,0,utRho03
yejK,4568218,4568218,4567894,324,196,utRho03
yejO,4578352,4578352,4577800,552,110,utRho03
yfaD,4713380,4713808,4713380,428,418,utRho03
yfaE,4696676,4697028,4696676,352,1842,utRho03
yfaL,4688568,4688568,4688338,230,0,utRho03
yfaP,4656398,4656398,4656286,112,0,utRho03
yfaU,4717892,4717892,4717690,202,0,utRho03
yfaY,4727310,4727310,4727266,44,14,utRho03
yfaZ,4728744,4728744,4728550,194,66,utRho03
yfbK,4771810,4771810,4771444,366,10,utRho03
yfbL,4771500,4771720,4771500,220,8,utRho03
yfbN,4777174,4777174,4776852,322,0,utRho03
yfbO,4776916,4777162,4776916,246,0,utRho03
yfbP,4777990,4778232,4777990,242,488,utRho03
yfbR,4817662,4817724,4817662,62,18,utRho03
yfcI,4847424,4847424,4847078,346,54,utRho03
yfcJ,4880482,4880482,4880240,242,182,utRho03
yfcL,4888502,4888502,4888338,164,54,utRho03
yfcV,4911642,4911642,4911292,350,14,utRho03
yfcZ,4921958,4921958,4921868,90,28,utRho03
yfdF,4925604,4926024,4925604,420,754,utRho03
yfdG,4935474,4935710,4935474,236,0,utRho03
yfdP,4946844,4947040,4946844,196,0,utRho03
yfdX,4988866,4988866,4988804,62,0,utRho03
yfdY,4990672,4990672,4990584,88,0,utRho03
yfeA,5035784,5035784,5035664,120,39278,utRho03
yfeC,5036668,5036934,5036668,266,272,utRho03
yfeH,5053818,5053892,5053818,74,2,utRho03
yfeK,5074630,5074684,5074630,54,0,utRho03
yfeO,5018906,5019260,5018906,354,234,utRho03
yfeR,5054078,5054078,5053712,366,6,utRho03
yfeX,5101356,5101356,5101090,266,14,utRho03
yfeY,5102486,5102486,5102432,54,0,utRho03
yfeZ,5103842,5103842,5103452,390,36,utRho03
yffO,5123804,5124222,5123804,418,16,utRho03
yffQ,5126778,5127154,5126778,376,20,utRho03
yffS,5128800,5128986,5128800,186,48,utRho03
yfgC,5232052,5232188,5232052,136,88,utRho03
yfgF,5258062,5258062,5257876,186,0,utRho03
yfgG,5258170,5258580,5258170,410,126,utRho03
yfgH,5259344,5259584,5259344,240,0,utRho03
yfgM,5278866,5278866,5278566,300,574,utRho03
yfhH,5397414,5397518,5397414,104,0,utRho03
yfhM,5304648,5304648,5304574,74,28,utRho03
yfhR,5328408,5328726,5328408,318,4222,utRho03
yfiC,5425610,5425610,5425528,82,0,utRho03
yfiE,5430688,5430688,5430640,48,0,utRho03
yfiL,5482630,5482720,5482630,90,0,utRho03
yfiM,5448066,5448358,5448066,292,20484,utRho03
yfiR,5483354,5483750,5483354,396,188,utRho03
yfjH,5517326,5517326,5517200,126,0,utRho03
yfjI,5517710,5517970,5517710,260,0,utRho03
yfjJ,5521014,5521094,5521014,80,46,utRho03
yfjM,5531970,5531970,5531552,418,1022,utRho03
yfjP,5535080,5535420,5535080,340,288,utRho03
yfjW,5546570,5546636,5546570,66,8,utRho03
yfjX,5551776,5551838,5551776,62,0,utRho03
ygaC,5601180,5601180,5599988,1192,794,utRho03
ygaM,5600242,5600292,5600242,50,122,utRho03
ygaU,5593628,5593628,5593572,56,6,utRho03
ygaZ,5619190,5619234,5619190,44,1100,utRho03
ygbA,5713656,5713656,5713612,44,0,utRho03
ygbE,5746784,5746784,5746674,110,78,utRho03
ygbI,5722882,5722882,5722528,354,0,utRho03
ygbK,5724394,5724670,5724394,276,40,utRho03
ygbL,5727074,5727186,5727074,112,0,utRho03
ygbN,5729814,5730202,5729814,388,42,utRho03
ygcG,5811210,5811422,5811210,212,0,utRho03
ygcN,5785144,5785314,5785144,170,54,utRho03
ygcU,5799214,5799214,5798836,378,44,utRho03
ygcW,5800942,5800942,5800546,396,0,utRho03
ygdD,5883442,5883442,5883262,180,84,utRho03
ygdG,5861746,5861930,5861746,184,470,utRho03
ygdI,5886526,5886526,5886290,236,40,utRho03
ygdQ,5940784,5940840,5940784,56,26,utRho03
ygdR,5942494,5942542,5942494,48,52,utRho03
ygeA,5961606,5961606,5961270,336,0,utRho03
ygeH,5983758,5984188,5983758,430,4,utRho03
ygeI,5987162,5987276,5987162,114,2,utRho03
ygeR,6000078,6000078,5999782,296,122,utRho03
ygeV,6011694,6011694,6011572,122,0,utRho03
ygeW,6012234,6012524,6012234,290,0,utRho03
ygfB,6110946,6110946,6110888,58,90,utRho03
ygfK,6031984,6032120,6031984,136,12,utRho03
ygfS,6058328,6058328,6058024,304,26,utRho03
ygfZ,6082564,6082626,6082564,62,82,utRho03
yggC,6149512,6149512,6149378,134,88,utRho03
yggE,6136370,6136370,6136160,210,0,utRho03
yggI,6179176,6179510,6179176,334,36,utRho03
yggL,6204508,6204508,6204266,242,74,utRho03
yggM,6199514,6199514,6199130,384,146,utRho03
yggN,6203596,6203596,6203246,350,0,utRho03
yggX,18623958,18624558,18623958,600,810,utRho03
yghA,6298966,6299324,6298966,358,22,utRho03
yghB,6307058,6307126,6307058,68,100,utRho03
yghD,6222614,6222614,6222252,362,100,utRho03
yghF,6225798,6225798,6225840,42,0,utRho03
yghJ,6238640,6238640,6238224,416,0,utRho03
yghQ,6265186,6265186,6264816,370,0,utRho03
yghT,6267830,6268262,6267830,432,0,utRho03
yghU,6277400,6277454,6277400,54,52,utRho03
yghW,6293506,6293506,6293474,32,12,utRho03
yghZ,6295562,6295794,6295562,232,0,utRho03
ygiD,6365122,6365122,6364868,254,548,utRho03
ygiH,6409066,6409388,6409066,322,4,utRho03
ygiL,6370622,6370828,6370622,206,0,utRho03
ygiM,6402084,6402414,6402084,330,46,utRho03
ygiN,6346156,6346284,6346156,128,982,utRho03
ygiQ,6322620,6322620,6322292,328,378,utRho03
ygiS,6335462,6335462,6335436,26,0,utRho03
ygiV,6338582,6338582,6338462,120,24,utRho03
ygiW,6339774,6339774,6339352,422,58,utRho03
ygiZ,6344506,6344506,6344422,84,0,utRho03
ygjH,6442528,6442528,6442494,34,32,utRho03
ygjI,6452140,6452468,6452140,328,0,utRho03
ygjQ,6472730,6473080,6472730,350,344,utRho03
ygjR,6474564,6474586,6474564,22,0,utRho03
ygjV,6483638,6483638,6483488,150,0,utRho03
yhaB,6535632,6535708,6535632,76,0,utRho03
yhaH,6504498,6504608,6504498,110,28,utRho03
yhaI,6505400,6505822,6505400,422,0,utRho03
yhaJ,6508560,6508560,6508428,132,64,utRho03
yhaK,6508538,6508638,6508538,100,54,utRho03
yhbQ,6599878,6599932,6599878,54,108,utRho03
yhbT,6602736,6602736,6602552,184,70,utRho03
yhbU,6602558,6602970,6602558,412,106,utRho03
yhbX,6643302,6643302,6643226,76,8,utRho03
yhbY,6655518,6655580,6655518,62,1392,utRho03
yhcA,6723956,6724224,6723956,268,20,utRho03
yhcB,6760364,6760382,6760364,18,146,utRho03
yhcC,6708470,6708470,6708100,370,288,utRho03
yhcF,6733440,6733852,6733440,412,82,utRho03
yhcH,6739124,6739124,6738956,168,16,utRho03
yhcM,6760312,6760312,6759994,318,94,utRho03
yhcN,6770812,6771076,6770812,264,878,utRho03
yhcO,6772606,6772606,6772258,348,36,utRho03
yhdH,6806560,6806968,6806560,408,130,utRho03
yhdJ,6823234,6823306,6823234,72,8,utRho03
yhdN,6879092,6879092,6879018,74,2934,utRho03
yhdT,6814702,6814750,6814702,48,460,utRho03
yhdU,6824994,6825242,6824994,248,98,utRho03
yhdV,6836392,6836780,6836392,388,20,utRho03
yhdW,6837944,6838298,6837944,354,0,utRho03
yheO,6953082,6953082,6952880,202,1230,utRho03
yheV,6957970,6957970,6957584,386,96,utRho03
yhfA,6971902,6971902,6971636,266,108,utRho03
yhfG,6983294,6983294,6983240,54,222,utRho03
yhfL,6998622,6998896,6998622,274,8,utRho03
yhfY,7023244,7023244,7022844,400,0,utRho03
yhgA,7086294,7086334,7086294,40,0,utRho03
yhgE,7065176,7065176,7064878,298,34,utRho03
yhgF,7074352,7074770,7074352,418,1720,utRho03
yhhA,7173458,7173886,7173458,428,70,utRho03
yhhI,7248346,7248756,7248346,410,0,utRho03
yhhJ,7253696,7253696,7253606,90,0,utRho03
yhhM,7211588,7211588,7211220,368,234,utRho03
yhhN,7211150,7211502,7211150,352,190,utRho03
yhhQ,7218238,7218434,7218238,196,798,utRho03
yhhT,7223682,7223730,7223682,48,8,utRho03
yhhX,7162032,7162032,7161610,422,622,utRho03
yhhY,7162222,7162276,7162222,54,92,utRho03
yhhZ,7163516,7163726,7163516,210,0,utRho03
yhiD,7312220,7312220,7311804,416,1928,utRho03
yhiJ,7265190,7265190,7265180,10,0,utRho03
yhiM,7269270,7269682,7269270,412,314,utRho03
yhiN,7275000,7275000,7274820,180,36,utRho03
yhjA,7338522,7338522,7338376,146,16,utRho03
yhjB,7344090,7344090,7343788,302,16,utRho03
yhjC,7344272,7344684,7344272,412,0,utRho03
yhjD,7346660,7346724,7346660,64,0,utRho03
yhjE,7349274,7349572,7349274,298,106,utRho03
yhjG,7356824,7356824,7356730,94,14,utRho03
yhjH,7358458,7358458,7358374,84,30,utRho03
yhjJ,7364032,7364032,7363880,152,76,utRho03
yhjK,7371296,7371296,7371158,138,24,utRho03
yhjR,7392750,7392750,7392370,380,0,utRho03
yhjV,7400796,7401126,7400796,330,896,utRho03
yhjX,7424194,7424194,7424014,180,16,utRho03
yhjY,7425966,7425966,7425868,98,48,utRho03
yiaB,7455654,7455654,7455496,158,0,utRho03
yiaD,7432712,7433094,7432712,382,18,utRho03
yiaF,7438194,7438194,7438088,106,86,utRho03
yiaG,7438862,7438956,7438862,94,122,utRho03
yiaJ,7485236,7485236,7485064,172,0,utRho03
yiaK,7485348,7485466,7485348,118,0,utRho03
yiaT,7503924,7503924,7503736,188,0,utRho03
yiaU,7503792,7503984,7503792,192,0,utRho03
yiaY,7515856,7515856,7515654,202,92,utRho03
yibF,7523950,7523950,7523910,40,16,utRho03
yibG,7536128,7536354,7536128,226,8,utRho03
yibL,7553194,7553330,7553194,136,60,utRho03
yibN,7570112,7570112,7570030,82,306,utRho03
yibT,7552848,7552848,7552760,88,138,utRho03
yicC,7633290,7633352,7633290,62,52,utRho03
yicH,7660862,7660914,7660862,52,8,utRho03
yicJ,7673328,7673328,7671858,1470,252,utRho03
yicN,7685018,7685018,7684804,214,0,utRho03
yicO,7687914,7687914,7687578,336,18,utRho03
yicR,15250308,15250308,15250236,72,0,utRho03
yidB,7755230,7755230,7754930,300,16,utRho03
yidE,7732780,7732780,7732546,234,0,utRho03
yidF,7711580,7711580,7711222,358,66,utRho03
yidQ,7735088,7735456,7735088,368,346,utRho03
yidR,7738824,7738824,7738618,206,0,utRho03
yieE,7787658,7787738,7787658,80,326,utRho03
yieH,7793314,7793548,7793314,234,0,utRho03
yieK,7798928,7798928,7798786,142,0,utRho03
yifB,7900350,7900350,7899998,352,242,utRho03
yifL,7988984,7989044,7988984,60,196,utRho03
yigF,8005750,8005750,8005598,152,42,utRho03
yigI,8009448,8009448,8009394,54,4,utRho03
yigM,8022100,8022152,8022100,52,44,utRho03
yihA,8101970,8101970,8101458,512,132,utRho03
yihD,8084098,8084138,8084098,40,94,utRho03
yihF,8088110,8088398,8088110,288,0,utRho03
yihG,8093304,8093304,8093204,100,12,utRho03
yihI,8102616,8102694,8102616,78,0,utRho03
yihL,8120506,8120894,8120506,388,146,utRho03
yihN,8124332,8124494,8124332,162,0,utRho03
yihO,8131942,8131942,8131532,410,10,utRho03
yihQ,8138892,8138892,8138552,340,0,utRho03
yihV,8147064,8147478,8147064,414,8,utRho03
yihX,8151096,8151106,8151096,10,0,utRho03
yiiE,8158192,8158582,8158192,390,0,utRho03
yiiF,8159124,8159502,8159124,378,4,utRho03
yiiG,8173762,8174004,8173762,242,0,utRho03
yiiM,8205506,8205644,8205506,138,30,utRho03
yiiQ,8224624,8224624,8224428,196,24,utRho03
yiiS,8225738,8225934,8225738,196,32,utRho03
yijE,8272178,8272216,8272178,38,0,utRho03
yijF,8275728,8275728,8275314,414,64,utRho03
yijO,8296858,8296858,8296634,224,16,utRho03
yjaA,8426240,8426468,8426240,228,47008,utRho03
yjaB,8428312,8428312,8428246,66,528,utRho03
yjaG,8398746,8399008,8398746,262,1132,utRho03
yjaH,8401022,8401132,8401022,110,132,utRho03
yjaZ,8379506,8379572,8379506,66,66,utRho03
yjbB,8455204,8455462,8455204,258,0,utRho03
yjbE,16943432,16943624,16943432,192,12,utRho03
yjbL,8520318,8520642,8520318,324,0,utRho03
yjbQ,8540428,8540476,8540428,48,0,utRho03
yjcB,8550328,8550328,8550082,246,8074,utRho03
yjcC,8550836,8550942,8550836,106,134,utRho03
yjcD,8556628,8556958,8556628,330,214,utRho03
yjcE,8559658,8559960,8559658,302,36,utRho03
yjcF,8566212,8566212,8566150,62,0,utRho03
yjcO,8594660,8594660,8594250,410,12,utRho03
yjdA,8654128,8654270,8654128,142,14,utRho03
yjdC,8726660,8726660,8726616,44,0,utRho03
yjdK,8704780,8705168,8704780,388,20,utRho03
yjdL,8713034,8713034,8712822,212,0,utRho03
yjdM,8653672,8653672,8653468,204,20,utRho03
yjeF,8787354,8788132,8787354,778,8428,utRho03
yjeI,8745522,8745618,8745522,96,0,utRho03
yjeJ,8748806,8748806,8748468,338,40,utRho03
yjeV,8785472,8785784,8785472,312,298,utRho03
yjfP,8833512,8833904,8833512,392,16,utRho03
yjfY,8849656,8849656,8849582,74,6,utRho03
yjfZ,8855052,8855052,8854844,208,0,utRho03
yjgA,8916162,8916162,8915730,432,108,utRho03
yjgL,8950802,8950874,8950802,72,0,utRho03
yjgM,8959342,8959342,8959074,268,0,utRho03
yjgN,8959132,8959460,8959132,328,0,utRho03
yjgR,8980170,8980170,8980126,44,78,utRho03
yjgZ,9002116,9002520,9002116,404,712,utRho03
yjhB,9007764,9008116,9007764,352,52,utRho03
yjhG,9048452,9048452,9048188,264,436,utRho03
yjhU,9041080,9041080,9040648,432,278,utRho03
yjiA,9178096,9178096,9177730,366,194,utRho03
yjiJ,9125364,9125364,9125350,14,0,utRho03
yjiK,9127270,9127270,9127422,152,58,utRho03
yjiL,9129604,9129604,9129378,226,54,utRho03
yjiS,9143410,9143502,9143410,92,0,utRho03
yjiY,9182734,9182734,9182558,176,14,utRho03
yjjA,9200674,9200674,9200378,296,472,utRho03
yjjB,18408708,18408708,18407800,908,100,utRho03
yjjJ,9243314,9243538,9243314,224,44,utRho03
yjjK,9261132,9261132,9261044,88,132,utRho03
yjjL,9189764,9189764,9189444,320,0,utRho03
yjjM,9191894,9191894,9191702,192,8,utRho03
yjjP,9206068,9206068,9205716,352,62,utRho03
yjjQ,9206638,9206954,9206638,316,26,utRho03
yjjX,9267798,9267798,9267490,308,576,utRho03
yjjY,9280716,9280804,9280716,88,504,utRho03
yjjZ,9211554,9211608,9211554,54,1600,utRho03
yjtD,9281676,9281884,9281676,208,8,utRho03
ykfB,532454,532454,532174,280,240,utRho03
ykfI,527636,527636,527338,298,16,utRho03
ykgB,637050,637050,636638,412,0,utRho03
ykgC,640430,640430,640002,428,0,utRho03
ykgD,640232,640454,640232,222,4,utRho03
ykgE,642962,643216,642962,254,24,utRho03
ykgJ,608524,608524,608364,160,104,utRho03
ykgL,623878,624224,623878,346,104,utRho03
ykgM,625610,625610,625554,56,0,utRho03
ykgR,626570,626570,626484,86,0,utRho03
ylaC,958576,958576,958502,74,952,utRho03
yliE,1745938,1745958,1745938,20,0,utRho03
ymcE,2103660,2103694,2103660,34,642,utRho03
ymdA,2210450,2210828,2210450,378,8,utRho03
ymdB,2211428,2211640,2211428,212,34,utRho03
ymfD,2395322,2395322,2395064,258,332,utRho03
ymfI,2402880,2402994,2402880,114,0,utRho03
ymfJ,2404518,2404518,2404168,350,78,utRho03
ymfK,2406176,2406176,2405866,310,60,utRho03
ymfT,2405766,2406048,2405766,282,54,utRho03
ymgE,2489110,2489456,2489110,346,228,utRho03
ymgF,2437628,2437966,2437628,338,0,utRho03
ymiA,2670112,2670320,2670112,208,42,utRho03
ymjA,2715620,2715620,2715336,284,478,utRho03
ynaI,2791946,2791946,2791844,102,0,utRho03
ynaK,2850438,2850754,2850438,316,0,utRho03
ynbA,2954924,2955242,2954924,318,0,utRho03
yncD,3046552,3046552,3046130,422,146,utRho03
yncE,3046454,3046614,3046454,160,0,utRho03
yncG,3052456,3052494,3052456,38,8,utRho03
yncL,3034492,3034492,3034388,104,236,utRho03
yneE,3218364,3218364,3218044,320,2,utRho03
yneF,3223748,3223748,3223708,40,0,utRho03
yneJ,3229560,3229608,3229560,48,68,utRho03
yneK,3231100,3231526,3231100,426,0,utRho03
yneM,3245176,3245292,3245176,116,210,utRho03
ynfA,3311398,3311398,3311346,52,24,utRho03
ynfB,3311418,3311616,3311418,198,186,utRho03
ynfC,3315094,3315094,3314914,180,24,utRho03
ynfD,3314828,3315130,3314828,302,24,utRho03
ynfE,3316006,3316138,3316006,132,88,utRho03
ynfK,3334670,3334670,3334438,232,42,utRho03
ynfL,3339304,3339304,3339184,120,26,utRho03
ynfM,3339260,3339398,3339260,138,52,utRho03
ynfN,3276598,3276598,3276218,380,2094,utRho03
ynfO,3273454,3273512,3273454,58,0,utRho03
ynhG,3517890,3517890,3517450,440,688,utRho03
yniA,3615158,3615592,3615158,434,36,utRho03
yniB,3618526,3618526,3618466,60,0,utRho03
yniC,3618652,3618760,3618652,108,0,utRho03
yniD,3610202,3610330,3610202,128,24,utRho03
ynjE,3678880,3678934,3678880,54,0,utRho03
ynjF,3683222,3683222,3682806,416,4,utRho03
ynjH,3684376,3684376,3684270,106,22,utRho03
ynjI,3690022,3690022,3689742,280,18,utRho03
yoaB,3786642,3786734,3786642,92,166,utRho03
yoaC,3787932,3788146,3787932,214,224,utRho03
yoaE,3803544,3803544,3803170,374,192,utRho03
yoaF,3755444,3755444,3755064,380,1168,utRho03
yoaH,3789866,3789866,3789462,404,412,utRho03
yobB,3850418,3850880,3850418,462,662,utRho03
yobF,3815586,3815586,3815182,404,44,utRho03
yobH,3817800,3817850,3817800,50,66,utRho03
yodB,4084352,4084736,4084352,384,54,utRho03
yodC,4057008,4057008,4056740,268,42,utRho03
yohC,4451358,4451358,4451262,96,18,utRho03
yohD,4451526,4451602,4451526,76,18,utRho03
yohJ,4460986,4461248,4460986,262,28,utRho03
yohO,4431172,4431314,4431172,142,16,utRho03
yojI,4617282,4617282,4617230,52,0,utRho03
ypdI,4988988,4989396,4988988,408,0,utRho03
ypfG,5165786,5165786,5165554,232,6,utRho03
ypfM,5182140,5182140,5181732,408,56,utRho03
yphB,5349590,5349590,5349376,214,22,utRho03
ypjA,5565644,5565644,5565452,192,16,utRho03
ypjB,5569636,5569636,5568858,778,0,utRho03
ypjD,5495860,5495774,5495860,86,0,utRho03
yqaE,5594170,5594170,5594056,114,0,utRho03
yqcA,5846100,5846100,5845968,132,66,utRho03
yqcE,5800944,5801184,5800944,240,0,utRho03
yqeC,6030468,6030468,6030114,354,0,utRho03
yqeF,5971618,5971618,5971184,434,158,utRho03
yqeG,5971438,5971694,5971438,256,116,utRho03
yqeH,5975016,5975072,5975016,56,0,utRho03
yqeI,5976688,5977004,5976688,316,0,utRho03
yqeK,5981140,5981140,5980720,420,68,utRho03
yqfA,6086728,6086728,6086296,432,440,utRho03
yqgA,6219042,6219106,6219042,64,0,utRho03
yqgB,6172500,6172500,6172102,398,1298,utRho03
yqgE,6185768,6185874,6185768,106,460,utRho03
yqhA,6299150,6299150,6298942,208,22,utRho03
yqhC,6310768,6310768,6310436,332,66,utRho03
yqhD,6310604,6310710,6310604,106,16,utRho03
yqhH,6316842,6317254,6316842,412,564,utRho03
yqiC,6369662,6369680,6369662,18,92,utRho03
yqiJ,6384108,6384416,6384108,308,152,utRho03
yqjA,6495096,6495546,6495096,450,11160,utRho03
yqjF,6500932,6501124,6500932,192,104,utRho03
yqjG,6501948,6502048,6501948,100,0,utRho03
yqjH,6433078,6433078,6432982,96,90,utRho03
yqjI,6433506,6433558,6433506,52,0,utRho03
yraH,6574552,6574852,6574552,300,0,utRho03
yraP,6592144,6592818,6592144,674,334,utRho03
yraQ,6596414,6596414,6596276,138,0,utRho03
yraR,6598024,6598024,6597692,332,38,utRho03
yrbG,13360844,13361100,13360844,256,196,utRho03
yrbL,6696842,6696904,6696842,62,940,utRho03
yrbN,6616172,6616172,6615866,306,16962,utRho03
yrdB,6860176,6860176,6860046,130,272,utRho03
yrfF,7052548,7052938,7052548,390,346,utRho03
yrhB,7169440,7169518,7169440,78,14,utRho03
ysaB,7451804,7451804,7451424,380,36,utRho03
ysgA,8032686,8032686,8032338,348,94,utRho03
ytfB,8857638,8857638,8857434,204,186,utRho03
ytfE,8864018,8864018,8863966,52,0,utRho03
ytfF,8866296,8866296,8866130,166,0,utRho03
ytfH,8868164,8868226,8868164,62,4,utRho03
ytfI,8875234,8875414,8875234,180,0,utRho03
ytfJ,8878572,8878572,8878524,48,16,utRho03
ytfK,8879022,8879174,8879022,152,150,utRho03
ytfL,8882642,8882642,8882430,212,0,utRho03
ytfQ,8899634,8899924,8899634,290,72,utRho03
ytjB,9249598,9249598,9249578,20,12,utRho03
yzfA,8896588,8896588,8896490,98,32,utRho03
zapA,6111102,6111224,6111102,122,3892,utRho03
zapB,8236772,8237030,8236772,258,122,utRho03
zapC,2011700,2011904,2011700,204,102,utRho03
zinT,4082692,4082750,4082692,58,10,utRho03
zipA,5062814,5062814,5062466,348,0,utRho03
zitB,1569716,1569716,1569646,70,30,utRho03
zntA,7212844,7212902,7212844,58,14,utRho03
zntR,6878336,6878336,6878260,76,68,utRho03
znuA,3885322,3885322,3885166,156,34,utRho03
znuC,3885268,3885324,3885268,56,34,utRho03
zraP,8403424,8403424,8403376,48,18,utRho03
zraS,8403810,8403852,8403810,42,0,utRho03
zupT,6364866,6365100,6364866,234,536,utRho03
zur,8520282,8520282,8520006,276,1576,utRho03
zwf,3872752,3872752,3872628,124,86,utRho03
C0343,2818676,2818728,2818676,52,0,utRho04
aaeB,6776526,6776526,6776376,150,0,utRho04
aaeR,6778762,6779040,6778762,278,54,utRho04
aaeX,6778860,6778860,6778674,186,46,utRho04
aat,1854920,1854920,1854864,56,14,utRho04
accA,416822,417242,416822,420,1866,utRho04
accB,6810280,6810872,6810280,592,8770,utRho04
accD,4868030,4868030,4867852,178,522,utRho04
aceB,8430804,8430956,8430804,152,0,utRho04
aceE,245938,246034,245938,96,542,utRho04
ackA,4826918,4826940,4826918,22,1964,utRho04
acnA,2670848,2671662,2670848,814,496,utRho04
acnB,263038,263230,263038,192,914,utRho04
acpP,2303148,2303230,2303148,82,142,utRho04
acpS,5402324,5402324,5401996,328,124,utRho04
acrA,971396,971396,971238,158,136,utRho04
acrB,969370,969370,968806,564,1396,utRho04
acrD,5174950,5175190,5174950,240,18,utRho04
acrE,6827404,6827728,6827404,324,0,utRho04
acrR,971398,971522,971398,124,202,utRho04
acrZ,1589502,1589546,1589502,44,0,utRho04
acs,8575190,8575190,8574742,448,14,utRho04
actP,8569870,8569870,8569804,66,0,utRho04
ada,4620854,4620854,4620810,44,0,utRho04
add,3404404,3404466,3404404,62,20,utRho04
ade,7687802,7687928,7687802,126,0,utRho04
adhE,2596826,2596826,2596242,584,22,utRho04
adhP,3107988,3107988,3107676,312,790,utRho04
adiA,8681112,8681112,8681042,70,50,utRho04
adiC,8674404,8674404,8674062,342,0,utRho04
adiY,8676084,8676084,8675858,226,0,utRho04
adk,994278,994350,994278,72,20,utRho04
adrA,807374,807406,807374,32,0,utRho04
aer,6438240,6438240,6438152,88,0,utRho04
aes,1000102,1000102,999946,156,12,utRho04
agaR,6557406,6557406,6557330,76,0,utRho04
agaS,6563778,6563952,6563778,174,0,utRho04
agp,2131118,2131170,2131118,52,0,utRho04
agrA,7296126,7296126,7296126,0,0,utRho04
agrB,7296588,7296588,7296588,0,0,utRho04
ahpC,1277386,1277890,1277386,504,616,utRho04
ahpF,1278004,1279506,1278004,1502,32364,utRho04
ahr,8992698,8992698,8992418,280,0,utRho04
aidB,8828494,8828550,8828494,56,0,utRho04
ais,4731512,4731512,4731240,272,0,utRho04
alaA,4814816,4815122,4814816,306,0,utRho04
alaC,4996798,4996798,4996590,208,0,utRho04
alaE,5598140,5598328,5598140,188,112,utRho04
alaS,5644180,5644180,5644022,158,1272,utRho04
alaW,5036612,5036612,5036462,150,0,utRho04
aldA,2976380,2976464,2976380,84,16,utRho04
aldB,7513070,7513070,7513022,48,0,utRho04
alkA,4295118,4295118,4295080,38,0,utRho04
alkB,4618890,4618890,4618682,208,84,utRho04
allA,1064780,1064902,1064780,122,0,utRho04
allD,1092822,1092822,1092726,96,0,utRho04
allE,1088112,1088112,1088092,20,2,utRho04
allS,1064600,1064600,1064442,158,0,utRho04
alr,8531178,8531564,8531178,386,1448,utRho04
alsE,8617334,8617334,8616956,378,78,utRho04
alsK,8615990,8615990,8615598,392,4,utRho04
alx,6476740,6477160,6476740,420,4,utRho04
amiA,5104482,5104704,5104482,222,46,utRho04
amiC,5898378,5898378,5898020,358,0,utRho04
amn,4110062,4110122,4110062,60,0,utRho04
ampC,8758006,8758006,8757888,118,0,utRho04
ampD,237362,237466,237362,104,38,utRho04
ampG,907372,907372,907090,282,308,utRho04
ampH,792726,792726,792574,152,20,utRho04
amyA,4012230,4012312,4012230,82,46,utRho04
anmK,3439346,3439346,3439204,142,22,utRho04
ansB,6201580,6201580,6201456,124,14,utRho04
ansP,3052040,3052040,3051960,80,116,utRho04
apaG,104068,104068,103212,856,3278,utRho04
apaH,102586,102586,102444,142,3470,utRho04
apbE,4623188,4623188,4623068,120,72,utRho04
appA,2081198,2081234,2081198,36,6,utRho04
appC,2075420,2075480,2075420,60,0,utRho04
appY,1167134,1167362,1167134,228,0,utRho04
apt,982620,982824,982620,204,168,utRho04
aqpZ,1832424,1832424,1832094,330,0,utRho04
araB,140150,140150,140096,54,0,utRho04
araC,140482,140774,140482,292,104,utRho04
araE,5964416,5964416,5964364,52,0,utRho04
araF,3972476,3972476,3972256,220,0,utRho04
araH,3967120,3967120,3967086,34,0,utRho04
araJ,825058,825058,824962,96,0,utRho04
arcA,9281602,9281602,9280612,990,6772,utRho04
arcB,6706098,6706098,6706050,48,0,utRho04
arcZ,6701154,6701154,6701154,0,0,utRho04
arfA,6877346,6877346,6877298,48,610,utRho04
argA,5898312,5898484,5898312,172,0,utRho04
argC,8309770,8310002,8309770,232,0,utRho04
argD,6980442,6980442,6980360,82,0,utRho04
argE,8310156,8310156,8309694,462,0,utRho04
argF,580680,580680,580610,70,76,utRho04
argG,6637124,6637274,6637124,150,22,utRho04
argI,8956688,8956688,8956622,66,0,utRho04
argO,6137672,6137672,6137616,56,70,utRho04
argP,6119460,6119506,6119460,46,0,utRho04
argR,6769204,6769406,6769204,202,116,utRho04
argS,3920002,3920124,3920002,122,0,utRho04
argT,4855698,4855698,4855582,116,146,utRho04
argU,1129406,1129446,1129406,40,4,utRho04
argW,4932616,4932618,4932616,2,2,utRho04
argX,7964728,7964750,7964728,22,16,utRho04
aroF,5482402,5482402,5482300,102,48,utRho04
aroG,1571182,1571266,1571182,84,66,utRho04
aroH,3576636,3576870,3576636,234,256,utRho04
aroK,7038760,7038760,7038128,632,1748,utRho04
aroL,812560,812810,812560,250,136,utRho04
aroP,243342,243342,243102,240,32,utRho04
arpA,8445382,8445382,8444974,408,284,utRho04
arrS,7316108,7316108,7316108,0,0,utRho04
arsR,7297024,7297056,7297024,32,0,utRho04
artJ,1801252,1801252,1801150,102,52,utRho04
artP,1807686,1807686,1807468,218,120,utRho04
ascF,5678858,5679048,5678858,190,20,utRho04
ascG,5678574,5678574,5678528,46,0,utRho04
aslB,7965562,7965916,7965562,354,26952,utRho04
asnA,7854258,7854310,7854258,52,46,utRho04
asnB,1398444,1398444,1398354,90,478,utRho04
asnC,23562186,23562186,23562018,168,114,utRho04
asnS,1978088,1978088,1977970,118,7360,utRho04
asnT,4089082,4089098,4089082,16,6,utRho04
asnU,4119690,4119702,4119690,12,0,utRho04
asnV,4124504,4124520,4124504,16,16,utRho04
aspA,17473728,17473728,17473308,420,416,utRho04
aspC,1971486,1971486,1971418,68,242,utRho04
aspS,3901402,3901402,3901044,358,62,utRho04
aspT,7893560,7893744,7893560,184,48832,utRho04
aspV,473826,473862,473826,36,4,utRho04
asr,3342654,3342752,3342654,98,32,utRho04
astC,3664088,3664088,3663964,124,30,utRho04
astE,3654138,3654138,3653846,292,4,utRho04
atoD,4646824,4646894,4646824,70,28,utRho04
atpB,7844540,7844540,7844102,438,328,utRho04
atpC,7832118,7832118,7831944,174,1324,utRho04
atpI,7845050,7845050,7844880,170,0,utRho04
avtA,7479348,7479410,7479348,62,118,utRho04
azoR,2965982,2965982,2965720,262,138,utRho04
azuC,3976002,3976002,3975918,84,46,utRho04
bacA,6408350,6408350,6408262,88,78,utRho04
bamA,394052,395856,394052,1804,660,utRho04
bamB,5277950,5277950,5277304,646,1414,utRho04
bamC,5198028,5198028,5197730,298,550,utRho04
bamD,5471922,5472292,5471922,370,4790,utRho04
bamE,5506972,5507210,5506972,238,272,utRho04
basS,8666954,8666954,8666544,410,170,utRho04
bax,7474468,7474468,7474354,114,146,utRho04
bcp,5200874,5200956,5200874,82,824,utRho04
bcsB,7385346,7385346,7385214,132,0,utRho04
bcsE,7392644,7392916,7392644,272,0,utRho04
bdcA,8948128,8948128,8948106,22,12,utRho04
bdcR,8948192,8948248,8948192,56,0,utRho04
bdm,3112680,3112680,3112560,120,0,utRho04
betA,654522,654522,654494,28,244,utRho04
betI,658722,658722,658668,54,0,utRho04
betT,658842,658926,658842,84,36,utRho04
bfr,6933498,6933498,6933450,48,24,utRho04
bglG,23440182,23440182,23439402,780,0,utRho04
bglX,4444240,4444240,4443978,262,0,utRho04
bhsA,2337962,2338146,2337962,184,48,utRho04
bioA,1618584,1618584,1618514,70,0,utRho04
bioB,1618604,1618688,1618604,84,38,utRho04
bioH,7089716,7089716,7089688,28,0,utRho04
bisC,7433026,7433026,7432788,238,92,utRho04
blc,8755490,8755490,8755444,46,0,utRho04
blr,3409024,3409102,3409024,78,138,utRho04
bluF,2431226,2431226,2430950,276,1626,utRho04
bluR,2428226,2428226,2428118,108,0,utRho04
bolA,908698,908944,908698,246,0,utRho04
borD,1157842,1157842,1157786,56,2,utRho04
brnQ,838976,839182,838976,206,1710,utRho04
bssR,1756492,1756496,1756492,4,0,utRho04
bssS,2242116,2242116,2241910,206,254,utRho04
btuB,8326798,8327278,8326798,480,2096,utRho04
cadB,8720212,8720212,8720062,150,0,utRho04
cadC,8723926,8723926,8723868,58,0,utRho04
caiE,70998,70998,70742,256,0,utRho04
caiF,68436,68600,68436,164,88,utRho04
caiT,84074,84074,83862,212,0,utRho04
can,285406,285406,285340,66,66,utRho04
carA,59102,59302,59102,200,2,utRho04
carB,61550,61634,61550,84,100,utRho04
cas2,5757830,5757830,5757706,124,0,utRho04
casA,5768638,5768638,5768276,362,0,utRho04
cbl,4121882,4121882,4121828,54,12,utRho04
cbpA,2128074,2128074,2127550,524,84,utRho04
cbrA,7738628,7738754,7738628,126,0,utRho04
cbrB,7794958,7795012,7794958,54,12,utRho04
ccmH,4585242,4585242,4584820,422,0,utRho04
cdaR,364894,364926,364894,32,0,utRho04
cdd,4463638,4463688,4463638,50,46,utRho04
cdh,8219814,8219860,8219814,46,12,utRho04
cdsA,391110,391354,391110,244,1046,utRho04
cedA,3627484,3627484,3627326,158,0,utRho04
cfa,3482402,3482826,3482402,424,246,utRho04
chaC,2544844,2544972,2544844,128,0,utRho04
chbB,3643452,3643452,3643238,214,0,utRho04
chbG,3634624,3634624,3634270,354,0,utRho04
cheW,3946924,3946924,3946678,246,44,utRho04
chiA,6939792,6939792,6939706,86,0,utRho04
chiP,1416472,1416668,1416472,196,8,utRho04
cho,3646984,3647030,3646984,46,88,utRho04
chpS,8896804,8896894,8896804,90,6,utRho04
cirA,4493884,4493884,4493538,346,268,utRho04
citC,1304078,1304078,1303712,366,0,utRho04
citT,1293264,1293264,1293160,104,0,utRho04
clcA,350104,350214,350104,110,0,utRho04
clpA,1846160,1846528,1846160,368,54,utRho04
clpB,5468410,5468410,5468346,64,44,utRho04
clpP,913154,913354,913154,200,604,utRho04
clpS,1845500,1845826,1845500,326,6,utRho04
clpX,914404,914852,914404,448,716,utRho04
clsA,2617346,2617346,2617290,56,20,utRho04
clsC,2212584,2212710,2212584,126,184,utRho04
cmk,1922330,1922402,1922330,72,30,utRho04
cnu,3409522,3409898,3409522,376,422,utRho04
coaA,8350214,8350214,8350052,162,712,utRho04
cobC,1340092,1340092,1339814,278,462,utRho04
cobT,4129202,4129202,4128934,268,12,utRho04
cobU,4131944,4131944,4131528,416,166,utRho04
codB,709768,709844,709768,76,16,utRho04
comR,2337726,2337726,2337664,62,0,utRho04
copA,1022822,1022822,1022758,64,0,utRho04
corA,8002388,8002852,8002388,464,2896,utRho04
cpdB,8873258,8873258,8873130,128,0,utRho04
cptB,6082198,6082198,6082140,58,26,utRho04
cpxA,8210202,8210202,8209950,252,554,utRho04
cpxP,8211570,8211640,8211570,70,70,utRho04
cpxR,8211372,8211372,8211340,32,0,utRho04
cra,175894,176056,175894,162,16,utRho04
crcB,1316016,1316016,1315876,140,22,utRho04
creA,9270486,9271042,9270486,556,388,utRho04
creD,9276320,9276356,9276320,36,0,utRho04
crl,515620,515658,515620,38,782,utRho04
crp,6971906,6972240,6971906,334,3196,utRho04
crr,5070960,5071668,5070960,708,2924,utRho04
csdA,5886414,5886674,5886414,260,0,utRho04
csgB,2207718,2207902,2207718,184,0,utRho04
csgD,2206688,2206688,2206392,296,16,utRho04
csgG,2203510,2203510,2203368,142,12,utRho04
csiD,5577854,5577970,5577854,116,0,utRho04
csiE,5330802,5330870,5330802,68,34,utRho04
csiR,5590942,5591348,5590942,406,0,utRho04
cspA,7439778,7440098,7439778,320,357638,utRho04
cspB,3283430,3283430,3283108,322,612,utRho04
cspC,3815018,3815018,3814870,148,226,utRho04
cspD,1845352,1845352,1845180,172,368,utRho04
cspE,1314294,1314584,1314294,290,122,utRho04
cspF,3283380,3283710,3283380,330,38,utRho04
cspG,2102610,2102922,2102610,312,142390,utRho04
cspH,2102746,2102746,2102350,396,312,utRho04
cspI,3277624,3277624,3277334,290,106,utRho04
csrA,5638746,5638746,5638292,454,1218,utRho04
csrB,5849048,5849048,5849048,0,0,utRho04
csrC,8102072,8102072,8102072,0,0,utRho04
csrD,6806850,6806850,6806664,186,84,utRho04
cstA,1259710,1259788,1259710,78,0,utRho04
cueO,274090,274166,274090,76,0,utRho04
cueR,1027948,1027986,1027948,38,0,utRho04
curA,3037784,3038054,3037784,270,12,utRho04
cusC,1191146,1191200,1191146,54,0,utRho04
cusR,1190924,1190924,1190886,38,0,utRho04
cutA,8730784,8730784,8730712,72,144,utRho04
cutC,3918534,3918534,3917920,614,154,utRho04
cvpA,4861600,4861600,4861526,74,48,utRho04
cvrA,2484328,2484328,2484142,186,186,utRho04
cyaA,7981548,7982306,7981548,758,1428,utRho04
cyaR,4334228,4334224,4334228,4,28,utRho04
cyaY,7988166,7988166,7988118,48,66,utRho04
cybB,2981522,2981804,2981522,282,162,utRho04
cycA,8859560,8859728,8859560,168,218,utRho04
cydA,1542340,1542916,1542340,576,12,utRho04
cydC,1858800,1858800,1858390,410,108,utRho04
cydD,1862062,1862062,1861924,138,26,utRho04
cydX,1548300,1548392,1548300,92,274,utRho04
cynR,717418,717418,717380,38,0,utRho04
cynT,1435092,1435196,1435092,104,0,utRho04
cyoA,903306,903306,903220,86,1672,utRho04
cyoE,895540,895540,895410,130,498,utRho04
cysB,2667576,2667710,2667576,134,438,utRho04
cysC,5748056,5748056,5747984,72,18,utRho04
cysD,5752736,5752736,5752658,78,0,utRho04
cysE,7565362,7565362,7565124,238,198,utRho04
cysG,6995508,6995656,6995508,148,10,utRho04
cysJ,5783928,5783928,5783796,132,830,utRho04
cysK,5064688,5064818,5064688,130,16,utRho04
cysP,5087114,5087114,5087056,58,174,utRho04
cysS,1109154,1109222,1109154,68,30,utRho04
cysT,3984100,3984100,3983974,126,116,utRho04
cysZ,5062766,5062926,5062766,160,132,utRho04
cytR,8249018,8249018,8248912,106,50,utRho04
dacA,1328002,1328002,1327926,76,8,utRho04
dacB,6657714,6657926,6657714,212,0,utRho04
dacC,1761306,1761454,1761306,148,0,utRho04
dadA,2475018,2475142,2475018,124,0,utRho04
dam,7032504,7032504,7031826,678,968,utRho04
damX,7035200,7035200,7034612,588,500,utRho04
dapA,5199568,5199568,5199520,48,0,utRho04
dapB,56576,56748,56576,172,4,utRho04
dapD,371954,371954,371894,60,108,utRho04
dapE,5183120,5183214,5183120,94,132,utRho04
dcp,3254844,3254844,3254760,84,0,utRho04
dcrB,7219534,7219910,7219534,376,0,utRho04
dctA,7366996,7366996,7366894,102,620,utRho04
dcuA,8733686,8733686,8733546,140,0,utRho04
dcuB,8698182,8698182,8697488,694,0,utRho04
dcuC,1312166,1312166,1311936,230,12,utRho04
dcuD,6749166,6749738,6749166,572,48,utRho04
dcuR,8701130,8701130,8700068,1062,260,utRho04
dcuS,8703370,8703370,8703324,46,0,utRho04
dcyD,3999016,3999016,3998960,56,0,utRho04
ddpX,3126498,3126498,3126152,346,0,utRho04
deaD,6615818,6615818,6615720,98,4050,utRho04
dedA,4869880,4869880,4869482,398,6426,utRho04
dedD,4863750,4863750,4863368,382,140,utRho04
def,6867300,6867380,6867300,80,0,utRho04
degP,361690,361768,361690,78,0,utRho04
degQ,6761308,6761486,6761308,178,2986,utRho04
deoB,9239134,9239206,9239134,72,0,utRho04
deoC,9233358,9234646,9233358,1288,152,utRho04
dfp,7625406,7625462,7625406,56,58,utRho04
dgcZ,3247758,3247758,3247700,58,0,utRho04
dgkA,8512914,8513274,8512914,360,68,utRho04
dgt,358392,358474,358392,82,0,utRho04
dhaK,2501888,2501888,2501676,212,90,utRho04
dhaR,2502006,2502132,2502006,126,40,utRho04
dicB,3299194,3299218,3299194,24,0,utRho04
dicC,3295752,3295752,3295700,52,0,utRho04
dinB,501760,501796,501760,36,0,utRho04
dinD,7635398,7635520,7635398,122,258,utRho04
dinG,1666146,1666140,1666146,6,0,utRho04
dinI,2243018,2243018,2242974,44,0,utRho04
dinJ,493230,493230,493004,226,76,utRho04
dinQ,7295964,7295964,7295576,388,1398,utRho04
djlA,114536,114728,114536,192,64,utRho04
dkgA,6313142,6313246,6313142,104,10,utRho04
dkgB,458196,458334,458196,138,266,utRho04
dksA,321502,321502,321208,294,292,utRho04
dld,4444164,4444370,4444164,206,0,utRho04
dmlA,3763424,3763824,3763424,400,4,utRho04
dmlR,3763710,3763710,3763618,92,0,utRho04
dmsA,1881646,1881918,1881646,272,184,utRho04
dnaA,7767922,7767922,7767458,464,5020,utRho04
dnaB,8528566,8528628,8528566,62,114,utRho04
dnaK,24096,24326,24096,230,174,utRho04
dnaN,7765466,7765466,7764642,824,842,utRho04
dnaQ,471868,472134,471868,266,910,utRho04
dnaT,18406460,18406460,18406068,392,292,utRho04
dnaX,984112,984184,984112,72,380,utRho04
dosP,3131486,3131486,3131466,20,0,utRho04
dpiB,1303968,1304470,1303968,502,0,utRho04
dppA,7415740,7415740,7415410,330,1250,utRho04
dps,1697900,1697900,1697822,78,66,utRho04
dsbA,8086754,8086836,8086754,82,1656,utRho04
dsbB,2466294,2466294,2466060,234,38,utRho04
dsbC,6079266,6079266,6077644,1622,748,utRho04
dsbG,1277600,1277600,1277146,454,508,utRho04
dsdA,4958242,4958404,4958242,162,102,utRho04
dsdC,4955492,4955492,4955258,234,0,utRho04
dsdX,4955642,4955694,4955642,52,0,utRho04
dsrA,4050626,4050626,4050626,0,0,utRho04
dsrB,4049686,4049686,4049646,40,0,utRho04
dtpD,1485340,1485340,1485112,228,76,utRho04
dusA,8523200,8523338,8523200,138,2422,utRho04
dusB,6820492,6820560,6820492,68,40,utRho04
dusC,4460790,4460790,4460770,20,0,utRho04
dut,7627704,7627864,7627704,160,1430,utRho04
dxr,386670,387042,386670,372,792,utRho04
ebgA,6445102,6445266,6445102,164,18,utRho04
ebgR,6442874,6442932,6442874,58,12,utRho04
ecnB,8753018,8753106,8753018,88,190,utRho04
eco,4607594,4607810,4607594,216,0,utRho04
ecpA,621594,621594,621342,252,42,utRho04
ecpB,620238,620238,620052,186,0,utRho04
ecpR,622964,622964,622672,292,0,utRho04
eda,3866218,3866218,3865512,706,68,utRho04
edd,3869426,3869426,3869208,218,42,utRho04
efeO,2164308,2164486,2164308,178,0,utRho04
efeU_1,2162614,2162712,2162614,98,4,utRho04
efp,8751134,8751398,8751134,264,5752,utRho04
elaA,4763372,4763372,4763086,286,128,utRho04
elaD,4765308,4765426,4765308,118,28,utRho04
elfA,1995530,1995736,1995530,206,24,utRho04
elfD,1996642,1996980,1996642,338,0,utRho04
emrD,7707690,7707844,7707690,154,0,utRho04
emrK,4966896,4966896,4966678,218,0,utRho04
emrY,4964668,4964668,4964352,316,0,utRho04
emtA,2486250,2486360,2486250,110,0,utRho04
endA,12361100,12361388,12361100,288,0,utRho04
eno,5817692,5817692,5815882,1810,4074,utRho04
entC,1249662,1249770,1249662,108,16,utRho04
entD,1220508,1220508,1220158,350,0,utRho04
entH,1258584,1258600,1258584,16,18,utRho04
entS,1244506,1244600,1244506,94,0,utRho04
envR,6827266,6827266,6826930,336,0,utRho04
epd,12295292,12295292,12294764,528,228,utRho04
epmA,8765236,8765286,8765236,50,14,utRho04
epmB,8751406,8751406,8751314,92,2964,utRho04
eptB,7421162,7421162,7420950,212,230,utRho04
eptC,8300622,8300622,8300530,92,140,utRho04
erfK,4126708,4126708,4126646,62,702,utRho04
erpA,353122,353220,353122,98,40,utRho04
esrE,8039956,8039956,8039956,0,0,utRho04
essD,1153746,1154796,1153746,1050,296,utRho04
etk,2088606,2088606,2088420,186,0,utRho04
evgA,4967262,4967510,4967262,248,0,utRho04
exbB,6304028,6304028,6303968,60,12,utRho04
exbD,6302780,6302780,6302486,294,136,utRho04
exuR,6493016,6493304,6493016,288,140,utRho04
exuT,6490004,6490208,6490004,204,0,utRho04
fabA,2032996,2032996,2032940,56,58,utRho04
fabB,4883282,4883282,4883210,72,2,utRho04
fabH,2297032,2297518,2297032,486,2828,utRho04
fabI,2702236,2702236,2702078,158,0,utRho04
fadB,8062026,8062026,8061942,84,0,utRho04
fadD,3779614,3779614,3779492,122,0,utRho04
fadE,486812,486812,486606,206,0,utRho04
fadH,6463248,6463330,6463248,82,0,utRho04
fadI,4921022,4921022,4920938,84,0,utRho04
fadL,4922410,4922600,4922410,190,0,utRho04
fadM,928720,928804,928720,84,0,utRho04
fadR,2469810,2469876,2469810,66,0,utRho04
fbaB,4357334,4357334,4357128,206,0,utRho04
fdhE,8162722,8162722,8162456,266,924,utRho04
fdhF,8598814,8598814,8598732,82,0,utRho04
fdnG,3094744,3094802,3094744,58,16,utRho04
fdrA,1093012,1093360,1093012,348,0,utRho04
feaB,2894994,2895038,2894994,44,0,utRho04
feaR,2894734,2894734,2894566,168,0,utRho04
fecA,9033454,9033454,9033354,100,384,utRho04
fecE,9023288,9023288,9022914,374,6076,utRho04
fecI,9036564,9036564,9036470,94,0,utRho04
feoA,7080114,7080326,7080114,212,94,utRho04
fepA,1225334,1225334,1224988,346,0,utRho04
fepB,1249454,1249454,1249020,434,292,utRho04
fepD,1244468,1244468,1244378,90,20,utRho04
fes,1225374,1225630,1225374,256,34,utRho04
ffh,5495706,5495706,5495590,116,1386,utRho04
ffs,952576,952848,952576,272,28,utRho04
fhuA,334884,334968,334884,84,102,utRho04
fhuE,2323294,2323294,2323102,192,178,utRho04
fhuF,9211504,9211504,9211326,178,2846,utRho04
fic,6983296,6983296,6982926,370,422,utRho04
fieF,8212864,8212938,8212864,74,78,utRho04
fimA,9085388,9086230,9085388,842,152,utRho04
fimB,9081334,9081914,9081334,580,304,utRho04
fimE,9083742,9084074,9083742,332,0,utRho04
fimZ,1129214,1129214,1128960,254,4,utRho04
fiu,1683296,1683296,1683062,234,32,utRho04
fixA,84650,84806,84650,156,0,utRho04
fkpA,6955050,6955050,6954838,212,5174,utRho04
fldA,2846084,2846084,2845860,224,3256,utRho04
fldB,6079644,6079710,6079644,66,104,utRho04
flgA,2261770,2261770,2261726,44,38,utRho04
flgB,2261986,2262036,2261986,50,0,utRho04
flgK,2276702,2276756,2276702,54,1788,utRho04
flgM,2260330,2260330,2260256,74,182,utRho04
flgN,2259828,2259828,2259660,168,122,utRho04
flhB,3932432,3932432,3932382,50,126,utRho04
flhC,3955864,3955864,3955688,176,68,utRho04
flhD,3957154,3957154,3956394,760,468,utRho04
fliA,4003638,4003638,4003578,60,40,utRho04
fliC,4007352,4007352,4007212,140,86,utRho04
fliD,4007634,4007744,4007634,110,222,utRho04
fliE,4026186,4026186,4026028,158,0,utRho04
fliF,4026292,4026458,4026292,166,304,utRho04
fliL,4039168,4039236,4039168,68,124,utRho04
flk,4875824,4875900,4875824,76,26,utRho04
flu,4142634,4143078,4142634,444,90,utRho04
flxA,3292776,3292810,3292776,34,130,utRho04
fnr,2799104,2799104,2799052,52,0,utRho04
fnrS,2818258,2818258,2818258,0,0,utRho04
focA,1909628,1909628,1908932,696,414,utRho04
folA,99598,99646,99598,48,0,utRho04
folB,6409296,6409296,6409178,118,0,utRho04
folD,1115562,1115562,1115482,80,176,utRho04
folE,4487696,4487696,4487304,392,2100,utRho04
fpr,8228998,8228998,8228944,54,0,utRho04
frc,4986878,4986878,4986508,370,0,utRho04
frdA,8764824,8764824,8764636,188,62,utRho04
frdD,8758948,8758948,8758732,216,160,utRho04
fre,8052886,8053054,8052886,168,1458,utRho04
frlA,6999518,6999820,6999518,302,0,utRho04
frr,385624,385744,385624,120,906,utRho04
frsA,513004,513054,513004,50,66,utRho04
fruB,4527194,4527194,4526990,204,0,utRho04
frvR,8179804,8179804,8179710,94,0,utRho04
fryA,5008986,5008986,5008970,16,0,utRho04
fsaA,1727060,1727284,1727060,224,0,utRho04
fsr,1009710,1009710,1009392,318,144,utRho04
ftnA,3977364,3977432,3977364,68,0,utRho04
ftnB,3973550,3973850,3973550,300,0,utRho04
ftsA,207122,207964,207122,842,854,utRho04
ftsB,5745802,5745802,5745640,162,16,utRho04
ftsH,6654204,6654204,6653870,334,498,utRho04
ftsK,1865858,1866448,1865858,590,1386,utRho04
ftsL,181376,182064,181376,688,1166,utRho04
ftsP,6325732,6325732,6325338,394,166,utRho04
ftsQ,205484,206310,205484,826,520,utRho04
ftsX,7204512,7204512,7204172,340,838,utRho04
ftsZ,209272,210610,209272,1338,46,utRho04
fucA,5867708,5867708,5867376,332,16,utRho04
fucP,5868238,5868470,5868238,232,4,utRho04
fumA,6753760,6753760,6753508,252,1692,utRho04
fumB,8694696,8694696,8694652,44,0,utRho04
fumC,3373418,3373418,3373176,242,0,utRho04
fur,2842892,2842892,2842584,308,6840,utRho04
fusA,6947370,6947370,6947028,342,13148,utRho04
fxsA,8737206,8737328,8737206,122,36,utRho04
gabD,5581824,5582546,5581824,722,172,utRho04
gadA,7335214,7335214,7335160,54,0,utRho04
gadB,3144144,3144144,3144090,54,0,utRho04
gadC,3141168,3141168,3140978,190,0,utRho04
gadE,7315600,7316732,7315600,1132,0,utRho04
gadW,7329562,7329562,7329236,326,0,utRho04
gadX,14663356,14663356,14663240,116,0,utRho04
gadY,7329728,7329728,7329728,0,0,utRho04
galE,1584354,1584354,1584110,244,0,utRho04
galF,4228702,4228702,4228654,48,28,utRho04
galM,1577796,1577796,1577674,122,176,utRho04
galP,6176510,6176568,6176510,58,6,utRho04
galR,5953138,5953198,5953138,60,56,utRho04
galS,4483420,4483420,4483336,84,0,utRho04
galU,2582810,2582914,2582810,104,156,utRho04
gapA,3724480,3725542,3724480,1062,2784,utRho04
garP,6549868,6549868,6549814,54,0,utRho04
gatY,4354468,4354468,4354408,60,0,utRho04
gatZ,4352864,4352864,4352642,222,4070,utRho04
gcd,282558,282558,282450,108,0,utRho04
gcl,1067814,1067832,1067814,18,0,utRho04
gcvA,5885278,5885278,5885134,144,0,utRho04
gcvB,5885392,5885392,5885392,0,0,utRho04
gcvR,5199758,5199812,5199758,54,0,utRho04
gcvT,6101544,6101544,6101334,210,376,utRho04
gdhA,3684616,3684742,3684616,126,0,utRho04
gfcA,2099668,2099668,2099488,180,146,utRho04
gfcD,2096236,2096236,2095890,346,10,utRho04
ghrA,2195648,2195772,2195648,124,178,utRho04
ghrB,7434378,7434620,7434378,242,424,utRho04
glcA,6242728,6242728,6242558,170,86,utRho04
glcC,6256412,6256544,6256412,132,0,utRho04
glcD,6256152,6256152,6256042,110,0,utRho04
gldA,8278092,8278092,8278070,22,0,utRho04
glgA,7136784,7136784,7136066,718,0,utRho04
glgB,7147314,7147314,7147004,310,162,utRho04
glgC,7139142,7139142,7138656,486,128,utRho04
glgP,7133546,7133546,7133162,384,108,utRho04
glgS,6384024,6384024,6383878,146,0,utRho04
glgX,7142838,7142838,7142638,200,0,utRho04
glk,5018922,5018922,5018852,70,48,utRho04
glmS,7827622,7827622,7827336,286,3984,utRho04
glmU,7830652,7830652,7830400,252,136,utRho04
glmY,10765360,10765360,10765360,0,0,utRho04
glmZ,7972864,7972864,7972864,0,0,utRho04
glnA,16232888,16232888,16232136,752,280,utRho04
glnB,5375052,5375052,5374816,236,78,utRho04
glnD,377310,377310,377300,10,58,utRho04
glnE,6399602,6399602,6399282,320,8,utRho04
glnH,1696396,1696396,1696008,388,0,utRho04
glnK,945112,945196,945112,84,0,utRho04
glnL,8112742,8112742,8112678,64,0,utRho04
glnQ,1693262,1693262,1692926,336,138,utRho04
glnS,1411998,1412186,1411998,188,266,utRho04
gloA,3455602,3455674,3455602,72,0,utRho04
gloB,469852,469852,469564,288,672,utRho04
glpA,4705166,4705294,4705166,128,0,utRho04
glpD,7123942,7124026,7123942,84,68,utRho04
glpE,7123698,7123698,7123646,52,86,utRho04
glpF,8236322,8236322,8236180,142,222,utRho04
glpG,7122960,7122960,7122904,56,258,utRho04
glpR,7121782,7121782,7121210,572,210,utRho04
glpT,4704902,4704902,4704748,154,60,utRho04
glpX,8231212,8231212,8231158,54,3626,utRho04
glrK,5382246,5382246,5382196,50,68,utRho04
gltA,1509534,1509534,1508936,598,13494,utRho04
gltB,6709018,6709264,6709018,246,250,utRho04
gltI,1375792,1375792,1375494,298,1380,utRho04
gltP,8588536,8588962,8588536,426,1282,utRho04
gltS,7657382,7657382,7657330,52,152,utRho04
gltX,5041568,5041568,5041344,224,110,utRho04
gluQ,320286,320286,320224,62,30,utRho04
glyA,5371148,5371148,5371014,134,2,utRho04
glyQ,7450708,7450708,7450636,72,50,utRho04
glyS,7448990,7448990,7448794,196,1030,utRho04
glyU,5998128,5998128,5998114,14,2,utRho04
glyV,8784626,8784720,8784626,94,288,utRho04
glyW,3984360,3984360,3984234,126,0,utRho04
gmhB,445612,445666,445612,54,0,utRho04
gmk,7642776,7642856,7642776,80,26,utRho04
gmr,2693686,2693686,2693484,202,26,utRho04
gnd,4202648,4202648,4202536,112,334,utRho04
gnsB,3275692,3275692,3275564,128,510,utRho04
gntK,14310580,14310580,14310368,212,440,utRho04
gntP,9102668,9102668,9102592,76,0,utRho04
gntR,7157760,7157760,7157452,308,204,utRho04
gntT,7092810,7093118,7092810,308,54,utRho04
gntU,7154170,7154170,7154122,48,28,utRho04
gntX,7089334,7089764,7089334,430,0,utRho04
gor,7292224,7292598,7292224,374,660,utRho04
gpmA,1575340,1575340,1575190,150,0,utRho04
gpmM,7570374,7570520,7570374,146,0,utRho04
gpsA,7567620,7567620,7567322,298,4702,utRho04
gpt,511828,511954,511828,126,272,utRho04
grcA,5433046,5433046,5432898,148,56,utRho04
greA,6657728,6657728,6657430,298,898,utRho04
greB,7073488,7073624,7073488,136,18,utRho04
groL,8741566,8742050,8741566,484,390,utRho04
groS,8741232,8741376,8741232,144,320,utRho04
grpE,5501494,5501494,5501416,78,142,utRho04
grxA,1781552,1781552,1781506,46,10,utRho04
grxB,2248206,2248206,2248108,98,12,utRho04
grxC,7569152,7569152,7568884,268,3464,utRho04
grxD,3468324,3468324,3468202,122,3762,utRho04
gspA,6911268,6911268,6910796,472,2,utRho04
gspC,6910964,6911156,6910964,192,0,utRho04
gss,6277220,6277220,6277044,176,0,utRho04
gstA,3428654,3428754,3428654,100,0,utRho04
gstB,1761038,1761038,1760960,78,0,utRho04
guaB,5268214,5268214,5268140,74,2,utRho04
gudD,5839026,5839026,5838770,256,0,utRho04
gyrA,4678914,4678914,4678840,74,8,utRho04
gyrB,7760300,7760300,7760238,62,166,utRho04
hcaE,5337964,5338064,5337964,100,4,utRho04
hcaR,5337928,5337928,5337792,136,0,utRho04
hcaT,5336106,5336106,5335692,414,128,utRho04
hchA,4071260,4071670,4071260,410,0,utRho04
hcp,1828258,1828258,1827628,630,8,utRho04
hcr,1824400,1824400,1824300,100,0,utRho04
hdeA,7313582,7313582,7313480,102,0,utRho04
hdeD,7313920,7313990,7313920,70,0,utRho04
hdfR,7896320,7896320,7895934,386,384,utRho04
hdhA,3396244,3396244,3396080,164,42,utRho04
helD,2048876,2048942,2048876,66,0,utRho04
hemA,2527166,2527428,2527166,262,238,utRho04
hemB,779722,779722,779454,268,32,utRho04
hemF,5106410,5106450,5106410,40,4,utRho04
hemH,996062,996110,996062,48,48,utRho04
hemL,349882,349882,349764,118,6,utRho04
hemN,8103886,8104090,8103886,204,38,utRho04
hepA,127176,127176,126528,648,2708,utRho04
hflD,2385372,2385372,2385262,110,776,utRho04
hfq,8799602,8800576,8799602,974,1878,utRho04
hha,961006,961006,960616,390,310,utRho04
hicA,3018442,3018572,3018442,130,0,utRho04
higA,6468682,6468682,6468288,394,72,utRho04
higB,6468960,6468960,6468910,50,58,utRho04
hinT,2323642,2323770,2323642,128,78,utRho04
hipB,3184964,3184964,3184884,80,12,utRho04
hisB,4186720,4186936,4186720,216,282,utRho04
hisJ,4853674,4853674,4853576,98,22,utRho04
hisL,8359856,8359984,8359856,128,500,utRho04
hisS,5281284,5281284,5281150,134,428,utRho04
hlpA,400910,400964,400910,54,140,utRho04
hlyE,2460932,2460932,2460788,144,0,utRho04
hmp,5371594,5371670,5371594,76,0,utRho04
hns,2585916,2585916,2585844,72,956,utRho04
hofM,7045856,7045856,7045502,354,8,utRho04
hokA,7441620,7441620,7441200,420,3210,utRho04
hokC,33902,33902,33806,96,42,utRho04
hokE,1215462,1215672,1215462,210,40,utRho04
holC,8968546,8968546,8968560,14,314,utRho04
holD,9215562,9215606,9215562,44,0,utRho04
holE,3850040,3850216,3850040,176,494,utRho04
hpt,282720,282862,282720,142,118,utRho04
hrpB,324150,324210,324150,60,142,utRho04
hscB,5319048,5319048,5318934,114,648,utRho04
hscC,1367188,1367188,1366786,402,278,utRho04
hsdS,9163004,9163004,9162924,80,0,utRho04
hslJ,2883560,2883560,2883486,74,126,utRho04
hslO,7059344,7059548,7059344,204,4128,utRho04
hslR,7058220,7058696,7058220,476,860,utRho04
hslV,8244708,8244708,8244574,134,130,utRho04
hsrA,7881412,7881412,7881224,188,36,utRho04
htgA,21286,21660,21286,374,662,utRho04
htpG,989634,990240,989634,606,4550,utRho04
htpX,3825236,3825236,3825152,84,0,utRho04
htrE,311036,311036,310852,184,102,utRho04
htrL,7587668,7587668,7587366,302,100,utRho04
hupA,8400352,8400562,8400352,210,274,utRho04
hupB,1845220,1845804,1845220,584,268,utRho04
hyaA,2063968,2064278,2063968,310,40,utRho04
hybO,6292726,6292726,6292522,204,700,utRho04
hycA,5700922,5700922,5700870,52,0,utRho04
hycI,5686204,5686204,5686086,118,12,utRho04
hydN,5676264,5676264,5676210,54,0,utRho04
hyfA,5202342,5202402,5202342,60,0,utRho04
hypA,11402508,11402588,11402508,80,0,utRho04
hypB,11403356,11404004,11403356,648,40,utRho04
hypF,5676210,5676210,5674850,1360,488,utRho04
hypT,9116634,9116634,9116578,56,24,utRho04
hyuA,6019660,6020056,6019660,396,0,utRho04
iaaA,1733074,1733136,1733074,62,0,utRho04
iadA,9119074,9119074,9119052,22,14,utRho04
iap,5753072,5753162,5753072,90,2,utRho04
ibaG,6673966,6673966,6673606,360,106,utRho04
ibpA,7735036,7735036,7734844,192,306,utRho04
ibpB,7733962,7733962,7733794,168,180,utRho04
icd,2389922,2390246,2389922,324,294,utRho04
iclR,8447304,8447304,8447256,48,74,utRho04
idi,6065876,6066130,6065876,254,0,utRho04
idnD,8988870,8988870,8988812,58,0,utRho04
idnK,8989194,8989246,8989194,52,0,utRho04
ihfA,3591442,3591442,3591104,338,960,utRho04
ihfB,1927498,1927656,1927498,158,660,utRho04
ileS,43666,44782,43666,1116,2732,utRho04
ileX,6431194,6431196,6431194,2,2,utRho04
ilvA,15820940,15821324,15820940,384,192,utRho04
ilvC,7915824,7915940,7915824,116,0,utRho04
ilvE,15809552,15809936,15809552,384,452,utRho04
ilvI,170840,171260,170840,420,0,utRho04
ilvL,23701308,23701932,23701308,624,0,utRho04
ilvY,7915734,7915734,7915640,94,0,utRho04
inaA,4698998,4698998,4698944,54,54,utRho04
infA,1853370,1853370,1852886,484,3242,utRho04
infC,3602692,3602692,3601276,1416,5266,utRho04
insA-5,3958452,3958452,3958430,22,4,utRho04
insA-7,9036758,9037054,9036758,296,108,utRho04
insC-5,6372080,6372284,6372080,204,102,utRho04
insEF-2,785238,785238,785820,582,264,utRho04
insEF-4,2190310,2190310,2190892,582,204,utRho04
insG,9007098,9007098,9006862,236,0,utRho04
insH-1,550596,550596,550234,362,44,utRho04
insH-11,7306538,7306538,7306396,142,42,utRho04
insH-2,1151548,1151548,1151506,42,102,utRho04
insH-3,1378444,1378444,1378026,418,180,utRho04
insH-4,2791942,2792152,2791942,210,58,utRho04
insH-5,2857852,2857852,2857452,400,14,utRho04
insH-6,4135022,4135022,4134642,380,60,utRho04
insH-7,4206186,4206186,4205822,364,4366,utRho04
insH-9,6260050,6260356,6260050,306,100,utRho04
insI-3,9017372,9017372,9017234,138,8,utRho04
insJ,7441188,7441360,7441188,172,1700,utRho04
insK,7442130,7442308,7442130,178,24,utRho04
insL-1,30760,30890,30760,130,254,utRho04
insL-2,1216112,1216130,1216112,18,22,utRho04
insL-3,5028644,5028662,5028644,18,108,utRho04
insN-1,540452,540484,540452,32,0,utRho04
intD,1132202,1132202,1131956,246,78,utRho04
intR,2826520,2826520,2826470,50,0,utRho04
intS,4933026,4933090,4933026,64,370,utRho04
intZ,5117386,5117542,5117386,156,10,utRho04
iraD,9113152,9113986,9113152,834,0,utRho04
iraM,2424246,2424246,2424006,240,0,utRho04
iraP,802638,802772,802638,134,0,utRho04
iscA,5319924,5319924,5319772,152,498,utRho04
iscR,5324398,5324398,5324262,136,18026,utRho04
iscX,5313834,5313834,5313472,362,2084,utRho04
ispF,5743968,5743968,5743560,408,818,utRho04
ispG,5283908,5283908,5283608,300,1064,utRho04
ispU,389568,389806,389568,238,280,utRho04
isrA,2811502,2811502,2811618,116,56,utRho04
istr-1,7706384,7706384,7706384,0,0,utRho04
istr-2,7706514,7706514,7706514,0,0,utRho04
ivbL,15412092,15412092,15411952,140,196,utRho04
ivy,480638,480686,480638,48,0,utRho04
katE,3627628,3627734,3627628,106,24,utRho04
katG,8267624,8267670,8267624,46,26,utRho04
kbaZ,6557732,6557828,6557732,96,0,utRho04
kbl,7585154,7585154,7585102,52,296,utRho04
kch,2621046,2621046,2620538,508,0,utRho04
kdgR,3820506,3820506,3820198,308,2,utRho04
kdpE,1443788,1443788,1443466,322,0,utRho04
kdpF,1457698,1457698,1457642,56,0,utRho04
kdsA,2535708,2536330,2535708,622,2032,utRho04
kdsC,6683438,6684546,6683438,1108,2378,utRho04
kduI,5968388,5968388,5968248,140,648,utRho04
kefF,94160,94492,94160,332,0,utRho04
kgtP,5451624,5451624,5451492,132,1016,utRho04
kup,7862206,7862632,7862206,426,24,utRho04
lacI,735076,735076,735020,56,34,utRho04
lacZ,1465508,1465508,1465220,288,176,utRho04
ldcA,2486394,2486394,2486160,234,0,utRho04
ldhA,2885830,2885830,2885686,144,0,utRho04
ldrA,2538954,2538954,2538550,404,1046,utRho04
ldrB,2540024,2540024,2539620,404,536,utRho04
ldrC,2541092,2541092,2540690,402,764,utRho04
ldrD,7400544,7400544,7400174,370,1144,utRho04
lepA,5414392,5414392,5414248,144,158,utRho04
lepB,5410928,5410928,5410618,310,928,utRho04
leuD,159188,159188,158906,282,0,utRho04
leuE,3761600,3761600,3761518,82,38,utRho04
leuL,168048,168048,167416,632,0,utRho04
leuO,168308,168736,168308,428,136,utRho04
leuQ,9212864,9212864,9212802,62,2,utRho04
leuU,6644556,6644556,6644316,240,3746,utRho04
leuV,9212546,9212546,9212330,216,938,utRho04
leuX,8992772,8992810,8992772,38,0,utRho04
lexA,8514174,8514230,8514174,56,104,utRho04
lhr,3456706,3458174,3456706,1468,3060,utRho04
ligA,5060402,5060402,5060352,50,0,utRho04
ligB,7642576,7642576,7642340,236,0,utRho04
lipA,1320602,1320602,1320432,170,0,utRho04
lipB,1324802,1324802,1324556,246,1710,utRho04
lit,2397032,2397390,2397032,358,184,utRho04
livJ,7199524,7199524,7199316,208,1652,utRho04
livK,7195510,7195510,7195120,390,2,utRho04
lldP,7554578,7554798,7554578,220,778,utRho04
lnt,1381968,1381968,1381762,206,192,utRho04
loiP,6163784,6163826,6163784,42,0,utRho04
lolA,1874656,1874738,1874656,82,516,utRho04
lolB,2527112,2527112,2527000,112,44,utRho04
lolC,2350748,2350854,2350748,106,24,utRho04
lon,917630,917776,917630,146,218,utRho04
lpcA,486936,487086,486936,150,0,utRho04
lpd,255434,255824,255434,390,3148,utRho04
lplA,9248476,9248476,9248234,242,646,utRho04
lplT,5947878,5947878,5947724,154,0,utRho04
lpoA,6586422,6586800,6586422,378,174,utRho04
lpp,3514592,3514842,3514592,250,232,utRho04
lptA,6686598,6686760,6686598,162,1122,utRho04
lptB,6686792,6687888,6686792,1096,1446,utRho04
lptD,114672,114672,114218,454,1528,utRho04
lptF,8972244,8972436,8972244,192,0,utRho04
lpxC,213016,213114,213016,98,19188,utRho04
lpxD,401920,401942,401920,22,0,utRho04
lpxL,2233418,2233418,2233164,254,30,utRho04
lpxM,3880456,3880456,3880386,70,98,utRho04
lpxP,4991156,4991290,4991156,134,348,utRho04
lrhA,4813312,4813312,4813282,30,0,utRho04
lrp,1864656,1865190,1864656,534,426,utRho04
lspA,50028,50414,50028,386,496,utRho04
lsrA,3202920,3202980,3202920,60,0,utRho04
lsrR,3202514,3202514,3202482,32,0,utRho04
ltaE,1818640,1818640,1818588,52,0,utRho04
luxS,5630130,5630130,5629466,664,1056,utRho04
lysA,5957902,5957902,5957798,104,0,utRho04
lysC,8467232,8467232,8466466,766,212,utRho04
lysP,4497120,4497120,4497064,56,50,utRho04
lysR,5957900,5958042,5957900,142,0,utRho04
lysT,1561028,1561108,1561028,80,32,utRho04
lysU,8709610,8709610,8709434,176,52,utRho04
macB,1840188,1840694,1840188,506,72,utRho04
maeA,3111484,3111484,3111338,146,1980,utRho04
mak,820236,820288,820236,52,2,utRho04
malE,8492928,8492928,8492838,90,36,utRho04
malI,3398456,3398456,3398360,96,0,utRho04
malK,8493472,8493568,8493472,96,0,utRho04
malP,7105020,7105020,7104946,74,166,utRho04
malQ,7100798,7100798,7100140,658,130,utRho04
malS,14949880,14949988,14949880,108,80,utRho04
malT,7106048,7106170,7106048,122,90,utRho04
malX,3398626,3398710,3398626,84,0,utRho04
malZ,1689980,1690072,1689980,92,1528,utRho04
manA,3377102,3377152,3377102,50,86,utRho04
manX,3803866,3804096,3803866,230,0,utRho04
marC,3237882,3237882,3237816,66,46,utRho04
marR,3238186,3238240,3238186,54,18,utRho04
matP,2036918,2036970,2036918,52,70,utRho04
mazE,5822736,5822736,5822678,58,12,utRho04
mazG,5821720,5821720,5821370,350,2142,utRho04
mcbA,1684306,1684306,1684112,194,0,utRho04
mcbR,3040192,3040524,3040192,332,0,utRho04
mcrA,2420278,2420692,2420278,414,88,utRho04
mcrC,9156124,9156124,9155916,208,168,utRho04
mdaB,6344814,6345060,6344814,246,0,utRho04
mdfA,1767138,1767346,1767138,208,0,utRho04
mdh,6768940,6768940,6768536,404,228,utRho04
mdoB,9198988,9198988,9198882,106,398,utRho04
mdoD,2993290,2993712,2993290,422,0,utRho04
mdoG,2218514,2218670,2218514,156,0,utRho04
mdtA,4307958,4308032,4307958,74,0,utRho04
mdtE,7318168,7318464,7318168,296,40,utRho04
mdtK,3486538,3486914,3486538,376,144,utRho04
mdtP,8602472,8602472,8602060,412,2,utRho04
melA,8683774,8683822,8683774,48,0,utRho04
melR,8683300,8683300,8683256,44,14,utRho04
menA,8240812,8240812,8240698,114,24,utRho04
menB,4753774,4753774,4753638,136,190,utRho04
mepH,3468714,3468870,3468714,156,0,utRho04
mepM,3883666,3883666,3883270,396,926,utRho04
mepS,4539840,4539958,4539840,118,478,utRho04
metA,8428318,8428560,8428318,242,178,utRho04
metB,8257272,8257344,8257272,72,528,utRho04
metC,6304150,6304472,6304150,322,196,utRho04
metE,8025768,8026106,8025768,338,88,utRho04
metF,8265092,8265232,8265092,140,82,utRho04
metG,4388538,4388600,4388538,62,80,utRho04
metH,8447010,8447656,8447010,646,5162,utRho04
metJ,8257116,8257116,8256790,326,210,utRho04
metK,6173154,6173412,6173154,258,94,utRho04
metN,445428,445428,445290,138,0,utRho04
metR,8025710,8025710,8025632,78,0,utRho04
metT,1394326,1394326,1394266,60,84,utRho04
metY,19910250,19910250,19909734,516,5898,utRho04
metZ,11789528,11789548,11789528,20,4,utRho04
mfd,2348056,2348056,2347928,128,120,utRho04
mglA,4478782,4478782,4478578,204,62,utRho04
mglB,4481132,4481132,4480696,436,2524,utRho04
mglC,4475918,4475918,4475506,412,254,utRho04
mgrB,3817584,3817584,3817532,52,16,utRho04
mgrR,3245828,3245828,3245828,0,0,utRho04
mgsA,2054082,2054082,2054030,52,0,utRho04
mgtL,8934560,8934862,8934560,302,100,utRho04
mhpA,737038,737222,737038,184,0,utRho04
mhpR,737072,737072,736840,232,0,utRho04
mhpT,750772,750918,750772,146,0,utRho04
miaA,8797964,8798504,8797964,540,992,utRho04
micA,5629604,5629604,5629604,0,0,utRho04
micC,2874242,2874238,2874242,4,0,utRho04
micF,4626168,4626168,4626168,0,0,utRho04
micM,1014408,1014408,1014408,0,0,utRho04
minE,2449422,2449422,2449090,332,470,utRho04
mioC,7852950,7852950,7852910,40,22,utRho04
mipA,3733012,3733012,3732944,68,2924,utRho04
mlaA,4930270,4930270,4930014,256,26,utRho04
mlc,3337206,3337206,3337128,78,0,utRho04
mlrA,4429498,4429732,4429498,234,0,utRho04
mltA,5894546,5894546,5894356,190,106,utRho04
mltD,468050,468050,467910,140,18,utRho04
mltF,5391534,5391602,5391534,68,0,utRho04
mmuP,550238,550650,550238,412,44,utRho04
mngA,1531622,1531968,1531622,346,50,utRho04
mngR,1531852,1531852,1531750,102,26,utRho04
mnmG,7851348,7851348,7851266,82,5076,utRho04
mntH,5025470,5025470,5025412,58,0,utRho04
mntP,3810918,3811376,3810918,458,574,utRho04
mntR,1706160,1706366,1706160,206,0,utRho04
mntS,1706128,1706128,1705994,134,98,utRho04
moaA,1633654,1634088,1633654,434,632,utRho04
moaB,1635954,1636110,1635954,156,486,utRho04
mobA,8084242,8084242,8083998,244,326,utRho04
mocA,6030112,6030320,6030112,208,0,utRho04
modA,1589990,1590178,1589990,188,28,utRho04
moeA,1732788,1732788,1732728,60,104,utRho04
mokB,2984610,2984610,2984258,352,446,utRho04
molR_1,4392888,4392948,4392888,60,166,utRho04
motA,3954604,3954604,3954278,326,8,utRho04
mpaA,2781278,2781278,2781196,82,56,utRho04
mpl,8911456,8911570,8911456,114,0,utRho04
mppA,2786108,2786454,2786108,346,0,utRho04
mprA,5621494,5621540,5621494,46,234,utRho04
mqo,4613848,4613848,4613508,340,382,utRho04
mqsA,6336742,6336742,6336492,250,18,utRho04
mqsR,6337306,6337306,6337088,218,128,utRho04
mraZ,179192,179268,179192,76,0,utRho04
mrcA,7045652,7045742,7045652,90,0,utRho04
mrcB,329442,329460,329442,18,0,utRho04
mreB,13605424,13605424,13604348,1076,1376,utRho04
mreD,6798166,6798166,6797750,416,292,utRho04
mrp,4388360,4388360,4388336,24,2,utRho04
mscK,972984,973072,972984,88,20,utRho04
mscL,6876002,6876048,6876002,46,144,utRho04
mscS,6139742,6139742,6139614,128,34,utRho04
msrA,8884522,8884522,8884352,170,118,utRho04
msrB,3725168,3725168,3724858,310,0,utRho04
msyB,2228426,2228426,2228362,64,36,utRho04
mtfA,4087236,4087302,4087236,66,436,utRho04
mtgA,6699662,6699662,6699618,44,48,utRho04
mtlA,30177504,30178248,30177504,744,696,utRho04
mtn,358366,358366,358306,60,6,utRho04
mtr,6611864,6611864,6611634,230,86,utRho04
mug,6430992,6430992,6430946,46,84,utRho04
murQ,5091466,5091546,5091466,80,0,utRho04
murR,5091586,5091586,5091218,368,0,utRho04
mutH,5939164,5939324,5939164,160,650,utRho04
mutL,8794092,8794824,8794092,732,786,utRho04
mutM,7622554,7622554,7622304,250,644,utRho04
mutS,5714038,5714186,5714038,148,114,utRho04
mutY,18617466,18618078,18617466,612,408,utRho04
nac,4123956,4123956,4123866,90,0,utRho04
nadA,1564122,1564170,1564122,48,0,utRho04
nadB,5420714,5420840,5420714,126,20,utRho04
nadC,237326,237326,237290,36,18,utRho04
nadE,3644604,3644916,3644604,312,78,utRho04
nadK,5501526,5501662,5501526,136,284,utRho04
nagA,1406350,1406350,1405502,848,1420,utRho04
nagB,1407416,1407416,1407222,194,52,utRho04
nagC,1404016,1404016,1403188,828,116,utRho04
nagE,1407680,1407888,1407680,208,48,utRho04
nagK,2357080,2357186,2357080,106,0,utRho04
nanA,6747240,6747240,6747152,88,2,utRho04
nanC,9079856,9079856,9079002,854,60,utRho04
nanR,6749406,6749406,6748978,428,108,utRho04
nanS,9075406,9075406,9075188,218,0,utRho04
napF,4607390,4607390,4606994,396,0,utRho04
narG,2559614,2559728,2559614,114,0,utRho04
narK,2555642,2555914,2555642,272,0,utRho04
narP,4580844,4581000,4580844,156,0,utRho04
narQ,5171154,5171462,5171154,308,46,utRho04
narU,3088326,3088326,3088120,206,20,utRho04
narW,3077374,3077374,3074618,2756,28,utRho04
narX,2555554,2555554,2555236,318,94,utRho04
narZ,3085380,3085380,3085180,200,0,utRho04
ndh,2331984,2332170,2331984,186,72,utRho04
ndk,5289920,5289920,5289728,192,390,utRho04
nemR,6904084,6904092,6904084,8,0,utRho04
nepI,7683542,7683542,7683478,64,224,utRho04
nfo,4501612,4501680,4501612,68,46,utRho04
nfsB,1210906,1210906,1210848,58,10,utRho04
nfuA,7090916,7091248,7090916,332,368,utRho04
nhaA,34634,34978,34634,344,58,utRho04
nhaB,2469534,2469534,2469434,100,12,utRho04
nhoA,3067926,3068048,3067926,122,0,utRho04
nikA,7226878,7227334,7226878,456,1302,utRho04
nikR,7237074,7237176,7237074,102,220,utRho04
nirB,6987974,6988022,6987974,48,34,utRho04
nlpA,7680034,7680034,7679986,48,0,utRho04
nlpC,3585654,3585654,3585462,192,60,utRho04
nlpD,5737658,5737658,5737506,152,16,utRho04
nlpI,6618080,6618080,6617848,232,12,utRho04
nmpC,1153740,1153740,1153650,90,0,utRho04
nohA,3273206,3273206,3272734,472,2,utRho04
norR,5664614,5664614,5664578,36,0,utRho04
norV,5664878,5664952,5664878,74,0,utRho04
nrdA,4689510,4689730,4689510,220,5018,utRho04
nrdD,8925676,8925676,8925320,356,1782,utRho04
nrdH,5601312,5601446,5601312,134,366,utRho04
nrdR,865954,866004,865954,50,0,utRho04
nrfA,8575342,8575528,8575342,186,50,utRho04
nsrR,8812088,8812380,8812088,292,26194,utRho04
nudB,3897348,3897348,3897264,84,42,utRho04
nudC,8393428,8393806,8393428,378,0,utRho04
nudE,7052658,7052658,7052298,360,2714,utRho04
nudG,3682876,3682980,3682876,104,0,utRho04
nudI,4729050,4729108,4729050,58,0,utRho04
nudJ,2388874,2388874,2388576,298,916,utRho04
nuoA,4810670,4810670,4810144,526,2146,utRho04
nuoN,4783434,4783434,4783010,424,1282,utRho04
nupC,5026018,5026084,5026018,66,0,utRho04
nupG,6211302,6211428,6211302,126,90,utRho04
ogrK,4335096,4335096,4335040,56,0,utRho04
ogt,2800568,2800568,2800472,96,70,utRho04
ohsC,5401036,5401040,5401036,4,4,utRho04
ompA,2040382,2040382,2040106,276,11932,utRho04
ompC,4625774,4625774,4625498,276,44,utRho04
ompF,1974184,1974184,1973964,220,90,utRho04
ompL,8128958,8128958,8128590,368,0,utRho04
ompN,2874158,2874158,2873786,372,4,utRho04
ompR,7073510,7073510,7073168,342,92,utRho04
ompT,1171330,1171330,1171266,64,2,utRho04
ompW,2627982,2628040,2627982,58,0,utRho04
ompX,1700418,1700900,1700418,482,626,utRho04
omrA,5952378,5952378,5952378,0,0,utRho04
omrB,5952770,5952770,5952770,0,0,utRho04
oppA,2602170,2602364,2602170,194,10364,utRho04
orn,8783168,8783208,8783168,40,0,utRho04
osmB,2686952,2686952,2686656,296,132,utRho04
osmC,3113192,3113250,3113192,58,0,utRho04
osmE,3644566,3644566,3644512,54,0,utRho04
osmF,4439046,4439046,4438962,84,392,utRho04
osmY,9222306,9222792,9222306,486,26,utRho04
otsA,3963302,3963302,3963224,78,12,utRho04
otsB,3964930,3964930,3964774,156,112,utRho04
oxc,4984288,4984288,4983900,388,0,utRho04
oxyR,8316914,8316980,8316914,66,0,utRho04
oxyS,8316788,8316788,8316788,0,0,utRho04
paaA,2907730,2907854,2907730,124,0,utRho04
paaX,2927018,2927078,2927018,60,0,utRho04
paaZ,2907340,2907340,2907284,56,0,utRho04
pabA,6981702,6981702,6981658,44,0,utRho04
pabB,3789256,3789610,3789256,354,132,utRho04
pabC,2306186,2306600,2306186,414,162,utRho04
pagP,1313052,1313114,1313052,62,0,utRho04
panB,299260,299260,299202,58,96,utRho04
panC,297840,297840,297590,250,356,utRho04
panD,293490,293490,293388,102,54,utRho04
panZ,7195656,7195968,7195656,312,0,utRho04
parC,6332060,6332060,6331946,114,26,utRho04
patA,6438916,6438988,6438916,72,0,utRho04
patD,3030830,3031156,3030830,326,0,utRho04
pbpC,5294986,5294986,5294650,336,12,utRho04
pbpG,4450132,4450132,4449740,392,24,utRho04
pck,7065358,7065636,7065358,278,1624,utRho04
pcnB,318782,318782,318252,530,608,utRho04
pdhR,244068,244184,244068,116,232,utRho04
pdxB,4875768,4875768,4875702,66,0,utRho04
pdxH,3436068,3436068,3436014,54,292,utRho04
pdxJ,5403626,5403626,5403458,168,90,utRho04
pdxK,5074638,5074638,5074474,164,74,utRho04
pepA,8972278,8972278,8971902,376,26,utRho04
pepD,511618,511618,511432,186,2330,utRho04
pepN,1981182,1981244,1981182,62,2,utRho04
pepQ,8062294,8062322,8062294,28,0,utRho04
pepT,2371646,2371688,2371646,42,0,utRho04
pfkA,8214948,8215104,8214948,156,302,utRho04
pfkB,3612646,3612740,3612646,94,0,utRho04
pflA,1902456,1902456,1902160,296,26,utRho04
pflB,1907850,1907850,1907108,742,1140,utRho04
pflD,8287716,8287990,8287716,274,0,utRho04
pgaA,2185046,2185046,2184578,468,4,utRho04
pgi,8467444,8467516,8467444,72,0,utRho04
pgk,12291428,12291428,12290488,940,2892,utRho04
pgl,1597078,1597172,1597078,94,0,utRho04
pgpB,2678324,2678660,2678324,336,48,utRho04
pgpC,5397276,5397276,5397100,176,0,utRho04
pgrR,2783744,2783982,2783744,238,0,utRho04
pheL,5475158,5475198,5475158,40,0,utRho04
pheM,7197204,7197204,7197080,124,128,utRho04
pheP,1203858,1203918,1203858,60,2,utRho04
pheU,8725254,8725254,8725252,2,0,utRho04
pheV,6220730,6220732,6220730,2,0,utRho04
phnC,8650412,8650412,8650330,82,8,utRho04
phoA,803414,803494,803414,80,0,utRho04
phoB,834202,834284,834202,82,0,utRho04
phoE,520316,520316,520200,116,0,utRho04
phoH,2169730,2169984,2169730,254,346,utRho04
phoP,2381016,2381016,2380894,122,472,utRho04
phoQ,2379880,2379880,2379552,328,890,utRho04
phoU,7815330,7815330,7815156,174,36,utRho04
phr,1478842,1479014,1478842,172,86,utRho04
pinE,2419054,2419370,2419054,316,0,utRho04
pinQ,3267168,3267244,3267168,76,600,utRho04
pinR,2867424,2867424,2867348,76,546,utRho04
pitA,7275224,7275284,7275224,60,0,utRho04
pitB,6272806,6272806,6272742,64,0,utRho04
pka,5439862,5439906,5439862,44,0,utRho04
plaP,4174476,4174476,4174124,352,776,utRho04
pldA,8009628,8009724,8009628,96,22,utRho04
pldB,8018028,8018340,8018028,312,170,utRho04
plsB,8513196,8513196,8512932,264,54,utRho04
pmbA,8915890,8915918,8915890,28,4,utRho04
pmrD,4747148,4747148,4747076,72,12,utRho04
pncB,1980828,1980828,1980712,116,66,utRho04
pncC,5648788,5648788,5648692,96,0,utRho04
pnp,6622652,6622652,6622336,316,56,utRho04
pntA,3355950,3355950,3355806,144,0,utRho04
pntB,3353096,3353096,3352720,376,24,utRho04
polA,8093880,8093932,8093880,52,66,utRho04
polB,131606,131606,131560,46,20,utRho04
potD,2365700,2365700,2365658,42,8,utRho04
potE,1436688,1436688,1436530,158,18,utRho04
potF,1787268,1787568,1787268,300,0,utRho04
poxB,1822152,1822152,1822098,54,0,utRho04
ppa,8899372,8899372,8899304,68,152,utRho04
ppc,8306380,8306380,8306196,184,156,utRho04
ppdA,5928440,5928440,5928354,86,782,utRho04
ppdD,235410,235410,235098,312,402,utRho04
pphA,3846770,3846770,3845938,832,1172,utRho04
pphB,5719474,5719520,5719474,46,0,utRho04
ppiA,6984898,6984898,6984594,304,0,utRho04
ppiC,7919682,7919682,7919626,56,8,utRho04
ppiD,923638,923830,923638,192,824,utRho04
ppk,5245748,5246088,5245748,340,380,utRho04
pppA,6228958,6228958,6228704,254,56,utRho04
ppsA,3574322,3574322,3574224,98,12,utRho04
ppsR,3574678,3574890,3574678,212,0,utRho04
pptA,3065716,3066104,3065716,388,0,utRho04
pqiA,2023318,2024002,2023318,684,124,utRho04
prc,3830054,3830054,3829632,422,12692,utRho04
preT,4467978,4468066,4467978,88,0,utRho04
prfC,9218688,9218828,9218688,140,682,utRho04
prkB,6968622,6968980,6968622,358,888,utRho04
prlC,7290476,7290476,7290364,112,280,utRho04
prlF,6553944,6554004,6553944,60,244,utRho04
proB,520432,520776,520432,344,156,utRho04
proC,811372,811372,811288,84,0,utRho04
proK,7417388,7417388,7417384,4,12,utRho04
proL,4572414,4572422,4572414,8,78,utRho04
proP,8660640,8661004,8660640,364,3500,utRho04
proS,437674,437674,437550,124,244,utRho04
proV,5609126,5609630,5609126,504,48,utRho04
prpB,697292,697364,697292,72,0,utRho04
prpR,696942,696942,696886,56,0,utRho04
prs,2524354,2524354,2523750,604,43112,utRho04
psd,8781276,8781276,8780720,556,2488,utRho04
psiE,8480600,8480650,8480600,50,0,utRho04
pspA,2736076,2736158,2736076,82,0,utRho04
pspF,2736080,2736080,2735824,256,0,utRho04
pspG,8525632,8525680,8525632,48,0,utRho04
pssA,5445156,5445454,5445156,298,1418,utRho04
pstB,7817112,7817112,7816732,380,138,utRho04
pstC,7821084,7821084,7820796,288,50,utRho04
pstS,23469408,23469408,23469150,258,72,utRho04
psuG,4517114,4517114,4516734,380,82,utRho04
psuT,4514992,4514992,4514670,322,0,utRho04
pth,2517084,2517084,2517026,58,42,utRho04
ptrA,5918022,5918022,5917768,254,22,utRho04
ptrB,3857730,3857730,3857678,52,2550,utRho04
ptsG,2315252,2315738,2315252,486,980,utRho04
ptsH,5066996,5067528,5066996,532,2334,utRho04
purA,8809328,8809374,8809328,46,2,utRho04
purC,5195562,5195562,5195236,326,16,utRho04
purD,8411972,8411972,8411862,110,24,utRho04
purE,1106284,1106284,1106200,84,862,utRho04
purH,8415254,8415254,8415064,190,84,utRho04
purL,5391178,5391178,5391086,92,332,utRho04
purM,5242306,5242394,5242306,88,20,utRho04
purR,3475378,3475688,3475378,310,810,utRho04
purT,3861438,3861762,3861438,324,174,utRho04
purU,2577512,2577512,2577248,264,896,utRho04
putA,2157850,2157850,2157764,86,0,utRho04
putP,2158336,2158610,2158336,274,286,utRho04
puuA,2721936,2721936,2721816,120,0,utRho04
puuC,2725456,2725486,2725456,30,0,utRho04
puuD,2722104,2722240,2722104,136,0,utRho04
puuP,2718746,2718746,2718374,372,614,utRho04
pykA,3874988,3875298,3874988,310,176,utRho04
pykF,3510934,3511396,3510934,462,1020,utRho04
pyrC,2245286,2245286,2245214,72,58,utRho04
pyrD,2009464,2009536,2009464,72,34,utRho04
pyrE,7631970,7631970,7631536,434,0,utRho04
pyrF,2683740,2683842,2683740,102,136,utRho04
pyrG,5819594,5819594,5819332,262,1872,utRho04
pyrH,383624,383710,383624,86,1162,utRho04
pyrL,8945490,8945490,8945066,424,0,utRho04
qmcA,1031646,1031646,1031546,100,36,utRho04
qor,8528608,8528608,8528462,146,140,utRho04
qseB,6339502,6339656,6339502,154,0,utRho04
queA,849970,850022,849970,52,300,utRho04
queE,5811212,5811212,5810836,376,0,utRho04
queF,5850642,5850696,5850642,54,6,utRho04
queG,8788184,8788184,8788134,50,408,utRho04
racC,2835630,2835630,2835526,104,2,utRho04
racR,2840898,2840898,2840482,416,0,utRho04
raiA,5474208,5474308,5474208,100,126,utRho04
rarD,8008594,8008594,8008356,238,76,utRho04
ravA,7862256,7862256,7862186,70,0,utRho04
rayT,495088,495274,495088,186,0,utRho04
rbn,4763162,4763216,4763162,54,0,utRho04
rbsD,7866644,7866702,7866644,58,0,utRho04
rcnA,4371654,4371834,4371654,180,2,utRho04
rcnB,4373768,4373920,4373768,152,92,utRho04
rcnR,4371806,4371806,4371592,214,2,utRho04
rcsA,4047672,4047936,4047672,264,170,utRho04
rcsB,4631390,4632354,4631390,964,1144,utRho04
rcsC,4640162,4640162,4639656,506,180,utRho04
rcsD,4626904,4626976,4626904,72,486,utRho04
rdgB,6193240,6193362,6193240,122,118,utRho04
rdlA,2538646,2538646,2538646,0,0,utRho04
rdlB,2539712,2539716,2539712,4,0,utRho04
rdlC,2540782,2540786,2540782,4,0,utRho04
rdlD,7400272,7400272,7400272,0,0,utRho04
rdoA,8084782,8084830,8084782,48,46,utRho04
recA,11295276,11295276,11295076,200,956,utRho04
recC,5925014,5925014,5924856,158,118,utRho04
recF,7763722,7763722,7762442,1280,11334,utRho04
recN,5503518,5503590,5503518,72,0,utRho04
recQ,8011666,8011728,8011666,62,0,utRho04
relA,5828554,5828554,5827302,1252,462,utRho04
relB,3291806,3291806,3291744,62,0,utRho04
rem,3289950,3289950,3289804,146,0,utRho04
rep,7921294,7921354,7921294,60,16,utRho04
rfaD,7587730,7587974,7587730,244,64,utRho04
rfaE,6393852,6393852,6393506,346,8,utRho04
rfaH,8049930,8049930,8049642,288,1260,utRho04
rfbX,4219436,4219436,4219168,268,1380,utRho04
rfe,7935600,7935832,7935600,232,32,utRho04
rhaB,8194944,8194944,8194896,48,0,utRho04
rhaD,8188770,8188770,8188544,226,0,utRho04
rhaS,8195422,8195472,8195422,50,0,utRho04
rhaT,8201132,8201132,8201050,82,0,utRho04
rhlE,1661566,1661744,1661566,178,288,utRho04
rhoL,47593944,47594772,47593944,828,262440,utRho04
rhsB,7238006,7238384,7238006,378,150,utRho04
rhsC,1458758,1459166,1458758,408,0,utRho04
rhsD,1046132,1046522,1046132,390,0,utRho04
rhtA,1700608,1700608,1700194,414,0,utRho04
rhtC,8015478,8015514,8015478,36,1394,utRho04
ribA,2678468,2678468,2678320,148,24,utRho04
ribC,3486916,3486916,3486484,432,176,utRho04
ribE,869008,869294,869008,286,4826,utRho04
ribF,42766,42814,42766,48,22,utRho04
ridA,8941892,8941892,8941826,66,58,utRho04
rihA,1369204,1369204,1368824,380,344,utRho04
rihB,4510504,4510504,4510372,132,0,utRho04
rimJ,2251044,2251124,2251044,80,0,utRho04
rimK,1783752,1783934,1783752,182,136,utRho04
rimL,2997486,2997876,2997486,390,130,utRho04
rimO,1756140,1756140,1756070,70,0,utRho04
rimP,6636350,6636350,6636012,338,642,utRho04
rlmA,3814172,3814172,3814120,52,298,utRho04
rlmD,5830086,5830086,5830000,86,0,utRho04
rlmE,6655520,6655520,6655328,192,2432,utRho04
rlmF,1684384,1684664,1684384,280,26,utRho04
rlmG,6471784,6471784,6471750,34,20,utRho04
rlmI,2060002,2060002,2059938,64,30,utRho04
rlmJ,7290700,7290770,7290700,70,70,utRho04
rlmL,2015344,2015688,2015344,344,578,utRho04
rlpA,1330444,1330444,1330380,64,262,utRho04
rluA,120900,120900,120692,208,138,utRho04
rluF,8460324,8460708,8460324,384,0,utRho04
rmf,2031006,2031430,2031006,424,956,utRho04
rna,1290068,1290068,1290006,62,30,utRho04
rnb,2698258,2698258,2697824,434,2594,utRho04
rnc,10816892,10816892,10816252,640,7100,utRho04
rnd,3776122,3776122,3775982,140,140,utRho04
rne,2289746,2289746,2288734,1012,8722,utRho04
rnhA,472082,472082,472004,78,324,utRho04
rnk,1288360,1288360,1287934,426,310,utRho04
rnlA,5531788,5531836,5531788,48,84,utRho04
rnlB,5533414,5533968,5533414,554,1560,utRho04
rnpB,19623552,19623552,19623552,0,0,utRho04
rob,9270706,9270706,9270620,86,0,utRho04
rodZ,5285868,5285868,5285688,180,112,utRho04
rpe,7030306,7030306,7030118,188,244,utRho04
rph,15266320,15266320,15266196,124,0,utRho04
rpiA,6118706,6118706,6118650,56,34,utRho04
rpiB,8626514,8626700,8626514,186,0,utRho04
rpiR,8626274,8626274,8625982,292,0,utRho04
rplJ,8359246,8359992,8359246,746,7720,utRho04
rplK,8356708,8356894,8356708,186,680,utRho04
rplM,6757344,6757344,6757302,42,7382,utRho04
rplN,6896444,6896444,6896298,146,6236,utRho04
rplS,5489284,5489284,5489060,224,10472,utRho04
rplT,7199052,7199052,7198996,56,724,utRho04
rplU,6667036,6667036,6666902,134,150,utRho04
rplY,4564866,4565034,4564866,168,48,utRho04
rpmA,6666450,6666450,6666238,212,460,utRho04
rpmB,15247980,15247980,15246696,1284,76920,utRho04
rpmE,8253816,8254026,8253816,210,768,utRho04
rpmF,2294676,2294734,2294676,58,34442,utRho04
rpmH,7768130,7768672,7768130,542,4166,utRho04
rpmI,3600854,3600854,3599998,856,11886,utRho04
rpoB,8362126,8362490,8362126,364,772,utRho04
rpoD,6424946,6426094,6424946,1148,13744,utRho04
rpoE,5420372,5420372,5420024,348,60,utRho04
rpoH,7202006,7202006,7201566,440,14672,utRho04
rpoN,6689324,6689434,6689324,110,62,utRho04
rpoS,5736236,5736236,5735102,1134,1784,utRho04
rpoZ,7644154,7644212,7644154,58,928,utRho04
rppH,5937986,5937986,5937954,32,0,utRho04
rprA,3540744,3540744,3540744,0,0,utRho04
rpsA,1923434,1923990,1923434,556,114030,utRho04
rpsF,8850050,8850236,8850050,186,27816,utRho04
rpsI,6756580,6756580,6756414,166,6624,utRho04
rpsJ,6906884,6906884,6906540,344,10088,utRho04
rpsL,6949242,6949242,6949104,138,196,utRho04
rpsM,6885130,6885130,6884942,188,1816,utRho04
rpsO,13247144,13247144,13246736,408,1180,utRho04
rpsP,5492508,5492508,5492370,138,66,utRho04
rpsT,42420,42420,42156,264,534,utRho04
rpsU,12842584,12843124,12842584,540,1776,utRho04
rraA,8238716,8238716,8238660,56,250,utRho04
rraB,8956768,8956946,8956768,178,0,utRho04
rrsA,8070478,8071062,8070478,584,5694,utRho04
rrsB,16665468,16666636,16665468,1168,12120,utRho04
rrsC,7883032,7883616,7883032,584,7184,utRho04
rrsD,6858094,6858094,6857524,570,472,utRho04
rrsE,8415726,8416294,8415726,568,1410,utRho04
rrsG,5462896,5462896,5462314,582,4452,utRho04
rrsH,446970,447542,446970,572,1544,utRho04
rsd,8393908,8393908,8393616,292,10,utRho04
rseA,5419264,5419264,5418808,456,530,utRho04
rseP,392940,393092,392940,152,198,utRho04
rseX,4067298,4067298,4067298,0,0,utRho04
rsfS,1338144,1338144,1338072,72,224,utRho04
rsgA,8783132,8783132,8783018,114,34,utRho04
rsmA,105176,105176,104860,316,2836,utRho04
rsmB,6869982,6870414,6869982,432,476,utRho04
rsmC,9215736,9215736,9215400,336,340,utRho04
rsmD,7208594,7208786,7208594,192,40,utRho04
rsmE,6182036,6182268,6182036,232,166,utRho04
rsmG,7847512,7847512,7847360,152,1806,utRho04
rsmH,180020,180188,180020,168,146,utRho04
rsmI,6587106,6587106,6586670,436,568,utRho04
rssA,2578212,2578412,2578212,200,226,utRho04
rssB,2580440,2580484,2580440,44,142,utRho04
rstA,3364276,3364300,3364276,24,0,utRho04
rsuA,4561096,4561096,4560966,130,322,utRho04
rsxA,3411510,3411534,3411510,24,102,utRho04
rtcA,7114004,7114004,7113698,306,84,utRho04
rtcB,7116214,7116214,7116158,56,0,utRho04
rtn,4541356,4541452,4541356,96,86,utRho04
rutA,2148052,2148052,2148022,30,0,utRho04
rutG,2140090,2140090,2139678,412,0,utRho04
rutR,2148226,2148484,2148226,258,0,utRho04
ruvA,7784096,7784096,7783904,192,0,utRho04
ruvB,7782176,7782176,7781424,752,420,utRho04
ruvC,3894878,3894878,3894752,126,0,utRho04
rybB,1776114,1776114,1776114,0,0,utRho04
rydB,3529860,3529860,3529322,538,140,utRho04
rydC,2983012,2983012,2983012,0,0,utRho04
ryfA,5307398,5307710,5307398,312,0,utRho04
ryfD,5468590,5468590,5468590,0,0,utRho04
ryhB,7162032,7162032,7162032,0,0,utRho04
ryjA,8556132,8556132,8556132,0,0,utRho04
ryjB,9055954,9055954,9055954,0,0,utRho04
sad,3229598,3229598,3229406,192,0,utRho04
safA,3168056,3168056,3167918,138,0,utRho04
sanA,4465368,4465756,4465368,388,36,utRho04
sapF,2705314,2705314,2705268,46,28,utRho04
sbcB,4165456,4165512,4165456,56,8,utRho04
sbcC,831694,831694,831506,188,166,utRho04
sbcD,833954,833954,833904,50,0,utRho04
sbmA,793106,793278,793106,172,124,utRho04
sbmC,4162650,4162650,4162524,126,2,utRho04
sdaA,3793618,3793864,3793618,246,78,utRho04
sdaC,5856070,5856458,5856070,388,944,utRho04
sdhC,1509916,1510354,1509916,438,21602,utRho04
sdhD,1510808,1511120,1510808,312,5986,utRho04
sdiA,3993834,3993834,3993664,170,64,utRho04
secE,8354354,8354716,8354354,362,678,utRho04
secG,6645180,6645180,6645010,170,2882,utRho04
selA,7522594,7522594,7522498,96,266,utRho04
selB,7519850,7519850,7519722,128,126,utRho04
selC,7672396,7672444,7672396,48,0,utRho04
selD,3696058,3696058,3696016,42,2592,utRho04
seqA,1425884,1425974,1425884,90,230,utRho04
serA,6117098,6117098,6116820,278,88,utRho04
serB,9249712,9249790,9249712,78,0,utRho04
serC,3830380,3830612,3830380,232,24,utRho04
serS,1878730,1878856,1878730,126,1760,utRho04
serT,2063438,2063438,2063424,14,0,utRho04
serU,4087124,4087124,4087114,10,82,utRho04
serV,5637394,5637394,5637290,104,182,utRho04
serW,1852014,1852014,1851942,72,188,utRho04
serX,2195352,2195352,2195304,48,24,utRho04
setB,4527426,4527726,4527426,300,28,utRho04
setC,7673488,7673906,7673488,418,0,utRho04
sfmA,1116124,1116424,1116124,300,0,utRho04
sfmC,1117606,1117948,1117606,342,0,utRho04
sfsA,323030,323030,322972,58,332,utRho04
sfsB,6669592,6669818,6669592,226,164,utRho04
sgrR,154676,154676,154598,78,0,utRho04
sgrS,154734,154734,154734,0,0,utRho04
shiA,4107068,4107286,4107068,218,0,utRho04
sibA,4306622,4306622,4306622,0,0,utRho04
sibB,4307292,4307292,4307292,0,0,utRho04
sibC,6113702,6113702,6113702,0,0,utRho04
sibD,6389730,6389730,6389730,0,0,utRho04
sibE,6390480,6390480,6390480,0,0,utRho04
sixA,4913998,4913998,4913624,374,12,utRho04
slp,7307872,7307922,7307872,50,0,utRho04
slt,9261400,9261466,9261400,66,22,utRho04
slyA,3442028,3442028,3441648,380,24,utRho04
slyB,3439496,3439752,3439496,256,84,utRho04
slyD,6957398,6957398,6956994,404,352,utRho04
slyX,6954862,6955280,6954862,418,5298,utRho04
smf,6867372,6867372,6867120,252,48,utRho04
smpB,5509534,5509792,5509534,258,900,utRho04
smrA,2811872,2811958,2811872,86,32,utRho04
smrB,4896872,4897212,4896872,340,0,utRho04
smtA,1946808,1947074,1946808,266,0,utRho04
sodA,8201518,8201620,8201518,102,4084,utRho04
sodB,3470646,3470756,3470646,110,0,utRho04
sodC,3449358,3449358,3449310,48,20,utRho04
sohB,2658568,2658664,2658568,96,36,utRho04
sokB,2984232,2984238,2984232,6,6,utRho04
solA,2241218,2241218,2241172,46,16,utRho04
soxR,8554894,8554938,8554894,44,0,utRho04
soxS,8554846,8554846,8554766,80,0,utRho04
speA,6172096,6172096,6171822,274,12,utRho04
speB,6167892,6167892,6167594,298,70,utRho04
speC,6218350,6218350,6218310,40,0,utRho04
spf,8099798,8099798,8099798,0,0,utRho04
sppA,3697422,3697674,3697422,252,26,utRho04
spy,3651376,3651376,3651250,126,0,utRho04
sra,3112092,3112092,3111926,166,66,utRho04
sraB,2293178,2293178,2293178,0,0,utRho04
sraC,3846132,3846132,3846132,0,0,utRho04
srlA,5651582,5651664,5651582,82,40,utRho04
srlR,5657720,5658094,5657720,374,48,utRho04
srmB,5425752,5425792,5425752,40,94,utRho04
sroA,151216,151216,151216,0,0,utRho04
sroG,6369436,6369436,6369436,0,0,utRho04
sroH,8380974,8380974,8380974,0,0,utRho04
ssb,8548022,8548250,8548022,228,90,utRho04
sseA,5304782,5304988,5304782,206,4086,utRho04
sspA,6755138,6755138,6754840,298,700,utRho04
ssrA,5511014,5511186,5511014,172,116,utRho04
ssrS,12223036,12223932,12223036,896,2084,utRho04
sstT,6479726,6479888,6479726,162,0,utRho04
ssuB,1988282,1988282,1988088,194,0,utRho04
ssuE,1995126,1995126,1995024,102,0,utRho04
sthA,8321604,8321604,8321580,24,1448,utRho04
stpA,5597156,5597156,5596990,166,58,utRho04
sucA,3034344,3034824,3034344,480,1360,utRho04
sufA,3528836,3528836,3528772,64,24,utRho04
sufE,3518962,3518962,3518580,382,848,utRho04
sugE,8753588,8753750,8753588,162,506,utRho04
sulA,2041894,2041894,2041838,56,70,utRho04
syd,5850738,5850738,5850560,178,74,utRho04
symE,9159834,9159834,9159680,154,12,utRho04
symR,9159670,9159670,9159670,0,0,utRho04
tabA,8949566,8949724,8949566,158,0,utRho04
talA,5157140,5157332,5157140,192,0,utRho04
talB,16382,16476,16382,94,3982,utRho04
tam,3214442,3214692,3214442,250,46,utRho04
tamA,8884540,8884764,8884540,224,68,utRho04
tar,3945432,3945432,3945382,50,12,utRho04
tas,5943138,5943194,5943138,56,152,utRho04
tatA,16087636,16087780,16087636,144,192,utRho04
tatE,1317742,1317894,1317742,152,18,utRho04
tauA,770410,770464,770410,54,0,utRho04
tdcA,6534186,6534186,6534130,56,0,utRho04
tdcG,6519652,6519652,6519298,354,68,utRho04
tdcR,6534380,6534760,6534380,380,12,utRho04
tdk,2586986,2587054,2586986,68,82,utRho04
tehA,3001072,3001146,3001072,74,0,utRho04
tesA,1039898,1039898,1039530,368,144,utRho04
tesB,950402,950402,950322,80,0,utRho04
tfaE,2418532,2418532,2418238,294,4,utRho04
tfaQ,3269912,3269912,3269770,142,46,utRho04
tff,379424,379256,379424,168,0,utRho04
tgt,852110,852274,852110,164,4,utRho04
thiD,4369346,4369346,4369032,314,0,utRho04
thiI,882936,883098,882936,162,288,utRho04
thiM,4370902,4370902,4370602,300,316,utRho04
thiQ,146170,146170,145854,316,366,utRho04
thrL,592,760,592,168,392,utRho04
thrS,7210932,7210932,7210280,652,2036,utRho04
thrU,8350762,8350776,8350762,14,0,utRho04
thrV,6847414,6847414,6847310,104,78174,utRho04
thrW,525682,525742,525682,60,1018,utRho04
thyA,5930696,5930696,5930310,386,2000,utRho04
tig,909986,910266,909986,280,366,utRho04
tisB,7706674,7707106,7706674,432,256,utRho04
tktA,6163414,6163414,6163270,144,34,utRho04
tktB,5158616,5159272,5158616,656,272,utRho04
tldD,6784368,6784368,6784056,312,12,utRho04
tmcA,5191876,5191876,5191718,158,0,utRho04
tnaC,15553644,15553740,15553644,96,84,utRho04
tolB,1555074,1555480,1555074,406,280,utRho04
tolC,6356008,6356230,6356008,222,404,utRho04
tomB,961588,961588,961416,172,4222,utRho04
tonB,2622108,2622178,2622108,70,66,utRho04
topA,2661578,2662096,2661578,518,946,utRho04
torC,2116112,2116168,2116112,56,72,utRho04
torR,2115968,2115968,2115908,60,168,utRho04
torS,2112364,2112364,2112356,8,0,utRho04
torT,2112414,2112522,2112414,108,0,utRho04
tpiA,8223138,8223138,8223014,124,46,utRho04
tppB,3425342,3425538,3425342,196,3254,utRho04
tpr,2574376,2574376,2574376,0,0,utRho04
tpx,2777688,2777688,2777622,66,706,utRho04
tqsA,3347780,3347826,3347780,46,0,utRho04
treA,2494850,2494850,2494752,98,146,utRho04
treB,8932420,8932420,8932360,60,78,utRho04
treF,7339102,7339184,7339102,82,28,utRho04
treR,8934694,8934694,8934492,202,0,utRho04
trg,2984878,2984940,2984878,62,24,utRho04
trkG,2847342,2847564,2847342,222,2,utRho04
trmA,8326590,8326590,8326540,50,64,utRho04
trpA,2634678,2634678,2634444,234,754,utRho04
trpC,2639888,2639888,2639570,318,276,utRho04
trpL,5292432,5292432,5292328,104,0,utRho04
trpR,9265408,9265520,9265408,112,68,utRho04
trpS,7027394,7027394,7027276,118,632,utRho04
trpT,7893560,7893914,7893560,354,49314,utRho04
trxA,7931294,7931522,7931294,228,440,utRho04
trxB,1864156,1864156,1864100,56,114,utRho04
trxC,5437350,5437470,5437350,120,116,utRho04
tsaD,6421256,6421256,6421086,170,0,utRho04
tsgA,6985038,6985136,6985038,98,0,utRho04
tsr,9182824,9183314,9182824,490,36,utRho04
tsx,864490,864490,864026,464,686,utRho04
ttcA,2823970,2823970,2823896,74,2486,utRho04
ttdA,6412848,6412926,6412848,78,0,utRho04
ttdR,6412760,6412760,6412512,248,0,utRho04
tufA,6943448,6943448,6942658,790,101578,utRho04
tus,3368346,3368518,3368346,172,2,utRho04
tusA,7218040,7218040,7217992,48,26,utRho04
tusB,6950218,6950218,6949930,288,706,utRho04
tynA,2902996,2902996,2902698,298,0,utRho04
typA,8116460,8116814,8116460,354,4874,utRho04
tyrB,8534164,8534228,8534164,64,1486,utRho04
tyrP,3979004,3979362,3979004,358,60,utRho04
tyrR,2773384,2773440,2773384,56,8,utRho04
tyrS,3434566,3434566,3434444,122,0,utRho04
tyrT,2575330,2575330,2575244,86,98,utRho04
uacT,6062378,6062734,6062378,356,0,utRho04
ubiC,8504886,8505012,8504886,126,82,utRho04
ubiD,8049618,8049976,8049618,358,1262,utRho04
ubiE,8037494,8037710,8037494,216,112,utRho04
ubiG,4679078,4679134,4679078,56,0,utRho04
ucpA,5089342,5089342,5089246,96,0,utRho04
udp,8032782,8032862,8032782,80,6,utRho04
ugd,4199470,4199470,4199226,244,6,utRho04
ugpB,7184852,7184852,7184650,202,244,utRho04
ugpQ,7176600,7176600,7176226,374,92,utRho04
uhpT,7694396,7694396,7694334,62,90,utRho04
uidA,3392304,3392304,3392142,162,50,utRho04
uidC,3386012,3386012,3385702,310,0,utRho04
uidR,3394150,3394150,3394104,46,44,utRho04
ulaA,8839854,8839960,8839854,106,126,utRho04
ulaG,8839350,8839350,8839250,100,0,utRho04
ulaR,8837124,8837124,8836906,218,0,utRho04
umpG,5741372,5741372,5740548,824,48,utRho04
umpH,1400704,1400704,1400652,52,138,utRho04
umuD,2461476,2461534,2461476,58,0,utRho04
ung,5433476,5433508,5433476,32,20,utRho04
uof,2843316,2843316,2842900,416,7436,utRho04
upp,5241818,5241818,5241744,74,292,utRho04
usg,4873780,4873780,4873298,482,42,utRho04
ushA,1009772,1009828,1009772,56,0,utRho04
uspA,7279966,7280222,7279966,256,650,utRho04
uspB,7279696,7279696,7279440,256,782,utRho04
uspC,3959172,3959506,3959172,334,16,utRho04
uspE,2797318,2797318,2797244,74,102,utRho04
uspF,2871282,2871282,2871238,44,22,utRho04
uspG,1283806,1283806,1283734,72,336,utRho04
uvrA,8547872,8547872,8547742,130,138,utRho04
uvrB,1626304,1627052,1626304,748,1380,utRho04
uvrC,3989758,3989758,3989412,346,106,utRho04
uvrD,7995814,7995966,7995814,152,126,utRho04
uvrY,3990812,3990812,3990718,94,36,utRho04
uxaB,3221474,3221474,3221360,114,0,utRho04
uxaC,6489714,6489714,6489482,232,30,utRho04
uxuA,9103036,9103272,9103036,236,150,utRho04
uxuR,9108916,9109152,9108916,236,8,utRho04
valS,8967854,8967854,8967674,180,358,utRho04
valU,5041848,5041862,5041848,14,44,utRho04
valV,3492830,3492870,3492830,40,8,utRho04
ves,3649968,3649968,3649874,94,30,utRho04
waaA,7616512,7617080,7616512,568,466,utRho04
waaH,7580298,7580298,7580162,136,0,utRho04
waaQ,7616476,7616476,7616196,280,54,utRho04
waaU,7598996,7598996,7598624,372,142,utRho04
waaY,7602272,7602272,7601930,342,4412,utRho04
wbbH,4214888,4214888,4214452,436,4456,utRho04
wbbK,4209212,4209212,4209018,194,308,utRho04
wcaM,4231868,4231868,4231792,76,0,utRho04
wrbA,2135516,2135516,2135416,100,0,utRho04
wza,4275166,4275166,4274486,680,0,utRho04
wzxC,4240674,4240674,4240316,358,0,utRho04
wzzB,4196950,4196950,4196602,348,138,utRho04
xanP,7657642,7657890,7657642,248,0,utRho04
xanQ,6048520,6048702,6048520,182,0,utRho04
xapA,5049820,5049820,5049756,64,0,utRho04
xapR,10090252,10090252,10089908,344,0,utRho04
xdhA,6000514,6000690,6000514,176,90,utRho04
xerD,6079702,6079702,6079486,216,0,utRho04
xseA,5268394,5268464,5268394,70,208,utRho04
xseB,882746,882746,882686,60,156,utRho04
xthA,3664798,3664856,3664798,58,0,utRho04
xylA,7461614,7461614,7461530,84,46,utRho04
xylE,8484540,8484540,8484508,32,0,utRho04
xylF,7462138,7462262,7462138,124,0,utRho04
xylR,7469812,7469958,7469812,146,0,utRho04
yaaA,13230,13230,12918,312,156,utRho04
yaaI,23876,23876,23572,304,10,utRho04
yaaJ,16034,16034,15918,116,80,utRho04
yaaU,91184,91614,91184,430,0,utRho04
yaaW,23084,23084,22712,372,0,utRho04
yaaX,10060,10468,10060,408,102,utRho04
yabI,142542,142702,142542,160,8,utRho04
yacC,273880,273880,273834,46,4000,utRho04
yacH,262932,262932,262520,412,36,utRho04
yacL,268678,268776,268678,98,38,utRho04
yadD,293796,293936,293796,140,0,utRho04
yadE,289930,290162,289930,232,576,utRho04
yadN,314110,314110,313766,344,8,utRho04
yadS,355572,355572,355248,324,368,utRho04
yadV,312470,312470,312402,68,2,utRho04
yaeF,434270,434270,434006,264,42,utRho04
yaeP,428374,428374,428250,124,24,utRho04
yaeQ,428176,428582,428176,406,48,utRho04
yaeR,423716,423754,423716,38,0,utRho04
yafC,462166,462166,461762,404,322,utRho04
yafD,462128,462244,462128,116,52,utRho04
yafK,491986,491986,491610,376,1996,utRho04
yafL,493282,493424,493282,142,22,utRho04
yafN,503938,504010,503938,72,0,utRho04
yafS,469568,469632,469568,64,328,utRho04
yafT,474470,474670,474470,200,0,utRho04
yafV,480432,480432,480378,54,34,utRho04
yafZ,536052,536052,536010,42,0,utRho04
yagE,564446,564556,564446,110,0,utRho04
yagG,570414,570790,570414,376,26,utRho04
yagI,578384,578384,578324,60,0,utRho04
yagK,586236,586236,585896,340,18,utRho04
yagL,588062,588062,587836,226,0,utRho04
yagN,591342,591342,591158,184,426,utRho04
yahA,663746,664742,663746,996,152,utRho04
yahC,670136,670136,670044,92,0,utRho04
yahE,671478,671850,671478,372,0,utRho04
yahM,690504,690808,690504,304,32,utRho04
yahN,692872,692872,692674,198,22,utRho04
yahO,692864,692968,692864,104,22,utRho04
yaiE,816296,816354,816296,58,6,utRho04
yaiI,811396,811528,811396,132,0,utRho04
yaiO,761946,761946,761684,262,54,utRho04
yaiP,767970,767970,767870,100,0,utRho04
yaiS,769660,769660,769232,428,0,utRho04
yaiV,788922,788922,788922,0,0,utRho04
yaiY,799094,799094,798666,428,98,utRho04
yaiZ,798888,799186,798888,298,442,utRho04
yajC,854410,854574,854410,164,1182,utRho04
yajD,860938,861210,860938,272,620,utRho04
yajI,866068,866068,865702,366,100,utRho04
yajL,887496,887496,887282,214,56,utRho04
yajQ,889316,889366,889316,50,14,utRho04
yajR,893374,893374,893332,42,360,utRho04
ybaB,987418,988152,987418,734,2118,utRho04
ybaL,1006590,1006590,1006476,114,44,utRho04
ybaM,980648,980648,980542,106,966,utRho04
ybaN,981436,981764,981436,328,262,utRho04
ybaO,936704,936766,936704,62,22,utRho04
ybaP,1016568,1016568,1016160,408,680,utRho04
ybaQ,1016348,1016436,1016348,88,0,utRho04
ybaS,1023146,1023282,1023146,136,28,utRho04
ybaV,927504,927874,927504,370,58,utRho04
ybaY,950490,950758,950490,268,64,utRho04
ybbB,1062724,1062724,1062452,272,48,utRho04
ybbJ,1030154,1030154,1029718,436,316,utRho04
ybbL,1031784,1031838,1031784,54,0,utRho04
ybbN,1037136,1037136,1036558,578,716,utRho04
ybbO,1038658,1038658,1038298,360,700,utRho04
ybbY,1080718,1081130,1080718,412,40,utRho04
ybcH,1176140,1176140,1175962,178,0,utRho04
ybcI,1113264,1113264,1113106,158,826,utRho04
ybcJ,1114050,1114050,1113746,304,42,utRho04
ybcK,1137502,1137804,1137502,302,28,utRho04
ybcL,1141690,1141786,1141690,96,0,utRho04
ybcN,1144628,1144932,1144628,304,0,utRho04
ybcQ,1147548,1147912,1147548,364,0,utRho04
ybcW,1159610,1159760,1159610,150,0,utRho04
ybdD,1263982,1264364,1263982,382,248,utRho04
ybdF,1212106,1212106,1211772,334,0,utRho04
ybdH,1267048,1267048,1266954,94,12,utRho04
ybdJ,1212822,1212822,1212398,424,54,utRho04
ybdK,1215122,1215122,1214766,356,308,utRho04
ybdL,1267114,1267172,1267114,58,0,utRho04
ybdM,1271110,1271110,1270752,358,242,utRho04
ybdN,1273372,1273372,1273138,234,0,utRho04
ybdR,1283844,1284176,1283844,332,380,utRho04
ybeD,1325412,1325412,1325284,128,246,utRho04
ybeF,1323090,1323090,1322756,334,84,utRho04
ybeL,1349986,1350036,1349986,50,2,utRho04
ybeQ,1353412,1353412,1353094,318,0,utRho04
ybeR,1353120,1353422,1353120,302,0,utRho04
ybeT,1358832,1358832,1358812,20,0,utRho04
ybeU,1358924,1359016,1358924,92,0,utRho04
ybeZ,1386938,1386938,1386834,104,1946,utRho04
ybfA,1458074,1458268,1458074,194,0,utRho04
ybfE,1423878,1423878,1423796,82,288,utRho04
ybfF,1425692,1425692,1425604,88,468,utRho04
ybfH,1433282,1433282,1433194,88,0,utRho04
ybgA,1477840,1478002,1477840,162,0,utRho04
ybgC,1549288,1549504,1549288,216,36,utRho04
ybgD,1505916,1505916,1505590,326,220,utRho04
ybgI,1485238,1485654,1485238,416,0,utRho04
ybgO,1498370,1498370,1497964,406,36,utRho04
ybgS,1570992,1570992,1570634,358,0,utRho04
ybhA,1597184,1597184,1596862,322,12,utRho04
ybhB,1616070,1616070,1615818,252,122,utRho04
ybhC,1614642,1614642,1614562,80,460,utRho04
ybhD,1601418,1601418,1601276,142,0,utRho04
ybhH,1601104,1601518,1601104,414,0,utRho04
ybhK,1633384,1633384,1633294,90,2,utRho04
ybhM,1641556,1641586,1641556,30,0,utRho04
ybhN,1645296,1645296,1644996,300,0,utRho04
ybhQ,1649202,1649260,1649202,58,0,utRho04
ybiA,1665920,1665920,1665900,20,0,utRho04
ybiI,1676968,1676968,1676912,56,6,utRho04
ybiO,1691328,1691328,1690960,368,156,utRho04
ybiP,1705252,1705252,1705194,58,1892,utRho04
ybiS,1711572,1711572,1711488,84,352,utRho04
ybiT,1711894,1711926,1711894,32,18,utRho04
ybiU,1718212,1718212,1718122,90,0,utRho04
ybiV,1720176,1720176,1720056,120,0,utRho04
ybiW,1725566,1725566,1725212,354,0,utRho04
ybiX,1678548,1678548,1678414,134,572,utRho04
ybjC,1781784,1781826,1781784,42,0,utRho04
ybjE,1830154,1830154,1829714,440,58,utRho04
ybjG,1767016,1767016,1766776,240,528,utRho04
ybjL,1779882,1779882,1779638,244,124,utRho04
ybjM,1779770,1780178,1779770,408,82,utRho04
ybjO,1795704,1795978,1795704,274,0,utRho04
ybjP,1809046,1809046,1808934,112,0,utRho04
ybjQ,1809034,1809186,1809034,152,0,utRho04
ybjS,1813796,1813796,1813506,290,152,utRho04
ybjX,1838206,1838206,1838168,38,0,utRho04
ycaD,1891438,1891742,1891438,304,0,utRho04
ycaI,1928210,1928640,1928210,430,258,utRho04
ycaK,1899094,1899336,1899094,242,28,utRho04
ycaL,1920264,1920528,1920264,264,0,utRho04
ycaM,1894240,1894458,1894240,218,20,utRho04
ycaR,1941284,1941346,1941284,62,1050,utRho04
ycbB,1961862,1962094,1961862,232,0,utRho04
ycbJ,1943344,1943504,1943344,160,0,utRho04
ycbK,1966046,1966150,1966046,104,492,utRho04
ycbZ,2036920,2036920,2036598,322,140,utRho04
yccA,2062886,2062886,2062836,50,356,utRho04
yccF,2048730,2048730,2048696,34,10,utRho04
yccS,2047988,2047988,2047766,222,34,utRho04
yccT,2055674,2055674,2055546,128,0,utRho04
yccX,2059960,2060128,2059960,168,104,utRho04
ycdT,2185682,2185752,2185682,70,0,utRho04
ycdU,2191266,2191686,2191266,420,0,utRho04
ycdZ,2200504,2200592,2200504,88,198,utRho04
yceA,2233544,2233614,2233544,70,58,utRho04
yceD,2293298,2293588,2293298,290,4238,utRho04
yceF,2293522,2293522,2293190,332,2412,utRho04
yceH,2252154,2252314,2252154,160,346,utRho04
yceI,2237282,2237282,2236952,330,134,utRho04
yceJ,2238142,2238142,2238092,50,80,utRho04
yceM,2253208,2253612,2253208,404,28,utRho04
yceO,2239264,2239264,2238894,370,220,utRho04
yceQ,2288760,2289004,2288760,244,6678,utRho04
ycfD,2376540,2376540,2376480,60,152,utRho04
ycfJ,2334814,2335198,2334814,384,140,utRho04
ycfS,2340834,2340834,2340748,86,0,utRho04
ycfT,2350658,2350658,2350330,328,36,utRho04
ycfZ,2362760,2362760,2362534,226,358,utRho04
ycgB,2474570,2474570,2474482,88,46,utRho04
ycgG,2434614,2434656,2434614,42,0,utRho04
ycgJ,2452956,2453200,2452956,244,0,utRho04
ycgL,2455218,2455362,2455218,144,8,utRho04
ycgN,2457366,2457660,2457366,294,0,utRho04
ycgR,2489112,2489112,2489054,58,0,utRho04
ycgV,2512222,2512222,2511904,318,156,utRho04
ycgX,2426568,2426568,2426214,354,12844,utRho04
ycgY,2490166,2490320,2490166,154,2,utRho04
ycgZ,2431504,2431578,2431504,74,0,utRho04
ychE,2596904,2597196,2596904,292,136,utRho04
ychF,2515764,2515764,2515624,140,0,utRho04
ychH,2517476,2517582,2517476,106,164,utRho04
ychJ,2578354,2578354,2578264,90,2,utRho04
ychN,2547310,2547310,2547198,112,20,utRho04
ychO,2547520,2547850,2547520,330,320,utRho04
ychQ,2533798,2533848,2533798,50,100,utRho04
yciA,2624828,2624828,2624492,336,268,utRho04
yciB,2626110,2626110,2625780,330,2128,utRho04
yciC,2627396,2627396,2627326,70,0,utRho04
yciE,2630794,2630794,2630448,346,28,utRho04
yciG,5264368,5264368,5264140,228,0,utRho04
yciI,2621784,2621784,2621730,54,24,utRho04
yciN,2661606,2661606,2661336,270,38,utRho04
yciS,2680270,2680486,2680270,216,12,utRho04
yciT,2689088,2689088,2688692,396,194,utRho04
yciU,2614718,2614718,2614300,418,2934,utRho04
yciV,2646376,2646440,2646376,64,0,utRho04
yciW,2700472,2700472,2700214,258,286,utRho04
yciZ,2689276,2689276,2689218,58,148,utRho04
ycjD,2703792,2703792,2703520,272,10,utRho04
ycjG,2777748,2777860,2777748,112,50,utRho04
ycjM,2740006,2740432,2740006,426,4,utRho04
ycjW,2767982,2767982,2767922,60,48,utRho04
ycjX,2768138,2768234,2768138,96,0,utRho04
ycjY,5568288,5568288,5567460,828,0,utRho04
ydaE,2836438,2836438,2836016,422,0,utRho04
ydaN,2816048,2816100,2816048,52,0,utRho04
ydaS,2840340,2840730,2840340,390,154,utRho04
ydbC,2948376,2948442,2948376,66,2,utRho04
ydbD,2950132,2950288,2950132,156,0,utRho04
ydbH,2885800,2886102,2885800,302,46,utRho04
ydbJ,2881712,2882116,2881712,404,0,utRho04
ydbK,2881692,2881692,2881568,124,0,utRho04
ydcA,2983294,2983354,2983294,60,18,utRho04
ydcF,2974404,2974470,2974404,66,0,utRho04
ydcI,2990268,2990268,2990142,126,28,utRho04
ydcJ,2990266,2990576,2990266,310,0,utRho04
ydcK,3001280,3001280,3000898,382,0,utRho04
ydcL,3004646,3004914,3004646,268,10,utRho04
ydcN,3012308,3012344,3012308,36,2,utRho04
ydcP,3013508,3013562,3013508,54,2,utRho04
ydcR,3019956,3020006,3019956,50,0,utRho04
ydcS,3022906,3023308,3022906,402,36,utRho04
ydcX,3034442,3034778,3034442,336,72,utRho04
ydcY,3035220,3035296,3035220,76,0,utRho04
ydcZ,3036750,3036750,3036662,88,198,utRho04
yddB,3155332,3155332,3155238,94,0,utRho04
yddE,3071738,3071738,3071716,22,0,utRho04
yddG,3094410,3094410,3094338,72,0,utRho04
yddJ,3089732,3089732,3089438,294,0,utRho04
yddW,3137704,3137704,3137646,58,42,utRho04
ydeA,3233910,3234056,3233910,146,146,utRho04
ydeE,3242528,3242664,3242528,136,0,utRho04
ydeI,3249118,3249118,3248994,124,0,utRho04
ydeJ,3249376,3249546,3249376,170,0,utRho04
ydeN,3165458,3165458,3165048,410,0,utRho04
ydeP,3173328,3173328,3172972,356,0,utRho04
ydeR,3176596,3176596,3176592,4,12,utRho04
ydfA,3296872,3297016,3296872,144,0,utRho04
ydfG,3254982,3255034,3254982,52,0,utRho04
ydfH,3256652,3256704,3256652,52,72,utRho04
ydfK,3265446,3266144,3265446,698,31296,utRho04
ydgA,3379588,3379704,3379588,116,46,utRho04
ydgC,3364124,3364124,3364060,64,68,utRho04
ydgD,3343906,3343920,3343906,14,14,utRho04
ydgH,3356754,3356854,3356754,100,16,utRho04
ydgJ,3408798,3408798,3408616,182,176,utRho04
ydgK,3410414,3410500,3410414,86,56,utRho04
ydhB,3479618,3479618,3479596,22,0,utRho04
ydhC,3479698,3479822,3479698,124,0,utRho04
ydhF,3451310,3451310,3451264,46,0,utRho04
ydhI,3441996,3442050,3441996,54,0,utRho04
ydhL,3451864,3451864,3451840,24,0,utRho04
ydhQ,3492404,3492404,3492254,150,0,utRho04
ydhS,3494136,3494262,3494136,126,418,utRho04
ydhT,3499138,3499138,3499118,20,0,utRho04
ydhY,3509284,3509284,3508954,330,0,utRho04
ydhZ,3510418,3510418,3510282,136,0,utRho04
ydiE,3579206,3579226,3579206,20,0,utRho04
ydiH,3530582,3530582,3530406,176,8,utRho04
ydiM,3541852,3542142,3541852,290,0,utRho04
ydiN,3544818,3545024,3544818,206,0,utRho04
ydiP,3558656,3558656,3558602,54,0,utRho04
ydiU,3582508,3582508,3582488,20,44,utRho04
ydiV,3584174,3584174,3584040,134,48,utRho04
ydiY,3612500,3612500,3612166,334,4,utRho04
ydjA,3697400,3697400,3697352,48,26,utRho04
ydjE,3708082,3708082,3707958,124,78,utRho04
ydjF,3709848,3709848,3709708,140,0,utRho04
ydjM,3620340,3620422,3620340,82,56,utRho04
ydjO,3626696,3626696,3626288,408,0,utRho04
ydjX,3666434,3666802,3666434,368,956,utRho04
yeaE,3731448,3731448,3731272,176,36,utRho04
yeaG,3733530,3733816,3733530,286,0,utRho04
yeaI,3740486,3740770,3740486,284,0,utRho04
yeaJ,3743874,3744082,3743874,208,28,utRho04
yeaL,3748646,3748704,3748646,58,90,utRho04
yeaM,3751296,3751296,3751152,144,0,utRho04
yeaN,3750926,3751346,3750926,420,16,utRho04
yeaO,3753554,3753818,3753554,264,0,utRho04
yeaP,3755314,3755430,3755314,116,762,utRho04
yeaQ,3758780,3758780,3758510,270,44,utRho04
yeaR,3759988,3759988,3759896,92,46,utRho04
yeaY,3781122,3781122,3781064,58,104,utRho04
yebB,3892220,3892502,3892220,282,0,utRho04
yebC,3896370,3896370,3896302,68,106,utRho04
yebE,3859464,3859464,3859414,50,290,utRho04
yebG,3861530,3861530,3861494,36,34,utRho04
yebK,3873180,3873304,3873180,124,16,utRho04
yebQ,3820314,3820552,3820314,238,2,utRho04
yebS,3832238,3832516,3832238,278,26,utRho04
yebV,3843430,3843560,3843430,130,0,utRho04
yebW,3843914,3844242,3843914,328,862,utRho04
yecC,3995646,3995646,3995628,18,0,utRho04
yecD,3901272,3901664,3901272,392,26,utRho04
yecF,3991434,3991636,3991434,202,158,utRho04
yecH,3979304,3979304,3978980,324,60,utRho04
yecJ,3975604,3975604,3975516,88,0,utRho04
yecM,3919968,3919968,3919692,276,72,utRho04
yecR,3976400,3976444,3976400,44,12,utRho04
yecT,3923862,3923944,3923862,82,86,utRho04
yedD,4016522,4016522,4016180,342,0,utRho04
yedE,4016310,4016554,4016310,244,0,utRho04
yedI,4058922,4058922,4058732,190,0,utRho04
yedJ,4066446,4066446,4066158,288,0,utRho04
yedV,4076404,4076404,4076304,100,26,utRho04
yedX,4077680,4077912,4077680,232,0,utRho04
yedY,4078572,4078956,4078572,384,10,utRho04
yeeA,4161322,4161322,4161182,140,0,utRho04
yeeE,4171104,4171104,4171050,54,0,utRho04
yeeJ,4089526,4089822,4089526,296,366,utRho04
yeeN,4113508,4113716,4113508,208,0,utRho04
yeeO,4119444,4119444,4119692,248,0,utRho04
yeeX,4158834,4158834,4158722,112,362,utRho04
yeeZ,4178422,4178422,4178256,166,0,utRho04
yefM,4179466,4179466,4179426,40,0,utRho04
yegD,4295288,4295348,4295288,60,0,utRho04
yegH,4275726,4275804,4275726,78,8,utRho04
yegI,4302154,4302154,4301970,184,0,utRho04
yegJ,4302032,4302370,4302032,338,0,utRho04
yegQ,4331182,4331336,4331182,154,40,utRho04
yegR,4336698,4336698,4336612,86,0,utRho04
yegS,4337086,4337424,4337086,338,0,utRho04
yegT,4357562,4357642,4357562,80,4,utRho04
yegX,4367640,4367640,4367302,338,0,utRho04
yehA,4376944,4376944,4376828,116,0,utRho04
yehE,4385818,4385818,4385592,226,0,utRho04
yehK,4407568,4407944,4407568,376,0,utRho04
yehL,4408804,4409192,4408804,388,0,utRho04
yeiB,4486146,4486146,4485934,212,48,utRho04
yeiE,4499422,4499422,4499236,186,12,utRho04
yeiG,4487776,4487820,4487776,44,312,utRho04
yeiH,4499332,4499434,4499332,102,14,utRho04
yeiI,4503306,4503400,4503306,94,92,utRho04
yeiL,4510580,4510710,4510580,130,0,utRho04
yeiP,4530834,4530900,4530834,66,294,utRho04
yeiQ,4532328,4532490,4532328,162,78,utRho04
yeiR,4535484,4535658,4535484,174,60,utRho04
yeiW,4530840,4530840,4530590,250,366,utRho04
yejA,4544624,4544728,4544624,104,24,utRho04
yejG,4556892,4556892,4556474,418,2944,utRho04
yejH,4561244,4561264,4561244,20,0,utRho04
yejK,4568218,4568218,4567894,324,308,utRho04
yejO,4578352,4578352,4577800,552,70,utRho04
yfaD,4713380,4713808,4713380,428,992,utRho04
yfaE,4696676,4697028,4696676,352,1484,utRho04
yfaL,4688568,4688568,4688338,230,0,utRho04
yfaP,4656398,4656398,4656286,112,0,utRho04
yfaU,4717892,4717892,4717690,202,0,utRho04
yfaY,4727310,4727310,4727266,44,2,utRho04
yfaZ,4728744,4728744,4728550,194,0,utRho04
yfbK,4771810,4771810,4771444,366,0,utRho04
yfbL,4771500,4771720,4771500,220,0,utRho04
yfbN,4777174,4777174,4776852,322,0,utRho04
yfbO,4776916,4777162,4776916,246,0,utRho04
yfbP,4777990,4778232,4777990,242,336,utRho04
yfbR,4817662,4817724,4817662,62,164,utRho04
yfcI,4847424,4847424,4847078,346,20,utRho04
yfcJ,4880482,4880482,4880240,242,84,utRho04
yfcL,4888502,4888502,4888338,164,0,utRho04
yfcV,4911642,4911642,4911292,350,0,utRho04
yfcZ,4921958,4921958,4921868,90,48,utRho04
yfdF,4925604,4926024,4925604,420,470,utRho04
yfdG,4935474,4935710,4935474,236,0,utRho04
yfdP,4946844,4947040,4946844,196,0,utRho04
yfdX,4988866,4988866,4988804,62,0,utRho04
yfdY,4990672,4990672,4990584,88,0,utRho04
yfeA,5035784,5035784,5035664,120,26924,utRho04
yfeC,5036668,5036934,5036668,266,170,utRho04
yfeH,5053818,5053892,5053818,74,0,utRho04
yfeK,5074630,5074684,5074630,54,0,utRho04
yfeO,5018906,5019260,5018906,354,146,utRho04
yfeR,5054078,5054078,5053712,366,0,utRho04
yfeX,5101356,5101356,5101090,266,0,utRho04
yfeY,5102486,5102486,5102432,54,0,utRho04
yfeZ,5103842,5103842,5103452,390,0,utRho04
yffO,5123804,5124222,5123804,418,0,utRho04
yffQ,5126778,5127154,5126778,376,0,utRho04
yffS,5128800,5128986,5128800,186,26,utRho04
yfgC,5232052,5232188,5232052,136,0,utRho04
yfgF,5258062,5258062,5257876,186,4,utRho04
yfgG,5258170,5258580,5258170,410,120,utRho04
yfgH,5259344,5259584,5259344,240,56,utRho04
yfgM,5278866,5278866,5278566,300,476,utRho04
yfhH,5397414,5397518,5397414,104,0,utRho04
yfhM,5304648,5304648,5304574,74,30,utRho04
yfhR,5328408,5328726,5328408,318,3132,utRho04
yfiC,5425610,5425610,5425528,82,0,utRho04
yfiE,5430688,5430688,5430640,48,2,utRho04
yfiL,5482630,5482720,5482630,90,0,utRho04
yfiM,5448066,5448358,5448066,292,14592,utRho04
yfiR,5483354,5483750,5483354,396,328,utRho04
yfjH,5517326,5517326,5517200,126,0,utRho04
yfjI,5517710,5517970,5517710,260,0,utRho04
yfjJ,5521014,5521094,5521014,80,0,utRho04
yfjM,5531970,5531970,5531552,418,790,utRho04
yfjP,5535080,5535420,5535080,340,32,utRho04
yfjW,5546570,5546636,5546570,66,26,utRho04
yfjX,5551776,5551838,5551776,62,0,utRho04
ygaC,5601180,5601180,5599988,1192,890,utRho04
ygaM,5600242,5600292,5600242,50,328,utRho04
ygaU,5593628,5593628,5593572,56,16,utRho04
ygaZ,5619190,5619234,5619190,44,686,utRho04
ygbA,5713656,5713656,5713612,44,0,utRho04
ygbE,5746784,5746784,5746674,110,138,utRho04
ygbI,5722882,5722882,5722528,354,2,utRho04
ygbK,5724394,5724670,5724394,276,52,utRho04
ygbL,5727074,5727186,5727074,112,0,utRho04
ygbN,5729814,5730202,5729814,388,24,utRho04
ygcG,5811210,5811422,5811210,212,0,utRho04
ygcN,5785144,5785314,5785144,170,38,utRho04
ygcU,5799214,5799214,5798836,378,0,utRho04
ygcW,5800942,5800942,5800546,396,0,utRho04
ygdD,5883442,5883442,5883262,180,14,utRho04
ygdG,5861746,5861930,5861746,184,618,utRho04
ygdI,5886526,5886526,5886290,236,0,utRho04
ygdQ,5940784,5940840,5940784,56,14,utRho04
ygdR,5942494,5942542,5942494,48,4,utRho04
ygeA,5961606,5961606,5961270,336,0,utRho04
ygeH,5983758,5984188,5983758,430,0,utRho04
ygeI,5987162,5987276,5987162,114,0,utRho04
ygeR,6000078,6000078,5999782,296,178,utRho04
ygeV,6011694,6011694,6011572,122,0,utRho04
ygeW,6012234,6012524,6012234,290,0,utRho04
ygfB,6110946,6110946,6110888,58,6,utRho04
ygfK,6031984,6032120,6031984,136,0,utRho04
ygfS,6058328,6058328,6058024,304,0,utRho04
ygfZ,6082564,6082626,6082564,62,46,utRho04
yggC,6149512,6149512,6149378,134,186,utRho04
yggE,6136370,6136370,6136160,210,0,utRho04
yggI,6179176,6179510,6179176,334,170,utRho04
yggL,6204508,6204508,6204266,242,140,utRho04
yggM,6199514,6199514,6199130,384,184,utRho04
yggN,6203596,6203596,6203246,350,64,utRho04
yggX,18623958,18624558,18623958,600,1008,utRho04
yghA,6298966,6299324,6298966,358,28,utRho04
yghB,6307058,6307126,6307058,68,4,utRho04
yghD,6222614,6222614,6222252,362,58,utRho04
yghF,6225798,6225798,6225840,42,0,utRho04
yghJ,6238640,6238640,6238224,416,0,utRho04
yghQ,6265186,6265186,6264816,370,2,utRho04
yghT,6267830,6268262,6267830,432,0,utRho04
yghU,6277400,6277454,6277400,54,0,utRho04
yghW,6293506,6293506,6293474,32,0,utRho04
yghZ,6295562,6295794,6295562,232,0,utRho04
ygiD,6365122,6365122,6364868,254,224,utRho04
ygiH,6409066,6409388,6409066,322,0,utRho04
ygiL,6370622,6370828,6370622,206,2,utRho04
ygiM,6402084,6402414,6402084,330,90,utRho04
ygiN,6346156,6346284,6346156,128,624,utRho04
ygiQ,6322620,6322620,6322292,328,548,utRho04
ygiS,6335462,6335462,6335436,26,2,utRho04
ygiV,6338582,6338582,6338462,120,74,utRho04
ygiW,6339774,6339774,6339352,422,0,utRho04
ygiZ,6344506,6344506,6344422,84,0,utRho04
ygjH,6442528,6442528,6442494,34,0,utRho04
ygjI,6452140,6452468,6452140,328,0,utRho04
ygjQ,6472730,6473080,6472730,350,378,utRho04
ygjR,6474564,6474586,6474564,22,0,utRho04
ygjV,6483638,6483638,6483488,150,0,utRho04
yhaB,6535632,6535708,6535632,76,0,utRho04
yhaH,6504498,6504608,6504498,110,0,utRho04
yhaI,6505400,6505822,6505400,422,68,utRho04
yhaJ,6508560,6508560,6508428,132,26,utRho04
yhaK,6508538,6508638,6508538,100,46,utRho04
yhbQ,6599878,6599932,6599878,54,110,utRho04
yhbT,6602736,6602736,6602552,184,0,utRho04
yhbU,6602558,6602970,6602558,412,0,utRho04
yhbX,6643302,6643302,6643226,76,0,utRho04
yhbY,6655518,6655580,6655518,62,1726,utRho04
yhcA,6723956,6724224,6723956,268,0,utRho04
yhcB,6760364,6760382,6760364,18,112,utRho04
yhcC,6708470,6708470,6708100,370,268,utRho04
yhcF,6733440,6733852,6733440,412,182,utRho04
yhcH,6739124,6739124,6738956,168,74,utRho04
yhcM,6760312,6760312,6759994,318,76,utRho04
yhcN,6770812,6771076,6770812,264,398,utRho04
yhcO,6772606,6772606,6772258,348,0,utRho04
yhdH,6806560,6806968,6806560,408,104,utRho04
yhdJ,6823234,6823306,6823234,72,0,utRho04
yhdN,6879092,6879092,6879018,74,2184,utRho04
yhdT,6814702,6814750,6814702,48,392,utRho04
yhdU,6824994,6825242,6824994,248,24,utRho04
yhdV,6836392,6836780,6836392,388,0,utRho04
yhdW,6837944,6838298,6837944,354,4,utRho04
yheO,6953082,6953082,6952880,202,466,utRho04
yheV,6957970,6957970,6957584,386,28,utRho04
yhfA,6971902,6971902,6971636,266,0,utRho04
yhfG,6983294,6983294,6983240,54,242,utRho04
yhfL,6998622,6998896,6998622,274,26,utRho04
yhfY,7023244,7023244,7022844,400,0,utRho04
yhgA,7086294,7086334,7086294,40,0,utRho04
yhgE,7065176,7065176,7064878,298,34,utRho04
yhgF,7074352,7074770,7074352,418,1480,utRho04
yhhA,7173458,7173886,7173458,428,134,utRho04
yhhI,7248346,7248756,7248346,410,0,utRho04
yhhJ,7253696,7253696,7253606,90,0,utRho04
yhhM,7211588,7211588,7211220,368,370,utRho04
yhhN,7211150,7211502,7211150,352,320,utRho04
yhhQ,7218238,7218434,7218238,196,326,utRho04
yhhT,7223682,7223730,7223682,48,20,utRho04
yhhX,7162032,7162032,7161610,422,556,utRho04
yhhY,7162222,7162276,7162222,54,48,utRho04
yhhZ,7163516,7163726,7163516,210,0,utRho04
yhiD,7312220,7312220,7311804,416,1080,utRho04
yhiJ,7265190,7265190,7265180,10,0,utRho04
yhiM,7269270,7269682,7269270,412,78,utRho04
yhiN,7275000,7275000,7274820,180,34,utRho04
yhjA,7338522,7338522,7338376,146,0,utRho04
yhjB,7344090,7344090,7343788,302,62,utRho04
yhjC,7344272,7344684,7344272,412,0,utRho04
yhjD,7346660,7346724,7346660,64,0,utRho04
yhjE,7349274,7349572,7349274,298,0,utRho04
yhjG,7356824,7356824,7356730,94,0,utRho04
yhjH,7358458,7358458,7358374,84,0,utRho04
yhjJ,7364032,7364032,7363880,152,282,utRho04
yhjK,7371296,7371296,7371158,138,0,utRho04
yhjR,7392750,7392750,7392370,380,0,utRho04
yhjV,7400796,7401126,7400796,330,710,utRho04
yhjX,7424194,7424194,7424014,180,8,utRho04
yhjY,7425966,7425966,7425868,98,28,utRho04
yiaB,7455654,7455654,7455496,158,0,utRho04
yiaD,7432712,7433094,7432712,382,158,utRho04
yiaF,7438194,7438194,7438088,106,20,utRho04
yiaG,7438862,7438956,7438862,94,140,utRho04
yiaJ,7485236,7485236,7485064,172,0,utRho04
yiaK,7485348,7485466,7485348,118,0,utRho04
yiaT,7503924,7503924,7503736,188,0,utRho04
yiaU,7503792,7503984,7503792,192,0,utRho04
yiaY,7515856,7515856,7515654,202,104,utRho04
yibF,7523950,7523950,7523910,40,0,utRho04
yibG,7536128,7536354,7536128,226,0,utRho04
yibL,7553194,7553330,7553194,136,26,utRho04
yibN,7570112,7570112,7570030,82,94,utRho04
yibT,7552848,7552848,7552760,88,86,utRho04
yicC,7633290,7633352,7633290,62,50,utRho04
yicH,7660862,7660914,7660862,52,0,utRho04
yicJ,7673328,7673328,7671858,1470,276,utRho04
yicN,7685018,7685018,7684804,214,0,utRho04
yicO,7687914,7687914,7687578,336,0,utRho04
yicR,15250308,15250308,15250236,72,0,utRho04
yidB,7755230,7755230,7754930,300,2,utRho04
yidE,7732780,7732780,7732546,234,0,utRho04
yidF,7711580,7711580,7711222,358,122,utRho04
yidQ,7735088,7735456,7735088,368,540,utRho04
yidR,7738824,7738824,7738618,206,0,utRho04
yieE,7787658,7787738,7787658,80,180,utRho04
yieH,7793314,7793548,7793314,234,0,utRho04
yieK,7798928,7798928,7798786,142,0,utRho04
yifB,7900350,7900350,7899998,352,124,utRho04
yifL,7988984,7989044,7988984,60,166,utRho04
yigF,8005750,8005750,8005598,152,38,utRho04
yigI,8009448,8009448,8009394,54,0,utRho04
yigM,8022100,8022152,8022100,52,38,utRho04
yihA,8101970,8101970,8101458,512,172,utRho04
yihD,8084098,8084138,8084098,40,76,utRho04
yihF,8088110,8088398,8088110,288,0,utRho04
yihG,8093304,8093304,8093204,100,0,utRho04
yihI,8102616,8102694,8102616,78,14,utRho04
yihL,8120506,8120894,8120506,388,0,utRho04
yihN,8124332,8124494,8124332,162,0,utRho04
yihO,8131942,8131942,8131532,410,154,utRho04
yihQ,8138892,8138892,8138552,340,0,utRho04
yihV,8147064,8147478,8147064,414,0,utRho04
yihX,8151096,8151106,8151096,10,18,utRho04
yiiE,8158192,8158582,8158192,390,0,utRho04
yiiF,8159124,8159502,8159124,378,78,utRho04
yiiG,8173762,8174004,8173762,242,0,utRho04
yiiM,8205506,8205644,8205506,138,44,utRho04
yiiQ,8224624,8224624,8224428,196,0,utRho04
yiiS,8225738,8225934,8225738,196,42,utRho04
yijE,8272178,8272216,8272178,38,96,utRho04
yijF,8275728,8275728,8275314,414,44,utRho04
yijO,8296858,8296858,8296634,224,64,utRho04
yjaA,8426240,8426468,8426240,228,46806,utRho04
yjaB,8428312,8428312,8428246,66,322,utRho04
yjaG,8398746,8399008,8398746,262,1176,utRho04
yjaH,8401022,8401132,8401022,110,150,utRho04
yjaZ,8379506,8379572,8379506,66,22,utRho04
yjbB,8455204,8455462,8455204,258,0,utRho04
yjbE,16943432,16943624,16943432,192,0,utRho04
yjbL,8520318,8520642,8520318,324,0,utRho04
yjbQ,8540428,8540476,8540428,48,76,utRho04
yjcB,8550328,8550328,8550082,246,4556,utRho04
yjcC,8550836,8550942,8550836,106,0,utRho04
yjcD,8556628,8556958,8556628,330,148,utRho04
yjcE,8559658,8559960,8559658,302,0,utRho04
yjcF,8566212,8566212,8566150,62,0,utRho04
yjcO,8594660,8594660,8594250,410,2,utRho04
yjdA,8654128,8654270,8654128,142,0,utRho04
yjdC,8726660,8726660,8726616,44,0,utRho04
yjdK,8704780,8705168,8704780,388,28,utRho04
yjdL,8713034,8713034,8712822,212,0,utRho04
yjdM,8653672,8653672,8653468,204,30,utRho04
yjeF,8787354,8788132,8787354,778,4438,utRho04
yjeI,8745522,8745618,8745522,96,0,utRho04
yjeJ,8748806,8748806,8748468,338,100,utRho04
yjeV,8785472,8785784,8785472,312,264,utRho04
yjfP,8833512,8833904,8833512,392,6,utRho04
yjfY,8849656,8849656,8849582,74,0,utRho04
yjfZ,8855052,8855052,8854844,208,0,utRho04
yjgA,8916162,8916162,8915730,432,72,utRho04
yjgL,8950802,8950874,8950802,72,0,utRho04
yjgM,8959342,8959342,8959074,268,0,utRho04
yjgN,8959132,8959460,8959132,328,0,utRho04
yjgR,8980170,8980170,8980126,44,132,utRho04
yjgZ,9002116,9002520,9002116,404,406,utRho04
yjhB,9007764,9008116,9007764,352,0,utRho04
yjhG,9048452,9048452,9048188,264,642,utRho04
yjhU,9041080,9041080,9040648,432,384,utRho04
yjiA,9178096,9178096,9177730,366,288,utRho04
yjiJ,9125364,9125364,9125350,14,0,utRho04
yjiK,9127270,9127270,9127422,152,56,utRho04
yjiL,9129604,9129604,9129378,226,12,utRho04
yjiS,9143410,9143502,9143410,92,0,utRho04
yjiY,9182734,9182734,9182558,176,0,utRho04
yjjA,9200674,9200674,9200378,296,156,utRho04
yjjB,18408708,18408708,18407800,908,0,utRho04
yjjJ,9243314,9243538,9243314,224,0,utRho04
yjjK,9261132,9261132,9261044,88,24,utRho04
yjjL,9189764,9189764,9189444,320,0,utRho04
yjjM,9191894,9191894,9191702,192,14,utRho04
yjjP,9206068,9206068,9205716,352,26,utRho04
yjjQ,9206638,9206954,9206638,316,36,utRho04
yjjX,9267798,9267798,9267490,308,260,utRho04
yjjY,9280716,9280804,9280716,88,614,utRho04
yjjZ,9211554,9211608,9211554,54,1856,utRho04
yjtD,9281676,9281884,9281676,208,24,utRho04
ykfB,532454,532454,532174,280,210,utRho04
ykfI,527636,527636,527338,298,0,utRho04
ykgB,637050,637050,636638,412,0,utRho04
ykgC,640430,640430,640002,428,0,utRho04
ykgD,640232,640454,640232,222,0,utRho04
ykgE,642962,643216,642962,254,28,utRho04
ykgJ,608524,608524,608364,160,30,utRho04
ykgL,623878,624224,623878,346,0,utRho04
ykgM,625610,625610,625554,56,0,utRho04
ykgR,626570,626570,626484,86,0,utRho04
ylaC,958576,958576,958502,74,678,utRho04
yliE,1745938,1745958,1745938,20,0,utRho04
ymcE,2103660,2103694,2103660,34,670,utRho04
ymdA,2210450,2210828,2210450,378,98,utRho04
ymdB,2211428,2211640,2211428,212,20,utRho04
ymfD,2395322,2395322,2395064,258,256,utRho04
ymfI,2402880,2402994,2402880,114,90,utRho04
ymfJ,2404518,2404518,2404168,350,12,utRho04
ymfK,2406176,2406176,2405866,310,84,utRho04
ymfT,2405766,2406048,2405766,282,112,utRho04
ymgE,2489110,2489456,2489110,346,84,utRho04
ymgF,2437628,2437966,2437628,338,0,utRho04
ymiA,2670112,2670320,2670112,208,16,utRho04
ymjA,2715620,2715620,2715336,284,428,utRho04
ynaI,2791946,2791946,2791844,102,0,utRho04
ynaK,2850438,2850754,2850438,316,46,utRho04
ynbA,2954924,2955242,2954924,318,0,utRho04
yncD,3046552,3046552,3046130,422,32,utRho04
yncE,3046454,3046614,3046454,160,0,utRho04
yncG,3052456,3052494,3052456,38,46,utRho04
yncL,3034492,3034492,3034388,104,36,utRho04
yneE,3218364,3218364,3218044,320,26,utRho04
yneF,3223748,3223748,3223708,40,0,utRho04
yneJ,3229560,3229608,3229560,48,0,utRho04
yneK,3231100,3231526,3231100,426,0,utRho04
yneM,3245176,3245292,3245176,116,54,utRho04
ynfA,3311398,3311398,3311346,52,0,utRho04
ynfB,3311418,3311616,3311418,198,154,utRho04
ynfC,3315094,3315094,3314914,180,0,utRho04
ynfD,3314828,3315130,3314828,302,0,utRho04
ynfE,3316006,3316138,3316006,132,0,utRho04
ynfK,3334670,3334670,3334438,232,102,utRho04
ynfL,3339304,3339304,3339184,120,0,utRho04
ynfM,3339260,3339398,3339260,138,38,utRho04
ynfN,3276598,3276598,3276218,380,1372,utRho04
ynfO,3273454,3273512,3273454,58,0,utRho04
ynhG,3517890,3517890,3517450,440,404,utRho04
yniA,3615158,3615592,3615158,434,16,utRho04
yniB,3618526,3618526,3618466,60,32,utRho04
yniC,3618652,3618760,3618652,108,32,utRho04
yniD,3610202,3610330,3610202,128,0,utRho04
ynjE,3678880,3678934,3678880,54,0,utRho04
ynjF,3683222,3683222,3682806,416,10,utRho04
ynjH,3684376,3684376,3684270,106,38,utRho04
ynjI,3690022,3690022,3689742,280,40,utRho04
yoaB,3786642,3786734,3786642,92,84,utRho04
yoaC,3787932,3788146,3787932,214,298,utRho04
yoaE,3803544,3803544,3803170,374,142,utRho04
yoaF,3755444,3755444,3755064,380,812,utRho04
yoaH,3789866,3789866,3789462,404,330,utRho04
yobB,3850418,3850880,3850418,462,210,utRho04
yobF,3815586,3815586,3815182,404,308,utRho04
yobH,3817800,3817850,3817800,50,68,utRho04
yodB,4084352,4084736,4084352,384,110,utRho04
yodC,4057008,4057008,4056740,268,0,utRho04
yohC,4451358,4451358,4451262,96,8,utRho04
yohD,4451526,4451602,4451526,76,0,utRho04
yohJ,4460986,4461248,4460986,262,16,utRho04
yohO,4431172,4431314,4431172,142,28,utRho04
yojI,4617282,4617282,4617230,52,0,utRho04
ypdI,4988988,4989396,4988988,408,8,utRho04
ypfG,5165786,5165786,5165554,232,0,utRho04
ypfM,5182140,5182140,5181732,408,44,utRho04
yphB,5349590,5349590,5349376,214,114,utRho04
ypjA,5565644,5565644,5565452,192,0,utRho04
ypjB,5569636,5569636,5568858,778,0,utRho04
ypjD,5495860,5495774,5495860,86,0,utRho04
yqaE,5594170,5594170,5594056,114,0,utRho04
yqcA,5846100,5846100,5845968,132,0,utRho04
yqcE,5800944,5801184,5800944,240,0,utRho04
yqeC,6030468,6030468,6030114,354,0,utRho04
yqeF,5971618,5971618,5971184,434,154,utRho04
yqeG,5971438,5971694,5971438,256,78,utRho04
yqeH,5975016,5975072,5975016,56,0,utRho04
yqeI,5976688,5977004,5976688,316,0,utRho04
yqeK,5981140,5981140,5980720,420,0,utRho04
yqfA,6086728,6086728,6086296,432,382,utRho04
yqgA,6219042,6219106,6219042,64,0,utRho04
yqgB,6172500,6172500,6172102,398,430,utRho04
yqgE,6185768,6185874,6185768,106,310,utRho04
yqhA,6299150,6299150,6298942,208,28,utRho04
yqhC,6310768,6310768,6310436,332,4,utRho04
yqhD,6310604,6310710,6310604,106,4,utRho04
yqhH,6316842,6317254,6316842,412,252,utRho04
yqiC,6369662,6369680,6369662,18,76,utRho04
yqiJ,6384108,6384416,6384108,308,20,utRho04
yqjA,6495096,6495546,6495096,450,6916,utRho04
yqjF,6500932,6501124,6500932,192,126,utRho04
yqjG,6501948,6502048,6501948,100,0,utRho04
yqjH,6433078,6433078,6432982,96,8,utRho04
yqjI,6433506,6433558,6433506,52,0,utRho04
yraH,6574552,6574852,6574552,300,0,utRho04
yraP,6592144,6592818,6592144,674,216,utRho04
yraQ,6596414,6596414,6596276,138,0,utRho04
yraR,6598024,6598024,6597692,332,24,utRho04
yrbG,13360844,13361100,13360844,256,72,utRho04
yrbL,6696842,6696904,6696842,62,302,utRho04
yrbN,6616172,6616172,6615866,306,14166,utRho04
yrdB,6860176,6860176,6860046,130,64,utRho04
yrfF,7052548,7052938,7052548,390,308,utRho04
yrhB,7169440,7169518,7169440,78,0,utRho04
ysaB,7451804,7451804,7451424,380,74,utRho04
ysgA,8032686,8032686,8032338,348,26,utRho04
ytfB,8857638,8857638,8857434,204,2,utRho04
ytfE,8864018,8864018,8863966,52,0,utRho04
ytfF,8866296,8866296,8866130,166,2,utRho04
ytfH,8868164,8868226,8868164,62,0,utRho04
ytfI,8875234,8875414,8875234,180,0,utRho04
ytfJ,8878572,8878572,8878524,48,0,utRho04
ytfK,8879022,8879174,8879022,152,112,utRho04
ytfL,8882642,8882642,8882430,212,56,utRho04
ytfQ,8899634,8899924,8899634,290,198,utRho04
ytjB,9249598,9249598,9249578,20,4,utRho04
yzfA,8896588,8896588,8896490,98,0,utRho04
zapA,6111102,6111224,6111102,122,5162,utRho04
zapB,8236772,8237030,8236772,258,36,utRho04
zapC,2011700,2011904,2011700,204,72,utRho04
zinT,4082692,4082750,4082692,58,0,utRho04
zipA,5062814,5062814,5062466,348,0,utRho04
zitB,1569716,1569716,1569646,70,0,utRho04
zntA,7212844,7212902,7212844,58,0,utRho04
zntR,6878336,6878336,6878260,76,76,utRho04
znuA,3885322,3885322,3885166,156,0,utRho04
znuC,3885268,3885324,3885268,56,0,utRho04
zraP,8403424,8403424,8403376,48,0,utRho04
zraS,8403810,8403852,8403810,42,0,utRho04
zupT,6364866,6365100,6364866,234,208,utRho04
zur,8520282,8520282,8520006,276,1728,utRho04
zwf,3872752,3872752,3872628,124,62,utRho04
C0343,2818676,2818728,2818676,52,18,utRho05
aaeB,6776526,6776526,6776376,150,0,utRho05
aaeR,6778762,6779040,6778762,278,120,utRho05
aaeX,6778860,6778860,6778674,186,106,utRho05
aat,1854920,1854920,1854864,56,0,utRho05
accA,416822,417242,416822,420,2388,utRho05
accB,6810280,6810872,6810280,592,7940,utRho05
accD,4868030,4868030,4867852,178,380,utRho05
aceB,8430804,8430956,8430804,152,48,utRho05
aceE,245938,246034,245938,96,662,utRho05
ackA,4826918,4826940,4826918,22,1302,utRho05
acnA,2670848,2671662,2670848,814,950,utRho05
acnB,263038,263230,263038,192,1020,utRho05
acpP,2303148,2303230,2303148,82,436,utRho05
acpS,5402324,5402324,5401996,328,398,utRho05
acrA,971396,971396,971238,158,414,utRho05
acrB,969370,969370,968806,564,1952,utRho05
acrD,5174950,5175190,5174950,240,0,utRho05
acrE,6827404,6827728,6827404,324,0,utRho05
acrR,971398,971522,971398,124,190,utRho05
acrZ,1589502,1589546,1589502,44,16,utRho05
acs,8575190,8575190,8574742,448,42,utRho05
actP,8569870,8569870,8569804,66,0,utRho05
ada,4620854,4620854,4620810,44,28,utRho05
add,3404404,3404466,3404404,62,30,utRho05
ade,7687802,7687928,7687802,126,0,utRho05
adhE,2596826,2596826,2596242,584,2,utRho05
adhP,3107988,3107988,3107676,312,1172,utRho05
adiA,8681112,8681112,8681042,70,46,utRho05
adiC,8674404,8674404,8674062,342,2,utRho05
adiY,8676084,8676084,8675858,226,0,utRho05
adk,994278,994350,994278,72,202,utRho05
adrA,807374,807406,807374,32,0,utRho05
aer,6438240,6438240,6438152,88,0,utRho05
aes,1000102,1000102,999946,156,10,utRho05
agaR,6557406,6557406,6557330,76,0,utRho05
agaS,6563778,6563952,6563778,174,0,utRho05
agp,2131118,2131170,2131118,52,0,utRho05
agrA,7296126,7296126,7296126,0,0,utRho05
agrB,7296588,7296588,7296588,0,0,utRho05
ahpC,1277386,1277890,1277386,504,880,utRho05
ahpF,1278004,1279506,1278004,1502,57012,utRho05
ahr,8992698,8992698,8992418,280,50,utRho05
aidB,8828494,8828550,8828494,56,0,utRho05
ais,4731512,4731512,4731240,272,0,utRho05
alaA,4814816,4815122,4814816,306,0,utRho05
alaC,4996798,4996798,4996590,208,14,utRho05
alaE,5598140,5598328,5598140,188,0,utRho05
alaS,5644180,5644180,5644022,158,2466,utRho05
alaW,5036612,5036612,5036462,150,2,utRho05
aldA,2976380,2976464,2976380,84,92,utRho05
aldB,7513070,7513070,7513022,48,0,utRho05
alkA,4295118,4295118,4295080,38,4,utRho05
alkB,4618890,4618890,4618682,208,78,utRho05
allA,1064780,1064902,1064780,122,0,utRho05
allD,1092822,1092822,1092726,96,0,utRho05
allE,1088112,1088112,1088092,20,40,utRho05
allS,1064600,1064600,1064442,158,2,utRho05
alr,8531178,8531564,8531178,386,4764,utRho05
alsE,8617334,8617334,8616956,378,48,utRho05
alsK,8615990,8615990,8615598,392,232,utRho05
alx,6476740,6477160,6476740,420,144,utRho05
amiA,5104482,5104704,5104482,222,88,utRho05
amiC,5898378,5898378,5898020,358,8,utRho05
amn,4110062,4110122,4110062,60,40,utRho05
ampC,8758006,8758006,8757888,118,0,utRho05
ampD,237362,237466,237362,104,98,utRho05
ampG,907372,907372,907090,282,876,utRho05
ampH,792726,792726,792574,152,112,utRho05
amyA,4012230,4012312,4012230,82,0,utRho05
anmK,3439346,3439346,3439204,142,0,utRho05
ansB,6201580,6201580,6201456,124,50,utRho05
ansP,3052040,3052040,3051960,80,286,utRho05
apaG,104068,104068,103212,856,7106,utRho05
apaH,102586,102586,102444,142,6458,utRho05
apbE,4623188,4623188,4623068,120,0,utRho05
appA,2081198,2081234,2081198,36,0,utRho05
appC,2075420,2075480,2075420,60,0,utRho05
appY,1167134,1167362,1167134,228,0,utRho05
apt,982620,982824,982620,204,454,utRho05
aqpZ,1832424,1832424,1832094,330,0,utRho05
araB,140150,140150,140096,54,0,utRho05
araC,140482,140774,140482,292,16,utRho05
araE,5964416,5964416,5964364,52,0,utRho05
araF,3972476,3972476,3972256,220,2,utRho05
araH,3967120,3967120,3967086,34,2,utRho05
araJ,825058,825058,824962,96,48,utRho05
arcA,9281602,9281602,9280612,990,6584,utRho05
arcB,6706098,6706098,6706050,48,0,utRho05
arcZ,6701154,6701154,6701154,0,0,utRho05
arfA,6877346,6877346,6877298,48,336,utRho05
argA,5898312,5898484,5898312,172,8,utRho05
argC,8309770,8310002,8309770,232,24,utRho05
argD,6980442,6980442,6980360,82,0,utRho05
argE,8310156,8310156,8309694,462,148,utRho05
argF,580680,580680,580610,70,0,utRho05
argG,6637124,6637274,6637124,150,134,utRho05
argI,8956688,8956688,8956622,66,2,utRho05
argO,6137672,6137672,6137616,56,264,utRho05
argP,6119460,6119506,6119460,46,0,utRho05
argR,6769204,6769406,6769204,202,40,utRho05
argS,3920002,3920124,3920002,122,4,utRho05
argT,4855698,4855698,4855582,116,98,utRho05
argU,1129406,1129446,1129406,40,2,utRho05
argW,4932616,4932618,4932616,2,32,utRho05
argX,7964728,7964750,7964728,22,104,utRho05
aroF,5482402,5482402,5482300,102,70,utRho05
aroG,1571182,1571266,1571182,84,296,utRho05
aroH,3576636,3576870,3576636,234,390,utRho05
aroK,7038760,7038760,7038128,632,3326,utRho05
aroL,812560,812810,812560,250,74,utRho05
aroP,243342,243342,243102,240,0,utRho05
arpA,8445382,8445382,8444974,408,130,utRho05
arrS,7316108,7316108,7316108,0,0,utRho05
arsR,7297024,7297056,7297024,32,0,utRho05
artJ,1801252,1801252,1801150,102,0,utRho05
artP,1807686,1807686,1807468,218,30,utRho05
ascF,5678858,5679048,5678858,190,2,utRho05
ascG,5678574,5678574,5678528,46,2,utRho05
aslB,7965562,7965916,7965562,354,38086,utRho05
asnA,7854258,7854310,7854258,52,2,utRho05
asnB,1398444,1398444,1398354,90,820,utRho05
asnC,23562186,23562186,23562018,168,6,utRho05
asnS,1978088,1978088,1977970,118,9116,utRho05
asnT,4089082,4089098,4089082,16,0,utRho05
asnU,4119690,4119702,4119690,12,0,utRho05
asnV,4124504,4124520,4124504,16,0,utRho05
aspA,17473728,17473728,17473308,420,344,utRho05
aspC,1971486,1971486,1971418,68,500,utRho05
aspS,3901402,3901402,3901044,358,324,utRho05
aspT,7893560,7893744,7893560,184,105586,utRho05
aspV,473826,473862,473826,36,48,utRho05
asr,3342654,3342752,3342654,98,44,utRho05
astC,3664088,3664088,3663964,124,0,utRho05
astE,3654138,3654138,3653846,292,18,utRho05
atoD,4646824,4646894,4646824,70,0,utRho05
atpB,7844540,7844540,7844102,438,800,utRho05
atpC,7832118,7832118,7831944,174,1012,utRho05
atpI,7845050,7845050,7844880,170,6,utRho05
avtA,7479348,7479410,7479348,62,342,utRho05
azoR,2965982,2965982,2965720,262,236,utRho05
azuC,3976002,3976002,3975918,84,30,utRho05
bacA,6408350,6408350,6408262,88,32,utRho05
bamA,394052,395856,394052,1804,1498,utRho05
bamB,5277950,5277950,5277304,646,2346,utRho05
bamC,5198028,5198028,5197730,298,1060,utRho05
bamD,5471922,5472292,5471922,370,8338,utRho05
bamE,5506972,5507210,5506972,238,420,utRho05
basS,8666954,8666954,8666544,410,120,utRho05
bax,7474468,7474468,7474354,114,202,utRho05
bcp,5200874,5200956,5200874,82,2082,utRho05
bcsB,7385346,7385346,7385214,132,6,utRho05
bcsE,7392644,7392916,7392644,272,0,utRho05
bdcA,8948128,8948128,8948106,22,48,utRho05
bdcR,8948192,8948248,8948192,56,0,utRho05
bdm,3112680,3112680,3112560,120,0,utRho05
betA,654522,654522,654494,28,434,utRho05
betI,658722,658722,658668,54,0,utRho05
betT,658842,658926,658842,84,30,utRho05
bfr,6933498,6933498,6933450,48,0,utRho05
bglG,23440182,23440182,23439402,780,0,utRho05
bglX,4444240,4444240,4443978,262,36,utRho05
bhsA,2337962,2338146,2337962,184,46,utRho05
bioA,1618584,1618584,1618514,70,0,utRho05
bioB,1618604,1618688,1618604,84,0,utRho05
bioH,7089716,7089716,7089688,28,14,utRho05
bisC,7433026,7433026,7432788,238,0,utRho05
blc,8755490,8755490,8755444,46,0,utRho05
blr,3409024,3409102,3409024,78,142,utRho05
bluF,2431226,2431226,2430950,276,2734,utRho05
bluR,2428226,2428226,2428118,108,0,utRho05
bolA,908698,908944,908698,246,0,utRho05
borD,1157842,1157842,1157786,56,48,utRho05
brnQ,838976,839182,838976,206,2774,utRho05
bssR,1756492,1756496,1756492,4,0,utRho05
bssS,2242116,2242116,2241910,206,352,utRho05
btuB,8326798,8327278,8326798,480,3838,utRho05
cadB,8720212,8720212,8720062,150,2,utRho05
cadC,8723926,8723926,8723868,58,0,utRho05
caiE,70998,70998,70742,256,72,utRho05
caiF,68436,68600,68436,164,2,utRho05
caiT,84074,84074,83862,212,0,utRho05
can,285406,285406,285340,66,68,utRho05
carA,59102,59302,59102,200,56,utRho05
carB,61550,61634,61550,84,0,utRho05
cas2,5757830,5757830,5757706,124,0,utRho05
casA,5768638,5768638,5768276,362,0,utRho05
cbl,4121882,4121882,4121828,54,6,utRho05
cbpA,2128074,2128074,2127550,524,206,utRho05
cbrA,7738628,7738754,7738628,126,0,utRho05
cbrB,7794958,7795012,7794958,54,116,utRho05
ccmH,4585242,4585242,4584820,422,4,utRho05
cdaR,364894,364926,364894,32,0,utRho05
cdd,4463638,4463688,4463638,50,140,utRho05
cdh,8219814,8219860,8219814,46,190,utRho05
cdsA,391110,391354,391110,244,2406,utRho05
cedA,3627484,3627484,3627326,158,20,utRho05
cfa,3482402,3482826,3482402,424,458,utRho05
chaC,2544844,2544972,2544844,128,2,utRho05
chbB,3643452,3643452,3643238,214,0,utRho05
chbG,3634624,3634624,3634270,354,0,utRho05
cheW,3946924,3946924,3946678,246,238,utRho05
chiA,6939792,6939792,6939706,86,50,utRho05
chiP,1416472,1416668,1416472,196,0,utRho05
cho,3646984,3647030,3646984,46,24,utRho05
chpS,8896804,8896894,8896804,90,0,utRho05
cirA,4493884,4493884,4493538,346,618,utRho05
citC,1304078,1304078,1303712,366,4,utRho05
citT,1293264,1293264,1293160,104,0,utRho05
clcA,350104,350214,350104,110,0,utRho05
clpA,1846160,1846528,1846160,368,0,utRho05
clpB,5468410,5468410,5468346,64,56,utRho05
clpP,913154,913354,913154,200,530,utRho05
clpS,1845500,1845826,1845500,326,2,utRho05
clpX,914404,914852,914404,448,1510,utRho05
clsA,2617346,2617346,2617290,56,56,utRho05
clsC,2212584,2212710,2212584,126,328,utRho05
cmk,1922330,1922402,1922330,72,162,utRho05
cnu,3409522,3409898,3409522,376,494,utRho05
coaA,8350214,8350214,8350052,162,988,utRho05
cobC,1340092,1340092,1339814,278,642,utRho05
cobT,4129202,4129202,4128934,268,0,utRho05
cobU,4131944,4131944,4131528,416,386,utRho05
codB,709768,709844,709768,76,2,utRho05
comR,2337726,2337726,2337664,62,0,utRho05
copA,1022822,1022822,1022758,64,2,utRho05
corA,8002388,8002852,8002388,464,5324,utRho05
cpdB,8873258,8873258,8873130,128,38,utRho05
cptB,6082198,6082198,6082140,58,60,utRho05
cpxA,8210202,8210202,8209950,252,790,utRho05
cpxP,8211570,8211640,8211570,70,34,utRho05
cpxR,8211372,8211372,8211340,32,78,utRho05
cra,175894,176056,175894,162,0,utRho05
crcB,1316016,1316016,1315876,140,262,utRho05
creA,9270486,9271042,9270486,556,726,utRho05
creD,9276320,9276356,9276320,36,44,utRho05
crl,515620,515658,515620,38,752,utRho05
crp,6971906,6972240,6971906,334,5318,utRho05
crr,5070960,5071668,5070960,708,4232,utRho05
csdA,5886414,5886674,5886414,260,0,utRho05
csgB,2207718,2207902,2207718,184,0,utRho05
csgD,2206688,2206688,2206392,296,0,utRho05
csgG,2203510,2203510,2203368,142,18,utRho05
csiD,5577854,5577970,5577854,116,56,utRho05
csiE,5330802,5330870,5330802,68,0,utRho05
csiR,5590942,5591348,5590942,406,0,utRho05
cspA,7439778,7440098,7439778,320,606382,utRho05
cspB,3283430,3283430,3283108,322,816,utRho05
cspC,3815018,3815018,3814870,148,240,utRho05
cspD,1845352,1845352,1845180,172,982,utRho05
cspE,1314294,1314584,1314294,290,0,utRho05
cspF,3283380,3283710,3283380,330,86,utRho05
cspG,2102610,2102922,2102610,312,134226,utRho05
cspH,2102746,2102746,2102350,396,600,utRho05
cspI,3277624,3277624,3277334,290,352,utRho05
csrA,5638746,5638746,5638292,454,1252,utRho05
csrB,5849048,5849048,5849048,0,0,utRho05
csrC,8102072,8102072,8102072,0,0,utRho05
csrD,6806850,6806850,6806664,186,62,utRho05
cstA,1259710,1259788,1259710,78,38,utRho05
cueO,274090,274166,274090,76,0,utRho05
cueR,1027948,1027986,1027948,38,0,utRho05
curA,3037784,3038054,3037784,270,32,utRho05
cusC,1191146,1191200,1191146,54,2,utRho05
cusR,1190924,1190924,1190886,38,2,utRho05
cutA,8730784,8730784,8730712,72,492,utRho05
cutC,3918534,3918534,3917920,614,16,utRho05
cvpA,4861600,4861600,4861526,74,116,utRho05
cvrA,2484328,2484328,2484142,186,106,utRho05
cyaA,7981548,7982306,7981548,758,1146,utRho05
cyaR,4334228,4334224,4334228,4,0,utRho05
cyaY,7988166,7988166,7988118,48,78,utRho05
cybB,2981522,2981804,2981522,282,346,utRho05
cycA,8859560,8859728,8859560,168,440,utRho05
cydA,1542340,1542916,1542340,576,0,utRho05
cydC,1858800,1858800,1858390,410,116,utRho05
cydD,1862062,1862062,1861924,138,196,utRho05
cydX,1548300,1548392,1548300,92,630,utRho05
cynR,717418,717418,717380,38,54,utRho05
cynT,1435092,1435196,1435092,104,108,utRho05
cyoA,903306,903306,903220,86,1748,utRho05
cyoE,895540,895540,895410,130,678,utRho05
cysB,2667576,2667710,2667576,134,304,utRho05
cysC,5748056,5748056,5747984,72,196,utRho05
cysD,5752736,5752736,5752658,78,10,utRho05
cysE,7565362,7565362,7565124,238,1334,utRho05
cysG,6995508,6995656,6995508,148,96,utRho05
cysJ,5783928,5783928,5783796,132,1890,utRho05
cysK,5064688,5064818,5064688,130,2,utRho05
cysP,5087114,5087114,5087056,58,38,utRho05
cysS,1109154,1109222,1109154,68,200,utRho05
cysT,3984100,3984100,3983974,126,222,utRho05
cysZ,5062766,5062926,5062766,160,264,utRho05
cytR,8249018,8249018,8248912,106,264,utRho05
dacA,1328002,1328002,1327926,76,98,utRho05
dacB,6657714,6657926,6657714,212,16,utRho05
dacC,1761306,1761454,1761306,148,0,utRho05
dadA,2475018,2475142,2475018,124,0,utRho05
dam,7032504,7032504,7031826,678,2008,utRho05
damX,7035200,7035200,7034612,588,966,utRho05
dapA,5199568,5199568,5199520,48,0,utRho05
dapB,56576,56748,56576,172,160,utRho05
dapD,371954,371954,371894,60,360,utRho05
dapE,5183120,5183214,5183120,94,276,utRho05
dcp,3254844,3254844,3254760,84,32,utRho05
dcrB,7219534,7219910,7219534,376,102,utRho05
dctA,7366996,7366996,7366894,102,478,utRho05
dcuA,8733686,8733686,8733546,140,0,utRho05
dcuB,8698182,8698182,8697488,694,240,utRho05
dcuC,1312166,1312166,1311936,230,26,utRho05
dcuD,6749166,6749738,6749166,572,0,utRho05
dcuR,8701130,8701130,8700068,1062,858,utRho05
dcuS,8703370,8703370,8703324,46,0,utRho05
dcyD,3999016,3999016,3998960,56,0,utRho05
ddpX,3126498,3126498,3126152,346,0,utRho05
deaD,6615818,6615818,6615720,98,7598,utRho05
dedA,4869880,4869880,4869482,398,13182,utRho05
dedD,4863750,4863750,4863368,382,148,utRho05
def,6867300,6867380,6867300,80,60,utRho05
degP,361690,361768,361690,78,0,utRho05
degQ,6761308,6761486,6761308,178,4112,utRho05
deoB,9239134,9239206,9239134,72,2,utRho05
deoC,9233358,9234646,9233358,1288,224,utRho05
dfp,7625406,7625462,7625406,56,0,utRho05
dgcZ,3247758,3247758,3247700,58,0,utRho05
dgkA,8512914,8513274,8512914,360,250,utRho05
dgt,358392,358474,358392,82,14,utRho05
dhaK,2501888,2501888,2501676,212,110,utRho05
dhaR,2502006,2502132,2502006,126,12,utRho05
dicB,3299194,3299218,3299194,24,0,utRho05
dicC,3295752,3295752,3295700,52,0,utRho05
dinB,501760,501796,501760,36,0,utRho05
dinD,7635398,7635520,7635398,122,292,utRho05
dinG,1666146,1666140,1666146,6,0,utRho05
dinI,2243018,2243018,2242974,44,0,utRho05
dinJ,493230,493230,493004,226,6,utRho05
dinQ,7295964,7295964,7295576,388,1490,utRho05
djlA,114536,114728,114536,192,0,utRho05
dkgA,6313142,6313246,6313142,104,32,utRho05
dkgB,458196,458334,458196,138,452,utRho05
dksA,321502,321502,321208,294,434,utRho05
dld,4444164,4444370,4444164,206,36,utRho05
dmlA,3763424,3763824,3763424,400,0,utRho05
dmlR,3763710,3763710,3763618,92,0,utRho05
dmsA,1881646,1881918,1881646,272,54,utRho05
dnaA,7767922,7767922,7767458,464,10298,utRho05
dnaB,8528566,8528628,8528566,62,148,utRho05
dnaK,24096,24326,24096,230,454,utRho05
dnaN,7765466,7765466,7764642,824,1544,utRho05
dnaQ,471868,472134,471868,266,1400,utRho05
dnaT,18406460,18406460,18406068,392,580,utRho05
dnaX,984112,984184,984112,72,604,utRho05
dosP,3131486,3131486,3131466,20,0,utRho05
dpiB,1303968,1304470,1303968,502,76,utRho05
dppA,7415740,7415740,7415410,330,1258,utRho05
dps,1697900,1697900,1697822,78,78,utRho05
dsbA,8086754,8086836,8086754,82,3224,utRho05
dsbB,2466294,2466294,2466060,234,68,utRho05
dsbC,6079266,6079266,6077644,1622,1168,utRho05
dsbG,1277600,1277600,1277146,454,384,utRho05
dsdA,4958242,4958404,4958242,162,106,utRho05
dsdC,4955492,4955492,4955258,234,0,utRho05
dsdX,4955642,4955694,4955642,52,48,utRho05
dsrA,4050626,4050626,4050626,0,0,utRho05
dsrB,4049686,4049686,4049646,40,82,utRho05
dtpD,1485340,1485340,1485112,228,82,utRho05
dusA,8523200,8523338,8523200,138,4272,utRho05
dusB,6820492,6820560,6820492,68,152,utRho05
dusC,4460790,4460790,4460770,20,0,utRho05
dut,7627704,7627864,7627704,160,1400,utRho05
dxr,386670,387042,386670,372,702,utRho05
ebgA,6445102,6445266,6445102,164,84,utRho05
ebgR,6442874,6442932,6442874,58,26,utRho05
ecnB,8753018,8753106,8753018,88,78,utRho05
eco,4607594,4607810,4607594,216,0,utRho05
ecpA,621594,621594,621342,252,0,utRho05
ecpB,620238,620238,620052,186,0,utRho05
ecpR,622964,622964,622672,292,0,utRho05
eda,3866218,3866218,3865512,706,112,utRho05
edd,3869426,3869426,3869208,218,0,utRho05
efeO,2164308,2164486,2164308,178,60,utRho05
efeU_1,2162614,2162712,2162614,98,108,utRho05
efp,8751134,8751398,8751134,264,12502,utRho05
elaA,4763372,4763372,4763086,286,104,utRho05
elaD,4765308,4765426,4765308,118,0,utRho05
elfA,1995530,1995736,1995530,206,0,utRho05
elfD,1996642,1996980,1996642,338,0,utRho05
emrD,7707690,7707844,7707690,154,30,utRho05
emrK,4966896,4966896,4966678,218,0,utRho05
emrY,4964668,4964668,4964352,316,4,utRho05
emtA,2486250,2486360,2486250,110,6,utRho05
endA,12361100,12361388,12361100,288,0,utRho05
eno,5817692,5817692,5815882,1810,4836,utRho05
entC,1249662,1249770,1249662,108,0,utRho05
entD,1220508,1220508,1220158,350,94,utRho05
entH,1258584,1258600,1258584,16,92,utRho05
entS,1244506,1244600,1244506,94,0,utRho05
envR,6827266,6827266,6826930,336,0,utRho05
epd,12295292,12295292,12294764,528,4,utRho05
epmA,8765236,8765286,8765236,50,34,utRho05
epmB,8751406,8751406,8751314,92,6496,utRho05
eptB,7421162,7421162,7420950,212,532,utRho05
eptC,8300622,8300622,8300530,92,122,utRho05
erfK,4126708,4126708,4126646,62,2106,utRho05
erpA,353122,353220,353122,98,56,utRho05
esrE,8039956,8039956,8039956,0,0,utRho05
essD,1153746,1154796,1153746,1050,228,utRho05
etk,2088606,2088606,2088420,186,0,utRho05
evgA,4967262,4967510,4967262,248,16,utRho05
exbB,6304028,6304028,6303968,60,70,utRho05
exbD,6302780,6302780,6302486,294,430,utRho05
exuR,6493016,6493304,6493016,288,92,utRho05
exuT,6490004,6490208,6490004,204,0,utRho05
fabA,2032996,2032996,2032940,56,4,utRho05
fabB,4883282,4883282,4883210,72,0,utRho05
fabH,2297032,2297518,2297032,486,4256,utRho05
fabI,2702236,2702236,2702078,158,260,utRho05
fadB,8062026,8062026,8061942,84,0,utRho05
fadD,3779614,3779614,3779492,122,2,utRho05
fadE,486812,486812,486606,206,106,utRho05
fadH,6463248,6463330,6463248,82,42,utRho05
fadI,4921022,4921022,4920938,84,8,utRho05
fadL,4922410,4922600,4922410,190,2,utRho05
fadM,928720,928804,928720,84,0,utRho05
fadR,2469810,2469876,2469810,66,80,utRho05
fbaB,4357334,4357334,4357128,206,0,utRho05
fdhE,8162722,8162722,8162456,266,1600,utRho05
fdhF,8598814,8598814,8598732,82,10,utRho05
fdnG,3094744,3094802,3094744,58,0,utRho05
fdrA,1093012,1093360,1093012,348,0,utRho05
feaB,2894994,2895038,2894994,44,0,utRho05
feaR,2894734,2894734,2894566,168,0,utRho05
fecA,9033454,9033454,9033354,100,414,utRho05
fecE,9023288,9023288,9022914,374,11110,utRho05
fecI,9036564,9036564,9036470,94,78,utRho05
feoA,7080114,7080326,7080114,212,32,utRho05
fepA,1225334,1225334,1224988,346,230,utRho05
fepB,1249454,1249454,1249020,434,538,utRho05
fepD,1244468,1244468,1244378,90,206,utRho05
fes,1225374,1225630,1225374,256,284,utRho05
ffh,5495706,5495706,5495590,116,2296,utRho05
ffs,952576,952848,952576,272,38,utRho05
fhuA,334884,334968,334884,84,184,utRho05
fhuE,2323294,2323294,2323102,192,444,utRho05
fhuF,9211504,9211504,9211326,178,3378,utRho05
fic,6983296,6983296,6982926,370,468,utRho05
fieF,8212864,8212938,8212864,74,218,utRho05
fimA,9085388,9086230,9085388,842,386,utRho05
fimB,9081334,9081914,9081334,580,628,utRho05
fimE,9083742,9084074,9083742,332,34,utRho05
fimZ,1129214,1129214,1128960,254,0,utRho05
fiu,1683296,1683296,1683062,234,86,utRho05
fixA,84650,84806,84650,156,0,utRho05
fkpA,6955050,6955050,6954838,212,8864,utRho05
fldA,2846084,2846084,2845860,224,4288,utRho05
fldB,6079644,6079710,6079644,66,34,utRho05
flgA,2261770,2261770,2261726,44,64,utRho05
flgB,2261986,2262036,2261986,50,2,utRho05
flgK,2276702,2276756,2276702,54,1694,utRho05
flgM,2260330,2260330,2260256,74,364,utRho05
flgN,2259828,2259828,2259660,168,228,utRho05
flhB,3932432,3932432,3932382,50,134,utRho05
flhC,3955864,3955864,3955688,176,66,utRho05
flhD,3957154,3957154,3956394,760,564,utRho05
fliA,4003638,4003638,4003578,60,172,utRho05
fliC,4007352,4007352,4007212,140,166,utRho05
fliD,4007634,4007744,4007634,110,292,utRho05
fliE,4026186,4026186,4026028,158,0,utRho05
fliF,4026292,4026458,4026292,166,172,utRho05
fliL,4039168,4039236,4039168,68,236,utRho05
flk,4875824,4875900,4875824,76,82,utRho05
flu,4142634,4143078,4142634,444,24,utRho05
flxA,3292776,3292810,3292776,34,0,utRho05
fnr,2799104,2799104,2799052,52,44,utRho05
fnrS,2818258,2818258,2818258,0,0,utRho05
focA,1909628,1909628,1908932,696,356,utRho05
folA,99598,99646,99598,48,40,utRho05
folB,6409296,6409296,6409178,118,0,utRho05
folD,1115562,1115562,1115482,80,252,utRho05
folE,4487696,4487696,4487304,392,3822,utRho05
fpr,8228998,8228998,8228944,54,110,utRho05
frc,4986878,4986878,4986508,370,2,utRho05
frdA,8764824,8764824,8764636,188,132,utRho05
frdD,8758948,8758948,8758732,216,126,utRho05
fre,8052886,8053054,8052886,168,1780,utRho05
frlA,6999518,6999820,6999518,302,0,utRho05
frr,385624,385744,385624,120,1158,utRho05
frsA,513004,513054,513004,50,86,utRho05
fruB,4527194,4527194,4526990,204,48,utRho05
frvR,8179804,8179804,8179710,94,0,utRho05
fryA,5008986,5008986,5008970,16,0,utRho05
fsaA,1727060,1727284,1727060,224,2,utRho05
fsr,1009710,1009710,1009392,318,202,utRho05
ftnA,3977364,3977432,3977364,68,42,utRho05
ftnB,3973550,3973850,3973550,300,16,utRho05
ftsA,207122,207964,207122,842,1594,utRho05
ftsB,5745802,5745802,5745640,162,58,utRho05
ftsH,6654204,6654204,6653870,334,664,utRho05
ftsK,1865858,1866448,1865858,590,1668,utRho05
ftsL,181376,182064,181376,688,1302,utRho05
ftsP,6325732,6325732,6325338,394,328,utRho05
ftsQ,205484,206310,205484,826,792,utRho05
ftsX,7204512,7204512,7204172,340,476,utRho05
ftsZ,209272,210610,209272,1338,388,utRho05
fucA,5867708,5867708,5867376,332,42,utRho05
fucP,5868238,5868470,5868238,232,0,utRho05
fumA,6753760,6753760,6753508,252,1968,utRho05
fumB,8694696,8694696,8694652,44,4,utRho05
fumC,3373418,3373418,3373176,242,0,utRho05
fur,2842892,2842892,2842584,308,5532,utRho05
fusA,6947370,6947370,6947028,342,26486,utRho05
fxsA,8737206,8737328,8737206,122,42,utRho05
gabD,5581824,5582546,5581824,722,650,utRho05
gadA,7335214,7335214,7335160,54,0,utRho05
gadB,3144144,3144144,3144090,54,0,utRho05
gadC,3141168,3141168,3140978,190,98,utRho05
gadE,7315600,7316732,7315600,1132,4,utRho05
gadW,7329562,7329562,7329236,326,126,utRho05
gadX,14663356,14663356,14663240,116,0,utRho05
gadY,7329728,7329728,7329728,0,0,utRho05
galE,1584354,1584354,1584110,244,2,utRho05
galF,4228702,4228702,4228654,48,116,utRho05
galM,1577796,1577796,1577674,122,644,utRho05
galP,6176510,6176568,6176510,58,0,utRho05
galR,5953138,5953198,5953138,60,148,utRho05
galS,4483420,4483420,4483336,84,0,utRho05
galU,2582810,2582914,2582810,104,346,utRho05
gapA,3724480,3725542,3724480,1062,3788,utRho05
garP,6549868,6549868,6549814,54,2,utRho05
gatY,4354468,4354468,4354408,60,0,utRho05
gatZ,4352864,4352864,4352642,222,9488,utRho05
gcd,282558,282558,282450,108,0,utRho05
gcl,1067814,1067832,1067814,18,0,utRho05
gcvA,5885278,5885278,5885134,144,96,utRho05
gcvB,5885392,5885392,5885392,0,0,utRho05
gcvR,5199758,5199812,5199758,54,56,utRho05
gcvT,6101544,6101544,6101334,210,770,utRho05
gdhA,3684616,3684742,3684616,126,0,utRho05
gfcA,2099668,2099668,2099488,180,432,utRho05
gfcD,2096236,2096236,2095890,346,122,utRho05
ghrA,2195648,2195772,2195648,124,150,utRho05
ghrB,7434378,7434620,7434378,242,590,utRho05
glcA,6242728,6242728,6242558,170,4,utRho05
glcC,6256412,6256544,6256412,132,0,utRho05
glcD,6256152,6256152,6256042,110,0,utRho05
gldA,8278092,8278092,8278070,22,0,utRho05
glgA,7136784,7136784,7136066,718,138,utRho05
glgB,7147314,7147314,7147004,310,118,utRho05
glgC,7139142,7139142,7138656,486,190,utRho05
glgP,7133546,7133546,7133162,384,84,utRho05
glgS,6384024,6384024,6383878,146,2,utRho05
glgX,7142838,7142838,7142638,200,18,utRho05
glk,5018922,5018922,5018852,70,46,utRho05
glmS,7827622,7827622,7827336,286,5720,utRho05
glmU,7830652,7830652,7830400,252,244,utRho05
glmY,10765360,10765360,10765360,0,0,utRho05
glmZ,7972864,7972864,7972864,0,0,utRho05
glnA,16232888,16232888,16232136,752,880,utRho05
glnB,5375052,5375052,5374816,236,46,utRho05
glnD,377310,377310,377300,10,18,utRho05
glnE,6399602,6399602,6399282,320,86,utRho05
glnH,1696396,1696396,1696008,388,4,utRho05
glnK,945112,945196,945112,84,4,utRho05
glnL,8112742,8112742,8112678,64,40,utRho05
glnQ,1693262,1693262,1692926,336,254,utRho05
glnS,1411998,1412186,1411998,188,492,utRho05
gloA,3455602,3455674,3455602,72,36,utRho05
gloB,469852,469852,469564,288,916,utRho05
glpA,4705166,4705294,4705166,128,30,utRho05
glpD,7123942,7124026,7123942,84,46,utRho05
glpE,7123698,7123698,7123646,52,104,utRho05
glpF,8236322,8236322,8236180,142,372,utRho05
glpG,7122960,7122960,7122904,56,520,utRho05
glpR,7121782,7121782,7121210,572,312,utRho05
glpT,4704902,4704902,4704748,154,140,utRho05
glpX,8231212,8231212,8231158,54,8002,utRho05
glrK,5382246,5382246,5382196,50,378,utRho05
gltA,1509534,1509534,1508936,598,15972,utRho05
gltB,6709018,6709264,6709018,246,326,utRho05
gltI,1375792,1375792,1375494,298,2964,utRho05
gltP,8588536,8588962,8588536,426,1408,utRho05
gltS,7657382,7657382,7657330,52,212,utRho05
gltX,5041568,5041568,5041344,224,240,utRho05
gluQ,320286,320286,320224,62,22,utRho05
glyA,5371148,5371148,5371014,134,2,utRho05
glyQ,7450708,7450708,7450636,72,190,utRho05
glyS,7448990,7448990,7448794,196,1908,utRho05
glyU,5998128,5998128,5998114,14,0,utRho05
glyV,8784626,8784720,8784626,94,340,utRho05
glyW,3984360,3984360,3984234,126,36,utRho05
gmhB,445612,445666,445612,54,0,utRho05
gmk,7642776,7642856,7642776,80,62,utRho05
gmr,2693686,2693686,2693484,202,252,utRho05
gnd,4202648,4202648,4202536,112,394,utRho05
gnsB,3275692,3275692,3275564,128,80,utRho05
gntK,14310580,14310580,14310368,212,680,utRho05
gntP,9102668,9102668,9102592,76,0,utRho05
gntR,7157760,7157760,7157452,308,250,utRho05
gntT,7092810,7093118,7092810,308,164,utRho05
gntU,7154170,7154170,7154122,48,2,utRho05
gntX,7089334,7089764,7089334,430,28,utRho05
gor,7292224,7292598,7292224,374,882,utRho05
gpmA,1575340,1575340,1575190,150,20,utRho05
gpmM,7570374,7570520,7570374,146,0,utRho05
gpsA,7567620,7567620,7567322,298,8398,utRho05
gpt,511828,511954,511828,126,478,utRho05
grcA,5433046,5433046,5432898,148,194,utRho05
greA,6657728,6657728,6657430,298,2590,utRho05
greB,7073488,7073624,7073488,136,8,utRho05
groL,8741566,8742050,8741566,484,228,utRho05
groS,8741232,8741376,8741232,144,422,utRho05
grpE,5501494,5501494,5501416,78,270,utRho05
grxA,1781552,1781552,1781506,46,0,utRho05
grxB,2248206,2248206,2248108,98,90,utRho05
grxC,7569152,7569152,7568884,268,4164,utRho05
grxD,3468324,3468324,3468202,122,8324,utRho05
gspA,6911268,6911268,6910796,472,0,utRho05
gspC,6910964,6911156,6910964,192,0,utRho05
gss,6277220,6277220,6277044,176,104,utRho05
gstA,3428654,3428754,3428654,100,0,utRho05
gstB,1761038,1761038,1760960,78,2,utRho05
guaB,5268214,5268214,5268140,74,2,utRho05
gudD,5839026,5839026,5838770,256,66,utRho05
gyrA,4678914,4678914,4678840,74,114,utRho05
gyrB,7760300,7760300,7760238,62,150,utRho05
hcaE,5337964,5338064,5337964,100,14,utRho05
hcaR,5337928,5337928,5337792,136,26,utRho05
hcaT,5336106,5336106,5335692,414,126,utRho05
hchA,4071260,4071670,4071260,410,2,utRho05
hcp,1828258,1828258,1827628,630,54,utRho05
hcr,1824400,1824400,1824300,100,32,utRho05
hdeA,7313582,7313582,7313480,102,0,utRho05
hdeD,7313920,7313990,7313920,70,6,utRho05
hdfR,7896320,7896320,7895934,386,516,utRho05
hdhA,3396244,3396244,3396080,164,0,utRho05
helD,2048876,2048942,2048876,66,0,utRho05
hemA,2527166,2527428,2527166,262,280,utRho05
hemB,779722,779722,779454,268,154,utRho05
hemF,5106410,5106450,5106410,40,0,utRho05
hemH,996062,996110,996062,48,34,utRho05
hemL,349882,349882,349764,118,84,utRho05
hemN,8103886,8104090,8103886,204,30,utRho05
hepA,127176,127176,126528,648,2786,utRho05
hflD,2385372,2385372,2385262,110,948,utRho05
hfq,8799602,8800576,8799602,974,3632,utRho05
hha,961006,961006,960616,390,120,utRho05
hicA,3018442,3018572,3018442,130,0,utRho05
higA,6468682,6468682,6468288,394,4,utRho05
higB,6468960,6468960,6468910,50,0,utRho05
hinT,2323642,2323770,2323642,128,32,utRho05
hipB,3184964,3184964,3184884,80,0,utRho05
hisB,4186720,4186936,4186720,216,1100,utRho05
hisJ,4853674,4853674,4853576,98,0,utRho05
hisL,8359856,8359984,8359856,128,600,utRho05
hisS,5281284,5281284,5281150,134,292,utRho05
hlpA,400910,400964,400910,54,248,utRho05
hlyE,2460932,2460932,2460788,144,2,utRho05
hmp,5371594,5371670,5371594,76,0,utRho05
hns,2585916,2585916,2585844,72,1244,utRho05
hofM,7045856,7045856,7045502,354,0,utRho05
hokA,7441620,7441620,7441200,420,6060,utRho05
hokC,33902,33902,33806,96,258,utRho05
hokE,1215462,1215672,1215462,210,114,utRho05
holC,8968546,8968546,8968560,14,1016,utRho05
holD,9215562,9215606,9215562,44,0,utRho05
holE,3850040,3850216,3850040,176,1162,utRho05
hpt,282720,282862,282720,142,148,utRho05
hrpB,324150,324210,324150,60,80,utRho05
hscB,5319048,5319048,5318934,114,1792,utRho05
hscC,1367188,1367188,1366786,402,406,utRho05
hsdS,9163004,9163004,9162924,80,0,utRho05
hslJ,2883560,2883560,2883486,74,18,utRho05
hslO,7059344,7059548,7059344,204,7486,utRho05
hslR,7058220,7058696,7058220,476,1264,utRho05
hslV,8244708,8244708,8244574,134,4,utRho05
hsrA,7881412,7881412,7881224,188,38,utRho05
htgA,21286,21660,21286,374,1446,utRho05
htpG,989634,990240,989634,606,8070,utRho05
htpX,3825236,3825236,3825152,84,0,utRho05
htrE,311036,311036,310852,184,0,utRho05
htrL,7587668,7587668,7587366,302,2,utRho05
hupA,8400352,8400562,8400352,210,500,utRho05
hupB,1845220,1845804,1845220,584,724,utRho05
hyaA,2063968,2064278,2063968,310,0,utRho05
hybO,6292726,6292726,6292522,204,146,utRho05
hycA,5700922,5700922,5700870,52,0,utRho05
hycI,5686204,5686204,5686086,118,90,utRho05
hydN,5676264,5676264,5676210,54,0,utRho05
hyfA,5202342,5202402,5202342,60,54,utRho05
hypA,11402508,11402588,11402508,80,0,utRho05
hypB,11403356,11404004,11403356,648,228,utRho05
hypF,5676210,5676210,5674850,1360,1708,utRho05
hypT,9116634,9116634,9116578,56,0,utRho05
hyuA,6019660,6020056,6019660,396,16,utRho05
iaaA,1733074,1733136,1733074,62,0,utRho05
iadA,9119074,9119074,9119052,22,24,utRho05
iap,5753072,5753162,5753072,90,20,utRho05
ibaG,6673966,6673966,6673606,360,516,utRho05
ibpA,7735036,7735036,7734844,192,352,utRho05
ibpB,7733962,7733962,7733794,168,552,utRho05
icd,2389922,2390246,2389922,324,350,utRho05
iclR,8447304,8447304,8447256,48,86,utRho05
idi,6065876,6066130,6065876,254,42,utRho05
idnD,8988870,8988870,8988812,58,2,utRho05
idnK,8989194,8989246,8989194,52,6,utRho05
ihfA,3591442,3591442,3591104,338,1058,utRho05
ihfB,1927498,1927656,1927498,158,782,utRho05
ileS,43666,44782,43666,1116,4592,utRho05
ileX,6431194,6431196,6431194,2,0,utRho05
ilvA,15820940,15821324,15820940,384,0,utRho05
ilvC,7915824,7915940,7915824,116,0,utRho05
ilvE,15809552,15809936,15809552,384,528,utRho05
ilvI,170840,171260,170840,420,4,utRho05
ilvL,23701308,23701932,23701308,624,6,utRho05
ilvY,7915734,7915734,7915640,94,0,utRho05
inaA,4698998,4698998,4698944,54,60,utRho05
infA,1853370,1853370,1852886,484,4822,utRho05
infC,3602692,3602692,3601276,1416,6302,utRho05
insA-5,3958452,3958452,3958430,22,64,utRho05
insA-7,9036758,9037054,9036758,296,92,utRho05
insC-5,6372080,6372284,6372080,204,208,utRho05
insEF-2,785238,785238,785820,582,438,utRho05
insEF-4,2190310,2190310,2190892,582,462,utRho05
insG,9007098,9007098,9006862,236,0,utRho05
insH-1,550596,550596,550234,362,190,utRho05
insH-11,7306538,7306538,7306396,142,58,utRho05
insH-2,1151548,1151548,1151506,42,48,utRho05
insH-3,1378444,1378444,1378026,418,382,utRho05
insH-4,2791942,2792152,2791942,210,62,utRho05
insH-5,2857852,2857852,2857452,400,0,utRho05
insH-6,4135022,4135022,4134642,380,148,utRho05
insH-7,4206186,4206186,4205822,364,10378,utRho05
insH-9,6260050,6260356,6260050,306,36,utRho05
insI-3,9017372,9017372,9017234,138,46,utRho05
insJ,7441188,7441360,7441188,172,2652,utRho05
insK,7442130,7442308,7442130,178,8,utRho05
insL-1,30760,30890,30760,130,766,utRho05
insL-2,1216112,1216130,1216112,18,28,utRho05
insL-3,5028644,5028662,5028644,18,152,utRho05
insN-1,540452,540484,540452,32,0,utRho05
intD,1132202,1132202,1131956,246,164,utRho05
intR,2826520,2826520,2826470,50,0,utRho05
intS,4933026,4933090,4933026,64,642,utRho05
intZ,5117386,5117542,5117386,156,230,utRho05
iraD,9113152,9113986,9113152,834,82,utRho05
iraM,2424246,2424246,2424006,240,0,utRho05
iraP,802638,802772,802638,134,0,utRho05
iscA,5319924,5319924,5319772,152,1860,utRho05
iscR,5324398,5324398,5324262,136,25928,utRho05
iscX,5313834,5313834,5313472,362,2114,utRho05
ispF,5743968,5743968,5743560,408,1236,utRho05
ispG,5283908,5283908,5283608,300,1424,utRho05
ispU,389568,389806,389568,238,130,utRho05
isrA,2811502,2811502,2811618,116,4,utRho05
istr-1,7706384,7706384,7706384,0,0,utRho05
istr-2,7706514,7706514,7706514,0,0,utRho05
ivbL,15412092,15412092,15411952,140,848,utRho05
ivy,480638,480686,480638,48,2,utRho05
katE,3627628,3627734,3627628,106,2,utRho05
katG,8267624,8267670,8267624,46,32,utRho05
kbaZ,6557732,6557828,6557732,96,0,utRho05
kbl,7585154,7585154,7585102,52,686,utRho05
kch,2621046,2621046,2620538,508,0,utRho05
kdgR,3820506,3820506,3820198,308,44,utRho05
kdpE,1443788,1443788,1443466,322,38,utRho05
kdpF,1457698,1457698,1457642,56,0,utRho05
kdsA,2535708,2536330,2535708,622,4152,utRho05
kdsC,6683438,6684546,6683438,1108,3990,utRho05
kduI,5968388,5968388,5968248,140,1034,utRho05
kefF,94160,94492,94160,332,302,utRho05
kgtP,5451624,5451624,5451492,132,1006,utRho05
kup,7862206,7862632,7862206,426,196,utRho05
lacI,735076,735076,735020,56,0,utRho05
lacZ,1465508,1465508,1465220,288,212,utRho05
ldcA,2486394,2486394,2486160,234,8,utRho05
ldhA,2885830,2885830,2885686,144,0,utRho05
ldrA,2538954,2538954,2538550,404,2018,utRho05
ldrB,2540024,2540024,2539620,404,934,utRho05
ldrC,2541092,2541092,2540690,402,2078,utRho05
ldrD,7400544,7400544,7400174,370,2204,utRho05
lepA,5414392,5414392,5414248,144,144,utRho05
lepB,5410928,5410928,5410618,310,814,utRho05
leuD,159188,159188,158906,282,0,utRho05
leuE,3761600,3761600,3761518,82,0,utRho05
leuL,168048,168048,167416,632,0,utRho05
leuO,168308,168736,168308,428,0,utRho05
leuQ,9212864,9212864,9212802,62,0,utRho05
leuU,6644556,6644556,6644316,240,5504,utRho05
leuV,9212546,9212546,9212330,216,810,utRho05
leuX,8992772,8992810,8992772,38,12,utRho05
lexA,8514174,8514230,8514174,56,188,utRho05
lhr,3456706,3458174,3456706,1468,3076,utRho05
ligA,5060402,5060402,5060352,50,0,utRho05
ligB,7642576,7642576,7642340,236,0,utRho05
lipA,1320602,1320602,1320432,170,40,utRho05
lipB,1324802,1324802,1324556,246,2208,utRho05
lit,2397032,2397390,2397032,358,82,utRho05
livJ,7199524,7199524,7199316,208,1412,utRho05
livK,7195510,7195510,7195120,390,38,utRho05
lldP,7554578,7554798,7554578,220,2290,utRho05
lnt,1381968,1381968,1381762,206,510,utRho05
loiP,6163784,6163826,6163784,42,0,utRho05
lolA,1874656,1874738,1874656,82,516,utRho05
lolB,2527112,2527112,2527000,112,120,utRho05
lolC,2350748,2350854,2350748,106,0,utRho05
lon,917630,917776,917630,146,1228,utRho05
lpcA,486936,487086,486936,150,0,utRho05
lpd,255434,255824,255434,390,3310,utRho05
lplA,9248476,9248476,9248234,242,1266,utRho05
lplT,5947878,5947878,5947724,154,12,utRho05
lpoA,6586422,6586800,6586422,378,550,utRho05
lpp,3514592,3514842,3514592,250,164,utRho05
lptA,6686598,6686760,6686598,162,1114,utRho05
lptB,6686792,6687888,6686792,1096,1868,utRho05
lptD,114672,114672,114218,454,4498,utRho05
lptF,8972244,8972436,8972244,192,240,utRho05
lpxC,213016,213114,213016,98,32354,utRho05
lpxD,401920,401942,401920,22,156,utRho05
lpxL,2233418,2233418,2233164,254,110,utRho05
lpxM,3880456,3880456,3880386,70,254,utRho05
lpxP,4991156,4991290,4991156,134,956,utRho05
lrhA,4813312,4813312,4813282,30,78,utRho05
lrp,1864656,1865190,1864656,534,1114,utRho05
lspA,50028,50414,50028,386,1174,utRho05
lsrA,3202920,3202980,3202920,60,34,utRho05
lsrR,3202514,3202514,3202482,32,0,utRho05
ltaE,1818640,1818640,1818588,52,0,utRho05
luxS,5630130,5630130,5629466,664,3208,utRho05
lysA,5957902,5957902,5957798,104,0,utRho05
lysC,8467232,8467232,8466466,766,748,utRho05
lysP,4497120,4497120,4497064,56,124,utRho05
lysR,5957900,5958042,5957900,142,0,utRho05
lysT,1561028,1561108,1561028,80,202,utRho05
lysU,8709610,8709610,8709434,176,0,utRho05
macB,1840188,1840694,1840188,506,316,utRho05
maeA,3111484,3111484,3111338,146,2474,utRho05
mak,820236,820288,820236,52,0,utRho05
malE,8492928,8492928,8492838,90,0,utRho05
malI,3398456,3398456,3398360,96,0,utRho05
malK,8493472,8493568,8493472,96,0,utRho05
malP,7105020,7105020,7104946,74,278,utRho05
malQ,7100798,7100798,7100140,658,474,utRho05
malS,14949880,14949988,14949880,108,44,utRho05
malT,7106048,7106170,7106048,122,118,utRho05
malX,3398626,3398710,3398626,84,0,utRho05
malZ,1689980,1690072,1689980,92,2728,utRho05
manA,3377102,3377152,3377102,50,144,utRho05
manX,3803866,3804096,3803866,230,2,utRho05
marC,3237882,3237882,3237816,66,176,utRho05
marR,3238186,3238240,3238186,54,0,utRho05
matP,2036918,2036970,2036918,52,56,utRho05
mazE,5822736,5822736,5822678,58,34,utRho05
mazG,5821720,5821720,5821370,350,4722,utRho05
mcbA,1684306,1684306,1684112,194,0,utRho05
mcbR,3040192,3040524,3040192,332,0,utRho05
mcrA,2420278,2420692,2420278,414,0,utRho05
mcrC,9156124,9156124,9155916,208,182,utRho05
mdaB,6344814,6345060,6344814,246,72,utRho05
mdfA,1767138,1767346,1767138,208,2,utRho05
mdh,6768940,6768940,6768536,404,118,utRho05
mdoB,9198988,9198988,9198882,106,518,utRho05
mdoD,2993290,2993712,2993290,422,0,utRho05
mdoG,2218514,2218670,2218514,156,170,utRho05
mdtA,4307958,4308032,4307958,74,76,utRho05
mdtE,7318168,7318464,7318168,296,64,utRho05
mdtK,3486538,3486914,3486538,376,312,utRho05
mdtP,8602472,8602472,8602060,412,4,utRho05
melA,8683774,8683822,8683774,48,0,utRho05
melR,8683300,8683300,8683256,44,30,utRho05
menA,8240812,8240812,8240698,114,34,utRho05
menB,4753774,4753774,4753638,136,246,utRho05
mepH,3468714,3468870,3468714,156,36,utRho05
mepM,3883666,3883666,3883270,396,614,utRho05
mepS,4539840,4539958,4539840,118,1166,utRho05
metA,8428318,8428560,8428318,242,350,utRho05
metB,8257272,8257344,8257272,72,536,utRho05
metC,6304150,6304472,6304150,322,174,utRho05
metE,8025768,8026106,8025768,338,28,utRho05
metF,8265092,8265232,8265092,140,70,utRho05
metG,4388538,4388600,4388538,62,102,utRho05
metH,8447010,8447656,8447010,646,9926,utRho05
metJ,8257116,8257116,8256790,326,2,utRho05
metK,6173154,6173412,6173154,258,284,utRho05
metN,445428,445428,445290,138,0,utRho05
metR,8025710,8025710,8025632,78,0,utRho05
metT,1394326,1394326,1394266,60,174,utRho05
metY,19910250,19910250,19909734,516,8304,utRho05
metZ,11789528,11789548,11789528,20,0,utRho05
mfd,2348056,2348056,2347928,128,202,utRho05
mglA,4478782,4478782,4478578,204,300,utRho05
mglB,4481132,4481132,4480696,436,4196,utRho05
mglC,4475918,4475918,4475506,412,166,utRho05
mgrB,3817584,3817584,3817532,52,0,utRho05
mgrR,3245828,3245828,3245828,0,0,utRho05
mgsA,2054082,2054082,2054030,52,40,utRho05
mgtL,8934560,8934862,8934560,302,134,utRho05
mhpA,737038,737222,737038,184,0,utRho05
mhpR,737072,737072,736840,232,0,utRho05
mhpT,750772,750918,750772,146,0,utRho05
miaA,8797964,8798504,8797964,540,1050,utRho05
micA,5629604,5629604,5629604,0,0,utRho05
micC,2874242,2874238,2874242,4,0,utRho05
micF,4626168,4626168,4626168,0,0,utRho05
micM,1014408,1014408,1014408,0,0,utRho05
minE,2449422,2449422,2449090,332,628,utRho05
mioC,7852950,7852950,7852910,40,76,utRho05
mipA,3733012,3733012,3732944,68,4306,utRho05
mlaA,4930270,4930270,4930014,256,20,utRho05
mlc,3337206,3337206,3337128,78,0,utRho05
mlrA,4429498,4429732,4429498,234,0,utRho05
mltA,5894546,5894546,5894356,190,0,utRho05
mltD,468050,468050,467910,140,2,utRho05
mltF,5391534,5391602,5391534,68,0,utRho05
mmuP,550238,550650,550238,412,198,utRho05
mngA,1531622,1531968,1531622,346,142,utRho05
mngR,1531852,1531852,1531750,102,46,utRho05
mnmG,7851348,7851348,7851266,82,7314,utRho05
mntH,5025470,5025470,5025412,58,46,utRho05
mntP,3810918,3811376,3810918,458,928,utRho05
mntR,1706160,1706366,1706160,206,0,utRho05
mntS,1706128,1706128,1705994,134,68,utRho05
moaA,1633654,1634088,1633654,434,1384,utRho05
moaB,1635954,1636110,1635954,156,734,utRho05
mobA,8084242,8084242,8083998,244,442,utRho05
mocA,6030112,6030320,6030112,208,28,utRho05
modA,1589990,1590178,1589990,188,276,utRho05
moeA,1732788,1732788,1732728,60,96,utRho05
mokB,2984610,2984610,2984258,352,770,utRho05
molR_1,4392888,4392948,4392888,60,244,utRho05
motA,3954604,3954604,3954278,326,56,utRho05
mpaA,2781278,2781278,2781196,82,190,utRho05
mpl,8911456,8911570,8911456,114,0,utRho05
mppA,2786108,2786454,2786108,346,0,utRho05
mprA,5621494,5621540,5621494,46,272,utRho05
mqo,4613848,4613848,4613508,340,376,utRho05
mqsA,6336742,6336742,6336492,250,76,utRho05
mqsR,6337306,6337306,6337088,218,358,utRho05
mraZ,179192,179268,179192,76,44,utRho05
mrcA,7045652,7045742,7045652,90,0,utRho05
mrcB,329442,329460,329442,18,0,utRho05
mreB,13605424,13605424,13604348,1076,2508,utRho05
mreD,6798166,6798166,6797750,416,446,utRho05
mrp,4388360,4388360,4388336,24,16,utRho05
mscK,972984,973072,972984,88,36,utRho05
mscL,6876002,6876048,6876002,46,316,utRho05
mscS,6139742,6139742,6139614,128,24,utRho05
msrA,8884522,8884522,8884352,170,138,utRho05
msrB,3725168,3725168,3724858,310,56,utRho05
msyB,2228426,2228426,2228362,64,308,utRho05
mtfA,4087236,4087302,4087236,66,754,utRho05
mtgA,6699662,6699662,6699618,44,304,utRho05
mtlA,30177504,30178248,30177504,744,672,utRho05
mtn,358366,358366,358306,60,28,utRho05
mtr,6611864,6611864,6611634,230,116,utRho05
mug,6430992,6430992,6430946,46,106,utRho05
murQ,5091466,5091546,5091466,80,0,utRho05
murR,5091586,5091586,5091218,368,68,utRho05
mutH,5939164,5939324,5939164,160,790,utRho05
mutL,8794092,8794824,8794092,732,1640,utRho05
mutM,7622554,7622554,7622304,250,1272,utRho05
mutS,5714038,5714186,5714038,148,706,utRho05
mutY,18617466,18618078,18617466,612,102,utRho05
nac,4123956,4123956,4123866,90,44,utRho05
nadA,1564122,1564170,1564122,48,2,utRho05
nadB,5420714,5420840,5420714,126,28,utRho05
nadC,237326,237326,237290,36,18,utRho05
nadE,3644604,3644916,3644604,312,30,utRho05
nadK,5501526,5501662,5501526,136,84,utRho05
nagA,1406350,1406350,1405502,848,1864,utRho05
nagB,1407416,1407416,1407222,194,0,utRho05
nagC,1404016,1404016,1403188,828,106,utRho05
nagE,1407680,1407888,1407680,208,0,utRho05
nagK,2357080,2357186,2357080,106,182,utRho05
nanA,6747240,6747240,6747152,88,92,utRho05
nanC,9079856,9079856,9079002,854,2,utRho05
nanR,6749406,6749406,6748978,428,214,utRho05
nanS,9075406,9075406,9075188,218,2,utRho05
napF,4607390,4607390,4606994,396,4,utRho05
narG,2559614,2559728,2559614,114,16,utRho05
narK,2555642,2555914,2555642,272,0,utRho05
narP,4580844,4581000,4580844,156,0,utRho05
narQ,5171154,5171462,5171154,308,84,utRho05
narU,3088326,3088326,3088120,206,0,utRho05
narW,3077374,3077374,3074618,2756,8,utRho05
narX,2555554,2555554,2555236,318,0,utRho05
narZ,3085380,3085380,3085180,200,0,utRho05
ndh,2331984,2332170,2331984,186,48,utRho05
ndk,5289920,5289920,5289728,192,456,utRho05
nemR,6904084,6904092,6904084,8,8,utRho05
nepI,7683542,7683542,7683478,64,332,utRho05
nfo,4501612,4501680,4501612,68,76,utRho05
nfsB,1210906,1210906,1210848,58,6,utRho05
nfuA,7090916,7091248,7090916,332,758,utRho05
nhaA,34634,34978,34634,344,2,utRho05
nhaB,2469534,2469534,2469434,100,50,utRho05
nhoA,3067926,3068048,3067926,122,0,utRho05
nikA,7226878,7227334,7226878,456,3076,utRho05
nikR,7237074,7237176,7237074,102,58,utRho05
nirB,6987974,6988022,6987974,48,0,utRho05
nlpA,7680034,7680034,7679986,48,0,utRho05
nlpC,3585654,3585654,3585462,192,22,utRho05
nlpD,5737658,5737658,5737506,152,66,utRho05
nlpI,6618080,6618080,6617848,232,32,utRho05
nmpC,1153740,1153740,1153650,90,0,utRho05
nohA,3273206,3273206,3272734,472,14,utRho05
norR,5664614,5664614,5664578,36,50,utRho05
norV,5664878,5664952,5664878,74,0,utRho05
nrdA,4689510,4689730,4689510,220,10246,utRho05
nrdD,8925676,8925676,8925320,356,3658,utRho05
nrdH,5601312,5601446,5601312,134,484,utRho05
nrdR,865954,866004,865954,50,20,utRho05
nrfA,8575342,8575528,8575342,186,62,utRho05
nsrR,8812088,8812380,8812088,292,59478,utRho05
nudB,3897348,3897348,3897264,84,0,utRho05
nudC,8393428,8393806,8393428,378,62,utRho05
nudE,7052658,7052658,7052298,360,5352,utRho05
nudG,3682876,3682980,3682876,104,0,utRho05
nudI,4729050,4729108,4729050,58,0,utRho05
nudJ,2388874,2388874,2388576,298,1326,utRho05
nuoA,4810670,4810670,4810144,526,3758,utRho05
nuoN,4783434,4783434,4783010,424,1940,utRho05
nupC,5026018,5026084,5026018,66,60,utRho05
nupG,6211302,6211428,6211302,126,48,utRho05
ogrK,4335096,4335096,4335040,56,0,utRho05
ogt,2800568,2800568,2800472,96,94,utRho05
ohsC,5401036,5401040,5401036,4,0,utRho05
ompA,2040382,2040382,2040106,276,16802,utRho05
ompC,4625774,4625774,4625498,276,116,utRho05
ompF,1974184,1974184,1973964,220,146,utRho05
ompL,8128958,8128958,8128590,368,0,utRho05
ompN,2874158,2874158,2873786,372,0,utRho05
ompR,7073510,7073510,7073168,342,92,utRho05
ompT,1171330,1171330,1171266,64,98,utRho05
ompW,2627982,2628040,2627982,58,0,utRho05
ompX,1700418,1700900,1700418,482,738,utRho05
omrA,5952378,5952378,5952378,0,0,utRho05
omrB,5952770,5952770,5952770,0,0,utRho05
oppA,2602170,2602364,2602170,194,21526,utRho05
orn,8783168,8783208,8783168,40,4,utRho05
osmB,2686952,2686952,2686656,296,240,utRho05
osmC,3113192,3113250,3113192,58,38,utRho05
osmE,3644566,3644566,3644512,54,36,utRho05
osmF,4439046,4439046,4438962,84,754,utRho05
osmY,9222306,9222792,9222306,486,178,utRho05
otsA,3963302,3963302,3963224,78,0,utRho05
otsB,3964930,3964930,3964774,156,96,utRho05
oxc,4984288,4984288,4983900,388,0,utRho05
oxyR,8316914,8316980,8316914,66,6,utRho05
oxyS,8316788,8316788,8316788,0,0,utRho05
paaA,2907730,2907854,2907730,124,70,utRho05
paaX,2927018,2927078,2927018,60,0,utRho05
paaZ,2907340,2907340,2907284,56,0,utRho05
pabA,6981702,6981702,6981658,44,0,utRho05
pabB,3789256,3789610,3789256,354,120,utRho05
pabC,2306186,2306600,2306186,414,298,utRho05
pagP,1313052,1313114,1313052,62,0,utRho05
panB,299260,299260,299202,58,112,utRho05
panC,297840,297840,297590,250,350,utRho05
panD,293490,293490,293388,102,4,utRho05
panZ,7195656,7195968,7195656,312,12,utRho05
parC,6332060,6332060,6331946,114,220,utRho05
patA,6438916,6438988,6438916,72,104,utRho05
patD,3030830,3031156,3030830,326,0,utRho05
pbpC,5294986,5294986,5294650,336,0,utRho05
pbpG,4450132,4450132,4449740,392,116,utRho05
pck,7065358,7065636,7065358,278,3116,utRho05
pcnB,318782,318782,318252,530,1332,utRho05
pdhR,244068,244184,244068,116,136,utRho05
pdxB,4875768,4875768,4875702,66,0,utRho05
pdxH,3436068,3436068,3436014,54,452,utRho05
pdxJ,5403626,5403626,5403458,168,2,utRho05
pdxK,5074638,5074638,5074474,164,72,utRho05
pepA,8972278,8972278,8971902,376,254,utRho05
pepD,511618,511618,511432,186,3474,utRho05
pepN,1981182,1981244,1981182,62,118,utRho05
pepQ,8062294,8062322,8062294,28,0,utRho05
pepT,2371646,2371688,2371646,42,0,utRho05
pfkA,8214948,8215104,8214948,156,310,utRho05
pfkB,3612646,3612740,3612646,94,0,utRho05
pflA,1902456,1902456,1902160,296,80,utRho05
pflB,1907850,1907850,1907108,742,848,utRho05
pflD,8287716,8287990,8287716,274,0,utRho05
pgaA,2185046,2185046,2184578,468,64,utRho05
pgi,8467444,8467516,8467444,72,10,utRho05
pgk,12291428,12291428,12290488,940,4488,utRho05
pgl,1597078,1597172,1597078,94,100,utRho05
pgpB,2678324,2678660,2678324,336,0,utRho05
pgpC,5397276,5397276,5397100,176,0,utRho05
pgrR,2783744,2783982,2783744,238,68,utRho05
pheL,5475158,5475198,5475158,40,0,utRho05
pheM,7197204,7197204,7197080,124,8,utRho05
pheP,1203858,1203918,1203858,60,70,utRho05
pheU,8725254,8725254,8725252,2,0,utRho05
pheV,6220730,6220732,6220730,2,60,utRho05
phnC,8650412,8650412,8650330,82,4,utRho05
phoA,803414,803494,803414,80,0,utRho05
phoB,834202,834284,834202,82,42,utRho05
phoE,520316,520316,520200,116,0,utRho05
phoH,2169730,2169984,2169730,254,508,utRho05
phoP,2381016,2381016,2380894,122,1878,utRho05
phoQ,2379880,2379880,2379552,328,630,utRho05
phoU,7815330,7815330,7815156,174,0,utRho05
phr,1478842,1479014,1478842,172,0,utRho05
pinE,2419054,2419370,2419054,316,20,utRho05
pinQ,3267168,3267244,3267168,76,636,utRho05
pinR,2867424,2867424,2867348,76,696,utRho05
pitA,7275224,7275284,7275224,60,4,utRho05
pitB,6272806,6272806,6272742,64,88,utRho05
pka,5439862,5439906,5439862,44,0,utRho05
plaP,4174476,4174476,4174124,352,770,utRho05
pldA,8009628,8009724,8009628,96,128,utRho05
pldB,8018028,8018340,8018028,312,502,utRho05
plsB,8513196,8513196,8512932,264,112,utRho05
pmbA,8915890,8915918,8915890,28,0,utRho05
pmrD,4747148,4747148,4747076,72,110,utRho05
pncB,1980828,1980828,1980712,116,48,utRho05
pncC,5648788,5648788,5648692,96,0,utRho05
pnp,6622652,6622652,6622336,316,44,utRho05
pntA,3355950,3355950,3355806,144,0,utRho05
pntB,3353096,3353096,3352720,376,0,utRho05
polA,8093880,8093932,8093880,52,0,utRho05
polB,131606,131606,131560,46,0,utRho05
potD,2365700,2365700,2365658,42,98,utRho05
potE,1436688,1436688,1436530,158,2,utRho05
potF,1787268,1787568,1787268,300,4,utRho05
poxB,1822152,1822152,1822098,54,0,utRho05
ppa,8899372,8899372,8899304,68,328,utRho05
ppc,8306380,8306380,8306196,184,658,utRho05
ppdA,5928440,5928440,5928354,86,1200,utRho05
ppdD,235410,235410,235098,312,438,utRho05
pphA,3846770,3846770,3845938,832,1942,utRho05
pphB,5719474,5719520,5719474,46,0,utRho05
ppiA,6984898,6984898,6984594,304,74,utRho05
ppiC,7919682,7919682,7919626,56,278,utRho05
ppiD,923638,923830,923638,192,1188,utRho05
ppk,5245748,5246088,5245748,340,216,utRho05
pppA,6228958,6228958,6228704,254,0,utRho05
ppsA,3574322,3574322,3574224,98,0,utRho05
ppsR,3574678,3574890,3574678,212,0,utRho05
pptA,3065716,3066104,3065716,388,8,utRho05
pqiA,2023318,2024002,2023318,684,76,utRho05
prc,3830054,3830054,3829632,422,24812,utRho05
preT,4467978,4468066,4467978,88,36,utRho05
prfC,9218688,9218828,9218688,140,1230,utRho05
prkB,6968622,6968980,6968622,358,1452,utRho05
prlC,7290476,7290476,7290364,112,64,utRho05
prlF,6553944,6554004,6553944,60,190,utRho05
proB,520432,520776,520432,344,16,utRho05
proC,811372,811372,811288,84,0,utRho05
proK,7417388,7417388,7417384,4,170,utRho05
proL,4572414,4572422,4572414,8,0,utRho05
proP,8660640,8661004,8660640,364,4422,utRho05
proS,437674,437674,437550,124,424,utRho05
proV,5609126,5609630,5609126,504,166,utRho05
prpB,697292,697364,697292,72,0,utRho05
prpR,696942,696942,696886,56,0,utRho05
prs,2524354,2524354,2523750,604,60526,utRho05
psd,8781276,8781276,8780720,556,4236,utRho05
psiE,8480600,8480650,8480600,50,0,utRho05
pspA,2736076,2736158,2736076,82,0,utRho05
pspF,2736080,2736080,2735824,256,0,utRho05
pspG,8525632,8525680,8525632,48,46,utRho05
pssA,5445156,5445454,5445156,298,3048,utRho05
pstB,7817112,7817112,7816732,380,124,utRho05
pstC,7821084,7821084,7820796,288,0,utRho05
pstS,23469408,23469408,23469150,258,204,utRho05
psuG,4517114,4517114,4516734,380,72,utRho05
psuT,4514992,4514992,4514670,322,0,utRho05
pth,2517084,2517084,2517026,58,12,utRho05
ptrA,5918022,5918022,5917768,254,0,utRho05
ptrB,3857730,3857730,3857678,52,6646,utRho05
ptsG,2315252,2315738,2315252,486,2630,utRho05
ptsH,5066996,5067528,5066996,532,2286,utRho05
purA,8809328,8809374,8809328,46,0,utRho05
purC,5195562,5195562,5195236,326,0,utRho05
purD,8411972,8411972,8411862,110,70,utRho05
purE,1106284,1106284,1106200,84,1372,utRho05
purH,8415254,8415254,8415064,190,48,utRho05
purL,5391178,5391178,5391086,92,374,utRho05
purM,5242306,5242394,5242306,88,0,utRho05
purR,3475378,3475688,3475378,310,818,utRho05
purT,3861438,3861762,3861438,324,20,utRho05
purU,2577512,2577512,2577248,264,996,utRho05
putA,2157850,2157850,2157764,86,0,utRho05
putP,2158336,2158610,2158336,274,450,utRho05
puuA,2721936,2721936,2721816,120,0,utRho05
puuC,2725456,2725486,2725456,30,0,utRho05
puuD,2722104,2722240,2722104,136,66,utRho05
puuP,2718746,2718746,2718374,372,1632,utRho05
pykA,3874988,3875298,3874988,310,82,utRho05
pykF,3510934,3511396,3510934,462,1442,utRho05
pyrC,2245286,2245286,2245214,72,138,utRho05
pyrD,2009464,2009536,2009464,72,32,utRho05
pyrE,7631970,7631970,7631536,434,120,utRho05
pyrF,2683740,2683842,2683740,102,304,utRho05
pyrG,5819594,5819594,5819332,262,2216,utRho05
pyrH,383624,383710,383624,86,2394,utRho05
pyrL,8945490,8945490,8945066,424,80,utRho05
qmcA,1031646,1031646,1031546,100,134,utRho05
qor,8528608,8528608,8528462,146,200,utRho05
qseB,6339502,6339656,6339502,154,56,utRho05
queA,849970,850022,849970,52,546,utRho05
queE,5811212,5811212,5810836,376,0,utRho05
queF,5850642,5850696,5850642,54,52,utRho05
queG,8788184,8788184,8788134,50,928,utRho05
racC,2835630,2835630,2835526,104,0,utRho05
racR,2840898,2840898,2840482,416,0,utRho05
raiA,5474208,5474308,5474208,100,120,utRho05
rarD,8008594,8008594,8008356,238,446,utRho05
ravA,7862256,7862256,7862186,70,62,utRho05
rayT,495088,495274,495088,186,40,utRho05
rbn,4763162,4763216,4763162,54,0,utRho05
rbsD,7866644,7866702,7866644,58,14,utRho05
rcnA,4371654,4371834,4371654,180,2,utRho05
rcnB,4373768,4373920,4373768,152,120,utRho05
rcnR,4371806,4371806,4371592,214,2,utRho05
rcsA,4047672,4047936,4047672,264,196,utRho05
rcsB,4631390,4632354,4631390,964,1238,utRho05
rcsC,4640162,4640162,4639656,506,140,utRho05
rcsD,4626904,4626976,4626904,72,420,utRho05
rdgB,6193240,6193362,6193240,122,320,utRho05
rdlA,2538646,2538646,2538646,0,0,utRho05
rdlB,2539712,2539716,2539712,4,0,utRho05
rdlC,2540782,2540786,2540782,4,0,utRho05
rdlD,7400272,7400272,7400272,0,0,utRho05
rdoA,8084782,8084830,8084782,48,270,utRho05
recA,11295276,11295276,11295076,200,1260,utRho05
recC,5925014,5925014,5924856,158,76,utRho05
recF,7763722,7763722,7762442,1280,9848,utRho05
recN,5503518,5503590,5503518,72,0,utRho05
recQ,8011666,8011728,8011666,62,0,utRho05
relA,5828554,5828554,5827302,1252,508,utRho05
relB,3291806,3291806,3291744,62,68,utRho05
rem,3289950,3289950,3289804,146,16,utRho05
rep,7921294,7921354,7921294,60,0,utRho05
rfaD,7587730,7587974,7587730,244,356,utRho05
rfaE,6393852,6393852,6393506,346,0,utRho05
rfaH,8049930,8049930,8049642,288,2144,utRho05
rfbX,4219436,4219436,4219168,268,3048,utRho05
rfe,7935600,7935832,7935600,232,118,utRho05
rhaB,8194944,8194944,8194896,48,0,utRho05
rhaD,8188770,8188770,8188544,226,0,utRho05
rhaS,8195422,8195472,8195422,50,0,utRho05
rhaT,8201132,8201132,8201050,82,0,utRho05
rhlE,1661566,1661744,1661566,178,588,utRho05
rhoL,47593944,47594772,47593944,828,310944,utRho05
rhsB,7238006,7238384,7238006,378,154,utRho05
rhsC,1458758,1459166,1458758,408,2,utRho05
rhsD,1046132,1046522,1046132,390,0,utRho05
rhtA,1700608,1700608,1700194,414,44,utRho05
rhtC,8015478,8015514,8015478,36,2888,utRho05
ribA,2678468,2678468,2678320,148,0,utRho05
ribC,3486916,3486916,3486484,432,328,utRho05
ribE,869008,869294,869008,286,9866,utRho05
ribF,42766,42814,42766,48,0,utRho05
ridA,8941892,8941892,8941826,66,42,utRho05
rihA,1369204,1369204,1368824,380,1286,utRho05
rihB,4510504,4510504,4510372,132,0,utRho05
rimJ,2251044,2251124,2251044,80,0,utRho05
rimK,1783752,1783934,1783752,182,318,utRho05
rimL,2997486,2997876,2997486,390,2,utRho05
rimO,1756140,1756140,1756070,70,34,utRho05
rimP,6636350,6636350,6636012,338,880,utRho05
rlmA,3814172,3814172,3814120,52,346,utRho05
rlmD,5830086,5830086,5830000,86,8,utRho05
rlmE,6655520,6655520,6655328,192,2848,utRho05
rlmF,1684384,1684664,1684384,280,0,utRho05
rlmG,6471784,6471784,6471750,34,104,utRho05
rlmI,2060002,2060002,2059938,64,88,utRho05
rlmJ,7290700,7290770,7290700,70,234,utRho05
rlmL,2015344,2015688,2015344,344,2272,utRho05
rlpA,1330444,1330444,1330380,64,252,utRho05
rluA,120900,120900,120692,208,146,utRho05
rluF,8460324,8460708,8460324,384,0,utRho05
rmf,2031006,2031430,2031006,424,1326,utRho05
rna,1290068,1290068,1290006,62,8,utRho05
rnb,2698258,2698258,2697824,434,2246,utRho05
rnc,10816892,10816892,10816252,640,16364,utRho05
rnd,3776122,3776122,3775982,140,302,utRho05
rne,2289746,2289746,2288734,1012,10984,utRho05
rnhA,472082,472082,472004,78,510,utRho05
rnk,1288360,1288360,1287934,426,124,utRho05
rnlA,5531788,5531836,5531788,48,98,utRho05
rnlB,5533414,5533968,5533414,554,2986,utRho05
rnpB,19623552,19623552,19623552,0,0,utRho05
rob,9270706,9270706,9270620,86,82,utRho05
rodZ,5285868,5285868,5285688,180,122,utRho05
rpe,7030306,7030306,7030118,188,236,utRho05
rph,15266320,15266320,15266196,124,108,utRho05
rpiA,6118706,6118706,6118650,56,2,utRho05
rpiB,8626514,8626700,8626514,186,18,utRho05
rpiR,8626274,8626274,8625982,292,0,utRho05
rplJ,8359246,8359992,8359246,746,10764,utRho05
rplK,8356708,8356894,8356708,186,618,utRho05
rplM,6757344,6757344,6757302,42,6720,utRho05
rplN,6896444,6896444,6896298,146,11134,utRho05
rplS,5489284,5489284,5489060,224,16008,utRho05
rplT,7199052,7199052,7198996,56,1540,utRho05
rplU,6667036,6667036,6666902,134,62,utRho05
rplY,4564866,4565034,4564866,168,154,utRho05
rpmA,6666450,6666450,6666238,212,1696,utRho05
rpmB,15247980,15247980,15246696,1284,130804,utRho05
rpmE,8253816,8254026,8253816,210,1298,utRho05
rpmF,2294676,2294734,2294676,58,67738,utRho05
rpmH,7768130,7768672,7768130,542,7962,utRho05
rpmI,3600854,3600854,3599998,856,13350,utRho05
rpoB,8362126,8362490,8362126,364,668,utRho05
rpoD,6424946,6426094,6424946,1148,24166,utRho05
rpoE,5420372,5420372,5420024,348,184,utRho05
rpoH,7202006,7202006,7201566,440,22294,utRho05
rpoN,6689324,6689434,6689324,110,46,utRho05
rpoS,5736236,5736236,5735102,1134,3696,utRho05
rpoZ,7644154,7644212,7644154,58,814,utRho05
rppH,5937986,5937986,5937954,32,0,utRho05
rprA,3540744,3540744,3540744,0,0,utRho05
rpsA,1923434,1923990,1923434,556,206608,utRho05
rpsF,8850050,8850236,8850050,186,41378,utRho05
rpsI,6756580,6756580,6756414,166,12180,utRho05
rpsJ,6906884,6906884,6906540,344,11082,utRho05
rpsL,6949242,6949242,6949104,138,616,utRho05
rpsM,6885130,6885130,6884942,188,1860,utRho05
rpsO,13247144,13247144,13246736,408,2580,utRho05
rpsP,5492508,5492508,5492370,138,298,utRho05
rpsT,42420,42420,42156,264,636,utRho05
rpsU,12842584,12843124,12842584,540,3092,utRho05
rraA,8238716,8238716,8238660,56,332,utRho05
rraB,8956768,8956946,8956768,178,0,utRho05
rrsA,8070478,8071062,8070478,584,9668,utRho05
rrsB,16665468,16666636,16665468,1168,20828,utRho05
rrsC,7883032,7883616,7883032,584,10314,utRho05
rrsD,6858094,6858094,6857524,570,600,utRho05
rrsE,8415726,8416294,8415726,568,1852,utRho05
rrsG,5462896,5462896,5462314,582,7878,utRho05
rrsH,446970,447542,446970,572,2294,utRho05
rsd,8393908,8393908,8393616,292,148,utRho05
rseA,5419264,5419264,5418808,456,884,utRho05
rseP,392940,393092,392940,152,36,utRho05
rseX,4067298,4067298,4067298,0,0,utRho05
rsfS,1338144,1338144,1338072,72,352,utRho05
rsgA,8783132,8783132,8783018,114,24,utRho05
rsmA,105176,105176,104860,316,5390,utRho05
rsmB,6869982,6870414,6869982,432,442,utRho05
rsmC,9215736,9215736,9215400,336,664,utRho05
rsmD,7208594,7208786,7208594,192,2,utRho05
rsmE,6182036,6182268,6182036,232,346,utRho05
rsmG,7847512,7847512,7847360,152,1694,utRho05
rsmH,180020,180188,180020,168,248,utRho05
rsmI,6587106,6587106,6586670,436,1242,utRho05
rssA,2578212,2578412,2578212,200,486,utRho05
rssB,2580440,2580484,2580440,44,136,utRho05
rstA,3364276,3364300,3364276,24,0,utRho05
rsuA,4561096,4561096,4560966,130,334,utRho05
rsxA,3411510,3411534,3411510,24,110,utRho05
rtcA,7114004,7114004,7113698,306,84,utRho05
rtcB,7116214,7116214,7116158,56,0,utRho05
rtn,4541356,4541452,4541356,96,132,utRho05
rutA,2148052,2148052,2148022,30,0,utRho05
rutG,2140090,2140090,2139678,412,0,utRho05
rutR,2148226,2148484,2148226,258,0,utRho05
ruvA,7784096,7784096,7783904,192,36,utRho05
ruvB,7782176,7782176,7781424,752,552,utRho05
ruvC,3894878,3894878,3894752,126,42,utRho05
rybB,1776114,1776114,1776114,0,0,utRho05
rydB,3529860,3529860,3529322,538,126,utRho05
rydC,2983012,2983012,2983012,0,0,utRho05
ryfA,5307398,5307710,5307398,312,42,utRho05
ryfD,5468590,5468590,5468590,0,0,utRho05
ryhB,7162032,7162032,7162032,0,0,utRho05
ryjA,8556132,8556132,8556132,0,0,utRho05
ryjB,9055954,9055954,9055954,0,0,utRho05
sad,3229598,3229598,3229406,192,372,utRho05
safA,3168056,3168056,3167918,138,0,utRho05
sanA,4465368,4465756,4465368,388,260,utRho05
sapF,2705314,2705314,2705268,46,112,utRho05
sbcB,4165456,4165512,4165456,56,0,utRho05
sbcC,831694,831694,831506,188,240,utRho05
sbcD,833954,833954,833904,50,104,utRho05
sbmA,793106,793278,793106,172,8,utRho05
sbmC,4162650,4162650,4162524,126,0,utRho05
sdaA,3793618,3793864,3793618,246,234,utRho05
sdaC,5856070,5856458,5856070,388,1212,utRho05
sdhC,1509916,1510354,1509916,438,35226,utRho05
sdhD,1510808,1511120,1510808,312,6072,utRho05
sdiA,3993834,3993834,3993664,170,66,utRho05
secE,8354354,8354716,8354354,362,318,utRho05
secG,6645180,6645180,6645010,170,2172,utRho05
selA,7522594,7522594,7522498,96,642,utRho05
selB,7519850,7519850,7519722,128,106,utRho05
selC,7672396,7672444,7672396,48,0,utRho05
selD,3696058,3696058,3696016,42,4010,utRho05
seqA,1425884,1425974,1425884,90,628,utRho05
serA,6117098,6117098,6116820,278,186,utRho05
serB,9249712,9249790,9249712,78,12,utRho05
serC,3830380,3830612,3830380,232,64,utRho05
serS,1878730,1878856,1878730,126,2948,utRho05
serT,2063438,2063438,2063424,14,0,utRho05
serU,4087124,4087124,4087114,10,80,utRho05
serV,5637394,5637394,5637290,104,242,utRho05
serW,1852014,1852014,1851942,72,232,utRho05
serX,2195352,2195352,2195304,48,26,utRho05
setB,4527426,4527726,4527426,300,0,utRho05
setC,7673488,7673906,7673488,418,0,utRho05
sfmA,1116124,1116424,1116124,300,0,utRho05
sfmC,1117606,1117948,1117606,342,0,utRho05
sfsA,323030,323030,322972,58,454,utRho05
sfsB,6669592,6669818,6669592,226,188,utRho05
sgrR,154676,154676,154598,78,112,utRho05
sgrS,154734,154734,154734,0,0,utRho05
shiA,4107068,4107286,4107068,218,0,utRho05
sibA,4306622,4306622,4306622,0,0,utRho05
sibB,4307292,4307292,4307292,0,0,utRho05
sibC,6113702,6113702,6113702,0,0,utRho05
sibD,6389730,6389730,6389730,0,0,utRho05
sibE,6390480,6390480,6390480,0,0,utRho05
sixA,4913998,4913998,4913624,374,0,utRho05
slp,7307872,7307922,7307872,50,0,utRho05
slt,9261400,9261466,9261400,66,0,utRho05
slyA,3442028,3442028,3441648,380,0,utRho05
slyB,3439496,3439752,3439496,256,110,utRho05
slyD,6957398,6957398,6956994,404,254,utRho05
slyX,6954862,6955280,6954862,418,9156,utRho05
smf,6867372,6867372,6867120,252,164,utRho05
smpB,5509534,5509792,5509534,258,2106,utRho05
smrA,2811872,2811958,2811872,86,286,utRho05
smrB,4896872,4897212,4896872,340,72,utRho05
smtA,1946808,1947074,1946808,266,2,utRho05
sodA,8201518,8201620,8201518,102,6590,utRho05
sodB,3470646,3470756,3470646,110,4,utRho05
sodC,3449358,3449358,3449310,48,0,utRho05
sohB,2658568,2658664,2658568,96,30,utRho05
sokB,2984232,2984238,2984232,6,22,utRho05
solA,2241218,2241218,2241172,46,0,utRho05
soxR,8554894,8554938,8554894,44,0,utRho05
soxS,8554846,8554846,8554766,80,0,utRho05
speA,6172096,6172096,6171822,274,130,utRho05
speB,6167892,6167892,6167594,298,416,utRho05
speC,6218350,6218350,6218310,40,14,utRho05
spf,8099798,8099798,8099798,0,0,utRho05
sppA,3697422,3697674,3697422,252,0,utRho05
spy,3651376,3651376,3651250,126,0,utRho05
sra,3112092,3112092,3111926,166,92,utRho05
sraB,2293178,2293178,2293178,0,0,utRho05
sraC,3846132,3846132,3846132,0,0,utRho05
srlA,5651582,5651664,5651582,82,48,utRho05
srlR,5657720,5658094,5657720,374,1144,utRho05
srmB,5425752,5425792,5425752,40,284,utRho05
sroA,151216,151216,151216,0,0,utRho05
sroG,6369436,6369436,6369436,0,0,utRho05
sroH,8380974,8380974,8380974,0,0,utRho05
ssb,8548022,8548250,8548022,228,172,utRho05
sseA,5304782,5304988,5304782,206,4842,utRho05
sspA,6755138,6755138,6754840,298,500,utRho05
ssrA,5511014,5511186,5511014,172,262,utRho05
ssrS,12223036,12223932,12223036,896,2108,utRho05
sstT,6479726,6479888,6479726,162,100,utRho05
ssuB,1988282,1988282,1988088,194,0,utRho05
ssuE,1995126,1995126,1995024,102,0,utRho05
sthA,8321604,8321604,8321580,24,2126,utRho05
stpA,5597156,5597156,5596990,166,46,utRho05
sucA,3034344,3034824,3034344,480,2612,utRho05
sufA,3528836,3528836,3528772,64,0,utRho05
sufE,3518962,3518962,3518580,382,1150,utRho05
sugE,8753588,8753750,8753588,162,560,utRho05
sulA,2041894,2041894,2041838,56,136,utRho05
syd,5850738,5850738,5850560,178,396,utRho05
symE,9159834,9159834,9159680,154,208,utRho05
symR,9159670,9159670,9159670,0,0,utRho05
tabA,8949566,8949724,8949566,158,0,utRho05
talA,5157140,5157332,5157140,192,0,utRho05
talB,16382,16476,16382,94,7042,utRho05
tam,3214442,3214692,3214442,250,14,utRho05
tamA,8884540,8884764,8884540,224,78,utRho05
tar,3945432,3945432,3945382,50,0,utRho05
tas,5943138,5943194,5943138,56,100,utRho05
tatA,16087636,16087780,16087636,144,644,utRho05
tatE,1317742,1317894,1317742,152,64,utRho05
tauA,770410,770464,770410,54,0,utRho05
tdcA,6534186,6534186,6534130,56,0,utRho05
tdcG,6519652,6519652,6519298,354,70,utRho05
tdcR,6534380,6534760,6534380,380,0,utRho05
tdk,2586986,2587054,2586986,68,0,utRho05
tehA,3001072,3001146,3001072,74,0,utRho05
tesA,1039898,1039898,1039530,368,392,utRho05
tesB,950402,950402,950322,80,0,utRho05
tfaE,2418532,2418532,2418238,294,0,utRho05
tfaQ,3269912,3269912,3269770,142,2,utRho05
tff,379424,379256,379424,168,14,utRho05
tgt,852110,852274,852110,164,2,utRho05
thiD,4369346,4369346,4369032,314,32,utRho05
thiI,882936,883098,882936,162,170,utRho05
thiM,4370902,4370902,4370602,300,634,utRho05
thiQ,146170,146170,145854,316,398,utRho05
thrL,592,760,592,168,544,utRho05
thrS,7210932,7210932,7210280,652,3564,utRho05
thrU,8350762,8350776,8350762,14,38,utRho05
thrV,6847414,6847414,6847310,104,155414,utRho05
thrW,525682,525742,525682,60,998,utRho05
thyA,5930696,5930696,5930310,386,3156,utRho05
tig,909986,910266,909986,280,1134,utRho05
tisB,7706674,7707106,7706674,432,896,utRho05
tktA,6163414,6163414,6163270,144,78,utRho05
tktB,5158616,5159272,5158616,656,946,utRho05
tldD,6784368,6784368,6784056,312,0,utRho05
tmcA,5191876,5191876,5191718,158,0,utRho05
tnaC,15553644,15553740,15553644,96,516,utRho05
tolB,1555074,1555480,1555074,406,226,utRho05
tolC,6356008,6356230,6356008,222,1066,utRho05
tomB,961588,961588,961416,172,6874,utRho05
tonB,2622108,2622178,2622108,70,0,utRho05
topA,2661578,2662096,2661578,518,2086,utRho05
torC,2116112,2116168,2116112,56,80,utRho05
torR,2115968,2115968,2115908,60,50,utRho05
torS,2112364,2112364,2112356,8,0,utRho05
torT,2112414,2112522,2112414,108,0,utRho05
tpiA,8223138,8223138,8223014,124,34,utRho05
tppB,3425342,3425538,3425342,196,6182,utRho05
tpr,2574376,2574376,2574376,0,0,utRho05
tpx,2777688,2777688,2777622,66,1366,utRho05
tqsA,3347780,3347826,3347780,46,0,utRho05
treA,2494850,2494850,2494752,98,66,utRho05
treB,8932420,8932420,8932360,60,28,utRho05
treF,7339102,7339184,7339102,82,214,utRho05
treR,8934694,8934694,8934492,202,0,utRho05
trg,2984878,2984940,2984878,62,42,utRho05
trkG,2847342,2847564,2847342,222,0,utRho05
trmA,8326590,8326590,8326540,50,102,utRho05
trpA,2634678,2634678,2634444,234,742,utRho05
trpC,2639888,2639888,2639570,318,272,utRho05
trpL,5292432,5292432,5292328,104,0,utRho05
trpR,9265408,9265520,9265408,112,208,utRho05
trpS,7027394,7027394,7027276,118,770,utRho05
trpT,7893560,7893914,7893560,354,106496,utRho05
trxA,7931294,7931522,7931294,228,526,utRho05
trxB,1864156,1864156,1864100,56,66,utRho05
trxC,5437350,5437470,5437350,120,286,utRho05
tsaD,6421256,6421256,6421086,170,26,utRho05
tsgA,6985038,6985136,6985038,98,48,utRho05
tsr,9182824,9183314,9182824,490,266,utRho05
tsx,864490,864490,864026,464,868,utRho05
ttcA,2823970,2823970,2823896,74,5032,utRho05
ttdA,6412848,6412926,6412848,78,0,utRho05
ttdR,6412760,6412760,6412512,248,4,utRho05
tufA,6943448,6943448,6942658,790,154040,utRho05
tus,3368346,3368518,3368346,172,144,utRho05
tusA,7218040,7218040,7217992,48,116,utRho05
tusB,6950218,6950218,6949930,288,1072,utRho05
tynA,2902996,2902996,2902698,298,0,utRho05
typA,8116460,8116814,8116460,354,8480,utRho05
tyrB,8534164,8534228,8534164,64,2396,utRho05
tyrP,3979004,3979362,3979004,358,72,utRho05
tyrR,2773384,2773440,2773384,56,38,utRho05
tyrS,3434566,3434566,3434444,122,50,utRho05
tyrT,2575330,2575330,2575244,86,68,utRho05
uacT,6062378,6062734,6062378,356,4,utRho05
ubiC,8504886,8505012,8504886,126,226,utRho05
ubiD,8049618,8049976,8049618,358,2206,utRho05
ubiE,8037494,8037710,8037494,216,24,utRho05
ubiG,4679078,4679134,4679078,56,0,utRho05
ucpA,5089342,5089342,5089246,96,0,utRho05
udp,8032782,8032862,8032782,80,54,utRho05
ugd,4199470,4199470,4199226,244,0,utRho05
ugpB,7184852,7184852,7184650,202,258,utRho05
ugpQ,7176600,7176600,7176226,374,46,utRho05
uhpT,7694396,7694396,7694334,62,40,utRho05
uidA,3392304,3392304,3392142,162,0,utRho05
uidC,3386012,3386012,3385702,310,0,utRho05
uidR,3394150,3394150,3394104,46,32,utRho05
ulaA,8839854,8839960,8839854,106,160,utRho05
ulaG,8839350,8839350,8839250,100,0,utRho05
ulaR,8837124,8837124,8836906,218,26,utRho05
umpG,5741372,5741372,5740548,824,172,utRho05
umpH,1400704,1400704,1400652,52,64,utRho05
umuD,2461476,2461534,2461476,58,0,utRho05
ung,5433476,5433508,5433476,32,76,utRho05
uof,2843316,2843316,2842900,416,6556,utRho05
upp,5241818,5241818,5241744,74,174,utRho05
usg,4873780,4873780,4873298,482,200,utRho05
ushA,1009772,1009828,1009772,56,2,utRho05
uspA,7279966,7280222,7279966,256,962,utRho05
uspB,7279696,7279696,7279440,256,664,utRho05
uspC,3959172,3959506,3959172,334,28,utRho05
uspE,2797318,2797318,2797244,74,104,utRho05
uspF,2871282,2871282,2871238,44,130,utRho05
uspG,1283806,1283806,1283734,72,458,utRho05
uvrA,8547872,8547872,8547742,130,376,utRho05
uvrB,1626304,1627052,1626304,748,1456,utRho05
uvrC,3989758,3989758,3989412,346,222,utRho05
uvrD,7995814,7995966,7995814,152,238,utRho05
uvrY,3990812,3990812,3990718,94,44,utRho05
uxaB,3221474,3221474,3221360,114,0,utRho05
uxaC,6489714,6489714,6489482,232,0,utRho05
uxuA,9103036,9103272,9103036,236,368,utRho05
uxuR,9108916,9109152,9108916,236,104,utRho05
valS,8967854,8967854,8967674,180,390,utRho05
valU,5041848,5041862,5041848,14,0,utRho05
valV,3492830,3492870,3492830,40,22,utRho05
ves,3649968,3649968,3649874,94,82,utRho05
waaA,7616512,7617080,7616512,568,260,utRho05
waaH,7580298,7580298,7580162,136,0,utRho05
waaQ,7616476,7616476,7616196,280,54,utRho05
waaU,7598996,7598996,7598624,372,30,utRho05
waaY,7602272,7602272,7601930,342,6162,utRho05
wbbH,4214888,4214888,4214452,436,3138,utRho05
wbbK,4209212,4209212,4209018,194,478,utRho05
wcaM,4231868,4231868,4231792,76,70,utRho05
wrbA,2135516,2135516,2135416,100,0,utRho05
wza,4275166,4275166,4274486,680,0,utRho05
wzxC,4240674,4240674,4240316,358,88,utRho05
wzzB,4196950,4196950,4196602,348,218,utRho05
xanP,7657642,7657890,7657642,248,0,utRho05
xanQ,6048520,6048702,6048520,182,0,utRho05
xapA,5049820,5049820,5049756,64,0,utRho05
xapR,10090252,10090252,10089908,344,0,utRho05
xdhA,6000514,6000690,6000514,176,2,utRho05
xerD,6079702,6079702,6079486,216,34,utRho05
xseA,5268394,5268464,5268394,70,304,utRho05
xseB,882746,882746,882686,60,166,utRho05
xthA,3664798,3664856,3664798,58,0,utRho05
xylA,7461614,7461614,7461530,84,142,utRho05
xylE,8484540,8484540,8484508,32,0,utRho05
xylF,7462138,7462262,7462138,124,4,utRho05
xylR,7469812,7469958,7469812,146,0,utRho05
yaaA,13230,13230,12918,312,110,utRho05
yaaI,23876,23876,23572,304,2,utRho05
yaaJ,16034,16034,15918,116,78,utRho05
yaaU,91184,91614,91184,430,0,utRho05
yaaW,23084,23084,22712,372,0,utRho05
yaaX,10060,10468,10060,408,66,utRho05
yabI,142542,142702,142542,160,0,utRho05
yacC,273880,273880,273834,46,3304,utRho05
yacH,262932,262932,262520,412,34,utRho05
yacL,268678,268776,268678,98,24,utRho05
yadD,293796,293936,293796,140,44,utRho05
yadE,289930,290162,289930,232,382,utRho05
yadN,314110,314110,313766,344,50,utRho05
yadS,355572,355572,355248,324,358,utRho05
yadV,312470,312470,312402,68,2,utRho05
yaeF,434270,434270,434006,264,0,utRho05
yaeP,428374,428374,428250,124,34,utRho05
yaeQ,428176,428582,428176,406,118,utRho05
yaeR,423716,423754,423716,38,2,utRho05
yafC,462166,462166,461762,404,322,utRho05
yafD,462128,462244,462128,116,260,utRho05
yafK,491986,491986,491610,376,1814,utRho05
yafL,493282,493424,493282,142,0,utRho05
yafN,503938,504010,503938,72,0,utRho05
yafS,469568,469632,469568,64,456,utRho05
yafT,474470,474670,474470,200,4,utRho05
yafV,480432,480432,480378,54,2,utRho05
yafZ,536052,536052,536010,42,0,utRho05
yagE,564446,564556,564446,110,2,utRho05
yagG,570414,570790,570414,376,8,utRho05
yagI,578384,578384,578324,60,2,utRho05
yagK,586236,586236,585896,340,26,utRho05
yagL,588062,588062,587836,226,8,utRho05
yagN,591342,591342,591158,184,664,utRho05
yahA,663746,664742,663746,996,468,utRho05
yahC,670136,670136,670044,92,4,utRho05
yahE,671478,671850,671478,372,2,utRho05
yahM,690504,690808,690504,304,44,utRho05
yahN,692872,692872,692674,198,152,utRho05
yahO,692864,692968,692864,104,74,utRho05
yaiE,816296,816354,816296,58,54,utRho05
yaiI,811396,811528,811396,132,0,utRho05
yaiO,761946,761946,761684,262,0,utRho05
yaiP,767970,767970,767870,100,0,utRho05
yaiS,769660,769660,769232,428,0,utRho05
yaiV,788922,788922,788922,0,0,utRho05
yaiY,799094,799094,798666,428,234,utRho05
yaiZ,798888,799186,798888,298,1048,utRho05
yajC,854410,854574,854410,164,722,utRho05
yajD,860938,861210,860938,272,806,utRho05
yajI,866068,866068,865702,366,386,utRho05
yajL,887496,887496,887282,214,606,utRho05
yajQ,889316,889366,889316,50,2,utRho05
yajR,893374,893374,893332,42,434,utRho05
ybaB,987418,988152,987418,734,2812,utRho05
ybaL,1006590,1006590,1006476,114,126,utRho05
ybaM,980648,980648,980542,106,660,utRho05
ybaN,981436,981764,981436,328,578,utRho05
ybaO,936704,936766,936704,62,0,utRho05
ybaP,1016568,1016568,1016160,408,968,utRho05
ybaQ,1016348,1016436,1016348,88,106,utRho05
ybaS,1023146,1023282,1023146,136,2,utRho05
ybaV,927504,927874,927504,370,80,utRho05
ybaY,950490,950758,950490,268,58,utRho05
ybbB,1062724,1062724,1062452,272,8,utRho05
ybbJ,1030154,1030154,1029718,436,462,utRho05
ybbL,1031784,1031838,1031784,54,0,utRho05
ybbN,1037136,1037136,1036558,578,1476,utRho05
ybbO,1038658,1038658,1038298,360,1656,utRho05
ybbY,1080718,1081130,1080718,412,0,utRho05
ybcH,1176140,1176140,1175962,178,2,utRho05
ybcI,1113264,1113264,1113106,158,2310,utRho05
ybcJ,1114050,1114050,1113746,304,126,utRho05
ybcK,1137502,1137804,1137502,302,2,utRho05
ybcL,1141690,1141786,1141690,96,0,utRho05
ybcN,1144628,1144932,1144628,304,0,utRho05
ybcQ,1147548,1147912,1147548,364,2,utRho05
ybcW,1159610,1159760,1159610,150,0,utRho05
ybdD,1263982,1264364,1263982,382,264,utRho05
ybdF,1212106,1212106,1211772,334,52,utRho05
ybdH,1267048,1267048,1266954,94,30,utRho05
ybdJ,1212822,1212822,1212398,424,0,utRho05
ybdK,1215122,1215122,1214766,356,428,utRho05
ybdL,1267114,1267172,1267114,58,62,utRho05
ybdM,1271110,1271110,1270752,358,184,utRho05
ybdN,1273372,1273372,1273138,234,10,utRho05
ybdR,1283844,1284176,1283844,332,542,utRho05
ybeD,1325412,1325412,1325284,128,572,utRho05
ybeF,1323090,1323090,1322756,334,330,utRho05
ybeL,1349986,1350036,1349986,50,40,utRho05
ybeQ,1353412,1353412,1353094,318,0,utRho05
ybeR,1353120,1353422,1353120,302,0,utRho05
ybeT,1358832,1358832,1358812,20,0,utRho05
ybeU,1358924,1359016,1358924,92,0,utRho05
ybeZ,1386938,1386938,1386834,104,2570,utRho05
ybfA,1458074,1458268,1458074,194,8,utRho05
ybfE,1423878,1423878,1423796,82,486,utRho05
ybfF,1425692,1425692,1425604,88,746,utRho05
ybfH,1433282,1433282,1433194,88,0,utRho05
ybgA,1477840,1478002,1477840,162,0,utRho05
ybgC,1549288,1549504,1549288,216,22,utRho05
ybgD,1505916,1505916,1505590,326,88,utRho05
ybgI,1485238,1485654,1485238,416,0,utRho05
ybgO,1498370,1498370,1497964,406,0,utRho05
ybgS,1570992,1570992,1570634,358,78,utRho05
ybhA,1597184,1597184,1596862,322,100,utRho05
ybhB,1616070,1616070,1615818,252,106,utRho05
ybhC,1614642,1614642,1614562,80,1064,utRho05
ybhD,1601418,1601418,1601276,142,0,utRho05
ybhH,1601104,1601518,1601104,414,0,utRho05
ybhK,1633384,1633384,1633294,90,62,utRho05
ybhM,1641556,1641586,1641556,30,0,utRho05
ybhN,1645296,1645296,1644996,300,16,utRho05
ybhQ,1649202,1649260,1649202,58,78,utRho05
ybiA,1665920,1665920,1665900,20,112,utRho05
ybiI,1676968,1676968,1676912,56,344,utRho05
ybiO,1691328,1691328,1690960,368,244,utRho05
ybiP,1705252,1705252,1705194,58,2244,utRho05
ybiS,1711572,1711572,1711488,84,598,utRho05
ybiT,1711894,1711926,1711894,32,0,utRho05
ybiU,1718212,1718212,1718122,90,24,utRho05
ybiV,1720176,1720176,1720056,120,0,utRho05
ybiW,1725566,1725566,1725212,354,8,utRho05
ybiX,1678548,1678548,1678414,134,1744,utRho05
ybjC,1781784,1781826,1781784,42,0,utRho05
ybjE,1830154,1830154,1829714,440,0,utRho05
ybjG,1767016,1767016,1766776,240,700,utRho05
ybjL,1779882,1779882,1779638,244,328,utRho05
ybjM,1779770,1780178,1779770,408,210,utRho05
ybjO,1795704,1795978,1795704,274,0,utRho05
ybjP,1809046,1809046,1808934,112,0,utRho05
ybjQ,1809034,1809186,1809034,152,0,utRho05
ybjS,1813796,1813796,1813506,290,94,utRho05
ybjX,1838206,1838206,1838168,38,32,utRho05
ycaD,1891438,1891742,1891438,304,0,utRho05
ycaI,1928210,1928640,1928210,430,240,utRho05
ycaK,1899094,1899336,1899094,242,22,utRho05
ycaL,1920264,1920528,1920264,264,16,utRho05
ycaM,1894240,1894458,1894240,218,48,utRho05
ycaR,1941284,1941346,1941284,62,2288,utRho05
ycbB,1961862,1962094,1961862,232,42,utRho05
ycbJ,1943344,1943504,1943344,160,0,utRho05
ycbK,1966046,1966150,1966046,104,892,utRho05
ycbZ,2036920,2036920,2036598,322,58,utRho05
yccA,2062886,2062886,2062836,50,570,utRho05
yccF,2048730,2048730,2048696,34,54,utRho05
yccS,2047988,2047988,2047766,222,66,utRho05
yccT,2055674,2055674,2055546,128,0,utRho05
yccX,2059960,2060128,2059960,168,106,utRho05
ycdT,2185682,2185752,2185682,70,0,utRho05
ycdU,2191266,2191686,2191266,420,0,utRho05
ycdZ,2200504,2200592,2200504,88,16,utRho05
yceA,2233544,2233614,2233544,70,98,utRho05
yceD,2293298,2293588,2293298,290,6990,utRho05
yceF,2293522,2293522,2293190,332,4594,utRho05
yceH,2252154,2252314,2252154,160,822,utRho05
yceI,2237282,2237282,2236952,330,274,utRho05
yceJ,2238142,2238142,2238092,50,132,utRho05
yceM,2253208,2253612,2253208,404,112,utRho05
yceO,2239264,2239264,2238894,370,218,utRho05
yceQ,2288760,2289004,2288760,244,8104,utRho05
ycfD,2376540,2376540,2376480,60,262,utRho05
ycfJ,2334814,2335198,2334814,384,298,utRho05
ycfS,2340834,2340834,2340748,86,0,utRho05
ycfT,2350658,2350658,2350330,328,2,utRho05
ycfZ,2362760,2362760,2362534,226,158,utRho05
ycgB,2474570,2474570,2474482,88,36,utRho05
ycgG,2434614,2434656,2434614,42,2,utRho05
ycgJ,2452956,2453200,2452956,244,28,utRho05
ycgL,2455218,2455362,2455218,144,0,utRho05
ycgN,2457366,2457660,2457366,294,54,utRho05
ycgR,2489112,2489112,2489054,58,62,utRho05
ycgV,2512222,2512222,2511904,318,166,utRho05
ycgX,2426568,2426568,2426214,354,21890,utRho05
ycgY,2490166,2490320,2490166,154,28,utRho05
ycgZ,2431504,2431578,2431504,74,16,utRho05
ychE,2596904,2597196,2596904,292,242,utRho05
ychF,2515764,2515764,2515624,140,0,utRho05
ychH,2517476,2517582,2517476,106,368,utRho05
ychJ,2578354,2578354,2578264,90,54,utRho05
ychN,2547310,2547310,2547198,112,64,utRho05
ychO,2547520,2547850,2547520,330,696,utRho05
ychQ,2533798,2533848,2533798,50,36,utRho05
yciA,2624828,2624828,2624492,336,300,utRho05
yciB,2626110,2626110,2625780,330,3032,utRho05
yciC,2627396,2627396,2627326,70,26,utRho05
yciE,2630794,2630794,2630448,346,0,utRho05
yciG,5264368,5264368,5264140,228,0,utRho05
yciI,2621784,2621784,2621730,54,0,utRho05
yciN,2661606,2661606,2661336,270,66,utRho05
yciS,2680270,2680486,2680270,216,84,utRho05
yciT,2689088,2689088,2688692,396,240,utRho05
yciU,2614718,2614718,2614300,418,3436,utRho05
yciV,2646376,2646440,2646376,64,24,utRho05
yciW,2700472,2700472,2700214,258,856,utRho05
yciZ,2689276,2689276,2689218,58,352,utRho05
ycjD,2703792,2703792,2703520,272,62,utRho05
ycjG,2777748,2777860,2777748,112,76,utRho05
ycjM,2740006,2740432,2740006,426,10,utRho05
ycjW,2767982,2767982,2767922,60,0,utRho05
ycjX,2768138,2768234,2768138,96,112,utRho05
ycjY,5568288,5568288,5567460,828,152,utRho05
ydaE,2836438,2836438,2836016,422,0,utRho05
ydaN,2816048,2816100,2816048,52,24,utRho05
ydaS,2840340,2840730,2840340,390,82,utRho05
ydbC,2948376,2948442,2948376,66,0,utRho05
ydbD,2950132,2950288,2950132,156,0,utRho05
ydbH,2885800,2886102,2885800,302,0,utRho05
ydbJ,2881712,2882116,2881712,404,2,utRho05
ydbK,2881692,2881692,2881568,124,90,utRho05
ydcA,2983294,2983354,2983294,60,0,utRho05
ydcF,2974404,2974470,2974404,66,2,utRho05
ydcI,2990268,2990268,2990142,126,60,utRho05
ydcJ,2990266,2990576,2990266,310,0,utRho05
ydcK,3001280,3001280,3000898,382,0,utRho05
ydcL,3004646,3004914,3004646,268,0,utRho05
ydcN,3012308,3012344,3012308,36,2,utRho05
ydcP,3013508,3013562,3013508,54,84,utRho05
ydcR,3019956,3020006,3019956,50,0,utRho05
ydcS,3022906,3023308,3022906,402,8,utRho05
ydcX,3034442,3034778,3034442,336,184,utRho05
ydcY,3035220,3035296,3035220,76,82,utRho05
ydcZ,3036750,3036750,3036662,88,188,utRho05
yddB,3155332,3155332,3155238,94,0,utRho05
yddE,3071738,3071738,3071716,22,0,utRho05
yddG,3094410,3094410,3094338,72,0,utRho05
yddJ,3089732,3089732,3089438,294,4,utRho05
yddW,3137704,3137704,3137646,58,0,utRho05
ydeA,3233910,3234056,3233910,146,226,utRho05
ydeE,3242528,3242664,3242528,136,22,utRho05
ydeI,3249118,3249118,3248994,124,0,utRho05
ydeJ,3249376,3249546,3249376,170,0,utRho05
ydeN,3165458,3165458,3165048,410,2,utRho05
ydeP,3173328,3173328,3172972,356,4,utRho05
ydeR,3176596,3176596,3176592,4,0,utRho05
ydfA,3296872,3297016,3296872,144,98,utRho05
ydfG,3254982,3255034,3254982,52,0,utRho05
ydfH,3256652,3256704,3256652,52,12,utRho05
ydfK,3265446,3266144,3265446,698,43568,utRho05
ydgA,3379588,3379704,3379588,116,0,utRho05
ydgC,3364124,3364124,3364060,64,38,utRho05
ydgD,3343906,3343920,3343906,14,100,utRho05
ydgH,3356754,3356854,3356754,100,16,utRho05
ydgJ,3408798,3408798,3408616,182,16,utRho05
ydgK,3410414,3410500,3410414,86,80,utRho05
ydhB,3479618,3479618,3479596,22,0,utRho05
ydhC,3479698,3479822,3479698,124,28,utRho05
ydhF,3451310,3451310,3451264,46,0,utRho05
ydhI,3441996,3442050,3441996,54,0,utRho05
ydhL,3451864,3451864,3451840,24,6,utRho05
ydhQ,3492404,3492404,3492254,150,0,utRho05
ydhS,3494136,3494262,3494136,126,334,utRho05
ydhT,3499138,3499138,3499118,20,0,utRho05
ydhY,3509284,3509284,3508954,330,0,utRho05
ydhZ,3510418,3510418,3510282,136,2,utRho05
ydiE,3579206,3579226,3579206,20,0,utRho05
ydiH,3530582,3530582,3530406,176,0,utRho05
ydiM,3541852,3542142,3541852,290,0,utRho05
ydiN,3544818,3545024,3544818,206,0,utRho05
ydiP,3558656,3558656,3558602,54,4,utRho05
ydiU,3582508,3582508,3582488,20,22,utRho05
ydiV,3584174,3584174,3584040,134,114,utRho05
ydiY,3612500,3612500,3612166,334,70,utRho05
ydjA,3697400,3697400,3697352,48,56,utRho05
ydjE,3708082,3708082,3707958,124,0,utRho05
ydjF,3709848,3709848,3709708,140,0,utRho05
ydjM,3620340,3620422,3620340,82,0,utRho05
ydjO,3626696,3626696,3626288,408,0,utRho05
ydjX,3666434,3666802,3666434,368,2016,utRho05
yeaE,3731448,3731448,3731272,176,70,utRho05
yeaG,3733530,3733816,3733530,286,0,utRho05
yeaI,3740486,3740770,3740486,284,0,utRho05
yeaJ,3743874,3744082,3743874,208,120,utRho05
yeaL,3748646,3748704,3748646,58,226,utRho05
yeaM,3751296,3751296,3751152,144,0,utRho05
yeaN,3750926,3751346,3750926,420,0,utRho05
yeaO,3753554,3753818,3753554,264,24,utRho05
yeaP,3755314,3755430,3755314,116,684,utRho05
yeaQ,3758780,3758780,3758510,270,144,utRho05
yeaR,3759988,3759988,3759896,92,22,utRho05
yeaY,3781122,3781122,3781064,58,120,utRho05
yebB,3892220,3892502,3892220,282,2,utRho05
yebC,3896370,3896370,3896302,68,50,utRho05
yebE,3859464,3859464,3859414,50,438,utRho05
yebG,3861530,3861530,3861494,36,0,utRho05
yebK,3873180,3873304,3873180,124,20,utRho05
yebQ,3820314,3820552,3820314,238,44,utRho05
yebS,3832238,3832516,3832238,278,6,utRho05
yebV,3843430,3843560,3843430,130,0,utRho05
yebW,3843914,3844242,3843914,328,1720,utRho05
yecC,3995646,3995646,3995628,18,0,utRho05
yecD,3901272,3901664,3901272,392,270,utRho05
yecF,3991434,3991636,3991434,202,358,utRho05
yecH,3979304,3979304,3978980,324,72,utRho05
yecJ,3975604,3975604,3975516,88,0,utRho05
yecM,3919968,3919968,3919692,276,0,utRho05
yecR,3976400,3976444,3976400,44,124,utRho05
yecT,3923862,3923944,3923862,82,176,utRho05
yedD,4016522,4016522,4016180,342,180,utRho05
yedE,4016310,4016554,4016310,244,110,utRho05
yedI,4058922,4058922,4058732,190,0,utRho05
yedJ,4066446,4066446,4066158,288,110,utRho05
yedV,4076404,4076404,4076304,100,112,utRho05
yedX,4077680,4077912,4077680,232,0,utRho05
yedY,4078572,4078956,4078572,384,84,utRho05
yeeA,4161322,4161322,4161182,140,76,utRho05
yeeE,4171104,4171104,4171050,54,0,utRho05
yeeJ,4089526,4089822,4089526,296,614,utRho05
yeeN,4113508,4113716,4113508,208,56,utRho05
yeeO,4119444,4119444,4119692,248,0,utRho05
yeeX,4158834,4158834,4158722,112,518,utRho05
yeeZ,4178422,4178422,4178256,166,0,utRho05
yefM,4179466,4179466,4179426,40,62,utRho05
yegD,4295288,4295348,4295288,60,4,utRho05
yegH,4275726,4275804,4275726,78,0,utRho05
yegI,4302154,4302154,4301970,184,0,utRho05
yegJ,4302032,4302370,4302032,338,0,utRho05
yegQ,4331182,4331336,4331182,154,42,utRho05
yegR,4336698,4336698,4336612,86,0,utRho05
yegS,4337086,4337424,4337086,338,0,utRho05
yegT,4357562,4357642,4357562,80,2,utRho05
yegX,4367640,4367640,4367302,338,2,utRho05
yehA,4376944,4376944,4376828,116,0,utRho05
yehE,4385818,4385818,4385592,226,0,utRho05
yehK,4407568,4407944,4407568,376,0,utRho05
yehL,4408804,4409192,4408804,388,0,utRho05
yeiB,4486146,4486146,4485934,212,82,utRho05
yeiE,4499422,4499422,4499236,186,0,utRho05
yeiG,4487776,4487820,4487776,44,398,utRho05
yeiH,4499332,4499434,4499332,102,0,utRho05
yeiI,4503306,4503400,4503306,94,116,utRho05
yeiL,4510580,4510710,4510580,130,0,utRho05
yeiP,4530834,4530900,4530834,66,470,utRho05
yeiQ,4532328,4532490,4532328,162,104,utRho05
yeiR,4535484,4535658,4535484,174,44,utRho05
yeiW,4530840,4530840,4530590,250,770,utRho05
yejA,4544624,4544728,4544624,104,2,utRho05
yejG,4556892,4556892,4556474,418,4510,utRho05
yejH,4561244,4561264,4561244,20,0,utRho05
yejK,4568218,4568218,4567894,324,432,utRho05
yejO,4578352,4578352,4577800,552,126,utRho05
yfaD,4713380,4713808,4713380,428,1246,utRho05
yfaE,4696676,4697028,4696676,352,1390,utRho05
yfaL,4688568,4688568,4688338,230,2,utRho05
yfaP,4656398,4656398,4656286,112,0,utRho05
yfaU,4717892,4717892,4717690,202,0,utRho05
yfaY,4727310,4727310,4727266,44,8,utRho05
yfaZ,4728744,4728744,4728550,194,48,utRho05
yfbK,4771810,4771810,4771444,366,2,utRho05
yfbL,4771500,4771720,4771500,220,0,utRho05
yfbN,4777174,4777174,4776852,322,0,utRho05
yfbO,4776916,4777162,4776916,246,0,utRho05
yfbP,4777990,4778232,4777990,242,752,utRho05
yfbR,4817662,4817724,4817662,62,16,utRho05
yfcI,4847424,4847424,4847078,346,146,utRho05
yfcJ,4880482,4880482,4880240,242,276,utRho05
yfcL,4888502,4888502,4888338,164,16,utRho05
yfcV,4911642,4911642,4911292,350,0,utRho05
yfcZ,4921958,4921958,4921868,90,136,utRho05
yfdF,4925604,4926024,4925604,420,192,utRho05
yfdG,4935474,4935710,4935474,236,20,utRho05
yfdP,4946844,4947040,4946844,196,0,utRho05
yfdX,4988866,4988866,4988804,62,0,utRho05
yfdY,4990672,4990672,4990584,88,2,utRho05
yfeA,5035784,5035784,5035664,120,41068,utRho05
yfeC,5036668,5036934,5036668,266,114,utRho05
yfeH,5053818,5053892,5053818,74,0,utRho05
yfeK,5074630,5074684,5074630,54,44,utRho05
yfeO,5018906,5019260,5018906,354,120,utRho05
yfeR,5054078,5054078,5053712,366,74,utRho05
yfeX,5101356,5101356,5101090,266,62,utRho05
yfeY,5102486,5102486,5102432,54,0,utRho05
yfeZ,5103842,5103842,5103452,390,2,utRho05
yffO,5123804,5124222,5123804,418,0,utRho05
yffQ,5126778,5127154,5126778,376,36,utRho05
yffS,5128800,5128986,5128800,186,74,utRho05
yfgC,5232052,5232188,5232052,136,42,utRho05
yfgF,5258062,5258062,5257876,186,42,utRho05
yfgG,5258170,5258580,5258170,410,260,utRho05
yfgH,5259344,5259584,5259344,240,4,utRho05
yfgM,5278866,5278866,5278566,300,768,utRho05
yfhH,5397414,5397518,5397414,104,0,utRho05
yfhM,5304648,5304648,5304574,74,0,utRho05
yfhR,5328408,5328726,5328408,318,4848,utRho05
yfiC,5425610,5425610,5425528,82,0,utRho05
yfiE,5430688,5430688,5430640,48,0,utRho05
yfiL,5482630,5482720,5482630,90,0,utRho05
yfiM,5448066,5448358,5448066,292,19512,utRho05
yfiR,5483354,5483750,5483354,396,178,utRho05
yfjH,5517326,5517326,5517200,126,0,utRho05
yfjI,5517710,5517970,5517710,260,2,utRho05
yfjJ,5521014,5521094,5521014,80,0,utRho05
yfjM,5531970,5531970,5531552,418,680,utRho05
yfjP,5535080,5535420,5535080,340,58,utRho05
yfjW,5546570,5546636,5546570,66,0,utRho05
yfjX,5551776,5551838,5551776,62,0,utRho05
ygaC,5601180,5601180,5599988,1192,1394,utRho05
ygaM,5600242,5600292,5600242,50,348,utRho05
ygaU,5593628,5593628,5593572,56,22,utRho05
ygaZ,5619190,5619234,5619190,44,1118,utRho05
ygbA,5713656,5713656,5713612,44,0,utRho05
ygbE,5746784,5746784,5746674,110,94,utRho05
ygbI,5722882,5722882,5722528,354,2,utRho05
ygbK,5724394,5724670,5724394,276,82,utRho05
ygbL,5727074,5727186,5727074,112,14,utRho05
ygbN,5729814,5730202,5729814,388,22,utRho05
ygcG,5811210,5811422,5811210,212,0,utRho05
ygcN,5785144,5785314,5785144,170,50,utRho05
ygcU,5799214,5799214,5798836,378,80,utRho05
ygcW,5800942,5800942,5800546,396,0,utRho05
ygdD,5883442,5883442,5883262,180,32,utRho05
ygdG,5861746,5861930,5861746,184,634,utRho05
ygdI,5886526,5886526,5886290,236,40,utRho05
ygdQ,5940784,5940840,5940784,56,30,utRho05
ygdR,5942494,5942542,5942494,48,0,utRho05
ygeA,5961606,5961606,5961270,336,72,utRho05
ygeH,5983758,5984188,5983758,430,2,utRho05
ygeI,5987162,5987276,5987162,114,66,utRho05
ygeR,6000078,6000078,5999782,296,126,utRho05
ygeV,6011694,6011694,6011572,122,0,utRho05
ygeW,6012234,6012524,6012234,290,0,utRho05
ygfB,6110946,6110946,6110888,58,26,utRho05
ygfK,6031984,6032120,6031984,136,0,utRho05
ygfS,6058328,6058328,6058024,304,116,utRho05
ygfZ,6082564,6082626,6082564,62,2,utRho05
yggC,6149512,6149512,6149378,134,112,utRho05
yggE,6136370,6136370,6136160,210,0,utRho05
yggI,6179176,6179510,6179176,334,94,utRho05
yggL,6204508,6204508,6204266,242,90,utRho05
yggM,6199514,6199514,6199130,384,32,utRho05
yggN,6203596,6203596,6203246,350,32,utRho05
yggX,18623958,18624558,18623958,600,696,utRho05
yghA,6298966,6299324,6298966,358,0,utRho05
yghB,6307058,6307126,6307058,68,76,utRho05
yghD,6222614,6222614,6222252,362,2,utRho05
yghF,6225798,6225798,6225840,42,12,utRho05
yghJ,6238640,6238640,6238224,416,2,utRho05
yghQ,6265186,6265186,6264816,370,0,utRho05
yghT,6267830,6268262,6267830,432,0,utRho05
yghU,6277400,6277454,6277400,54,186,utRho05
yghW,6293506,6293506,6293474,32,0,utRho05
yghZ,6295562,6295794,6295562,232,4,utRho05
ygiD,6365122,6365122,6364868,254,982,utRho05
ygiH,6409066,6409388,6409066,322,2,utRho05
ygiL,6370622,6370828,6370622,206,0,utRho05
ygiM,6402084,6402414,6402084,330,60,utRho05
ygiN,6346156,6346284,6346156,128,824,utRho05
ygiQ,6322620,6322620,6322292,328,464,utRho05
ygiS,6335462,6335462,6335436,26,22,utRho05
ygiV,6338582,6338582,6338462,120,0,utRho05
ygiW,6339774,6339774,6339352,422,116,utRho05
ygiZ,6344506,6344506,6344422,84,0,utRho05
ygjH,6442528,6442528,6442494,34,0,utRho05
ygjI,6452140,6452468,6452140,328,0,utRho05
ygjQ,6472730,6473080,6472730,350,466,utRho05
ygjR,6474564,6474586,6474564,22,0,utRho05
ygjV,6483638,6483638,6483488,150,128,utRho05
yhaB,6535632,6535708,6535632,76,0,utRho05
yhaH,6504498,6504608,6504498,110,0,utRho05
yhaI,6505400,6505822,6505400,422,0,utRho05
yhaJ,6508560,6508560,6508428,132,18,utRho05
yhaK,6508538,6508638,6508538,100,2,utRho05
yhbQ,6599878,6599932,6599878,54,124,utRho05
yhbT,6602736,6602736,6602552,184,48,utRho05
yhbU,6602558,6602970,6602558,412,100,utRho05
yhbX,6643302,6643302,6643226,76,0,utRho05
yhbY,6655518,6655580,6655518,62,1758,utRho05
yhcA,6723956,6724224,6723956,268,12,utRho05
yhcB,6760364,6760382,6760364,18,108,utRho05
yhcC,6708470,6708470,6708100,370,536,utRho05
yhcF,6733440,6733852,6733440,412,48,utRho05
yhcH,6739124,6739124,6738956,168,36,utRho05
yhcM,6760312,6760312,6759994,318,134,utRho05
yhcN,6770812,6771076,6770812,264,858,utRho05
yhcO,6772606,6772606,6772258,348,0,utRho05
yhdH,6806560,6806968,6806560,408,122,utRho05
yhdJ,6823234,6823306,6823234,72,0,utRho05
yhdN,6879092,6879092,6879018,74,2616,utRho05
yhdT,6814702,6814750,6814702,48,588,utRho05
yhdU,6824994,6825242,6824994,248,244,utRho05
yhdV,6836392,6836780,6836392,388,4,utRho05
yhdW,6837944,6838298,6837944,354,0,utRho05
yheO,6953082,6953082,6952880,202,1172,utRho05
yheV,6957970,6957970,6957584,386,100,utRho05
yhfA,6971902,6971902,6971636,266,266,utRho05
yhfG,6983294,6983294,6983240,54,302,utRho05
yhfL,6998622,6998896,6998622,274,38,utRho05
yhfY,7023244,7023244,7022844,400,0,utRho05
yhgA,7086294,7086334,7086294,40,0,utRho05
yhgE,7065176,7065176,7064878,298,108,utRho05
yhgF,7074352,7074770,7074352,418,1664,utRho05
yhhA,7173458,7173886,7173458,428,160,utRho05
yhhI,7248346,7248756,7248346,410,0,utRho05
yhhJ,7253696,7253696,7253606,90,0,utRho05
yhhM,7211588,7211588,7211220,368,520,utRho05
yhhN,7211150,7211502,7211150,352,538,utRho05
yhhQ,7218238,7218434,7218238,196,588,utRho05
yhhT,7223682,7223730,7223682,48,0,utRho05
yhhX,7162032,7162032,7161610,422,740,utRho05
yhhY,7162222,7162276,7162222,54,30,utRho05
yhhZ,7163516,7163726,7163516,210,2,utRho05
yhiD,7312220,7312220,7311804,416,2492,utRho05
yhiJ,7265190,7265190,7265180,10,0,utRho05
yhiM,7269270,7269682,7269270,412,124,utRho05
yhiN,7275000,7275000,7274820,180,134,utRho05
yhjA,7338522,7338522,7338376,146,0,utRho05
yhjB,7344090,7344090,7343788,302,34,utRho05
yhjC,7344272,7344684,7344272,412,0,utRho05
yhjD,7346660,7346724,7346660,64,0,utRho05
yhjE,7349274,7349572,7349274,298,0,utRho05
yhjG,7356824,7356824,7356730,94,0,utRho05
yhjH,7358458,7358458,7358374,84,0,utRho05
yhjJ,7364032,7364032,7363880,152,178,utRho05
yhjK,7371296,7371296,7371158,138,0,utRho05
yhjR,7392750,7392750,7392370,380,32,utRho05
yhjV,7400796,7401126,7400796,330,964,utRho05
yhjX,7424194,7424194,7424014,180,0,utRho05
yhjY,7425966,7425966,7425868,98,0,utRho05
yiaB,7455654,7455654,7455496,158,0,utRho05
yiaD,7432712,7433094,7432712,382,116,utRho05
yiaF,7438194,7438194,7438088,106,106,utRho05
yiaG,7438862,7438956,7438862,94,134,utRho05
yiaJ,7485236,7485236,7485064,172,4,utRho05
yiaK,7485348,7485466,7485348,118,0,utRho05
yiaT,7503924,7503924,7503736,188,0,utRho05
yiaU,7503792,7503984,7503792,192,0,utRho05
yiaY,7515856,7515856,7515654,202,36,utRho05
yibF,7523950,7523950,7523910,40,0,utRho05
yibG,7536128,7536354,7536128,226,0,utRho05
yibL,7553194,7553330,7553194,136,152,utRho05
yibN,7570112,7570112,7570030,82,222,utRho05
yibT,7552848,7552848,7552760,88,110,utRho05
yicC,7633290,7633352,7633290,62,8,utRho05
yicH,7660862,7660914,7660862,52,0,utRho05
yicJ,7673328,7673328,7671858,1470,1266,utRho05
yicN,7685018,7685018,7684804,214,0,utRho05
yicO,7687914,7687914,7687578,336,0,utRho05
yicR,15250308,15250308,15250236,72,0,utRho05
yidB,7755230,7755230,7754930,300,0,utRho05
yidE,7732780,7732780,7732546,234,0,utRho05
yidF,7711580,7711580,7711222,358,188,utRho05
yidQ,7735088,7735456,7735088,368,616,utRho05
yidR,7738824,7738824,7738618,206,0,utRho05
yieE,7787658,7787738,7787658,80,204,utRho05
yieH,7793314,7793548,7793314,234,2,utRho05
yieK,7798928,7798928,7798786,142,0,utRho05
yifB,7900350,7900350,7899998,352,118,utRho05
yifL,7988984,7989044,7988984,60,112,utRho05
yigF,8005750,8005750,8005598,152,200,utRho05
yigI,8009448,8009448,8009394,54,44,utRho05
yigM,8022100,8022152,8022100,52,82,utRho05
yihA,8101970,8101970,8101458,512,494,utRho05
yihD,8084098,8084138,8084098,40,72,utRho05
yihF,8088110,8088398,8088110,288,0,utRho05
yihG,8093304,8093304,8093204,100,0,utRho05
yihI,8102616,8102694,8102616,78,0,utRho05
yihL,8120506,8120894,8120506,388,34,utRho05
yihN,8124332,8124494,8124332,162,2,utRho05
yihO,8131942,8131942,8131532,410,0,utRho05
yihQ,8138892,8138892,8138552,340,2,utRho05
yihV,8147064,8147478,8147064,414,0,utRho05
yihX,8151096,8151106,8151096,10,120,utRho05
yiiE,8158192,8158582,8158192,390,0,utRho05
yiiF,8159124,8159502,8159124,378,28,utRho05
yiiG,8173762,8174004,8173762,242,0,utRho05
yiiM,8205506,8205644,8205506,138,128,utRho05
yiiQ,8224624,8224624,8224428,196,0,utRho05
yiiS,8225738,8225934,8225738,196,38,utRho05
yijE,8272178,8272216,8272178,38,0,utRho05
yijF,8275728,8275728,8275314,414,104,utRho05
yijO,8296858,8296858,8296634,224,0,utRho05
yjaA,8426240,8426468,8426240,228,101326,utRho05
yjaB,8428312,8428312,8428246,66,472,utRho05
yjaG,8398746,8399008,8398746,262,1396,utRho05
yjaH,8401022,8401132,8401022,110,78,utRho05
yjaZ,8379506,8379572,8379506,66,14,utRho05
yjbB,8455204,8455462,8455204,258,0,utRho05
yjbE,16943432,16943624,16943432,192,0,utRho05
yjbL,8520318,8520642,8520318,324,0,utRho05
yjbQ,8540428,8540476,8540428,48,2,utRho05
yjcB,8550328,8550328,8550082,246,11850,utRho05
yjcC,8550836,8550942,8550836,106,82,utRho05
yjcD,8556628,8556958,8556628,330,370,utRho05
yjcE,8559658,8559960,8559658,302,84,utRho05
yjcF,8566212,8566212,8566150,62,0,utRho05
yjcO,8594660,8594660,8594250,410,0,utRho05
yjdA,8654128,8654270,8654128,142,0,utRho05
yjdC,8726660,8726660,8726616,44,54,utRho05
yjdK,8704780,8705168,8704780,388,224,utRho05
yjdL,8713034,8713034,8712822,212,0,utRho05
yjdM,8653672,8653672,8653468,204,2,utRho05
yjeF,8787354,8788132,8787354,778,10542,utRho05
yjeI,8745522,8745618,8745522,96,68,utRho05
yjeJ,8748806,8748806,8748468,338,44,utRho05
yjeV,8785472,8785784,8785472,312,282,utRho05
yjfP,8833512,8833904,8833512,392,74,utRho05
yjfY,8849656,8849656,8849582,74,22,utRho05
yjfZ,8855052,8855052,8854844,208,0,utRho05
yjgA,8916162,8916162,8915730,432,114,utRho05
yjgL,8950802,8950874,8950802,72,0,utRho05
yjgM,8959342,8959342,8959074,268,0,utRho05
yjgN,8959132,8959460,8959132,328,0,utRho05
yjgR,8980170,8980170,8980126,44,2,utRho05
yjgZ,9002116,9002520,9002116,404,696,utRho05
yjhB,9007764,9008116,9007764,352,2,utRho05
yjhG,9048452,9048452,9048188,264,326,utRho05
yjhU,9041080,9041080,9040648,432,550,utRho05
yjiA,9178096,9178096,9177730,366,954,utRho05
yjiJ,9125364,9125364,9125350,14,0,utRho05
yjiK,9127270,9127270,9127422,152,128,utRho05
yjiL,9129604,9129604,9129378,226,0,utRho05
yjiS,9143410,9143502,9143410,92,18,utRho05
yjiY,9182734,9182734,9182558,176,68,utRho05
yjjA,9200674,9200674,9200378,296,486,utRho05
yjjB,18408708,18408708,18407800,908,216,utRho05
yjjJ,9243314,9243538,9243314,224,24,utRho05
yjjK,9261132,9261132,9261044,88,66,utRho05
yjjL,9189764,9189764,9189444,320,6,utRho05
yjjM,9191894,9191894,9191702,192,0,utRho05
yjjP,9206068,9206068,9205716,352,130,utRho05
yjjQ,9206638,9206954,9206638,316,6,utRho05
yjjX,9267798,9267798,9267490,308,632,utRho05
yjjY,9280716,9280804,9280716,88,748,utRho05
yjjZ,9211554,9211608,9211554,54,1912,utRho05
yjtD,9281676,9281884,9281676,208,0,utRho05
ykfB,532454,532454,532174,280,334,utRho05
ykfI,527636,527636,527338,298,96,utRho05
ykgB,637050,637050,636638,412,0,utRho05
ykgC,640430,640430,640002,428,0,utRho05
ykgD,640232,640454,640232,222,2,utRho05
ykgE,642962,643216,642962,254,4,utRho05
ykgJ,608524,608524,608364,160,34,utRho05
ykgL,623878,624224,623878,346,4,utRho05
ykgM,625610,625610,625554,56,4,utRho05
ykgR,626570,626570,626484,86,0,utRho05
ylaC,958576,958576,958502,74,1268,utRho05
yliE,1745938,1745958,1745938,20,0,utRho05
ymcE,2103660,2103694,2103660,34,874,utRho05
ymdA,2210450,2210828,2210450,378,36,utRho05
ymdB,2211428,2211640,2211428,212,54,utRho05
ymfD,2395322,2395322,2395064,258,28,utRho05
ymfI,2402880,2402994,2402880,114,0,utRho05
ymfJ,2404518,2404518,2404168,350,62,utRho05
ymfK,2406176,2406176,2405866,310,172,utRho05
ymfT,2405766,2406048,2405766,282,174,utRho05
ymgE,2489110,2489456,2489110,346,300,utRho05
ymgF,2437628,2437966,2437628,338,0,utRho05
ymiA,2670112,2670320,2670112,208,176,utRho05
ymjA,2715620,2715620,2715336,284,1208,utRho05
ynaI,2791946,2791946,2791844,102,0,utRho05
ynaK,2850438,2850754,2850438,316,2,utRho05
ynbA,2954924,2955242,2954924,318,0,utRho05
yncD,3046552,3046552,3046130,422,194,utRho05
yncE,3046454,3046614,3046454,160,0,utRho05
yncG,3052456,3052494,3052456,38,10,utRho05
yncL,3034492,3034492,3034388,104,94,utRho05
yneE,3218364,3218364,3218044,320,6,utRho05
yneF,3223748,3223748,3223708,40,0,utRho05
yneJ,3229560,3229608,3229560,48,178,utRho05
yneK,3231100,3231526,3231100,426,0,utRho05
yneM,3245176,3245292,3245176,116,144,utRho05
ynfA,3311398,3311398,3311346,52,0,utRho05
ynfB,3311418,3311616,3311418,198,118,utRho05
ynfC,3315094,3315094,3314914,180,0,utRho05
ynfD,3314828,3315130,3314828,302,0,utRho05
ynfE,3316006,3316138,3316006,132,30,utRho05
ynfK,3334670,3334670,3334438,232,110,utRho05
ynfL,3339304,3339304,3339184,120,0,utRho05
ynfM,3339260,3339398,3339260,138,0,utRho05
ynfN,3276598,3276598,3276218,380,1502,utRho05
ynfO,3273454,3273512,3273454,58,4,utRho05
ynhG,3517890,3517890,3517450,440,532,utRho05
yniA,3615158,3615592,3615158,434,0,utRho05
yniB,3618526,3618526,3618466,60,0,utRho05
yniC,3618652,3618760,3618652,108,0,utRho05
yniD,3610202,3610330,3610202,128,0,utRho05
ynjE,3678880,3678934,3678880,54,0,utRho05
ynjF,3683222,3683222,3682806,416,42,utRho05
ynjH,3684376,3684376,3684270,106,44,utRho05
ynjI,3690022,3690022,3689742,280,58,utRho05
yoaB,3786642,3786734,3786642,92,88,utRho05
yoaC,3787932,3788146,3787932,214,406,utRho05
yoaE,3803544,3803544,3803170,374,52,utRho05
yoaF,3755444,3755444,3755064,380,818,utRho05
yoaH,3789866,3789866,3789462,404,384,utRho05
yobB,3850418,3850880,3850418,462,862,utRho05
yobF,3815586,3815586,3815182,404,58,utRho05
yobH,3817800,3817850,3817800,50,0,utRho05
yodB,4084352,4084736,4084352,384,48,utRho05
yodC,4057008,4057008,4056740,268,0,utRho05
yohC,4451358,4451358,4451262,96,8,utRho05
yohD,4451526,4451602,4451526,76,0,utRho05
yohJ,4460986,4461248,4460986,262,0,utRho05
yohO,4431172,4431314,4431172,142,0,utRho05
yojI,4617282,4617282,4617230,52,0,utRho05
ypdI,4988988,4989396,4988988,408,60,utRho05
ypfG,5165786,5165786,5165554,232,0,utRho05
ypfM,5182140,5182140,5181732,408,154,utRho05
yphB,5349590,5349590,5349376,214,0,utRho05
ypjA,5565644,5565644,5565452,192,4,utRho05
ypjB,5569636,5569636,5568858,778,0,utRho05
ypjD,5495860,5495774,5495860,86,0,utRho05
yqaE,5594170,5594170,5594056,114,0,utRho05
yqcA,5846100,5846100,5845968,132,4,utRho05
yqcE,5800944,5801184,5800944,240,0,utRho05
yqeC,6030468,6030468,6030114,354,56,utRho05
yqeF,5971618,5971618,5971184,434,14,utRho05
yqeG,5971438,5971694,5971438,256,16,utRho05
yqeH,5975016,5975072,5975016,56,14,utRho05
yqeI,5976688,5977004,5976688,316,0,utRho05
yqeK,5981140,5981140,5980720,420,10,utRho05
yqfA,6086728,6086728,6086296,432,20,utRho05
yqgA,6219042,6219106,6219042,64,0,utRho05
yqgB,6172500,6172500,6172102,398,1934,utRho05
yqgE,6185768,6185874,6185768,106,710,utRho05
yqhA,6299150,6299150,6298942,208,0,utRho05
yqhC,6310768,6310768,6310436,332,158,utRho05
yqhD,6310604,6310710,6310604,106,92,utRho05
yqhH,6316842,6317254,6316842,412,982,utRho05
yqiC,6369662,6369680,6369662,18,2,utRho05
yqiJ,6384108,6384416,6384108,308,440,utRho05
yqjA,6495096,6495546,6495096,450,8842,utRho05
yqjF,6500932,6501124,6500932,192,222,utRho05
yqjG,6501948,6502048,6501948,100,0,utRho05
yqjH,6433078,6433078,6432982,96,44,utRho05
yqjI,6433506,6433558,6433506,52,0,utRho05
yraH,6574552,6574852,6574552,300,0,utRho05
yraP,6592144,6592818,6592144,674,248,utRho05
yraQ,6596414,6596414,6596276,138,0,utRho05
yraR,6598024,6598024,6597692,332,2,utRho05
yrbG,13360844,13361100,13360844,256,112,utRho05
yrbL,6696842,6696904,6696842,62,200,utRho05
yrbN,6616172,6616172,6615866,306,23814,utRho05
yrdB,6860176,6860176,6860046,130,160,utRho05
yrfF,7052548,7052938,7052548,390,250,utRho05
yrhB,7169440,7169518,7169440,78,0,utRho05
ysaB,7451804,7451804,7451424,380,102,utRho05
ysgA,8032686,8032686,8032338,348,160,utRho05
ytfB,8857638,8857638,8857434,204,148,utRho05
ytfE,8864018,8864018,8863966,52,52,utRho05
ytfF,8866296,8866296,8866130,166,0,utRho05
ytfH,8868164,8868226,8868164,62,0,utRho05
ytfI,8875234,8875414,8875234,180,2,utRho05
ytfJ,8878572,8878572,8878524,48,0,utRho05
ytfK,8879022,8879174,8879022,152,174,utRho05
ytfL,8882642,8882642,8882430,212,84,utRho05
ytfQ,8899634,8899924,8899634,290,26,utRho05
ytjB,9249598,9249598,9249578,20,50,utRho05
yzfA,8896588,8896588,8896490,98,0,utRho05
zapA,6111102,6111224,6111102,122,8984,utRho05
zapB,8236772,8237030,8236772,258,90,utRho05
zapC,2011700,2011904,2011700,204,30,utRho05
zinT,4082692,4082750,4082692,58,0,utRho05
zipA,5062814,5062814,5062466,348,48,utRho05
zitB,1569716,1569716,1569646,70,26,utRho05
zntA,7212844,7212902,7212844,58,106,utRho05
zntR,6878336,6878336,6878260,76,24,utRho05
znuA,3885322,3885322,3885166,156,66,utRho05
znuC,3885268,3885324,3885268,56,66,utRho05
zraP,8403424,8403424,8403376,48,0,utRho05
zraS,8403810,8403852,8403810,42,0,utRho05
zupT,6364866,6365100,6364866,234,896,utRho05
zur,8520282,8520282,8520006,276,2662,utRho05
zwf,3872752,3872752,3872628,124,88,utRho05
C0343,2818676,2818728,2818676,52,0,utRho06
aaeB,6776526,6776526,6776376,150,0,utRho06
aaeR,6778762,6779040,6778762,278,34,utRho06
aaeX,6778860,6778860,6778674,186,68,utRho06
aat,1854920,1854920,1854864,56,66,utRho06
accA,416822,417242,416822,420,1426,utRho06
accB,6810280,6810872,6810280,592,4916,utRho06
accD,4868030,4868030,4867852,178,296,utRho06
aceB,8430804,8430956,8430804,152,0,utRho06
aceE,245938,246034,245938,96,438,utRho06
ackA,4826918,4826940,4826918,22,1182,utRho06
acnA,2670848,2671662,2670848,814,668,utRho06
acnB,263038,263230,263038,192,360,utRho06
acpP,2303148,2303230,2303148,82,118,utRho06
acpS,5402324,5402324,5401996,328,142,utRho06
acrA,971396,971396,971238,158,172,utRho06
acrB,969370,969370,968806,564,2068,utRho06
acrD,5174950,5175190,5174950,240,40,utRho06
acrE,6827404,6827728,6827404,324,0,utRho06
acrR,971398,971522,971398,124,102,utRho06
acrZ,1589502,1589546,1589502,44,0,utRho06
acs,8575190,8575190,8574742,448,22,utRho06
actP,8569870,8569870,8569804,66,0,utRho06
ada,4620854,4620854,4620810,44,0,utRho06
add,3404404,3404466,3404404,62,28,utRho06
ade,7687802,7687928,7687802,126,0,utRho06
adhE,2596826,2596826,2596242,584,20,utRho06
adhP,3107988,3107988,3107676,312,608,utRho06
adiA,8681112,8681112,8681042,70,10,utRho06
adiC,8674404,8674404,8674062,342,0,utRho06
adiY,8676084,8676084,8675858,226,0,utRho06
adk,994278,994350,994278,72,94,utRho06
adrA,807374,807406,807374,32,0,utRho06
aer,6438240,6438240,6438152,88,44,utRho06
aes,1000102,1000102,999946,156,4,utRho06
agaR,6557406,6557406,6557330,76,0,utRho06
agaS,6563778,6563952,6563778,174,14,utRho06
agp,2131118,2131170,2131118,52,0,utRho06
agrA,7296126,7296126,7296126,0,0,utRho06
agrB,7296588,7296588,7296588,0,0,utRho06
ahpC,1277386,1277890,1277386,504,606,utRho06
ahpF,1278004,1279506,1278004,1502,35450,utRho06
ahr,8992698,8992698,8992418,280,0,utRho06
aidB,8828494,8828550,8828494,56,56,utRho06
ais,4731512,4731512,4731240,272,0,utRho06
alaA,4814816,4815122,4814816,306,2,utRho06
alaC,4996798,4996798,4996590,208,0,utRho06
alaE,5598140,5598328,5598140,188,48,utRho06
alaS,5644180,5644180,5644022,158,1116,utRho06
alaW,5036612,5036612,5036462,150,0,utRho06
aldA,2976380,2976464,2976380,84,158,utRho06
aldB,7513070,7513070,7513022,48,58,utRho06
alkA,4295118,4295118,4295080,38,0,utRho06
alkB,4618890,4618890,4618682,208,0,utRho06
allA,1064780,1064902,1064780,122,0,utRho06
allD,1092822,1092822,1092726,96,0,utRho06
allE,1088112,1088112,1088092,20,22,utRho06
allS,1064600,1064600,1064442,158,0,utRho06
alr,8531178,8531564,8531178,386,1746,utRho06
alsE,8617334,8617334,8616956,378,22,utRho06
alsK,8615990,8615990,8615598,392,28,utRho06
alx,6476740,6477160,6476740,420,0,utRho06
amiA,5104482,5104704,5104482,222,40,utRho06
amiC,5898378,5898378,5898020,358,0,utRho06
amn,4110062,4110122,4110062,60,0,utRho06
ampC,8758006,8758006,8757888,118,0,utRho06
ampD,237362,237466,237362,104,70,utRho06
ampG,907372,907372,907090,282,262,utRho06
ampH,792726,792726,792574,152,116,utRho06
amyA,4012230,4012312,4012230,82,14,utRho06
anmK,3439346,3439346,3439204,142,0,utRho06
ansB,6201580,6201580,6201456,124,108,utRho06
ansP,3052040,3052040,3051960,80,128,utRho06
apaG,104068,104068,103212,856,3664,utRho06
apaH,102586,102586,102444,142,5026,utRho06
apbE,4623188,4623188,4623068,120,78,utRho06
appA,2081198,2081234,2081198,36,20,utRho06
appC,2075420,2075480,2075420,60,0,utRho06
appY,1167134,1167362,1167134,228,0,utRho06
apt,982620,982824,982620,204,236,utRho06
aqpZ,1832424,1832424,1832094,330,0,utRho06
araB,140150,140150,140096,54,0,utRho06
araC,140482,140774,140482,292,22,utRho06
araE,5964416,5964416,5964364,52,0,utRho06
araF,3972476,3972476,3972256,220,0,utRho06
araH,3967120,3967120,3967086,34,2,utRho06
araJ,825058,825058,824962,96,2,utRho06
arcA,9281602,9281602,9280612,990,3968,utRho06
arcB,6706098,6706098,6706050,48,0,utRho06
arcZ,6701154,6701154,6701154,0,0,utRho06
arfA,6877346,6877346,6877298,48,424,utRho06
argA,5898312,5898484,5898312,172,0,utRho06
argC,8309770,8310002,8309770,232,120,utRho06
argD,6980442,6980442,6980360,82,0,utRho06
argE,8310156,8310156,8309694,462,120,utRho06
argF,580680,580680,580610,70,0,utRho06
argG,6637124,6637274,6637124,150,12,utRho06
argI,8956688,8956688,8956622,66,8,utRho06
argO,6137672,6137672,6137616,56,210,utRho06
argP,6119460,6119506,6119460,46,0,utRho06
argR,6769204,6769406,6769204,202,52,utRho06
argS,3920002,3920124,3920002,122,0,utRho06
argT,4855698,4855698,4855582,116,168,utRho06
argU,1129406,1129446,1129406,40,0,utRho06
argW,4932616,4932618,4932616,2,36,utRho06
argX,7964728,7964750,7964728,22,42,utRho06
aroF,5482402,5482402,5482300,102,54,utRho06
aroG,1571182,1571266,1571182,84,148,utRho06
aroH,3576636,3576870,3576636,234,322,utRho06
aroK,7038760,7038760,7038128,632,2182,utRho06
aroL,812560,812810,812560,250,140,utRho06
aroP,243342,243342,243102,240,0,utRho06
arpA,8445382,8445382,8444974,408,142,utRho06
arrS,7316108,7316108,7316108,0,0,utRho06
arsR,7297024,7297056,7297024,32,26,utRho06
artJ,1801252,1801252,1801150,102,0,utRho06
artP,1807686,1807686,1807468,218,0,utRho06
ascF,5678858,5679048,5678858,190,0,utRho06
ascG,5678574,5678574,5678528,46,0,utRho06
aslB,7965562,7965916,7965562,354,25434,utRho06
asnA,7854258,7854310,7854258,52,74,utRho06
asnB,1398444,1398444,1398354,90,206,utRho06
asnC,23562186,23562186,23562018,168,192,utRho06
asnS,1978088,1978088,1977970,118,7050,utRho06
asnT,4089082,4089098,4089082,16,38,utRho06
asnU,4119690,4119702,4119690,12,0,utRho06
asnV,4124504,4124520,4124504,16,0,utRho06
aspA,17473728,17473728,17473308,420,64,utRho06
aspC,1971486,1971486,1971418,68,298,utRho06
aspS,3901402,3901402,3901044,358,58,utRho06
aspT,7893560,7893744,7893560,184,92464,utRho06
aspV,473826,473862,473826,36,26,utRho06
asr,3342654,3342752,3342654,98,54,utRho06
astC,3664088,3664088,3663964,124,0,utRho06
astE,3654138,3654138,3653846,292,0,utRho06
atoD,4646824,4646894,4646824,70,4,utRho06
atpB,7844540,7844540,7844102,438,496,utRho06
atpC,7832118,7832118,7831944,174,1220,utRho06
atpI,7845050,7845050,7844880,170,0,utRho06
avtA,7479348,7479410,7479348,62,354,utRho06
azoR,2965982,2965982,2965720,262,56,utRho06
azuC,3976002,3976002,3975918,84,96,utRho06
bacA,6408350,6408350,6408262,88,2,utRho06
bamA,394052,395856,394052,1804,870,utRho06
bamB,5277950,5277950,5277304,646,1988,utRho06
bamC,5198028,5198028,5197730,298,1488,utRho06
bamD,5471922,5472292,5471922,370,4006,utRho06
bamE,5506972,5507210,5506972,238,784,utRho06
basS,8666954,8666954,8666544,410,428,utRho06
bax,7474468,7474468,7474354,114,150,utRho06
bcp,5200874,5200956,5200874,82,994,utRho06
bcsB,7385346,7385346,7385214,132,0,utRho06
bcsE,7392644,7392916,7392644,272,0,utRho06
bdcA,8948128,8948128,8948106,22,32,utRho06
bdcR,8948192,8948248,8948192,56,26,utRho06
bdm,3112680,3112680,3112560,120,0,utRho06
betA,654522,654522,654494,28,202,utRho06
betI,658722,658722,658668,54,14,utRho06
betT,658842,658926,658842,84,14,utRho06
bfr,6933498,6933498,6933450,48,0,utRho06
bglG,23440182,23440182,23439402,780,6,utRho06
bglX,4444240,4444240,4443978,262,0,utRho06
bhsA,2337962,2338146,2337962,184,114,utRho06
bioA,1618584,1618584,1618514,70,0,utRho06
bioB,1618604,1618688,1618604,84,0,utRho06
bioH,7089716,7089716,7089688,28,0,utRho06
bisC,7433026,7433026,7432788,238,0,utRho06
blc,8755490,8755490,8755444,46,0,utRho06
blr,3409024,3409102,3409024,78,142,utRho06
bluF,2431226,2431226,2430950,276,1482,utRho06
bluR,2428226,2428226,2428118,108,0,utRho06
bolA,908698,908944,908698,246,0,utRho06
borD,1157842,1157842,1157786,56,0,utRho06
brnQ,838976,839182,838976,206,1858,utRho06
bssR,1756492,1756496,1756492,4,0,utRho06
bssS,2242116,2242116,2241910,206,376,utRho06
btuB,8326798,8327278,8326798,480,2232,utRho06
cadB,8720212,8720212,8720062,150,0,utRho06
cadC,8723926,8723926,8723868,58,0,utRho06
caiE,70998,70998,70742,256,0,utRho06
caiF,68436,68600,68436,164,0,utRho06
caiT,84074,84074,83862,212,0,utRho06
can,285406,285406,285340,66,80,utRho06
carA,59102,59302,59102,200,0,utRho06
carB,61550,61634,61550,84,20,utRho06
cas2,5757830,5757830,5757706,124,2,utRho06
casA,5768638,5768638,5768276,362,0,utRho06
cbl,4121882,4121882,4121828,54,2,utRho06
cbpA,2128074,2128074,2127550,524,222,utRho06
cbrA,7738628,7738754,7738628,126,0,utRho06
cbrB,7794958,7795012,7794958,54,12,utRho06
ccmH,4585242,4585242,4584820,422,0,utRho06
cdaR,364894,364926,364894,32,0,utRho06
cdd,4463638,4463688,4463638,50,40,utRho06
cdh,8219814,8219860,8219814,46,54,utRho06
cdsA,391110,391354,391110,244,1930,utRho06
cedA,3627484,3627484,3627326,158,0,utRho06
cfa,3482402,3482826,3482402,424,250,utRho06
chaC,2544844,2544972,2544844,128,0,utRho06
chbB,3643452,3643452,3643238,214,0,utRho06
chbG,3634624,3634624,3634270,354,4,utRho06
cheW,3946924,3946924,3946678,246,280,utRho06
chiA,6939792,6939792,6939706,86,0,utRho06
chiP,1416472,1416668,1416472,196,0,utRho06
cho,3646984,3647030,3646984,46,30,utRho06
chpS,8896804,8896894,8896804,90,0,utRho06
cirA,4493884,4493884,4493538,346,384,utRho06
citC,1304078,1304078,1303712,366,0,utRho06
citT,1293264,1293264,1293160,104,0,utRho06
clcA,350104,350214,350104,110,28,utRho06
clpA,1846160,1846528,1846160,368,4,utRho06
clpB,5468410,5468410,5468346,64,62,utRho06
clpP,913154,913354,913154,200,300,utRho06
clpS,1845500,1845826,1845500,326,0,utRho06
clpX,914404,914852,914404,448,710,utRho06
clsA,2617346,2617346,2617290,56,58,utRho06
clsC,2212584,2212710,2212584,126,366,utRho06
cmk,1922330,1922402,1922330,72,174,utRho06
cnu,3409522,3409898,3409522,376,430,utRho06
coaA,8350214,8350214,8350052,162,546,utRho06
cobC,1340092,1340092,1339814,278,428,utRho06
cobT,4129202,4129202,4128934,268,76,utRho06
cobU,4131944,4131944,4131528,416,72,utRho06
codB,709768,709844,709768,76,0,utRho06
comR,2337726,2337726,2337664,62,28,utRho06
copA,1022822,1022822,1022758,64,0,utRho06
corA,8002388,8002852,8002388,464,3566,utRho06
cpdB,8873258,8873258,8873130,128,74,utRho06
cptB,6082198,6082198,6082140,58,6,utRho06
cpxA,8210202,8210202,8209950,252,586,utRho06
cpxP,8211570,8211640,8211570,70,34,utRho06
cpxR,8211372,8211372,8211340,32,0,utRho06
cra,175894,176056,175894,162,0,utRho06
crcB,1316016,1316016,1315876,140,0,utRho06
creA,9270486,9271042,9270486,556,682,utRho06
creD,9276320,9276356,9276320,36,34,utRho06
crl,515620,515658,515620,38,1272,utRho06
crp,6971906,6972240,6971906,334,4522,utRho06
crr,5070960,5071668,5070960,708,3314,utRho06
csdA,5886414,5886674,5886414,260,52,utRho06
csgB,2207718,2207902,2207718,184,2,utRho06
csgD,2206688,2206688,2206392,296,0,utRho06
csgG,2203510,2203510,2203368,142,50,utRho06
csiD,5577854,5577970,5577854,116,2,utRho06
csiE,5330802,5330870,5330802,68,18,utRho06
csiR,5590942,5591348,5590942,406,0,utRho06
cspA,7439778,7440098,7439778,320,369996,utRho06
cspB,3283430,3283430,3283108,322,556,utRho06
cspC,3815018,3815018,3814870,148,608,utRho06
cspD,1845352,1845352,1845180,172,416,utRho06
cspE,1314294,1314584,1314294,290,24,utRho06
cspF,3283380,3283710,3283380,330,52,utRho06
cspG,2102610,2102922,2102610,312,106514,utRho06
cspH,2102746,2102746,2102350,396,334,utRho06
cspI,3277624,3277624,3277334,290,254,utRho06
csrA,5638746,5638746,5638292,454,1040,utRho06
csrB,5849048,5849048,5849048,0,0,utRho06
csrC,8102072,8102072,8102072,0,0,utRho06
csrD,6806850,6806850,6806664,186,0,utRho06
cstA,1259710,1259788,1259710,78,0,utRho06
cueO,274090,274166,274090,76,0,utRho06
cueR,1027948,1027986,1027948,38,26,utRho06
curA,3037784,3038054,3037784,270,0,utRho06
cusC,1191146,1191200,1191146,54,0,utRho06
cusR,1190924,1190924,1190886,38,12,utRho06
cutA,8730784,8730784,8730712,72,286,utRho06
cutC,3918534,3918534,3917920,614,164,utRho06
cvpA,4861600,4861600,4861526,74,106,utRho06
cvrA,2484328,2484328,2484142,186,246,utRho06
cyaA,7981548,7982306,7981548,758,1056,utRho06
cyaR,4334228,4334224,4334228,4,0,utRho06
cyaY,7988166,7988166,7988118,48,46,utRho06
cybB,2981522,2981804,2981522,282,60,utRho06
cycA,8859560,8859728,8859560,168,404,utRho06
cydA,1542340,1542916,1542340,576,160,utRho06
cydC,1858800,1858800,1858390,410,90,utRho06
cydD,1862062,1862062,1861924,138,96,utRho06
cydX,1548300,1548392,1548300,92,218,utRho06
cynR,717418,717418,717380,38,0,utRho06
cynT,1435092,1435196,1435092,104,0,utRho06
cyoA,903306,903306,903220,86,1324,utRho06
cyoE,895540,895540,895410,130,418,utRho06
cysB,2667576,2667710,2667576,134,308,utRho06
cysC,5748056,5748056,5747984,72,0,utRho06
cysD,5752736,5752736,5752658,78,0,utRho06
cysE,7565362,7565362,7565124,238,738,utRho06
cysG,6995508,6995656,6995508,148,0,utRho06
cysJ,5783928,5783928,5783796,132,1576,utRho06
cysK,5064688,5064818,5064688,130,0,utRho06
cysP,5087114,5087114,5087056,58,180,utRho06
cysS,1109154,1109222,1109154,68,52,utRho06
cysT,3984100,3984100,3983974,126,306,utRho06
cysZ,5062766,5062926,5062766,160,188,utRho06
cytR,8249018,8249018,8248912,106,120,utRho06
dacA,1328002,1328002,1327926,76,106,utRho06
dacB,6657714,6657926,6657714,212,60,utRho06
dacC,1761306,1761454,1761306,148,0,utRho06
dadA,2475018,2475142,2475018,124,0,utRho06
dam,7032504,7032504,7031826,678,1104,utRho06
damX,7035200,7035200,7034612,588,476,utRho06
dapA,5199568,5199568,5199520,48,0,utRho06
dapB,56576,56748,56576,172,8,utRho06
dapD,371954,371954,371894,60,54,utRho06
dapE,5183120,5183214,5183120,94,450,utRho06
dcp,3254844,3254844,3254760,84,6,utRho06
dcrB,7219534,7219910,7219534,376,66,utRho06
dctA,7366996,7366996,7366894,102,580,utRho06
dcuA,8733686,8733686,8733546,140,0,utRho06
dcuB,8698182,8698182,8697488,694,16,utRho06
dcuC,1312166,1312166,1311936,230,0,utRho06
dcuD,6749166,6749738,6749166,572,0,utRho06
dcuR,8701130,8701130,8700068,1062,384,utRho06
dcuS,8703370,8703370,8703324,46,4,utRho06
dcyD,3999016,3999016,3998960,56,0,utRho06
ddpX,3126498,3126498,3126152,346,0,utRho06
deaD,6615818,6615818,6615720,98,4236,utRho06
dedA,4869880,4869880,4869482,398,9008,utRho06
dedD,4863750,4863750,4863368,382,72,utRho06
def,6867300,6867380,6867300,80,66,utRho06
degP,361690,361768,361690,78,0,utRho06
degQ,6761308,6761486,6761308,178,2664,utRho06
deoB,9239134,9239206,9239134,72,0,utRho06
deoC,9233358,9234646,9233358,1288,24,utRho06
dfp,7625406,7625462,7625406,56,18,utRho06
dgcZ,3247758,3247758,3247700,58,0,utRho06
dgkA,8512914,8513274,8512914,360,366,utRho06
dgt,358392,358474,358392,82,52,utRho06
dhaK,2501888,2501888,2501676,212,82,utRho06
dhaR,2502006,2502132,2502006,126,0,utRho06
dicB,3299194,3299218,3299194,24,0,utRho06
dicC,3295752,3295752,3295700,52,0,utRho06
dinB,501760,501796,501760,36,0,utRho06
dinD,7635398,7635520,7635398,122,284,utRho06
dinG,1666146,1666140,1666146,6,22,utRho06
dinI,2243018,2243018,2242974,44,14,utRho06
dinJ,493230,493230,493004,226,6,utRho06
dinQ,7295964,7295964,7295576,388,1258,utRho06
djlA,114536,114728,114536,192,0,utRho06
dkgA,6313142,6313246,6313142,104,2,utRho06
dkgB,458196,458334,458196,138,380,utRho06
dksA,321502,321502,321208,294,204,utRho06
dld,4444164,4444370,4444164,206,0,utRho06
dmlA,3763424,3763824,3763424,400,42,utRho06
dmlR,3763710,3763710,3763618,92,20,utRho06
dmsA,1881646,1881918,1881646,272,34,utRho06
dnaA,7767922,7767922,7767458,464,5198,utRho06
dnaB,8528566,8528628,8528566,62,192,utRho06
dnaK,24096,24326,24096,230,68,utRho06
dnaN,7765466,7765466,7764642,824,874,utRho06
dnaQ,471868,472134,471868,266,786,utRho06
dnaT,18406460,18406460,18406068,392,76,utRho06
dnaX,984112,984184,984112,72,616,utRho06
dosP,3131486,3131486,3131466,20,0,utRho06
dpiB,1303968,1304470,1303968,502,0,utRho06
dppA,7415740,7415740,7415410,330,1382,utRho06
dps,1697900,1697900,1697822,78,64,utRho06
dsbA,8086754,8086836,8086754,82,2012,utRho06
dsbB,2466294,2466294,2466060,234,58,utRho06
dsbC,6079266,6079266,6077644,1622,1206,utRho06
dsbG,1277600,1277600,1277146,454,266,utRho06
dsdA,4958242,4958404,4958242,162,56,utRho06
dsdC,4955492,4955492,4955258,234,0,utRho06
dsdX,4955642,4955694,4955642,52,0,utRho06
dsrA,4050626,4050626,4050626,0,0,utRho06
dsrB,4049686,4049686,4049646,40,66,utRho06
dtpD,1485340,1485340,1485112,228,24,utRho06
dusA,8523200,8523338,8523200,138,3360,utRho06
dusB,6820492,6820560,6820492,68,74,utRho06
dusC,4460790,4460790,4460770,20,0,utRho06
dut,7627704,7627864,7627704,160,928,utRho06
dxr,386670,387042,386670,372,490,utRho06
ebgA,6445102,6445266,6445102,164,8,utRho06
ebgR,6442874,6442932,6442874,58,80,utRho06
ecnB,8753018,8753106,8753018,88,340,utRho06
eco,4607594,4607810,4607594,216,2,utRho06
ecpA,621594,621594,621342,252,0,utRho06
ecpB,620238,620238,620052,186,0,utRho06
ecpR,622964,622964,622672,292,0,utRho06
eda,3866218,3866218,3865512,706,72,utRho06
edd,3869426,3869426,3869208,218,74,utRho06
efeO,2164308,2164486,2164308,178,32,utRho06
efeU_1,2162614,2162712,2162614,98,10,utRho06
efp,8751134,8751398,8751134,264,7400,utRho06
elaA,4763372,4763372,4763086,286,76,utRho06
elaD,4765308,4765426,4765308,118,46,utRho06
elfA,1995530,1995736,1995530,206,0,utRho06
elfD,1996642,1996980,1996642,338,0,utRho06
emrD,7707690,7707844,7707690,154,0,utRho06
emrK,4966896,4966896,4966678,218,0,utRho06
emrY,4964668,4964668,4964352,316,0,utRho06
emtA,2486250,2486360,2486250,110,0,utRho06
endA,12361100,12361388,12361100,288,0,utRho06
eno,5817692,5817692,5815882,1810,2710,utRho06
entC,1249662,1249770,1249662,108,50,utRho06
entD,1220508,1220508,1220158,350,272,utRho06
entH,1258584,1258600,1258584,16,84,utRho06
entS,1244506,1244600,1244506,94,0,utRho06
envR,6827266,6827266,6826930,336,0,utRho06
epd,12295292,12295292,12294764,528,360,utRho06
epmA,8765236,8765286,8765236,50,38,utRho06
epmB,8751406,8751406,8751314,92,4854,utRho06
eptB,7421162,7421162,7420950,212,442,utRho06
eptC,8300622,8300622,8300530,92,274,utRho06
erfK,4126708,4126708,4126646,62,1360,utRho06
erpA,353122,353220,353122,98,104,utRho06
esrE,8039956,8039956,8039956,0,0,utRho06
essD,1153746,1154796,1153746,1050,228,utRho06
etk,2088606,2088606,2088420,186,0,utRho06
evgA,4967262,4967510,4967262,248,44,utRho06
exbB,6304028,6304028,6303968,60,0,utRho06
exbD,6302780,6302780,6302486,294,78,utRho06
exuR,6493016,6493304,6493016,288,176,utRho06
exuT,6490004,6490208,6490004,204,0,utRho06
fabA,2032996,2032996,2032940,56,152,utRho06
fabB,4883282,4883282,4883210,72,78,utRho06
fabH,2297032,2297518,2297032,486,2316,utRho06
fabI,2702236,2702236,2702078,158,2,utRho06
fadB,8062026,8062026,8061942,84,0,utRho06
fadD,3779614,3779614,3779492,122,0,utRho06
fadE,486812,486812,486606,206,0,utRho06
fadH,6463248,6463330,6463248,82,0,utRho06
fadI,4921022,4921022,4920938,84,84,utRho06
fadL,4922410,4922600,4922410,190,34,utRho06
fadM,928720,928804,928720,84,36,utRho06
fadR,2469810,2469876,2469810,66,14,utRho06
fbaB,4357334,4357334,4357128,206,0,utRho06
fdhE,8162722,8162722,8162456,266,994,utRho06
fdhF,8598814,8598814,8598732,82,0,utRho06
fdnG,3094744,3094802,3094744,58,44,utRho06
fdrA,1093012,1093360,1093012,348,0,utRho06
feaB,2894994,2895038,2894994,44,0,utRho06
feaR,2894734,2894734,2894566,168,40,utRho06
fecA,9033454,9033454,9033354,100,302,utRho06
fecE,9023288,9023288,9022914,374,6694,utRho06
fecI,9036564,9036564,9036470,94,118,utRho06
feoA,7080114,7080326,7080114,212,134,utRho06
fepA,1225334,1225334,1224988,346,104,utRho06
fepB,1249454,1249454,1249020,434,680,utRho06
fepD,1244468,1244468,1244378,90,66,utRho06
fes,1225374,1225630,1225374,256,228,utRho06
ffh,5495706,5495706,5495590,116,1250,utRho06
ffs,952576,952848,952576,272,0,utRho06
fhuA,334884,334968,334884,84,220,utRho06
fhuE,2323294,2323294,2323102,192,214,utRho06
fhuF,9211504,9211504,9211326,178,2882,utRho06
fic,6983296,6983296,6982926,370,262,utRho06
fieF,8212864,8212938,8212864,74,84,utRho06
fimA,9085388,9086230,9085388,842,32,utRho06
fimB,9081334,9081914,9081334,580,190,utRho06
fimE,9083742,9084074,9083742,332,46,utRho06
fimZ,1129214,1129214,1128960,254,0,utRho06
fiu,1683296,1683296,1683062,234,162,utRho06
fixA,84650,84806,84650,156,0,utRho06
fkpA,6955050,6955050,6954838,212,6492,utRho06
fldA,2846084,2846084,2845860,224,2808,utRho06
fldB,6079644,6079710,6079644,66,116,utRho06
flgA,2261770,2261770,2261726,44,74,utRho06
flgB,2261986,2262036,2261986,50,0,utRho06
flgK,2276702,2276756,2276702,54,1106,utRho06
flgM,2260330,2260330,2260256,74,292,utRho06
flgN,2259828,2259828,2259660,168,162,utRho06
flhB,3932432,3932432,3932382,50,122,utRho06
flhC,3955864,3955864,3955688,176,2,utRho06
flhD,3957154,3957154,3956394,760,514,utRho06
fliA,4003638,4003638,4003578,60,36,utRho06
fliC,4007352,4007352,4007212,140,182,utRho06
fliD,4007634,4007744,4007634,110,358,utRho06
fliE,4026186,4026186,4026028,158,20,utRho06
fliF,4026292,4026458,4026292,166,154,utRho06
fliL,4039168,4039236,4039168,68,116,utRho06
flk,4875824,4875900,4875824,76,144,utRho06
flu,4142634,4143078,4142634,444,92,utRho06
flxA,3292776,3292810,3292776,34,0,utRho06
fnr,2799104,2799104,2799052,52,246,utRho06
fnrS,2818258,2818258,2818258,0,0,utRho06
focA,1909628,1909628,1908932,696,148,utRho06
folA,99598,99646,99598,48,0,utRho06
folB,6409296,6409296,6409178,118,0,utRho06
folD,1115562,1115562,1115482,80,158,utRho06
folE,4487696,4487696,4487304,392,2120,utRho06
fpr,8228998,8228998,8228944,54,58,utRho06
frc,4986878,4986878,4986508,370,0,utRho06
frdA,8764824,8764824,8764636,188,80,utRho06
frdD,8758948,8758948,8758732,216,66,utRho06
fre,8052886,8053054,8052886,168,1548,utRho06
frlA,6999518,6999820,6999518,302,0,utRho06
frr,385624,385744,385624,120,426,utRho06
frsA,513004,513054,513004,50,148,utRho06
fruB,4527194,4527194,4526990,204,0,utRho06
frvR,8179804,8179804,8179710,94,0,utRho06
fryA,5008986,5008986,5008970,16,2,utRho06
fsaA,1727060,1727284,1727060,224,0,utRho06
fsr,1009710,1009710,1009392,318,18,utRho06
ftnA,3977364,3977432,3977364,68,0,utRho06
ftnB,3973550,3973850,3973550,300,0,utRho06
ftsA,207122,207964,207122,842,320,utRho06
ftsB,5745802,5745802,5745640,162,42,utRho06
ftsH,6654204,6654204,6653870,334,1022,utRho06
ftsK,1865858,1866448,1865858,590,1402,utRho06
ftsL,181376,182064,181376,688,1076,utRho06
ftsP,6325732,6325732,6325338,394,284,utRho06
ftsQ,205484,206310,205484,826,766,utRho06
ftsX,7204512,7204512,7204172,340,636,utRho06
ftsZ,209272,210610,209272,1338,160,utRho06
fucA,5867708,5867708,5867376,332,0,utRho06
fucP,5868238,5868470,5868238,232,0,utRho06
fumA,6753760,6753760,6753508,252,1648,utRho06
fumB,8694696,8694696,8694652,44,0,utRho06
fumC,3373418,3373418,3373176,242,0,utRho06
fur,2842892,2842892,2842584,308,5280,utRho06
fusA,6947370,6947370,6947028,342,16300,utRho06
fxsA,8737206,8737328,8737206,122,162,utRho06
gabD,5581824,5582546,5581824,722,412,utRho06
gadA,7335214,7335214,7335160,54,0,utRho06
gadB,3144144,3144144,3144090,54,0,utRho06
gadC,3141168,3141168,3140978,190,54,utRho06
gadE,7315600,7316732,7315600,1132,0,utRho06
gadW,7329562,7329562,7329236,326,6,utRho06
gadX,14663356,14663356,14663240,116,0,utRho06
gadY,7329728,7329728,7329728,0,0,utRho06
galE,1584354,1584354,1584110,244,0,utRho06
galF,4228702,4228702,4228654,48,162,utRho06
galM,1577796,1577796,1577674,122,342,utRho06
galP,6176510,6176568,6176510,58,0,utRho06
galR,5953138,5953198,5953138,60,76,utRho06
galS,4483420,4483420,4483336,84,0,utRho06
galU,2582810,2582914,2582810,104,160,utRho06
gapA,3724480,3725542,3724480,1062,3302,utRho06
garP,6549868,6549868,6549814,54,30,utRho06
gatY,4354468,4354468,4354408,60,30,utRho06
gatZ,4352864,4352864,4352642,222,5162,utRho06
gcd,282558,282558,282450,108,0,utRho06
gcl,1067814,1067832,1067814,18,0,utRho06
gcvA,5885278,5885278,5885134,144,0,utRho06
gcvB,5885392,5885392,5885392,0,0,utRho06
gcvR,5199758,5199812,5199758,54,14,utRho06
gcvT,6101544,6101544,6101334,210,330,utRho06
gdhA,3684616,3684742,3684616,126,18,utRho06
gfcA,2099668,2099668,2099488,180,112,utRho06
gfcD,2096236,2096236,2095890,346,16,utRho06
ghrA,2195648,2195772,2195648,124,212,utRho06
ghrB,7434378,7434620,7434378,242,460,utRho06
glcA,6242728,6242728,6242558,170,0,utRho06
glcC,6256412,6256544,6256412,132,0,utRho06
glcD,6256152,6256152,6256042,110,28,utRho06
gldA,8278092,8278092,8278070,22,0,utRho06
glgA,7136784,7136784,7136066,718,2,utRho06
glgB,7147314,7147314,7147004,310,250,utRho06
glgC,7139142,7139142,7138656,486,18,utRho06
glgP,7133546,7133546,7133162,384,4,utRho06
glgS,6384024,6384024,6383878,146,0,utRho06
glgX,7142838,7142838,7142638,200,0,utRho06
glk,5018922,5018922,5018852,70,82,utRho06
glmS,7827622,7827622,7827336,286,4482,utRho06
glmU,7830652,7830652,7830400,252,478,utRho06
glmY,10765360,10765360,10765360,0,0,utRho06
glmZ,7972864,7972864,7972864,0,0,utRho06
glnA,16232888,16232888,16232136,752,468,utRho06
glnB,5375052,5375052,5374816,236,14,utRho06
glnD,377310,377310,377300,10,30,utRho06
glnE,6399602,6399602,6399282,320,0,utRho06
glnH,1696396,1696396,1696008,388,2,utRho06
glnK,945112,945196,945112,84,0,utRho06
glnL,8112742,8112742,8112678,64,2,utRho06
glnQ,1693262,1693262,1692926,336,426,utRho06
glnS,1411998,1412186,1411998,188,718,utRho06
gloA,3455602,3455674,3455602,72,0,utRho06
gloB,469852,469852,469564,288,810,utRho06
glpA,4705166,4705294,4705166,128,0,utRho06
glpD,7123942,7124026,7123942,84,64,utRho06
glpE,7123698,7123698,7123646,52,116,utRho06
glpF,8236322,8236322,8236180,142,80,utRho06
glpG,7122960,7122960,7122904,56,294,utRho06
glpR,7121782,7121782,7121210,572,138,utRho06
glpT,4704902,4704902,4704748,154,242,utRho06
glpX,8231212,8231212,8231158,54,6354,utRho06
glrK,5382246,5382246,5382196,50,262,utRho06
gltA,1509534,1509534,1508936,598,10844,utRho06
gltB,6709018,6709264,6709018,246,304,utRho06
gltI,1375792,1375792,1375494,298,1758,utRho06
gltP,8588536,8588962,8588536,426,1254,utRho06
gltS,7657382,7657382,7657330,52,134,utRho06
gltX,5041568,5041568,5041344,224,136,utRho06
gluQ,320286,320286,320224,62,68,utRho06
glyA,5371148,5371148,5371014,134,100,utRho06
glyQ,7450708,7450708,7450636,72,96,utRho06
glyS,7448990,7448990,7448794,196,1124,utRho06
glyU,5998128,5998128,5998114,14,0,utRho06
glyV,8784626,8784720,8784626,94,174,utRho06
glyW,3984360,3984360,3984234,126,18,utRho06
gmhB,445612,445666,445612,54,0,utRho06
gmk,7642776,7642856,7642776,80,26,utRho06
gmr,2693686,2693686,2693484,202,48,utRho06
gnd,4202648,4202648,4202536,112,422,utRho06
gnsB,3275692,3275692,3275564,128,86,utRho06
gntK,14310580,14310580,14310368,212,616,utRho06
gntP,9102668,9102668,9102592,76,0,utRho06
gntR,7157760,7157760,7157452,308,252,utRho06
gntT,7092810,7093118,7092810,308,156,utRho06
gntU,7154170,7154170,7154122,48,0,utRho06
gntX,7089334,7089764,7089334,430,34,utRho06
gor,7292224,7292598,7292224,374,1066,utRho06
gpmA,1575340,1575340,1575190,150,0,utRho06
gpmM,7570374,7570520,7570374,146,0,utRho06
gpsA,7567620,7567620,7567322,298,4342,utRho06
gpt,511828,511954,511828,126,418,utRho06
grcA,5433046,5433046,5432898,148,52,utRho06
greA,6657728,6657728,6657430,298,1686,utRho06
greB,7073488,7073624,7073488,136,64,utRho06
groL,8741566,8742050,8741566,484,302,utRho06
groS,8741232,8741376,8741232,144,176,utRho06
grpE,5501494,5501494,5501416,78,194,utRho06
grxA,1781552,1781552,1781506,46,0,utRho06
grxB,2248206,2248206,2248108,98,124,utRho06
grxC,7569152,7569152,7568884,268,3396,utRho06
grxD,3468324,3468324,3468202,122,5804,utRho06
gspA,6911268,6911268,6910796,472,2,utRho06
gspC,6910964,6911156,6910964,192,0,utRho06
gss,6277220,6277220,6277044,176,24,utRho06
gstA,3428654,3428754,3428654,100,8,utRho06
gstB,1761038,1761038,1760960,78,28,utRho06
guaB,5268214,5268214,5268140,74,50,utRho06
gudD,5839026,5839026,5838770,256,0,utRho06
gyrA,4678914,4678914,4678840,74,0,utRho06
gyrB,7760300,7760300,7760238,62,142,utRho06
hcaE,5337964,5338064,5337964,100,8,utRho06
hcaR,5337928,5337928,5337792,136,8,utRho06
hcaT,5336106,5336106,5335692,414,106,utRho06
hchA,4071260,4071670,4071260,410,0,utRho06
hcp,1828258,1828258,1827628,630,40,utRho06
hcr,1824400,1824400,1824300,100,8,utRho06
hdeA,7313582,7313582,7313480,102,0,utRho06
hdeD,7313920,7313990,7313920,70,0,utRho06
hdfR,7896320,7896320,7895934,386,72,utRho06
hdhA,3396244,3396244,3396080,164,30,utRho06
helD,2048876,2048942,2048876,66,0,utRho06
hemA,2527166,2527428,2527166,262,102,utRho06
hemB,779722,779722,779454,268,72,utRho06
hemF,5106410,5106450,5106410,40,106,utRho06
hemH,996062,996110,996062,48,118,utRho06
hemL,349882,349882,349764,118,14,utRho06
hemN,8103886,8104090,8103886,204,26,utRho06
hepA,127176,127176,126528,648,2668,utRho06
hflD,2385372,2385372,2385262,110,1298,utRho06
hfq,8799602,8800576,8799602,974,1834,utRho06
hha,961006,961006,960616,390,270,utRho06
hicA,3018442,3018572,3018442,130,14,utRho06
higA,6468682,6468682,6468288,394,100,utRho06
higB,6468960,6468960,6468910,50,28,utRho06
hinT,2323642,2323770,2323642,128,0,utRho06
hipB,3184964,3184964,3184884,80,0,utRho06
hisB,4186720,4186936,4186720,216,252,utRho06
hisJ,4853674,4853674,4853576,98,40,utRho06
hisL,8359856,8359984,8359856,128,712,utRho06
hisS,5281284,5281284,5281150,134,332,utRho06
hlpA,400910,400964,400910,54,128,utRho06
hlyE,2460932,2460932,2460788,144,0,utRho06
hmp,5371594,5371670,5371594,76,0,utRho06
hns,2585916,2585916,2585844,72,870,utRho06
hofM,7045856,7045856,7045502,354,0,utRho06
hokA,7441620,7441620,7441200,420,3858,utRho06
hokC,33902,33902,33806,96,138,utRho06
hokE,1215462,1215672,1215462,210,0,utRho06
holC,8968546,8968546,8968560,14,670,utRho06
holD,9215562,9215606,9215562,44,16,utRho06
holE,3850040,3850216,3850040,176,786,utRho06
hpt,282720,282862,282720,142,120,utRho06
hrpB,324150,324210,324150,60,70,utRho06
hscB,5319048,5319048,5318934,114,836,utRho06
hscC,1367188,1367188,1366786,402,216,utRho06
hsdS,9163004,9163004,9162924,80,4,utRho06
hslJ,2883560,2883560,2883486,74,32,utRho06
hslO,7059344,7059548,7059344,204,5206,utRho06
hslR,7058220,7058696,7058220,476,912,utRho06
hslV,8244708,8244708,8244574,134,96,utRho06
hsrA,7881412,7881412,7881224,188,162,utRho06
htgA,21286,21660,21286,374,804,utRho06
htpG,989634,990240,989634,606,4182,utRho06
htpX,3825236,3825236,3825152,84,0,utRho06
htrE,311036,311036,310852,184,2,utRho06
htrL,7587668,7587668,7587366,302,36,utRho06
hupA,8400352,8400562,8400352,210,408,utRho06
hupB,1845220,1845804,1845220,584,144,utRho06
hyaA,2063968,2064278,2063968,310,0,utRho06
hybO,6292726,6292726,6292522,204,748,utRho06
hycA,5700922,5700922,5700870,52,0,utRho06
hycI,5686204,5686204,5686086,118,40,utRho06
hydN,5676264,5676264,5676210,54,0,utRho06
hyfA,5202342,5202402,5202342,60,0,utRho06
hypA,11402508,11402588,11402508,80,0,utRho06
hypB,11403356,11404004,11403356,648,0,utRho06
hypF,5676210,5676210,5674850,1360,848,utRho06
hypT,9116634,9116634,9116578,56,0,utRho06
hyuA,6019660,6020056,6019660,396,0,utRho06
iaaA,1733074,1733136,1733074,62,0,utRho06
iadA,9119074,9119074,9119052,22,76,utRho06
iap,5753072,5753162,5753072,90,10,utRho06
ibaG,6673966,6673966,6673606,360,168,utRho06
ibpA,7735036,7735036,7734844,192,170,utRho06
ibpB,7733962,7733962,7733794,168,380,utRho06
icd,2389922,2390246,2389922,324,246,utRho06
iclR,8447304,8447304,8447256,48,8,utRho06
idi,6065876,6066130,6065876,254,0,utRho06
idnD,8988870,8988870,8988812,58,0,utRho06
idnK,8989194,8989246,8989194,52,0,utRho06
ihfA,3591442,3591442,3591104,338,888,utRho06
ihfB,1927498,1927656,1927498,158,356,utRho06
ileS,43666,44782,43666,1116,3006,utRho06
ileX,6431194,6431196,6431194,2,4,utRho06
ilvA,15820940,15821324,15820940,384,88,utRho06
ilvC,7915824,7915940,7915824,116,20,utRho06
ilvE,15809552,15809936,15809552,384,384,utRho06
ilvI,170840,171260,170840,420,8,utRho06
ilvL,23701308,23701932,23701308,624,36,utRho06
ilvY,7915734,7915734,7915640,94,0,utRho06
inaA,4698998,4698998,4698944,54,34,utRho06
infA,1853370,1853370,1852886,484,2986,utRho06
infC,3602692,3602692,3601276,1416,5210,utRho06
insA-5,3958452,3958452,3958430,22,32,utRho06
insA-7,9036758,9037054,9036758,296,200,utRho06
insC-5,6372080,6372284,6372080,204,96,utRho06
insEF-2,785238,785238,785820,582,262,utRho06
insEF-4,2190310,2190310,2190892,582,182,utRho06
insG,9007098,9007098,9006862,236,4,utRho06
insH-1,550596,550596,550234,362,94,utRho06
insH-11,7306538,7306538,7306396,142,28,utRho06
insH-2,1151548,1151548,1151506,42,20,utRho06
insH-3,1378444,1378444,1378026,418,62,utRho06
insH-4,2791942,2792152,2791942,210,24,utRho06
insH-5,2857852,2857852,2857452,400,0,utRho06
insH-6,4135022,4135022,4134642,380,268,utRho06
insH-7,4206186,4206186,4205822,364,5138,utRho06
insH-9,6260050,6260356,6260050,306,72,utRho06
insI-3,9017372,9017372,9017234,138,0,utRho06
insJ,7441188,7441360,7441188,172,1784,utRho06
insK,7442130,7442308,7442130,178,0,utRho06
insL-1,30760,30890,30760,130,464,utRho06
insL-2,1216112,1216130,1216112,18,88,utRho06
insL-3,5028644,5028662,5028644,18,158,utRho06
insN-1,540452,540484,540452,32,0,utRho06
intD,1132202,1132202,1131956,246,22,utRho06
intR,2826520,2826520,2826470,50,0,utRho06
intS,4933026,4933090,4933026,64,538,utRho06
intZ,5117386,5117542,5117386,156,34,utRho06
iraD,9113152,9113986,9113152,834,0,utRho06
iraM,2424246,2424246,2424006,240,0,utRho06
iraP,802638,802772,802638,134,0,utRho06
iscA,5319924,5319924,5319772,152,1450,utRho06
iscR,5324398,5324398,5324262,136,19120,utRho06
iscX,5313834,5313834,5313472,362,1780,utRho06
ispF,5743968,5743968,5743560,408,1194,utRho06
ispG,5283908,5283908,5283608,300,580,utRho06
ispU,389568,389806,389568,238,108,utRho06
isrA,2811502,2811502,2811618,116,34,utRho06
istr-1,7706384,7706384,7706384,0,0,utRho06
istr-2,7706514,7706514,7706514,0,0,utRho06
ivbL,15412092,15412092,15411952,140,336,utRho06
ivy,480638,480686,480638,48,0,utRho06
katE,3627628,3627734,3627628,106,8,utRho06
katG,8267624,8267670,8267624,46,106,utRho06
kbaZ,6557732,6557828,6557732,96,0,utRho06
kbl,7585154,7585154,7585102,52,378,utRho06
kch,2621046,2621046,2620538,508,0,utRho06
kdgR,3820506,3820506,3820198,308,0,utRho06
kdpE,1443788,1443788,1443466,322,56,utRho06
kdpF,1457698,1457698,1457642,56,0,utRho06
kdsA,2535708,2536330,2535708,622,2486,utRho06
kdsC,6683438,6684546,6683438,1108,2450,utRho06
kduI,5968388,5968388,5968248,140,810,utRho06
kefF,94160,94492,94160,332,0,utRho06
kgtP,5451624,5451624,5451492,132,1056,utRho06
kup,7862206,7862632,7862206,426,112,utRho06
lacI,735076,735076,735020,56,0,utRho06
lacZ,1465508,1465508,1465220,288,140,utRho06
ldcA,2486394,2486394,2486160,234,0,utRho06
ldhA,2885830,2885830,2885686,144,0,utRho06
ldrA,2538954,2538954,2538550,404,1894,utRho06
ldrB,2540024,2540024,2539620,404,842,utRho06
ldrC,2541092,2541092,2540690,402,1306,utRho06
ldrD,7400544,7400544,7400174,370,1256,utRho06
lepA,5414392,5414392,5414248,144,172,utRho06
lepB,5410928,5410928,5410618,310,602,utRho06
leuD,159188,159188,158906,282,56,utRho06
leuE,3761600,3761600,3761518,82,0,utRho06
leuL,168048,168048,167416,632,0,utRho06
leuO,168308,168736,168308,428,0,utRho06
leuQ,9212864,9212864,9212802,62,18,utRho06
leuU,6644556,6644556,6644316,240,3992,utRho06
leuV,9212546,9212546,9212330,216,666,utRho06
leuX,8992772,8992810,8992772,38,0,utRho06
lexA,8514174,8514230,8514174,56,30,utRho06
lhr,3456706,3458174,3456706,1468,2524,utRho06
ligA,5060402,5060402,5060352,50,6,utRho06
ligB,7642576,7642576,7642340,236,0,utRho06
lipA,1320602,1320602,1320432,170,132,utRho06
lipB,1324802,1324802,1324556,246,2086,utRho06
lit,2397032,2397390,2397032,358,38,utRho06
livJ,7199524,7199524,7199316,208,1636,utRho06
livK,7195510,7195510,7195120,390,120,utRho06
lldP,7554578,7554798,7554578,220,1454,utRho06
lnt,1381968,1381968,1381762,206,242,utRho06
loiP,6163784,6163826,6163784,42,0,utRho06
lolA,1874656,1874738,1874656,82,406,utRho06
lolB,2527112,2527112,2527000,112,142,utRho06
lolC,2350748,2350854,2350748,106,0,utRho06
lon,917630,917776,917630,146,840,utRho06
lpcA,486936,487086,486936,150,0,utRho06
lpd,255434,255824,255434,390,1716,utRho06
lplA,9248476,9248476,9248234,242,668,utRho06
lplT,5947878,5947878,5947724,154,8,utRho06
lpoA,6586422,6586800,6586422,378,48,utRho06
lpp,3514592,3514842,3514592,250,54,utRho06
lptA,6686598,6686760,6686598,162,1052,utRho06
lptB,6686792,6687888,6686792,1096,1212,utRho06
lptD,114672,114672,114218,454,2068,utRho06
lptF,8972244,8972436,8972244,192,0,utRho06
lpxC,213016,213114,213016,98,17758,utRho06
lpxD,401920,401942,401920,22,70,utRho06
lpxL,2233418,2233418,2233164,254,100,utRho06
lpxM,3880456,3880456,3880386,70,138,utRho06
lpxP,4991156,4991290,4991156,134,304,utRho06
lrhA,4813312,4813312,4813282,30,0,utRho06
lrp,1864656,1865190,1864656,534,714,utRho06
lspA,50028,50414,50028,386,474,utRho06
lsrA,3202920,3202980,3202920,60,0,utRho06
lsrR,3202514,3202514,3202482,32,0,utRho06
ltaE,1818640,1818640,1818588,52,0,utRho06
luxS,5630130,5630130,5629466,664,1226,utRho06
lysA,5957902,5957902,5957798,104,0,utRho06
lysC,8467232,8467232,8466466,766,384,utRho06
lysP,4497120,4497120,4497064,56,0,utRho06
lysR,5957900,5958042,5957900,142,0,utRho06
lysT,1561028,1561108,1561028,80,292,utRho06
lysU,8709610,8709610,8709434,176,0,utRho06
macB,1840188,1840694,1840188,506,252,utRho06
maeA,3111484,3111484,3111338,146,1962,utRho06
mak,820236,820288,820236,52,0,utRho06
malE,8492928,8492928,8492838,90,0,utRho06
malI,3398456,3398456,3398360,96,32,utRho06
malK,8493472,8493568,8493472,96,0,utRho06
malP,7105020,7105020,7104946,74,42,utRho06
malQ,7100798,7100798,7100140,658,104,utRho06
malS,14949880,14949988,14949880,108,0,utRho06
malT,7106048,7106170,7106048,122,120,utRho06
malX,3398626,3398710,3398626,84,0,utRho06
malZ,1689980,1690072,1689980,92,1568,utRho06
manA,3377102,3377152,3377102,50,0,utRho06
manX,3803866,3804096,3803866,230,0,utRho06
marC,3237882,3237882,3237816,66,142,utRho06
marR,3238186,3238240,3238186,54,96,utRho06
matP,2036918,2036970,2036918,52,54,utRho06
mazE,5822736,5822736,5822678,58,0,utRho06
mazG,5821720,5821720,5821370,350,2874,utRho06
mcbA,1684306,1684306,1684112,194,0,utRho06
mcbR,3040192,3040524,3040192,332,0,utRho06
mcrA,2420278,2420692,2420278,414,36,utRho06
mcrC,9156124,9156124,9155916,208,80,utRho06
mdaB,6344814,6345060,6344814,246,26,utRho06
mdfA,1767138,1767346,1767138,208,0,utRho06
mdh,6768940,6768940,6768536,404,6,utRho06
mdoB,9198988,9198988,9198882,106,308,utRho06
mdoD,2993290,2993712,2993290,422,34,utRho06
mdoG,2218514,2218670,2218514,156,64,utRho06
mdtA,4307958,4308032,4307958,74,0,utRho06
mdtE,7318168,7318464,7318168,296,22,utRho06
mdtK,3486538,3486914,3486538,376,126,utRho06
mdtP,8602472,8602472,8602060,412,56,utRho06
melA,8683774,8683822,8683774,48,0,utRho06
melR,8683300,8683300,8683256,44,0,utRho06
menA,8240812,8240812,8240698,114,14,utRho06
menB,4753774,4753774,4753638,136,238,utRho06
mepH,3468714,3468870,3468714,156,0,utRho06
mepM,3883666,3883666,3883270,396,732,utRho06
mepS,4539840,4539958,4539840,118,1056,utRho06
metA,8428318,8428560,8428318,242,128,utRho06
metB,8257272,8257344,8257272,72,614,utRho06
metC,6304150,6304472,6304150,322,56,utRho06
metE,8025768,8026106,8025768,338,168,utRho06
metF,8265092,8265232,8265092,140,100,utRho06
metG,4388538,4388600,4388538,62,126,utRho06
metH,8447010,8447656,8447010,646,5242,utRho06
metJ,8257116,8257116,8256790,326,62,utRho06
metK,6173154,6173412,6173154,258,48,utRho06
metN,445428,445428,445290,138,0,utRho06
metR,8025710,8025710,8025632,78,0,utRho06
metT,1394326,1394326,1394266,60,74,utRho06
metY,19910250,19910250,19909734,516,8046,utRho06
metZ,11789528,11789548,11789528,20,120,utRho06
mfd,2348056,2348056,2347928,128,82,utRho06
mglA,4478782,4478782,4478578,204,244,utRho06
mglB,4481132,4481132,4480696,436,3860,utRho06
mglC,4475918,4475918,4475506,412,6,utRho06
mgrB,3817584,3817584,3817532,52,0,utRho06
mgrR,3245828,3245828,3245828,0,0,utRho06
mgsA,2054082,2054082,2054030,52,0,utRho06
mgtL,8934560,8934862,8934560,302,116,utRho06
mhpA,737038,737222,737038,184,0,utRho06
mhpR,737072,737072,736840,232,16,utRho06
mhpT,750772,750918,750772,146,56,utRho06
miaA,8797964,8798504,8797964,540,480,utRho06
micA,5629604,5629604,5629604,0,0,utRho06
micC,2874242,2874238,2874242,4,0,utRho06
micF,4626168,4626168,4626168,0,0,utRho06
micM,1014408,1014408,1014408,0,0,utRho06
minE,2449422,2449422,2449090,332,558,utRho06
mioC,7852950,7852950,7852910,40,0,utRho06
mipA,3733012,3733012,3732944,68,2426,utRho06
mlaA,4930270,4930270,4930014,256,14,utRho06
mlc,3337206,3337206,3337128,78,2,utRho06
mlrA,4429498,4429732,4429498,234,0,utRho06
mltA,5894546,5894546,5894356,190,6,utRho06
mltD,468050,468050,467910,140,84,utRho06
mltF,5391534,5391602,5391534,68,0,utRho06
mmuP,550238,550650,550238,412,96,utRho06
mngA,1531622,1531968,1531622,346,0,utRho06
mngR,1531852,1531852,1531750,102,0,utRho06
mnmG,7851348,7851348,7851266,82,6732,utRho06
mntH,5025470,5025470,5025412,58,34,utRho06
mntP,3810918,3811376,3810918,458,720,utRho06
mntR,1706160,1706366,1706160,206,0,utRho06
mntS,1706128,1706128,1705994,134,138,utRho06
moaA,1633654,1634088,1633654,434,984,utRho06
moaB,1635954,1636110,1635954,156,980,utRho06
mobA,8084242,8084242,8083998,244,114,utRho06
mocA,6030112,6030320,6030112,208,0,utRho06
modA,1589990,1590178,1589990,188,210,utRho06
moeA,1732788,1732788,1732728,60,146,utRho06
mokB,2984610,2984610,2984258,352,482,utRho06
molR_1,4392888,4392948,4392888,60,134,utRho06
motA,3954604,3954604,3954278,326,84,utRho06
mpaA,2781278,2781278,2781196,82,124,utRho06
mpl,8911456,8911570,8911456,114,0,utRho06
mppA,2786108,2786454,2786108,346,46,utRho06
mprA,5621494,5621540,5621494,46,296,utRho06
mqo,4613848,4613848,4613508,340,1168,utRho06
mqsA,6336742,6336742,6336492,250,42,utRho06
mqsR,6337306,6337306,6337088,218,146,utRho06
mraZ,179192,179268,179192,76,18,utRho06
mrcA,7045652,7045742,7045652,90,0,utRho06
mrcB,329442,329460,329442,18,0,utRho06
mreB,13605424,13605424,13604348,1076,1860,utRho06
mreD,6798166,6798166,6797750,416,210,utRho06
mrp,4388360,4388360,4388336,24,2,utRho06
mscK,972984,973072,972984,88,58,utRho06
mscL,6876002,6876048,6876002,46,418,utRho06
mscS,6139742,6139742,6139614,128,76,utRho06
msrA,8884522,8884522,8884352,170,76,utRho06
msrB,3725168,3725168,3724858,310,28,utRho06
msyB,2228426,2228426,2228362,64,24,utRho06
mtfA,4087236,4087302,4087236,66,1090,utRho06
mtgA,6699662,6699662,6699618,44,138,utRho06
mtlA,30177504,30178248,30177504,744,304,utRho06
mtn,358366,358366,358306,60,52,utRho06
mtr,6611864,6611864,6611634,230,98,utRho06
mug,6430992,6430992,6430946,46,30,utRho06
murQ,5091466,5091546,5091466,80,0,utRho06
murR,5091586,5091586,5091218,368,0,utRho06
mutH,5939164,5939324,5939164,160,616,utRho06
mutL,8794092,8794824,8794092,732,692,utRho06
mutM,7622554,7622554,7622304,250,760,utRho06
mutS,5714038,5714186,5714038,148,348,utRho06
mutY,18617466,18618078,18617466,612,156,utRho06
nac,4123956,4123956,4123866,90,0,utRho06
nadA,1564122,1564170,1564122,48,66,utRho06
nadB,5420714,5420840,5420714,126,30,utRho06
nadC,237326,237326,237290,36,0,utRho06
nadE,3644604,3644916,3644604,312,90,utRho06
nadK,5501526,5501662,5501526,136,208,utRho06
nagA,1406350,1406350,1405502,848,1970,utRho06
nagB,1407416,1407416,1407222,194,36,utRho06
nagC,1404016,1404016,1403188,828,372,utRho06
nagE,1407680,1407888,1407680,208,0,utRho06
nagK,2357080,2357186,2357080,106,90,utRho06
nanA,6747240,6747240,6747152,88,2,utRho06
nanC,9079856,9079856,9079002,854,72,utRho06
nanR,6749406,6749406,6748978,428,68,utRho06
nanS,9075406,9075406,9075188,218,0,utRho06
napF,4607390,4607390,4606994,396,0,utRho06
narG,2559614,2559728,2559614,114,0,utRho06
narK,2555642,2555914,2555642,272,48,utRho06
narP,4580844,4581000,4580844,156,16,utRho06
narQ,5171154,5171462,5171154,308,36,utRho06
narU,3088326,3088326,3088120,206,0,utRho06
narW,3077374,3077374,3074618,2756,8,utRho06
narX,2555554,2555554,2555236,318,0,utRho06
narZ,3085380,3085380,3085180,200,0,utRho06
ndh,2331984,2332170,2331984,186,58,utRho06
ndk,5289920,5289920,5289728,192,186,utRho06
nemR,6904084,6904092,6904084,8,0,utRho06
nepI,7683542,7683542,7683478,64,198,utRho06
nfo,4501612,4501680,4501612,68,24,utRho06
nfsB,1210906,1210906,1210848,58,30,utRho06
nfuA,7090916,7091248,7090916,332,318,utRho06
nhaA,34634,34978,34634,344,22,utRho06
nhaB,2469534,2469534,2469434,100,0,utRho06
nhoA,3067926,3068048,3067926,122,0,utRho06
nikA,7226878,7227334,7226878,456,2320,utRho06
nikR,7237074,7237176,7237074,102,102,utRho06
nirB,6987974,6988022,6987974,48,18,utRho06
nlpA,7680034,7680034,7679986,48,0,utRho06
nlpC,3585654,3585654,3585462,192,16,utRho06
nlpD,5737658,5737658,5737506,152,90,utRho06
nlpI,6618080,6618080,6617848,232,50,utRho06
nmpC,1153740,1153740,1153650,90,0,utRho06
nohA,3273206,3273206,3272734,472,0,utRho06
norR,5664614,5664614,5664578,36,0,utRho06
norV,5664878,5664952,5664878,74,8,utRho06
nrdA,4689510,4689730,4689510,220,8226,utRho06
nrdD,8925676,8925676,8925320,356,2956,utRho06
nrdH,5601312,5601446,5601312,134,674,utRho06
nrdR,865954,866004,865954,50,0,utRho06
nrfA,8575342,8575528,8575342,186,0,utRho06
nsrR,8812088,8812380,8812088,292,46570,utRho06
nudB,3897348,3897348,3897264,84,70,utRho06
nudC,8393428,8393806,8393428,378,116,utRho06
nudE,7052658,7052658,7052298,360,4876,utRho06
nudG,3682876,3682980,3682876,104,4,utRho06
nudI,4729050,4729108,4729050,58,0,utRho06
nudJ,2388874,2388874,2388576,298,1024,utRho06
nuoA,4810670,4810670,4810144,526,2082,utRho06
nuoN,4783434,4783434,4783010,424,1140,utRho06
nupC,5026018,5026084,5026018,66,0,utRho06
nupG,6211302,6211428,6211302,126,0,utRho06
ogrK,4335096,4335096,4335040,56,0,utRho06
ogt,2800568,2800568,2800472,96,40,utRho06
ohsC,5401036,5401040,5401036,4,0,utRho06
ompA,2040382,2040382,2040106,276,10308,utRho06
ompC,4625774,4625774,4625498,276,84,utRho06
ompF,1974184,1974184,1973964,220,64,utRho06
ompL,8128958,8128958,8128590,368,0,utRho06
ompN,2874158,2874158,2873786,372,0,utRho06
ompR,7073510,7073510,7073168,342,0,utRho06
ompT,1171330,1171330,1171266,64,60,utRho06
ompW,2627982,2628040,2627982,58,0,utRho06
ompX,1700418,1700900,1700418,482,724,utRho06
omrA,5952378,5952378,5952378,0,0,utRho06
omrB,5952770,5952770,5952770,0,0,utRho06
oppA,2602170,2602364,2602170,194,17116,utRho06
orn,8783168,8783208,8783168,40,78,utRho06
osmB,2686952,2686952,2686656,296,196,utRho06
osmC,3113192,3113250,3113192,58,8,utRho06
osmE,3644566,3644566,3644512,54,0,utRho06
osmF,4439046,4439046,4438962,84,474,utRho06
osmY,9222306,9222792,9222306,486,4,utRho06
otsA,3963302,3963302,3963224,78,0,utRho06
otsB,3964930,3964930,3964774,156,60,utRho06
oxc,4984288,4984288,4983900,388,0,utRho06
oxyR,8316914,8316980,8316914,66,0,utRho06
oxyS,8316788,8316788,8316788,0,0,utRho06
paaA,2907730,2907854,2907730,124,0,utRho06
paaX,2927018,2927078,2927018,60,0,utRho06
paaZ,2907340,2907340,2907284,56,0,utRho06
pabA,6981702,6981702,6981658,44,0,utRho06
pabB,3789256,3789610,3789256,354,220,utRho06
pabC,2306186,2306600,2306186,414,168,utRho06
pagP,1313052,1313114,1313052,62,0,utRho06
panB,299260,299260,299202,58,148,utRho06
panC,297840,297840,297590,250,224,utRho06
panD,293490,293490,293388,102,4,utRho06
panZ,7195656,7195968,7195656,312,132,utRho06
parC,6332060,6332060,6331946,114,200,utRho06
patA,6438916,6438988,6438916,72,0,utRho06
patD,3030830,3031156,3030830,326,0,utRho06
pbpC,5294986,5294986,5294650,336,4,utRho06
pbpG,4450132,4450132,4449740,392,52,utRho06
pck,7065358,7065636,7065358,278,2518,utRho06
pcnB,318782,318782,318252,530,782,utRho06
pdhR,244068,244184,244068,116,164,utRho06
pdxB,4875768,4875768,4875702,66,0,utRho06
pdxH,3436068,3436068,3436014,54,58,utRho06
pdxJ,5403626,5403626,5403458,168,158,utRho06
pdxK,5074638,5074638,5074474,164,20,utRho06
pepA,8972278,8972278,8971902,376,44,utRho06
pepD,511618,511618,511432,186,2752,utRho06
pepN,1981182,1981244,1981182,62,0,utRho06
pepQ,8062294,8062322,8062294,28,0,utRho06
pepT,2371646,2371688,2371646,42,0,utRho06
pfkA,8214948,8215104,8214948,156,178,utRho06
pfkB,3612646,3612740,3612646,94,0,utRho06
pflA,1902456,1902456,1902160,296,36,utRho06
pflB,1907850,1907850,1907108,742,466,utRho06
pflD,8287716,8287990,8287716,274,0,utRho06
pgaA,2185046,2185046,2184578,468,12,utRho06
pgi,8467444,8467516,8467444,72,0,utRho06
pgk,12291428,12291428,12290488,940,4236,utRho06
pgl,1597078,1597172,1597078,94,66,utRho06
pgpB,2678324,2678660,2678324,336,2,utRho06
pgpC,5397276,5397276,5397100,176,0,utRho06
pgrR,2783744,2783982,2783744,238,0,utRho06
pheL,5475158,5475198,5475158,40,0,utRho06
pheM,7197204,7197204,7197080,124,188,utRho06
pheP,1203858,1203918,1203858,60,2,utRho06
pheU,8725254,8725254,8725252,2,0,utRho06
pheV,6220730,6220732,6220730,2,0,utRho06
phnC,8650412,8650412,8650330,82,0,utRho06
phoA,803414,803494,803414,80,2,utRho06
phoB,834202,834284,834202,82,0,utRho06
phoE,520316,520316,520200,116,0,utRho06
phoH,2169730,2169984,2169730,254,482,utRho06
phoP,2381016,2381016,2380894,122,854,utRho06
phoQ,2379880,2379880,2379552,328,672,utRho06
phoU,7815330,7815330,7815156,174,114,utRho06
phr,1478842,1479014,1478842,172,0,utRho06
pinE,2419054,2419370,2419054,316,36,utRho06
pinQ,3267168,3267244,3267168,76,524,utRho06
pinR,2867424,2867424,2867348,76,470,utRho06
pitA,7275224,7275284,7275224,60,16,utRho06
pitB,6272806,6272806,6272742,64,0,utRho06
pka,5439862,5439906,5439862,44,0,utRho06
plaP,4174476,4174476,4174124,352,732,utRho06
pldA,8009628,8009724,8009628,96,30,utRho06
pldB,8018028,8018340,8018028,312,212,utRho06
plsB,8513196,8513196,8512932,264,248,utRho06
pmbA,8915890,8915918,8915890,28,12,utRho06
pmrD,4747148,4747148,4747076,72,0,utRho06
pncB,1980828,1980828,1980712,116,8,utRho06
pncC,5648788,5648788,5648692,96,0,utRho06
pnp,6622652,6622652,6622336,316,170,utRho06
pntA,3355950,3355950,3355806,144,0,utRho06
pntB,3353096,3353096,3352720,376,0,utRho06
polA,8093880,8093932,8093880,52,50,utRho06
polB,131606,131606,131560,46,0,utRho06
potD,2365700,2365700,2365658,42,6,utRho06
potE,1436688,1436688,1436530,158,0,utRho06
potF,1787268,1787568,1787268,300,44,utRho06
poxB,1822152,1822152,1822098,54,12,utRho06
ppa,8899372,8899372,8899304,68,74,utRho06
ppc,8306380,8306380,8306196,184,112,utRho06
ppdA,5928440,5928440,5928354,86,788,utRho06
ppdD,235410,235410,235098,312,460,utRho06
pphA,3846770,3846770,3845938,832,1694,utRho06
pphB,5719474,5719520,5719474,46,0,utRho06
ppiA,6984898,6984898,6984594,304,0,utRho06
ppiC,7919682,7919682,7919626,56,84,utRho06
ppiD,923638,923830,923638,192,1014,utRho06
ppk,5245748,5246088,5245748,340,304,utRho06
pppA,6228958,6228958,6228704,254,28,utRho06
ppsA,3574322,3574322,3574224,98,64,utRho06
ppsR,3574678,3574890,3574678,212,0,utRho06
pptA,3065716,3066104,3065716,388,50,utRho06
pqiA,2023318,2024002,2023318,684,30,utRho06
prc,3830054,3830054,3829632,422,19934,utRho06
preT,4467978,4468066,4467978,88,8,utRho06
prfC,9218688,9218828,9218688,140,852,utRho06
prkB,6968622,6968980,6968622,358,864,utRho06
prlC,7290476,7290476,7290364,112,162,utRho06
prlF,6553944,6554004,6553944,60,68,utRho06
proB,520432,520776,520432,344,76,utRho06
proC,811372,811372,811288,84,0,utRho06
proK,7417388,7417388,7417384,4,0,utRho06
proL,4572414,4572422,4572414,8,44,utRho06
proP,8660640,8661004,8660640,364,3112,utRho06
proS,437674,437674,437550,124,560,utRho06
proV,5609126,5609630,5609126,504,34,utRho06
prpB,697292,697364,697292,72,0,utRho06
prpR,696942,696942,696886,56,0,utRho06
prs,2524354,2524354,2523750,604,39826,utRho06
psd,8781276,8781276,8780720,556,3278,utRho06
psiE,8480600,8480650,8480600,50,0,utRho06
pspA,2736076,2736158,2736076,82,0,utRho06
pspF,2736080,2736080,2735824,256,0,utRho06
pspG,8525632,8525680,8525632,48,12,utRho06
pssA,5445156,5445454,5445156,298,1906,utRho06
pstB,7817112,7817112,7816732,380,0,utRho06
pstC,7821084,7821084,7820796,288,76,utRho06
pstS,23469408,23469408,23469150,258,330,utRho06
psuG,4517114,4517114,4516734,380,108,utRho06
psuT,4514992,4514992,4514670,322,30,utRho06
pth,2517084,2517084,2517026,58,44,utRho06
ptrA,5918022,5918022,5917768,254,0,utRho06
ptrB,3857730,3857730,3857678,52,5926,utRho06
ptsG,2315252,2315738,2315252,486,1822,utRho06
ptsH,5066996,5067528,5066996,532,1872,utRho06
purA,8809328,8809374,8809328,46,0,utRho06
purC,5195562,5195562,5195236,326,0,utRho06
purD,8411972,8411972,8411862,110,0,utRho06
purE,1106284,1106284,1106200,84,1158,utRho06
purH,8415254,8415254,8415064,190,12,utRho06
purL,5391178,5391178,5391086,92,160,utRho06
purM,5242306,5242394,5242306,88,0,utRho06
purR,3475378,3475688,3475378,310,486,utRho06
purT,3861438,3861762,3861438,324,60,utRho06
purU,2577512,2577512,2577248,264,366,utRho06
putA,2157850,2157850,2157764,86,0,utRho06
putP,2158336,2158610,2158336,274,198,utRho06
puuA,2721936,2721936,2721816,120,22,utRho06
puuC,2725456,2725486,2725456,30,0,utRho06
puuD,2722104,2722240,2722104,136,4,utRho06
puuP,2718746,2718746,2718374,372,584,utRho06
pykA,3874988,3875298,3874988,310,74,utRho06
pykF,3510934,3511396,3510934,462,948,utRho06
pyrC,2245286,2245286,2245214,72,168,utRho06
pyrD,2009464,2009536,2009464,72,0,utRho06
pyrE,7631970,7631970,7631536,434,158,utRho06
pyrF,2683740,2683842,2683740,102,172,utRho06
pyrG,5819594,5819594,5819332,262,1204,utRho06
pyrH,383624,383710,383624,86,1518,utRho06
pyrL,8945490,8945490,8945066,424,52,utRho06
qmcA,1031646,1031646,1031546,100,40,utRho06
qor,8528608,8528608,8528462,146,198,utRho06
qseB,6339502,6339656,6339502,154,116,utRho06
queA,849970,850022,849970,52,658,utRho06
queE,5811212,5811212,5810836,376,46,utRho06
queF,5850642,5850696,5850642,54,28,utRho06
queG,8788184,8788184,8788134,50,828,utRho06
racC,2835630,2835630,2835526,104,0,utRho06
racR,2840898,2840898,2840482,416,234,utRho06
raiA,5474208,5474308,5474208,100,130,utRho06
rarD,8008594,8008594,8008356,238,222,utRho06
ravA,7862256,7862256,7862186,70,2,utRho06
rayT,495088,495274,495088,186,0,utRho06
rbn,4763162,4763216,4763162,54,0,utRho06
rbsD,7866644,7866702,7866644,58,0,utRho06
rcnA,4371654,4371834,4371654,180,78,utRho06
rcnB,4373768,4373920,4373768,152,68,utRho06
rcnR,4371806,4371806,4371592,214,78,utRho06
rcsA,4047672,4047936,4047672,264,232,utRho06
rcsB,4631390,4632354,4631390,964,748,utRho06
rcsC,4640162,4640162,4639656,506,368,utRho06
rcsD,4626904,4626976,4626904,72,130,utRho06
rdgB,6193240,6193362,6193240,122,254,utRho06
rdlA,2538646,2538646,2538646,0,0,utRho06
rdlB,2539712,2539716,2539712,4,14,utRho06
rdlC,2540782,2540786,2540782,4,0,utRho06
rdlD,7400272,7400272,7400272,0,0,utRho06
rdoA,8084782,8084830,8084782,48,28,utRho06
recA,11295276,11295276,11295076,200,536,utRho06
recC,5925014,5925014,5924856,158,56,utRho06
recF,7763722,7763722,7762442,1280,8408,utRho06
recN,5503518,5503590,5503518,72,0,utRho06
recQ,8011666,8011728,8011666,62,0,utRho06
relA,5828554,5828554,5827302,1252,466,utRho06
relB,3291806,3291806,3291744,62,0,utRho06
rem,3289950,3289950,3289804,146,80,utRho06
rep,7921294,7921354,7921294,60,28,utRho06
rfaD,7587730,7587974,7587730,244,206,utRho06
rfaE,6393852,6393852,6393506,346,0,utRho06
rfaH,8049930,8049930,8049642,288,1384,utRho06
rfbX,4219436,4219436,4219168,268,2644,utRho06
rfe,7935600,7935832,7935600,232,92,utRho06
rhaB,8194944,8194944,8194896,48,0,utRho06
rhaD,8188770,8188770,8188544,226,2,utRho06
rhaS,8195422,8195472,8195422,50,0,utRho06
rhaT,8201132,8201132,8201050,82,32,utRho06
rhlE,1661566,1661744,1661566,178,424,utRho06
rhoL,47593944,47594772,47593944,828,262344,utRho06
rhsB,7238006,7238384,7238006,378,126,utRho06
rhsC,1458758,1459166,1458758,408,0,utRho06
rhsD,1046132,1046522,1046132,390,0,utRho06
rhtA,1700608,1700608,1700194,414,0,utRho06
rhtC,8015478,8015514,8015478,36,1816,utRho06
ribA,2678468,2678468,2678320,148,0,utRho06
ribC,3486916,3486916,3486484,432,242,utRho06
ribE,869008,869294,869008,286,6052,utRho06
ribF,42766,42814,42766,48,28,utRho06
ridA,8941892,8941892,8941826,66,50,utRho06
rihA,1369204,1369204,1368824,380,652,utRho06
rihB,4510504,4510504,4510372,132,0,utRho06
rimJ,2251044,2251124,2251044,80,18,utRho06
rimK,1783752,1783934,1783752,182,92,utRho06
rimL,2997486,2997876,2997486,390,42,utRho06
rimO,1756140,1756140,1756070,70,0,utRho06
rimP,6636350,6636350,6636012,338,1300,utRho06
rlmA,3814172,3814172,3814120,52,376,utRho06
rlmD,5830086,5830086,5830000,86,30,utRho06
rlmE,6655520,6655520,6655328,192,1496,utRho06
rlmF,1684384,1684664,1684384,280,68,utRho06
rlmG,6471784,6471784,6471750,34,0,utRho06
rlmI,2060002,2060002,2059938,64,24,utRho06
rlmJ,7290700,7290770,7290700,70,130,utRho06
rlmL,2015344,2015688,2015344,344,802,utRho06
rlpA,1330444,1330444,1330380,64,184,utRho06
rluA,120900,120900,120692,208,300,utRho06
rluF,8460324,8460708,8460324,384,0,utRho06
rmf,2031006,2031430,2031006,424,1920,utRho06
rna,1290068,1290068,1290006,62,78,utRho06
rnb,2698258,2698258,2697824,434,2438,utRho06
rnc,10816892,10816892,10816252,640,12504,utRho06
rnd,3776122,3776122,3775982,140,352,utRho06
rne,2289746,2289746,2288734,1012,7460,utRho06
rnhA,472082,472082,472004,78,318,utRho06
rnk,1288360,1288360,1287934,426,60,utRho06
rnlA,5531788,5531836,5531788,48,156,utRho06
rnlB,5533414,5533968,5533414,554,2252,utRho06
rnpB,19623552,19623552,19623552,0,0,utRho06
rob,9270706,9270706,9270620,86,60,utRho06
rodZ,5285868,5285868,5285688,180,112,utRho06
rpe,7030306,7030306,7030118,188,228,utRho06
rph,15266320,15266320,15266196,124,232,utRho06
rpiA,6118706,6118706,6118650,56,0,utRho06
rpiB,8626514,8626700,8626514,186,18,utRho06
rpiR,8626274,8626274,8625982,292,0,utRho06
rplJ,8359246,8359992,8359246,746,8734,utRho06
rplK,8356708,8356894,8356708,186,420,utRho06
rplM,6757344,6757344,6757302,42,4858,utRho06
rplN,6896444,6896444,6896298,146,7008,utRho06
rplS,5489284,5489284,5489060,224,12228,utRho06
rplT,7199052,7199052,7198996,56,628,utRho06
rplU,6667036,6667036,6666902,134,98,utRho06
rplY,4564866,4565034,4564866,168,96,utRho06
rpmA,6666450,6666450,6666238,212,936,utRho06
rpmB,15247980,15247980,15246696,1284,105404,utRho06
rpmE,8253816,8254026,8253816,210,718,utRho06
rpmF,2294676,2294734,2294676,58,43996,utRho06
rpmH,7768130,7768672,7768130,542,6032,utRho06
rpmI,3600854,3600854,3599998,856,9130,utRho06
rpoB,8362126,8362490,8362126,364,748,utRho06
rpoD,6424946,6426094,6424946,1148,16138,utRho06
rpoE,5420372,5420372,5420024,348,74,utRho06
rpoH,7202006,7202006,7201566,440,17760,utRho06
rpoN,6689324,6689434,6689324,110,104,utRho06
rpoS,5736236,5736236,5735102,1134,2242,utRho06
rpoZ,7644154,7644212,7644154,58,834,utRho06
rppH,5937986,5937986,5937954,32,28,utRho06
rprA,3540744,3540744,3540744,0,0,utRho06
rpsA,1923434,1923990,1923434,556,147406,utRho06
rpsF,8850050,8850236,8850050,186,28292,utRho06
rpsI,6756580,6756580,6756414,166,6412,utRho06
rpsJ,6906884,6906884,6906540,344,10000,utRho06
rpsL,6949242,6949242,6949104,138,324,utRho06
rpsM,6885130,6885130,6884942,188,1982,utRho06
rpsO,13247144,13247144,13246736,408,1008,utRho06
rpsP,5492508,5492508,5492370,138,100,utRho06
rpsT,42420,42420,42156,264,1152,utRho06
rpsU,12842584,12843124,12842584,540,2316,utRho06
rraA,8238716,8238716,8238660,56,140,utRho06
rraB,8956768,8956946,8956768,178,58,utRho06
rrsA,8070478,8071062,8070478,584,8702,utRho06
rrsB,16665468,16666636,16665468,1168,17912,utRho06
rrsC,7883032,7883616,7883032,584,9166,utRho06
rrsD,6858094,6858094,6857524,570,510,utRho06
rrsE,8415726,8416294,8415726,568,1812,utRho06
rrsG,5462896,5462896,5462314,582,7232,utRho06
rrsH,446970,447542,446970,572,1478,utRho06
rsd,8393908,8393908,8393616,292,112,utRho06
rseA,5419264,5419264,5418808,456,294,utRho06
rseP,392940,393092,392940,152,134,utRho06
rseX,4067298,4067298,4067298,0,0,utRho06
rsfS,1338144,1338144,1338072,72,226,utRho06
rsgA,8783132,8783132,8783018,114,64,utRho06
rsmA,105176,105176,104860,316,2850,utRho06
rsmB,6869982,6870414,6869982,432,224,utRho06
rsmC,9215736,9215736,9215400,336,634,utRho06
rsmD,7208594,7208786,7208594,192,150,utRho06
rsmE,6182036,6182268,6182036,232,96,utRho06
rsmG,7847512,7847512,7847360,152,1316,utRho06
rsmH,180020,180188,180020,168,146,utRho06
rsmI,6587106,6587106,6586670,436,396,utRho06
rssA,2578212,2578412,2578212,200,276,utRho06
rssB,2580440,2580484,2580440,44,156,utRho06
rstA,3364276,3364300,3364276,24,0,utRho06
rsuA,4561096,4561096,4560966,130,212,utRho06
rsxA,3411510,3411534,3411510,24,12,utRho06
rtcA,7114004,7114004,7113698,306,42,utRho06
rtcB,7116214,7116214,7116158,56,32,utRho06
rtn,4541356,4541452,4541356,96,322,utRho06
rutA,2148052,2148052,2148022,30,0,utRho06
rutG,2140090,2140090,2139678,412,0,utRho06
rutR,2148226,2148484,2148226,258,0,utRho06
ruvA,7784096,7784096,7783904,192,0,utRho06
ruvB,7782176,7782176,7781424,752,448,utRho06
ruvC,3894878,3894878,3894752,126,72,utRho06
rybB,1776114,1776114,1776114,0,0,utRho06
rydB,3529860,3529860,3529322,538,50,utRho06
rydC,2983012,2983012,2983012,0,0,utRho06
ryfA,5307398,5307710,5307398,312,66,utRho06
ryfD,5468590,5468590,5468590,0,0,utRho06
ryhB,7162032,7162032,7162032,0,0,utRho06
ryjA,8556132,8556132,8556132,0,0,utRho06
ryjB,9055954,9055954,9055954,0,0,utRho06
sad,3229598,3229598,3229406,192,296,utRho06
safA,3168056,3168056,3167918,138,0,utRho06
sanA,4465368,4465756,4465368,388,84,utRho06
sapF,2705314,2705314,2705268,46,22,utRho06
sbcB,4165456,4165512,4165456,56,8,utRho06
sbcC,831694,831694,831506,188,144,utRho06
sbcD,833954,833954,833904,50,22,utRho06
sbmA,793106,793278,793106,172,98,utRho06
sbmC,4162650,4162650,4162524,126,0,utRho06
sdaA,3793618,3793864,3793618,246,176,utRho06
sdaC,5856070,5856458,5856070,388,500,utRho06
sdhC,1509916,1510354,1509916,438,24614,utRho06
sdhD,1510808,1511120,1510808,312,5266,utRho06
sdiA,3993834,3993834,3993664,170,6,utRho06
secE,8354354,8354716,8354354,362,82,utRho06
secG,6645180,6645180,6645010,170,1846,utRho06
selA,7522594,7522594,7522498,96,546,utRho06
selB,7519850,7519850,7519722,128,174,utRho06
selC,7672396,7672444,7672396,48,0,utRho06
selD,3696058,3696058,3696016,42,2832,utRho06
seqA,1425884,1425974,1425884,90,340,utRho06
serA,6117098,6117098,6116820,278,0,utRho06
serB,9249712,9249790,9249712,78,44,utRho06
serC,3830380,3830612,3830380,232,0,utRho06
serS,1878730,1878856,1878730,126,2714,utRho06
serT,2063438,2063438,2063424,14,0,utRho06
serU,4087124,4087124,4087114,10,98,utRho06
serV,5637394,5637394,5637290,104,54,utRho06
serW,1852014,1852014,1851942,72,204,utRho06
serX,2195352,2195352,2195304,48,14,utRho06
setB,4527426,4527726,4527426,300,32,utRho06
setC,7673488,7673906,7673488,418,2,utRho06
sfmA,1116124,1116424,1116124,300,0,utRho06
sfmC,1117606,1117948,1117606,342,0,utRho06
sfsA,323030,323030,322972,58,328,utRho06
sfsB,6669592,6669818,6669592,226,254,utRho06
sgrR,154676,154676,154598,78,0,utRho06
sgrS,154734,154734,154734,0,0,utRho06
shiA,4107068,4107286,4107068,218,112,utRho06
sibA,4306622,4306622,4306622,0,0,utRho06
sibB,4307292,4307292,4307292,0,0,utRho06
sibC,6113702,6113702,6113702,0,0,utRho06
sibD,6389730,6389730,6389730,0,0,utRho06
sibE,6390480,6390480,6390480,0,0,utRho06
sixA,4913998,4913998,4913624,374,46,utRho06
slp,7307872,7307922,7307872,50,0,utRho06
slt,9261400,9261466,9261400,66,2,utRho06
slyA,3442028,3442028,3441648,380,56,utRho06
slyB,3439496,3439752,3439496,256,152,utRho06
slyD,6957398,6957398,6956994,404,214,utRho06
slyX,6954862,6955280,6954862,418,6952,utRho06
smf,6867372,6867372,6867120,252,204,utRho06
smpB,5509534,5509792,5509534,258,1242,utRho06
smrA,2811872,2811958,2811872,86,286,utRho06
smrB,4896872,4897212,4896872,340,0,utRho06
smtA,1946808,1947074,1946808,266,40,utRho06
sodA,8201518,8201620,8201518,102,5506,utRho06
sodB,3470646,3470756,3470646,110,30,utRho06
sodC,3449358,3449358,3449310,48,0,utRho06
sohB,2658568,2658664,2658568,96,0,utRho06
sokB,2984232,2984238,2984232,6,62,utRho06
solA,2241218,2241218,2241172,46,0,utRho06
soxR,8554894,8554938,8554894,44,38,utRho06
soxS,8554846,8554846,8554766,80,0,utRho06
speA,6172096,6172096,6171822,274,182,utRho06
speB,6167892,6167892,6167594,298,172,utRho06
speC,6218350,6218350,6218310,40,40,utRho06
spf,8099798,8099798,8099798,0,0,utRho06
sppA,3697422,3697674,3697422,252,36,utRho06
spy,3651376,3651376,3651250,126,0,utRho06
sra,3112092,3112092,3111926,166,0,utRho06
sraB,2293178,2293178,2293178,0,0,utRho06
sraC,3846132,3846132,3846132,0,0,utRho06
srlA,5651582,5651664,5651582,82,32,utRho06
srlR,5657720,5658094,5657720,374,772,utRho06
srmB,5425752,5425792,5425752,40,160,utRho06
sroA,151216,151216,151216,0,0,utRho06
sroG,6369436,6369436,6369436,0,0,utRho06
sroH,8380974,8380974,8380974,0,0,utRho06
ssb,8548022,8548250,8548022,228,218,utRho06
sseA,5304782,5304988,5304782,206,3646,utRho06
sspA,6755138,6755138,6754840,298,462,utRho06
ssrA,5511014,5511186,5511014,172,162,utRho06
ssrS,12223036,12223932,12223036,896,2004,utRho06
sstT,6479726,6479888,6479726,162,126,utRho06
ssuB,1988282,1988282,1988088,194,2,utRho06
ssuE,1995126,1995126,1995024,102,0,utRho06
sthA,8321604,8321604,8321580,24,1306,utRho06
stpA,5597156,5597156,5596990,166,102,utRho06
sucA,3034344,3034824,3034344,480,1236,utRho06
sufA,3528836,3528836,3528772,64,14,utRho06
sufE,3518962,3518962,3518580,382,558,utRho06
sugE,8753588,8753750,8753588,162,272,utRho06
sulA,2041894,2041894,2041838,56,218,utRho06
syd,5850738,5850738,5850560,178,70,utRho06
symE,9159834,9159834,9159680,154,182,utRho06
symR,9159670,9159670,9159670,0,0,utRho06
tabA,8949566,8949724,8949566,158,38,utRho06
talA,5157140,5157332,5157140,192,0,utRho06
talB,16382,16476,16382,94,4516,utRho06
tam,3214442,3214692,3214442,250,0,utRho06
tamA,8884540,8884764,8884540,224,76,utRho06
tar,3945432,3945432,3945382,50,0,utRho06
tas,5943138,5943194,5943138,56,170,utRho06
tatA,16087636,16087780,16087636,144,64,utRho06
tatE,1317742,1317894,1317742,152,78,utRho06
tauA,770410,770464,770410,54,0,utRho06
tdcA,6534186,6534186,6534130,56,0,utRho06
tdcG,6519652,6519652,6519298,354,2,utRho06
tdcR,6534380,6534760,6534380,380,48,utRho06
tdk,2586986,2587054,2586986,68,24,utRho06
tehA,3001072,3001146,3001072,74,0,utRho06
tesA,1039898,1039898,1039530,368,242,utRho06
tesB,950402,950402,950322,80,0,utRho06
tfaE,2418532,2418532,2418238,294,0,utRho06
tfaQ,3269912,3269912,3269770,142,0,utRho06
tff,379424,379256,379424,168,38,utRho06
tgt,852110,852274,852110,164,106,utRho06
thiD,4369346,4369346,4369032,314,0,utRho06
thiI,882936,883098,882936,162,142,utRho06
thiM,4370902,4370902,4370602,300,380,utRho06
thiQ,146170,146170,145854,316,260,utRho06
thrL,592,760,592,168,568,utRho06
thrS,7210932,7210932,7210280,652,2152,utRho06
thrU,8350762,8350776,8350762,14,0,utRho06
thrV,6847414,6847414,6847310,104,136942,utRho06
thrW,525682,525742,525682,60,900,utRho06
thyA,5930696,5930696,5930310,386,2258,utRho06
tig,909986,910266,909986,280,824,utRho06
tisB,7706674,7707106,7706674,432,234,utRho06
tktA,6163414,6163414,6163270,144,110,utRho06
tktB,5158616,5159272,5158616,656,724,utRho06
tldD,6784368,6784368,6784056,312,0,utRho06
tmcA,5191876,5191876,5191718,158,26,utRho06
tnaC,15553644,15553740,15553644,96,328,utRho06
tolB,1555074,1555480,1555074,406,134,utRho06
tolC,6356008,6356230,6356008,222,258,utRho06
tomB,961588,961588,961416,172,4668,utRho06
tonB,2622108,2622178,2622108,70,0,utRho06
topA,2661578,2662096,2661578,518,962,utRho06
torC,2116112,2116168,2116112,56,2,utRho06
torR,2115968,2115968,2115908,60,2,utRho06
torS,2112364,2112364,2112356,8,0,utRho06
torT,2112414,2112522,2112414,108,0,utRho06
tpiA,8223138,8223138,8223014,124,80,utRho06
tppB,3425342,3425538,3425342,196,4512,utRho06
tpr,2574376,2574376,2574376,0,0,utRho06
tpx,2777688,2777688,2777622,66,586,utRho06
tqsA,3347780,3347826,3347780,46,12,utRho06
treA,2494850,2494850,2494752,98,70,utRho06
treB,8932420,8932420,8932360,60,38,utRho06
treF,7339102,7339184,7339102,82,0,utRho06
treR,8934694,8934694,8934492,202,32,utRho06
trg,2984878,2984940,2984878,62,0,utRho06
trkG,2847342,2847564,2847342,222,0,utRho06
trmA,8326590,8326590,8326540,50,70,utRho06
trpA,2634678,2634678,2634444,234,328,utRho06
trpC,2639888,2639888,2639570,318,170,utRho06
trpL,5292432,5292432,5292328,104,0,utRho06
trpR,9265408,9265520,9265408,112,8,utRho06
trpS,7027394,7027394,7027276,118,780,utRho06
trpT,7893560,7893914,7893560,354,92992,utRho06
trxA,7931294,7931522,7931294,228,710,utRho06
trxB,1864156,1864156,1864100,56,72,utRho06
trxC,5437350,5437470,5437350,120,208,utRho06
tsaD,6421256,6421256,6421086,170,66,utRho06
tsgA,6985038,6985136,6985038,98,26,utRho06
tsr,9182824,9183314,9182824,490,108,utRho06
tsx,864490,864490,864026,464,556,utRho06
ttcA,2823970,2823970,2823896,74,3538,utRho06
ttdA,6412848,6412926,6412848,78,0,utRho06
ttdR,6412760,6412760,6412512,248,58,utRho06
tufA,6943448,6943448,6942658,790,101850,utRho06
tus,3368346,3368518,3368346,172,46,utRho06
tusA,7218040,7218040,7217992,48,22,utRho06
tusB,6950218,6950218,6949930,288,1106,utRho06
tynA,2902996,2902996,2902698,298,0,utRho06
typA,8116460,8116814,8116460,354,4596,utRho06
tyrB,8534164,8534228,8534164,64,1580,utRho06
tyrP,3979004,3979362,3979004,358,8,utRho06
tyrR,2773384,2773440,2773384,56,0,utRho06
tyrS,3434566,3434566,3434444,122,0,utRho06
tyrT,2575330,2575330,2575244,86,34,utRho06
uacT,6062378,6062734,6062378,356,4,utRho06
ubiC,8504886,8505012,8504886,126,40,utRho06
ubiD,8049618,8049976,8049618,358,1506,utRho06
ubiE,8037494,8037710,8037494,216,72,utRho06
ubiG,4679078,4679134,4679078,56,0,utRho06
ucpA,5089342,5089342,5089246,96,14,utRho06
udp,8032782,8032862,8032782,80,66,utRho06
ugd,4199470,4199470,4199226,244,0,utRho06
ugpB,7184852,7184852,7184650,202,136,utRho06
ugpQ,7176600,7176600,7176226,374,0,utRho06
uhpT,7694396,7694396,7694334,62,0,utRho06
uidA,3392304,3392304,3392142,162,40,utRho06
uidC,3386012,3386012,3385702,310,0,utRho06
uidR,3394150,3394150,3394104,46,22,utRho06
ulaA,8839854,8839960,8839854,106,44,utRho06
ulaG,8839350,8839350,8839250,100,24,utRho06
ulaR,8837124,8837124,8836906,218,20,utRho06
umpG,5741372,5741372,5740548,824,168,utRho06
umpH,1400704,1400704,1400652,52,0,utRho06
umuD,2461476,2461534,2461476,58,0,utRho06
ung,5433476,5433508,5433476,32,0,utRho06
uof,2843316,2843316,2842900,416,5232,utRho06
upp,5241818,5241818,5241744,74,82,utRho06
usg,4873780,4873780,4873298,482,276,utRho06
ushA,1009772,1009828,1009772,56,0,utRho06
uspA,7279966,7280222,7279966,256,446,utRho06
uspB,7279696,7279696,7279440,256,516,utRho06
uspC,3959172,3959506,3959172,334,0,utRho06
uspE,2797318,2797318,2797244,74,28,utRho06
uspF,2871282,2871282,2871238,44,0,utRho06
uspG,1283806,1283806,1283734,72,418,utRho06
uvrA,8547872,8547872,8547742,130,320,utRho06
uvrB,1626304,1627052,1626304,748,1306,utRho06
uvrC,3989758,3989758,3989412,346,118,utRho06
uvrD,7995814,7995966,7995814,152,240,utRho06
uvrY,3990812,3990812,3990718,94,44,utRho06
uxaB,3221474,3221474,3221360,114,54,utRho06
uxaC,6489714,6489714,6489482,232,0,utRho06
uxuA,9103036,9103272,9103036,236,36,utRho06
uxuR,9108916,9109152,9108916,236,0,utRho06
valS,8967854,8967854,8967674,180,280,utRho06
valU,5041848,5041862,5041848,14,14,utRho06
valV,3492830,3492870,3492830,40,2,utRho06
ves,3649968,3649968,3649874,94,0,utRho06
waaA,7616512,7617080,7616512,568,180,utRho06
waaH,7580298,7580298,7580162,136,0,utRho06
waaQ,7616476,7616476,7616196,280,36,utRho06
waaU,7598996,7598996,7598624,372,108,utRho06
waaY,7602272,7602272,7601930,342,4182,utRho06
wbbH,4214888,4214888,4214452,436,2922,utRho06
wbbK,4209212,4209212,4209018,194,232,utRho06
wcaM,4231868,4231868,4231792,76,18,utRho06
wrbA,2135516,2135516,2135416,100,0,utRho06
wza,4275166,4275166,4274486,680,4,utRho06
wzxC,4240674,4240674,4240316,358,18,utRho06
wzzB,4196950,4196950,4196602,348,74,utRho06
xanP,7657642,7657890,7657642,248,0,utRho06
xanQ,6048520,6048702,6048520,182,0,utRho06
xapA,5049820,5049820,5049756,64,0,utRho06
xapR,10090252,10090252,10089908,344,0,utRho06
xdhA,6000514,6000690,6000514,176,94,utRho06
xerD,6079702,6079702,6079486,216,174,utRho06
xseA,5268394,5268464,5268394,70,328,utRho06
xseB,882746,882746,882686,60,140,utRho06
xthA,3664798,3664856,3664798,58,0,utRho06
xylA,7461614,7461614,7461530,84,58,utRho06
xylE,8484540,8484540,8484508,32,0,utRho06
xylF,7462138,7462262,7462138,124,0,utRho06
xylR,7469812,7469958,7469812,146,0,utRho06
yaaA,13230,13230,12918,312,60,utRho06
yaaI,23876,23876,23572,304,32,utRho06
yaaJ,16034,16034,15918,116,52,utRho06
yaaU,91184,91614,91184,430,0,utRho06
yaaW,23084,23084,22712,372,4,utRho06
yaaX,10060,10468,10060,408,50,utRho06
yabI,142542,142702,142542,160,40,utRho06
yacC,273880,273880,273834,46,2226,utRho06
yacH,262932,262932,262520,412,0,utRho06
yacL,268678,268776,268678,98,64,utRho06
yadD,293796,293936,293796,140,48,utRho06
yadE,289930,290162,289930,232,378,utRho06
yadN,314110,314110,313766,344,0,utRho06
yadS,355572,355572,355248,324,106,utRho06
yadV,312470,312470,312402,68,0,utRho06
yaeF,434270,434270,434006,264,56,utRho06
yaeP,428374,428374,428250,124,32,utRho06
yaeQ,428176,428582,428176,406,56,utRho06
yaeR,423716,423754,423716,38,0,utRho06
yafC,462166,462166,461762,404,144,utRho06
yafD,462128,462244,462128,116,136,utRho06
yafK,491986,491986,491610,376,1330,utRho06
yafL,493282,493424,493282,142,0,utRho06
yafN,503938,504010,503938,72,8,utRho06
yafS,469568,469632,469568,64,360,utRho06
yafT,474470,474670,474470,200,0,utRho06
yafV,480432,480432,480378,54,20,utRho06
yafZ,536052,536052,536010,42,0,utRho06
yagE,564446,564556,564446,110,22,utRho06
yagG,570414,570790,570414,376,0,utRho06
yagI,578384,578384,578324,60,0,utRho06
yagK,586236,586236,585896,340,78,utRho06
yagL,588062,588062,587836,226,56,utRho06
yagN,591342,591342,591158,184,648,utRho06
yahA,663746,664742,663746,996,326,utRho06
yahC,670136,670136,670044,92,2,utRho06
yahE,671478,671850,671478,372,0,utRho06
yahM,690504,690808,690504,304,82,utRho06
yahN,692872,692872,692674,198,0,utRho06
yahO,692864,692968,692864,104,0,utRho06
yaiE,816296,816354,816296,58,28,utRho06
yaiI,811396,811528,811396,132,0,utRho06
yaiO,761946,761946,761684,262,0,utRho06
yaiP,767970,767970,767870,100,0,utRho06
yaiS,769660,769660,769232,428,0,utRho06
yaiV,788922,788922,788922,0,0,utRho06
yaiY,799094,799094,798666,428,172,utRho06
yaiZ,798888,799186,798888,298,476,utRho06
yajC,854410,854574,854410,164,696,utRho06
yajD,860938,861210,860938,272,532,utRho06
yajI,866068,866068,865702,366,170,utRho06
yajL,887496,887496,887282,214,152,utRho06
yajQ,889316,889366,889316,50,84,utRho06
yajR,893374,893374,893332,42,278,utRho06
ybaB,987418,988152,987418,734,2322,utRho06
ybaL,1006590,1006590,1006476,114,172,utRho06
ybaM,980648,980648,980542,106,588,utRho06
ybaN,981436,981764,981436,328,202,utRho06
ybaO,936704,936766,936704,62,0,utRho06
ybaP,1016568,1016568,1016160,408,594,utRho06
ybaQ,1016348,1016436,1016348,88,38,utRho06
ybaS,1023146,1023282,1023146,136,0,utRho06
ybaV,927504,927874,927504,370,0,utRho06
ybaY,950490,950758,950490,268,34,utRho06
ybbB,1062724,1062724,1062452,272,40,utRho06
ybbJ,1030154,1030154,1029718,436,426,utRho06
ybbL,1031784,1031838,1031784,54,0,utRho06
ybbN,1037136,1037136,1036558,578,592,utRho06
ybbO,1038658,1038658,1038298,360,852,utRho06
ybbY,1080718,1081130,1080718,412,16,utRho06
ybcH,1176140,1176140,1175962,178,2,utRho06
ybcI,1113264,1113264,1113106,158,1272,utRho06
ybcJ,1114050,1114050,1113746,304,148,utRho06
ybcK,1137502,1137804,1137502,302,0,utRho06
ybcL,1141690,1141786,1141690,96,0,utRho06
ybcN,1144628,1144932,1144628,304,0,utRho06
ybcQ,1147548,1147912,1147548,364,0,utRho06
ybcW,1159610,1159760,1159610,150,0,utRho06
ybdD,1263982,1264364,1263982,382,120,utRho06
ybdF,1212106,1212106,1211772,334,150,utRho06
ybdH,1267048,1267048,1266954,94,52,utRho06
ybdJ,1212822,1212822,1212398,424,0,utRho06
ybdK,1215122,1215122,1214766,356,92,utRho06
ybdL,1267114,1267172,1267114,58,52,utRho06
ybdM,1271110,1271110,1270752,358,12,utRho06
ybdN,1273372,1273372,1273138,234,0,utRho06
ybdR,1283844,1284176,1283844,332,482,utRho06
ybeD,1325412,1325412,1325284,128,110,utRho06
ybeF,1323090,1323090,1322756,334,108,utRho06
ybeL,1349986,1350036,1349986,50,28,utRho06
ybeQ,1353412,1353412,1353094,318,0,utRho06
ybeR,1353120,1353422,1353120,302,0,utRho06
ybeT,1358832,1358832,1358812,20,0,utRho06
ybeU,1358924,1359016,1358924,92,0,utRho06
ybeZ,1386938,1386938,1386834,104,2310,utRho06
ybfA,1458074,1458268,1458074,194,6,utRho06
ybfE,1423878,1423878,1423796,82,288,utRho06
ybfF,1425692,1425692,1425604,88,898,utRho06
ybfH,1433282,1433282,1433194,88,0,utRho06
ybgA,1477840,1478002,1477840,162,0,utRho06
ybgC,1549288,1549504,1549288,216,0,utRho06
ybgD,1505916,1505916,1505590,326,474,utRho06
ybgI,1485238,1485654,1485238,416,0,utRho06
ybgO,1498370,1498370,1497964,406,24,utRho06
ybgS,1570992,1570992,1570634,358,32,utRho06
ybhA,1597184,1597184,1596862,322,66,utRho06
ybhB,1616070,1616070,1615818,252,48,utRho06
ybhC,1614642,1614642,1614562,80,1048,utRho06
ybhD,1601418,1601418,1601276,142,0,utRho06
ybhH,1601104,1601518,1601104,414,0,utRho06
ybhK,1633384,1633384,1633294,90,60,utRho06
ybhM,1641556,1641586,1641556,30,0,utRho06
ybhN,1645296,1645296,1644996,300,2,utRho06
ybhQ,1649202,1649260,1649202,58,4,utRho06
ybiA,1665920,1665920,1665900,20,0,utRho06
ybiI,1676968,1676968,1676912,56,74,utRho06
ybiO,1691328,1691328,1690960,368,222,utRho06
ybiP,1705252,1705252,1705194,58,1584,utRho06
ybiS,1711572,1711572,1711488,84,274,utRho06
ybiT,1711894,1711926,1711894,32,0,utRho06
ybiU,1718212,1718212,1718122,90,34,utRho06
ybiV,1720176,1720176,1720056,120,0,utRho06
ybiW,1725566,1725566,1725212,354,0,utRho06
ybiX,1678548,1678548,1678414,134,664,utRho06
ybjC,1781784,1781826,1781784,42,0,utRho06
ybjE,1830154,1830154,1829714,440,28,utRho06
ybjG,1767016,1767016,1766776,240,592,utRho06
ybjL,1779882,1779882,1779638,244,244,utRho06
ybjM,1779770,1780178,1779770,408,122,utRho06
ybjO,1795704,1795978,1795704,274,0,utRho06
ybjP,1809046,1809046,1808934,112,0,utRho06
ybjQ,1809034,1809186,1809034,152,0,utRho06
ybjS,1813796,1813796,1813506,290,160,utRho06
ybjX,1838206,1838206,1838168,38,0,utRho06
ycaD,1891438,1891742,1891438,304,0,utRho06
ycaI,1928210,1928640,1928210,430,150,utRho06
ycaK,1899094,1899336,1899094,242,68,utRho06
ycaL,1920264,1920528,1920264,264,28,utRho06
ycaM,1894240,1894458,1894240,218,28,utRho06
ycaR,1941284,1941346,1941284,62,1542,utRho06
ycbB,1961862,1962094,1961862,232,0,utRho06
ycbJ,1943344,1943504,1943344,160,0,utRho06
ycbK,1966046,1966150,1966046,104,272,utRho06
ycbZ,2036920,2036920,2036598,322,64,utRho06
yccA,2062886,2062886,2062836,50,250,utRho06
yccF,2048730,2048730,2048696,34,0,utRho06
yccS,2047988,2047988,2047766,222,6,utRho06
yccT,2055674,2055674,2055546,128,0,utRho06
yccX,2059960,2060128,2059960,168,184,utRho06
ycdT,2185682,2185752,2185682,70,0,utRho06
ycdU,2191266,2191686,2191266,420,0,utRho06
ycdZ,2200504,2200592,2200504,88,0,utRho06
yceA,2233544,2233614,2233544,70,210,utRho06
yceD,2293298,2293588,2293298,290,5024,utRho06
yceF,2293522,2293522,2293190,332,3238,utRho06
yceH,2252154,2252314,2252154,160,358,utRho06
yceI,2237282,2237282,2236952,330,172,utRho06
yceJ,2238142,2238142,2238092,50,62,utRho06
yceM,2253208,2253612,2253208,404,60,utRho06
yceO,2239264,2239264,2238894,370,246,utRho06
yceQ,2288760,2289004,2288760,244,5772,utRho06
ycfD,2376540,2376540,2376480,60,192,utRho06
ycfJ,2334814,2335198,2334814,384,380,utRho06
ycfS,2340834,2340834,2340748,86,20,utRho06
ycfT,2350658,2350658,2350330,328,38,utRho06
ycfZ,2362760,2362760,2362534,226,214,utRho06
ycgB,2474570,2474570,2474482,88,0,utRho06
ycgG,2434614,2434656,2434614,42,28,utRho06
ycgJ,2452956,2453200,2452956,244,106,utRho06
ycgL,2455218,2455362,2455218,144,0,utRho06
ycgN,2457366,2457660,2457366,294,30,utRho06
ycgR,2489112,2489112,2489054,58,0,utRho06
ycgV,2512222,2512222,2511904,318,148,utRho06
ycgX,2426568,2426568,2426214,354,13590,utRho06
ycgY,2490166,2490320,2490166,154,2,utRho06
ycgZ,2431504,2431578,2431504,74,16,utRho06
ychE,2596904,2597196,2596904,292,24,utRho06
ychF,2515764,2515764,2515624,140,50,utRho06
ychH,2517476,2517582,2517476,106,238,utRho06
ychJ,2578354,2578354,2578264,90,0,utRho06
ychN,2547310,2547310,2547198,112,0,utRho06
ychO,2547520,2547850,2547520,330,262,utRho06
ychQ,2533798,2533848,2533798,50,140,utRho06
yciA,2624828,2624828,2624492,336,98,utRho06
yciB,2626110,2626110,2625780,330,3104,utRho06
yciC,2627396,2627396,2627326,70,0,utRho06
yciE,2630794,2630794,2630448,346,0,utRho06
yciG,5264368,5264368,5264140,228,0,utRho06
yciI,2621784,2621784,2621730,54,0,utRho06
yciN,2661606,2661606,2661336,270,12,utRho06
yciS,2680270,2680486,2680270,216,156,utRho06
yciT,2689088,2689088,2688692,396,372,utRho06
yciU,2614718,2614718,2614300,418,2066,utRho06
yciV,2646376,2646440,2646376,64,0,utRho06
yciW,2700472,2700472,2700214,258,352,utRho06
yciZ,2689276,2689276,2689218,58,256,utRho06
ycjD,2703792,2703792,2703520,272,18,utRho06
ycjG,2777748,2777860,2777748,112,214,utRho06
ycjM,2740006,2740432,2740006,426,0,utRho06
ycjW,2767982,2767982,2767922,60,26,utRho06
ycjX,2768138,2768234,2768138,96,20,utRho06
ycjY,5568288,5568288,5567460,828,156,utRho06
ydaE,2836438,2836438,2836016,422,0,utRho06
ydaN,2816048,2816100,2816048,52,18,utRho06
ydaS,2840340,2840730,2840340,390,188,utRho06
ydbC,2948376,2948442,2948376,66,0,utRho06
ydbD,2950132,2950288,2950132,156,0,utRho06
ydbH,2885800,2886102,2885800,302,0,utRho06
ydbJ,2881712,2882116,2881712,404,62,utRho06
ydbK,2881692,2881692,2881568,124,52,utRho06
ydcA,2983294,2983354,2983294,60,0,utRho06
ydcF,2974404,2974470,2974404,66,38,utRho06
ydcI,2990268,2990268,2990142,126,10,utRho06
ydcJ,2990266,2990576,2990266,310,0,utRho06
ydcK,3001280,3001280,3000898,382,0,utRho06
ydcL,3004646,3004914,3004646,268,0,utRho06
ydcN,3012308,3012344,3012308,36,0,utRho06
ydcP,3013508,3013562,3013508,54,0,utRho06
ydcR,3019956,3020006,3019956,50,0,utRho06
ydcS,3022906,3023308,3022906,402,0,utRho06
ydcX,3034442,3034778,3034442,336,44,utRho06
ydcY,3035220,3035296,3035220,76,68,utRho06
ydcZ,3036750,3036750,3036662,88,122,utRho06
yddB,3155332,3155332,3155238,94,2,utRho06
yddE,3071738,3071738,3071716,22,0,utRho06
yddG,3094410,3094410,3094338,72,0,utRho06
yddJ,3089732,3089732,3089438,294,2,utRho06
yddW,3137704,3137704,3137646,58,0,utRho06
ydeA,3233910,3234056,3233910,146,178,utRho06
ydeE,3242528,3242664,3242528,136,0,utRho06
ydeI,3249118,3249118,3248994,124,0,utRho06
ydeJ,3249376,3249546,3249376,170,0,utRho06
ydeN,3165458,3165458,3165048,410,0,utRho06
ydeP,3173328,3173328,3172972,356,0,utRho06
ydeR,3176596,3176596,3176592,4,0,utRho06
ydfA,3296872,3297016,3296872,144,0,utRho06
ydfG,3254982,3255034,3254982,52,0,utRho06
ydfH,3256652,3256704,3256652,52,124,utRho06
ydfK,3265446,3266144,3265446,698,39644,utRho06
ydgA,3379588,3379704,3379588,116,10,utRho06
ydgC,3364124,3364124,3364060,64,12,utRho06
ydgD,3343906,3343920,3343906,14,0,utRho06
ydgH,3356754,3356854,3356754,100,0,utRho06
ydgJ,3408798,3408798,3408616,182,88,utRho06
ydgK,3410414,3410500,3410414,86,152,utRho06
ydhB,3479618,3479618,3479596,22,0,utRho06
ydhC,3479698,3479822,3479698,124,0,utRho06
ydhF,3451310,3451310,3451264,46,0,utRho06
ydhI,3441996,3442050,3441996,54,0,utRho06
ydhL,3451864,3451864,3451840,24,0,utRho06
ydhQ,3492404,3492404,3492254,150,0,utRho06
ydhS,3494136,3494262,3494136,126,168,utRho06
ydhT,3499138,3499138,3499118,20,0,utRho06
ydhY,3509284,3509284,3508954,330,0,utRho06
ydhZ,3510418,3510418,3510282,136,0,utRho06
ydiE,3579206,3579226,3579206,20,0,utRho06
ydiH,3530582,3530582,3530406,176,0,utRho06
ydiM,3541852,3542142,3541852,290,0,utRho06
ydiN,3544818,3545024,3544818,206,0,utRho06
ydiP,3558656,3558656,3558602,54,0,utRho06
ydiU,3582508,3582508,3582488,20,84,utRho06
ydiV,3584174,3584174,3584040,134,84,utRho06
ydiY,3612500,3612500,3612166,334,0,utRho06
ydjA,3697400,3697400,3697352,48,0,utRho06
ydjE,3708082,3708082,3707958,124,0,utRho06
ydjF,3709848,3709848,3709708,140,0,utRho06
ydjM,3620340,3620422,3620340,82,0,utRho06
ydjO,3626696,3626696,3626288,408,0,utRho06
ydjX,3666434,3666802,3666434,368,1626,utRho06
yeaE,3731448,3731448,3731272,176,84,utRho06
yeaG,3733530,3733816,3733530,286,60,utRho06
yeaI,3740486,3740770,3740486,284,0,utRho06
yeaJ,3743874,3744082,3743874,208,20,utRho06
yeaL,3748646,3748704,3748646,58,202,utRho06
yeaM,3751296,3751296,3751152,144,0,utRho06
yeaN,3750926,3751346,3750926,420,0,utRho06
yeaO,3753554,3753818,3753554,264,22,utRho06
yeaP,3755314,3755430,3755314,116,344,utRho06
yeaQ,3758780,3758780,3758510,270,32,utRho06
yeaR,3759988,3759988,3759896,92,0,utRho06
yeaY,3781122,3781122,3781064,58,80,utRho06
yebB,3892220,3892502,3892220,282,0,utRho06
yebC,3896370,3896370,3896302,68,86,utRho06
yebE,3859464,3859464,3859414,50,344,utRho06
yebG,3861530,3861530,3861494,36,26,utRho06
yebK,3873180,3873304,3873180,124,24,utRho06
yebQ,3820314,3820552,3820314,238,0,utRho06
yebS,3832238,3832516,3832238,278,42,utRho06
yebV,3843430,3843560,3843430,130,74,utRho06
yebW,3843914,3844242,3843914,328,1042,utRho06
yecC,3995646,3995646,3995628,18,0,utRho06
yecD,3901272,3901664,3901272,392,88,utRho06
yecF,3991434,3991636,3991434,202,134,utRho06
yecH,3979304,3979304,3978980,324,40,utRho06
yecJ,3975604,3975604,3975516,88,20,utRho06
yecM,3919968,3919968,3919692,276,64,utRho06
yecR,3976400,3976444,3976400,44,52,utRho06
yecT,3923862,3923944,3923862,82,140,utRho06
yedD,4016522,4016522,4016180,342,88,utRho06
yedE,4016310,4016554,4016310,244,34,utRho06
yedI,4058922,4058922,4058732,190,0,utRho06
yedJ,4066446,4066446,4066158,288,0,utRho06
yedV,4076404,4076404,4076304,100,76,utRho06
yedX,4077680,4077912,4077680,232,0,utRho06
yedY,4078572,4078956,4078572,384,32,utRho06
yeeA,4161322,4161322,4161182,140,94,utRho06
yeeE,4171104,4171104,4171050,54,0,utRho06
yeeJ,4089526,4089822,4089526,296,328,utRho06
yeeN,4113508,4113716,4113508,208,4,utRho06
yeeO,4119444,4119444,4119692,248,0,utRho06
yeeX,4158834,4158834,4158722,112,82,utRho06
yeeZ,4178422,4178422,4178256,166,0,utRho06
yefM,4179466,4179466,4179426,40,66,utRho06
yegD,4295288,4295348,4295288,60,0,utRho06
yegH,4275726,4275804,4275726,78,0,utRho06
yegI,4302154,4302154,4301970,184,0,utRho06
yegJ,4302032,4302370,4302032,338,0,utRho06
yegQ,4331182,4331336,4331182,154,104,utRho06
yegR,4336698,4336698,4336612,86,0,utRho06
yegS,4337086,4337424,4337086,338,0,utRho06
yegT,4357562,4357642,4357562,80,0,utRho06
yegX,4367640,4367640,4367302,338,28,utRho06
yehA,4376944,4376944,4376828,116,0,utRho06
yehE,4385818,4385818,4385592,226,0,utRho06
yehK,4407568,4407944,4407568,376,0,utRho06
yehL,4408804,4409192,4408804,388,0,utRho06
yeiB,4486146,4486146,4485934,212,34,utRho06
yeiE,4499422,4499422,4499236,186,56,utRho06
yeiG,4487776,4487820,4487776,44,474,utRho06
yeiH,4499332,4499434,4499332,102,0,utRho06
yeiI,4503306,4503400,4503306,94,72,utRho06
yeiL,4510580,4510710,4510580,130,0,utRho06
yeiP,4530834,4530900,4530834,66,240,utRho06
yeiQ,4532328,4532490,4532328,162,58,utRho06
yeiR,4535484,4535658,4535484,174,48,utRho06
yeiW,4530840,4530840,4530590,250,430,utRho06
yejA,4544624,4544728,4544624,104,88,utRho06
yejG,4556892,4556892,4556474,418,2730,utRho06
yejH,4561244,4561264,4561244,20,10,utRho06
yejK,4568218,4568218,4567894,324,414,utRho06
yejO,4578352,4578352,4577800,552,84,utRho06
yfaD,4713380,4713808,4713380,428,1018,utRho06
yfaE,4696676,4697028,4696676,352,1298,utRho06
yfaL,4688568,4688568,4688338,230,0,utRho06
yfaP,4656398,4656398,4656286,112,22,utRho06
yfaU,4717892,4717892,4717690,202,14,utRho06
yfaY,4727310,4727310,4727266,44,34,utRho06
yfaZ,4728744,4728744,4728550,194,2,utRho06
yfbK,4771810,4771810,4771444,366,38,utRho06
yfbL,4771500,4771720,4771500,220,38,utRho06
yfbN,4777174,4777174,4776852,322,0,utRho06
yfbO,4776916,4777162,4776916,246,0,utRho06
yfbP,4777990,4778232,4777990,242,522,utRho06
yfbR,4817662,4817724,4817662,62,112,utRho06
yfcI,4847424,4847424,4847078,346,34,utRho06
yfcJ,4880482,4880482,4880240,242,234,utRho06
yfcL,4888502,4888502,4888338,164,114,utRho06
yfcV,4911642,4911642,4911292,350,0,utRho06
yfcZ,4921958,4921958,4921868,90,26,utRho06
yfdF,4925604,4926024,4925604,420,418,utRho06
yfdG,4935474,4935710,4935474,236,0,utRho06
yfdP,4946844,4947040,4946844,196,0,utRho06
yfdX,4988866,4988866,4988804,62,0,utRho06
yfdY,4990672,4990672,4990584,88,0,utRho06
yfeA,5035784,5035784,5035664,120,34978,utRho06
yfeC,5036668,5036934,5036668,266,210,utRho06
yfeH,5053818,5053892,5053818,74,12,utRho06
yfeK,5074630,5074684,5074630,54,0,utRho06
yfeO,5018906,5019260,5018906,354,172,utRho06
yfeR,5054078,5054078,5053712,366,24,utRho06
yfeX,5101356,5101356,5101090,266,0,utRho06
yfeY,5102486,5102486,5102432,54,0,utRho06
yfeZ,5103842,5103842,5103452,390,0,utRho06
yffO,5123804,5124222,5123804,418,0,utRho06
yffQ,5126778,5127154,5126778,376,6,utRho06
yffS,5128800,5128986,5128800,186,62,utRho06
yfgC,5232052,5232188,5232052,136,2,utRho06
yfgF,5258062,5258062,5257876,186,36,utRho06
yfgG,5258170,5258580,5258170,410,56,utRho06
yfgH,5259344,5259584,5259344,240,8,utRho06
yfgM,5278866,5278866,5278566,300,648,utRho06
yfhH,5397414,5397518,5397414,104,0,utRho06
yfhM,5304648,5304648,5304574,74,0,utRho06
yfhR,5328408,5328726,5328408,318,4692,utRho06
yfiC,5425610,5425610,5425528,82,0,utRho06
yfiE,5430688,5430688,5430640,48,30,utRho06
yfiL,5482630,5482720,5482630,90,0,utRho06
yfiM,5448066,5448358,5448066,292,14604,utRho06
yfiR,5483354,5483750,5483354,396,176,utRho06
yfjH,5517326,5517326,5517200,126,14,utRho06
yfjI,5517710,5517970,5517710,260,26,utRho06
yfjJ,5521014,5521094,5521014,80,2,utRho06
yfjM,5531970,5531970,5531552,418,746,utRho06
yfjP,5535080,5535420,5535080,340,272,utRho06
yfjW,5546570,5546636,5546570,66,36,utRho06
yfjX,5551776,5551838,5551776,62,0,utRho06
ygaC,5601180,5601180,5599988,1192,1080,utRho06
ygaM,5600242,5600292,5600242,50,328,utRho06
ygaU,5593628,5593628,5593572,56,0,utRho06
ygaZ,5619190,5619234,5619190,44,1230,utRho06
ygbA,5713656,5713656,5713612,44,0,utRho06
ygbE,5746784,5746784,5746674,110,204,utRho06
ygbI,5722882,5722882,5722528,354,0,utRho06
ygbK,5724394,5724670,5724394,276,82,utRho06
ygbL,5727074,5727186,5727074,112,16,utRho06
ygbN,5729814,5730202,5729814,388,122,utRho06
ygcG,5811210,5811422,5811210,212,0,utRho06
ygcN,5785144,5785314,5785144,170,2,utRho06
ygcU,5799214,5799214,5798836,378,0,utRho06
ygcW,5800942,5800942,5800546,396,0,utRho06
ygdD,5883442,5883442,5883262,180,156,utRho06
ygdG,5861746,5861930,5861746,184,900,utRho06
ygdI,5886526,5886526,5886290,236,98,utRho06
ygdQ,5940784,5940840,5940784,56,14,utRho06
ygdR,5942494,5942542,5942494,48,14,utRho06
ygeA,5961606,5961606,5961270,336,0,utRho06
ygeH,5983758,5984188,5983758,430,4,utRho06
ygeI,5987162,5987276,5987162,114,2,utRho06
ygeR,6000078,6000078,5999782,296,180,utRho06
ygeV,6011694,6011694,6011572,122,12,utRho06
ygeW,6012234,6012524,6012234,290,0,utRho06
ygfB,6110946,6110946,6110888,58,28,utRho06
ygfK,6031984,6032120,6031984,136,0,utRho06
ygfS,6058328,6058328,6058024,304,2,utRho06
ygfZ,6082564,6082626,6082564,62,14,utRho06
yggC,6149512,6149512,6149378,134,2,utRho06
yggE,6136370,6136370,6136160,210,32,utRho06
yggI,6179176,6179510,6179176,334,174,utRho06
yggL,6204508,6204508,6204266,242,56,utRho06
yggM,6199514,6199514,6199130,384,160,utRho06
yggN,6203596,6203596,6203246,350,0,utRho06
yggX,18623958,18624558,18623958,600,1008,utRho06
yghA,6298966,6299324,6298966,358,48,utRho06
yghB,6307058,6307126,6307058,68,26,utRho06
yghD,6222614,6222614,6222252,362,158,utRho06
yghF,6225798,6225798,6225840,42,0,utRho06
yghJ,6238640,6238640,6238224,416,0,utRho06
yghQ,6265186,6265186,6264816,370,0,utRho06
yghT,6267830,6268262,6267830,432,0,utRho06
yghU,6277400,6277454,6277400,54,28,utRho06
yghW,6293506,6293506,6293474,32,0,utRho06
yghZ,6295562,6295794,6295562,232,0,utRho06
ygiD,6365122,6365122,6364868,254,382,utRho06
ygiH,6409066,6409388,6409066,322,0,utRho06
ygiL,6370622,6370828,6370622,206,114,utRho06
ygiM,6402084,6402414,6402084,330,40,utRho06
ygiN,6346156,6346284,6346156,128,734,utRho06
ygiQ,6322620,6322620,6322292,328,698,utRho06
ygiS,6335462,6335462,6335436,26,4,utRho06
ygiV,6338582,6338582,6338462,120,36,utRho06
ygiW,6339774,6339774,6339352,422,226,utRho06
ygiZ,6344506,6344506,6344422,84,0,utRho06
ygjH,6442528,6442528,6442494,34,0,utRho06
ygjI,6452140,6452468,6452140,328,0,utRho06
ygjQ,6472730,6473080,6472730,350,144,utRho06
ygjR,6474564,6474586,6474564,22,0,utRho06
ygjV,6483638,6483638,6483488,150,0,utRho06
yhaB,6535632,6535708,6535632,76,0,utRho06
yhaH,6504498,6504608,6504498,110,46,utRho06
yhaI,6505400,6505822,6505400,422,0,utRho06
yhaJ,6508560,6508560,6508428,132,24,utRho06
yhaK,6508538,6508638,6508538,100,24,utRho06
yhbQ,6599878,6599932,6599878,54,134,utRho06
yhbT,6602736,6602736,6602552,184,70,utRho06
yhbU,6602558,6602970,6602558,412,92,utRho06
yhbX,6643302,6643302,6643226,76,0,utRho06
yhbY,6655518,6655580,6655518,62,830,utRho06
yhcA,6723956,6724224,6723956,268,0,utRho06
yhcB,6760364,6760382,6760364,18,68,utRho06
yhcC,6708470,6708470,6708100,370,330,utRho06
yhcF,6733440,6733852,6733440,412,46,utRho06
yhcH,6739124,6739124,6738956,168,102,utRho06
yhcM,6760312,6760312,6759994,318,160,utRho06
yhcN,6770812,6771076,6770812,264,628,utRho06
yhcO,6772606,6772606,6772258,348,0,utRho06
yhdH,6806560,6806968,6806560,408,52,utRho06
yhdJ,6823234,6823306,6823234,72,0,utRho06
yhdN,6879092,6879092,6879018,74,3246,utRho06
yhdT,6814702,6814750,6814702,48,414,utRho06
yhdU,6824994,6825242,6824994,248,124,utRho06
yhdV,6836392,6836780,6836392,388,0,utRho06
yhdW,6837944,6838298,6837944,354,0,utRho06
yheO,6953082,6953082,6952880,202,762,utRho06
yheV,6957970,6957970,6957584,386,28,utRho06
yhfA,6971902,6971902,6971636,266,12,utRho06
yhfG,6983294,6983294,6983240,54,128,utRho06
yhfL,6998622,6998896,6998622,274,56,utRho06
yhfY,7023244,7023244,7022844,400,20,utRho06
yhgA,7086294,7086334,7086294,40,0,utRho06
yhgE,7065176,7065176,7064878,298,108,utRho06
yhgF,7074352,7074770,7074352,418,1352,utRho06
yhhA,7173458,7173886,7173458,428,72,utRho06
yhhI,7248346,7248756,7248346,410,0,utRho06
yhhJ,7253696,7253696,7253606,90,0,utRho06
yhhM,7211588,7211588,7211220,368,324,utRho06
yhhN,7211150,7211502,7211150,352,282,utRho06
yhhQ,7218238,7218434,7218238,196,606,utRho06
yhhT,7223682,7223730,7223682,48,2,utRho06
yhhX,7162032,7162032,7161610,422,706,utRho06
yhhY,7162222,7162276,7162222,54,78,utRho06
yhhZ,7163516,7163726,7163516,210,0,utRho06
yhiD,7312220,7312220,7311804,416,1448,utRho06
yhiJ,7265190,7265190,7265180,10,0,utRho06
yhiM,7269270,7269682,7269270,412,148,utRho06
yhiN,7275000,7275000,7274820,180,30,utRho06
yhjA,7338522,7338522,7338376,146,0,utRho06
yhjB,7344090,7344090,7343788,302,28,utRho06
yhjC,7344272,7344684,7344272,412,0,utRho06
yhjD,7346660,7346724,7346660,64,0,utRho06
yhjE,7349274,7349572,7349274,298,62,utRho06
yhjG,7356824,7356824,7356730,94,2,utRho06
yhjH,7358458,7358458,7358374,84,2,utRho06
yhjJ,7364032,7364032,7363880,152,166,utRho06
yhjK,7371296,7371296,7371158,138,0,utRho06
yhjR,7392750,7392750,7392370,380,0,utRho06
yhjV,7400796,7401126,7400796,330,592,utRho06
yhjX,7424194,7424194,7424014,180,34,utRho06
yhjY,7425966,7425966,7425868,98,4,utRho06
yiaB,7455654,7455654,7455496,158,0,utRho06
yiaD,7432712,7433094,7432712,382,0,utRho06
yiaF,7438194,7438194,7438088,106,54,utRho06
yiaG,7438862,7438956,7438862,94,206,utRho06
yiaJ,7485236,7485236,7485064,172,0,utRho06
yiaK,7485348,7485466,7485348,118,0,utRho06
yiaT,7503924,7503924,7503736,188,0,utRho06
yiaU,7503792,7503984,7503792,192,0,utRho06
yiaY,7515856,7515856,7515654,202,44,utRho06
yibF,7523950,7523950,7523910,40,0,utRho06
yibG,7536128,7536354,7536128,226,0,utRho06
yibL,7553194,7553330,7553194,136,108,utRho06
yibN,7570112,7570112,7570030,82,162,utRho06
yibT,7552848,7552848,7552760,88,44,utRho06
yicC,7633290,7633352,7633290,62,0,utRho06
yicH,7660862,7660914,7660862,52,0,utRho06
yicJ,7673328,7673328,7671858,1470,702,utRho06
yicN,7685018,7685018,7684804,214,0,utRho06
yicO,7687914,7687914,7687578,336,0,utRho06
yicR,15250308,15250308,15250236,72,0,utRho06
yidB,7755230,7755230,7754930,300,24,utRho06
yidE,7732780,7732780,7732546,234,0,utRho06
yidF,7711580,7711580,7711222,358,164,utRho06
yidQ,7735088,7735456,7735088,368,594,utRho06
yidR,7738824,7738824,7738618,206,0,utRho06
yieE,7787658,7787738,7787658,80,210,utRho06
yieH,7793314,7793548,7793314,234,16,utRho06
yieK,7798928,7798928,7798786,142,2,utRho06
yifB,7900350,7900350,7899998,352,208,utRho06
yifL,7988984,7989044,7988984,60,4,utRho06
yigF,8005750,8005750,8005598,152,98,utRho06
yigI,8009448,8009448,8009394,54,68,utRho06
yigM,8022100,8022152,8022100,52,0,utRho06
yihA,8101970,8101970,8101458,512,72,utRho06
yihD,8084098,8084138,8084098,40,22,utRho06
yihF,8088110,8088398,8088110,288,0,utRho06
yihG,8093304,8093304,8093204,100,0,utRho06
yihI,8102616,8102694,8102616,78,92,utRho06
yihL,8120506,8120894,8120506,388,56,utRho06
yihN,8124332,8124494,8124332,162,0,utRho06
yihO,8131942,8131942,8131532,410,48,utRho06
yihQ,8138892,8138892,8138552,340,0,utRho06
yihV,8147064,8147478,8147064,414,0,utRho06
yihX,8151096,8151106,8151096,10,4,utRho06
yiiE,8158192,8158582,8158192,390,0,utRho06
yiiF,8159124,8159502,8159124,378,0,utRho06
yiiG,8173762,8174004,8173762,242,0,utRho06
yiiM,8205506,8205644,8205506,138,4,utRho06
yiiQ,8224624,8224624,8224428,196,16,utRho06
yiiS,8225738,8225934,8225738,196,0,utRho06
yijE,8272178,8272216,8272178,38,0,utRho06
yijF,8275728,8275728,8275314,414,12,utRho06
yijO,8296858,8296858,8296634,224,94,utRho06
yjaA,8426240,8426468,8426240,228,88612,utRho06
yjaB,8428312,8428312,8428246,66,196,utRho06
yjaG,8398746,8399008,8398746,262,1126,utRho06
yjaH,8401022,8401132,8401022,110,98,utRho06
yjaZ,8379506,8379572,8379506,66,112,utRho06
yjbB,8455204,8455462,8455204,258,0,utRho06
yjbE,16943432,16943624,16943432,192,0,utRho06
yjbL,8520318,8520642,8520318,324,0,utRho06
yjbQ,8540428,8540476,8540428,48,38,utRho06
yjcB,8550328,8550328,8550082,246,7830,utRho06
yjcC,8550836,8550942,8550836,106,104,utRho06
yjcD,8556628,8556958,8556628,330,46,utRho06
yjcE,8559658,8559960,8559658,302,28,utRho06
yjcF,8566212,8566212,8566150,62,0,utRho06
yjcO,8594660,8594660,8594250,410,52,utRho06
yjdA,8654128,8654270,8654128,142,4,utRho06
yjdC,8726660,8726660,8726616,44,0,utRho06
yjdK,8704780,8705168,8704780,388,62,utRho06
yjdL,8713034,8713034,8712822,212,0,utRho06
yjdM,8653672,8653672,8653468,204,0,utRho06
yjeF,8787354,8788132,8787354,778,7818,utRho06
yjeI,8745522,8745618,8745522,96,6,utRho06
yjeJ,8748806,8748806,8748468,338,0,utRho06
yjeV,8785472,8785784,8785472,312,420,utRho06
yjfP,8833512,8833904,8833512,392,0,utRho06
yjfY,8849656,8849656,8849582,74,0,utRho06
yjfZ,8855052,8855052,8854844,208,0,utRho06
yjgA,8916162,8916162,8915730,432,134,utRho06
yjgL,8950802,8950874,8950802,72,0,utRho06
yjgM,8959342,8959342,8959074,268,0,utRho06
yjgN,8959132,8959460,8959132,328,0,utRho06
yjgR,8980170,8980170,8980126,44,32,utRho06
yjgZ,9002116,9002520,9002116,404,650,utRho06
yjhB,9007764,9008116,9007764,352,134,utRho06
yjhG,9048452,9048452,9048188,264,402,utRho06
yjhU,9041080,9041080,9040648,432,150,utRho06
yjiA,9178096,9178096,9177730,366,366,utRho06
yjiJ,9125364,9125364,9125350,14,0,utRho06
yjiK,9127270,9127270,9127422,152,62,utRho06
yjiL,9129604,9129604,9129378,226,0,utRho06
yjiS,9143410,9143502,9143410,92,0,utRho06
yjiY,9182734,9182734,9182558,176,68,utRho06
yjjA,9200674,9200674,9200378,296,238,utRho06
yjjB,18408708,18408708,18407800,908,20,utRho06
yjjJ,9243314,9243538,9243314,224,0,utRho06
yjjK,9261132,9261132,9261044,88,178,utRho06
yjjL,9189764,9189764,9189444,320,0,utRho06
yjjM,9191894,9191894,9191702,192,2,utRho06
yjjP,9206068,9206068,9205716,352,48,utRho06
yjjQ,9206638,9206954,9206638,316,8,utRho06
yjjX,9267798,9267798,9267490,308,294,utRho06
yjjY,9280716,9280804,9280716,88,450,utRho06
yjjZ,9211554,9211608,9211554,54,1820,utRho06
yjtD,9281676,9281884,9281676,208,58,utRho06
ykfB,532454,532454,532174,280,232,utRho06
ykfI,527636,527636,527338,298,0,utRho06
ykgB,637050,637050,636638,412,6,utRho06
ykgC,640430,640430,640002,428,2,utRho06
ykgD,640232,640454,640232,222,2,utRho06
ykgE,642962,643216,642962,254,78,utRho06
ykgJ,608524,608524,608364,160,60,utRho06
ykgL,623878,624224,623878,346,0,utRho06
ykgM,625610,625610,625554,56,0,utRho06
ykgR,626570,626570,626484,86,0,utRho06
ylaC,958576,958576,958502,74,1216,utRho06
yliE,1745938,1745958,1745938,20,0,utRho06
ymcE,2103660,2103694,2103660,34,250,utRho06
ymdA,2210450,2210828,2210450,378,20,utRho06
ymdB,2211428,2211640,2211428,212,0,utRho06
ymfD,2395322,2395322,2395064,258,40,utRho06
ymfI,2402880,2402994,2402880,114,0,utRho06
ymfJ,2404518,2404518,2404168,350,110,utRho06
ymfK,2406176,2406176,2405866,310,8,utRho06
ymfT,2405766,2406048,2405766,282,10,utRho06
ymgE,2489110,2489456,2489110,346,42,utRho06
ymgF,2437628,2437966,2437628,338,0,utRho06
ymiA,2670112,2670320,2670112,208,82,utRho06
ymjA,2715620,2715620,2715336,284,570,utRho06
ynaI,2791946,2791946,2791844,102,0,utRho06
ynaK,2850438,2850754,2850438,316,76,utRho06
ynbA,2954924,2955242,2954924,318,0,utRho06
yncD,3046552,3046552,3046130,422,72,utRho06
yncE,3046454,3046614,3046454,160,0,utRho06
yncG,3052456,3052494,3052456,38,32,utRho06
yncL,3034492,3034492,3034388,104,66,utRho06
yneE,3218364,3218364,3218044,320,52,utRho06
yneF,3223748,3223748,3223708,40,14,utRho06
yneJ,3229560,3229608,3229560,48,124,utRho06
yneK,3231100,3231526,3231100,426,0,utRho06
yneM,3245176,3245292,3245176,116,50,utRho06
ynfA,3311398,3311398,3311346,52,0,utRho06
ynfB,3311418,3311616,3311418,198,230,utRho06
ynfC,3315094,3315094,3314914,180,0,utRho06
ynfD,3314828,3315130,3314828,302,0,utRho06
ynfE,3316006,3316138,3316006,132,6,utRho06
ynfK,3334670,3334670,3334438,232,12,utRho06
ynfL,3339304,3339304,3339184,120,0,utRho06
ynfM,3339260,3339398,3339260,138,0,utRho06
ynfN,3276598,3276598,3276218,380,1474,utRho06
ynfO,3273454,3273512,3273454,58,0,utRho06
ynhG,3517890,3517890,3517450,440,466,utRho06
yniA,3615158,3615592,3615158,434,0,utRho06
yniB,3618526,3618526,3618466,60,0,utRho06
yniC,3618652,3618760,3618652,108,0,utRho06
yniD,3610202,3610330,3610202,128,0,utRho06
ynjE,3678880,3678934,3678880,54,40,utRho06
ynjF,3683222,3683222,3682806,416,4,utRho06
ynjH,3684376,3684376,3684270,106,50,utRho06
ynjI,3690022,3690022,3689742,280,144,utRho06
yoaB,3786642,3786734,3786642,92,76,utRho06
yoaC,3787932,3788146,3787932,214,136,utRho06
yoaE,3803544,3803544,3803170,374,272,utRho06
yoaF,3755444,3755444,3755064,380,432,utRho06
yoaH,3789866,3789866,3789462,404,208,utRho06
yobB,3850418,3850880,3850418,462,642,utRho06
yobF,3815586,3815586,3815182,404,92,utRho06
yobH,3817800,3817850,3817800,50,14,utRho06
yodB,4084352,4084736,4084352,384,38,utRho06
yodC,4057008,4057008,4056740,268,0,utRho06
yohC,4451358,4451358,4451262,96,56,utRho06
yohD,4451526,4451602,4451526,76,58,utRho06
yohJ,4460986,4461248,4460986,262,0,utRho06
yohO,4431172,4431314,4431172,142,72,utRho06
yojI,4617282,4617282,4617230,52,4,utRho06
ypdI,4988988,4989396,4988988,408,22,utRho06
ypfG,5165786,5165786,5165554,232,110,utRho06
ypfM,5182140,5182140,5181732,408,72,utRho06
yphB,5349590,5349590,5349376,214,4,utRho06
ypjA,5565644,5565644,5565452,192,2,utRho06
ypjB,5569636,5569636,5568858,778,0,utRho06
ypjD,5495860,5495774,5495860,86,0,utRho06
yqaE,5594170,5594170,5594056,114,22,utRho06
yqcA,5846100,5846100,5845968,132,22,utRho06
yqcE,5800944,5801184,5800944,240,0,utRho06
yqeC,6030468,6030468,6030114,354,6,utRho06
yqeF,5971618,5971618,5971184,434,32,utRho06
yqeG,5971438,5971694,5971438,256,16,utRho06
yqeH,5975016,5975072,5975016,56,6,utRho06
yqeI,5976688,5977004,5976688,316,6,utRho06
yqeK,5981140,5981140,5980720,420,2,utRho06
yqfA,6086728,6086728,6086296,432,64,utRho06
yqgA,6219042,6219106,6219042,64,0,utRho06
yqgB,6172500,6172500,6172102,398,1200,utRho06
yqgE,6185768,6185874,6185768,106,474,utRho06
yqhA,6299150,6299150,6298942,208,48,utRho06
yqhC,6310768,6310768,6310436,332,158,utRho06
yqhD,6310604,6310710,6310604,106,30,utRho06
yqhH,6316842,6317254,6316842,412,592,utRho06
yqiC,6369662,6369680,6369662,18,30,utRho06
yqiJ,6384108,6384416,6384108,308,136,utRho06
yqjA,6495096,6495546,6495096,450,6476,utRho06
yqjF,6500932,6501124,6500932,192,80,utRho06
yqjG,6501948,6502048,6501948,100,0,utRho06
yqjH,6433078,6433078,6432982,96,0,utRho06
yqjI,6433506,6433558,6433506,52,0,utRho06
yraH,6574552,6574852,6574552,300,0,utRho06
yraP,6592144,6592818,6592144,674,182,utRho06
yraQ,6596414,6596414,6596276,138,0,utRho06
yraR,6598024,6598024,6597692,332,0,utRho06
yrbG,13360844,13361100,13360844,256,176,utRho06
yrbL,6696842,6696904,6696842,62,566,utRho06
yrbN,6616172,6616172,6615866,306,13834,utRho06
yrdB,6860176,6860176,6860046,130,38,utRho06
yrfF,7052548,7052938,7052548,390,686,utRho06
yrhB,7169440,7169518,7169440,78,0,utRho06
ysaB,7451804,7451804,7451424,380,32,utRho06
ysgA,8032686,8032686,8032338,348,80,utRho06
ytfB,8857638,8857638,8857434,204,80,utRho06
ytfE,8864018,8864018,8863966,52,0,utRho06
ytfF,8866296,8866296,8866130,166,0,utRho06
ytfH,8868164,8868226,8868164,62,0,utRho06
ytfI,8875234,8875414,8875234,180,0,utRho06
ytfJ,8878572,8878572,8878524,48,38,utRho06
ytfK,8879022,8879174,8879022,152,208,utRho06
ytfL,8882642,8882642,8882430,212,16,utRho06
ytfQ,8899634,8899924,8899634,290,60,utRho06
ytjB,9249598,9249598,9249578,20,0,utRho06
yzfA,8896588,8896588,8896490,98,2,utRho06
zapA,6111102,6111224,6111102,122,4762,utRho06
zapB,8236772,8237030,8236772,258,102,utRho06
zapC,2011700,2011904,2011700,204,34,utRho06
zinT,4082692,4082750,4082692,58,0,utRho06
zipA,5062814,5062814,5062466,348,80,utRho06
zitB,1569716,1569716,1569646,70,36,utRho06
zntA,7212844,7212902,7212844,58,30,utRho06
zntR,6878336,6878336,6878260,76,62,utRho06
znuA,3885322,3885322,3885166,156,0,utRho06
znuC,3885268,3885324,3885268,56,0,utRho06
zraP,8403424,8403424,8403376,48,0,utRho06
zraS,8403810,8403852,8403810,42,0,utRho06
zupT,6364866,6365100,6364866,234,382,utRho06
zur,8520282,8520282,8520006,276,1292,utRho06
zwf,3872752,3872752,3872628,124,108,utRho06
C0343,2818676,2818728,2818676,52,0,utRho07
aaeB,6776526,6776526,6776376,150,0,utRho07
aaeR,6778762,6779040,6778762,278,100,utRho07
aaeX,6778860,6778860,6778674,186,140,utRho07
aat,1854920,1854920,1854864,56,0,utRho07
accA,416822,417242,416822,420,1938,utRho07
accB,6810280,6810872,6810280,592,10912,utRho07
accD,4868030,4868030,4867852,178,722,utRho07
aceB,8430804,8430956,8430804,152,0,utRho07
aceE,245938,246034,245938,96,216,utRho07
ackA,4826918,4826940,4826918,22,1194,utRho07
acnA,2670848,2671662,2670848,814,428,utRho07
acnB,263038,263230,263038,192,758,utRho07
acpP,2303148,2303230,2303148,82,280,utRho07
acpS,5402324,5402324,5401996,328,120,utRho07
acrA,971396,971396,971238,158,142,utRho07
acrB,969370,969370,968806,564,3210,utRho07
acrD,5174950,5175190,5174950,240,50,utRho07
acrE,6827404,6827728,6827404,324,0,utRho07
acrR,971398,971522,971398,124,202,utRho07
acrZ,1589502,1589546,1589502,44,0,utRho07
acs,8575190,8575190,8574742,448,38,utRho07
actP,8569870,8569870,8569804,66,10,utRho07
ada,4620854,4620854,4620810,44,0,utRho07
add,3404404,3404466,3404404,62,0,utRho07
ade,7687802,7687928,7687802,126,0,utRho07
adhE,2596826,2596826,2596242,584,112,utRho07
adhP,3107988,3107988,3107676,312,1266,utRho07
adiA,8681112,8681112,8681042,70,44,utRho07
adiC,8674404,8674404,8674062,342,0,utRho07
adiY,8676084,8676084,8675858,226,0,utRho07
adk,994278,994350,994278,72,100,utRho07
adrA,807374,807406,807374,32,0,utRho07
aer,6438240,6438240,6438152,88,222,utRho07
aes,1000102,1000102,999946,156,0,utRho07
agaR,6557406,6557406,6557330,76,0,utRho07
agaS,6563778,6563952,6563778,174,30,utRho07
agp,2131118,2131170,2131118,52,0,utRho07
agrA,7296126,7296126,7296126,0,0,utRho07
agrB,7296588,7296588,7296588,0,0,utRho07
ahpC,1277386,1277890,1277386,504,654,utRho07
ahpF,1278004,1279506,1278004,1502,66284,utRho07
ahr,8992698,8992698,8992418,280,0,utRho07
aidB,8828494,8828550,8828494,56,0,utRho07
ais,4731512,4731512,4731240,272,0,utRho07
alaA,4814816,4815122,4814816,306,22,utRho07
alaC,4996798,4996798,4996590,208,38,utRho07
alaE,5598140,5598328,5598140,188,0,utRho07
alaS,5644180,5644180,5644022,158,2208,utRho07
alaW,5036612,5036612,5036462,150,0,utRho07
aldA,2976380,2976464,2976380,84,148,utRho07
aldB,7513070,7513070,7513022,48,0,utRho07
alkA,4295118,4295118,4295080,38,0,utRho07
alkB,4618890,4618890,4618682,208,0,utRho07
allA,1064780,1064902,1064780,122,0,utRho07
allD,1092822,1092822,1092726,96,0,utRho07
allE,1088112,1088112,1088092,20,16,utRho07
allS,1064600,1064600,1064442,158,0,utRho07
alr,8531178,8531564,8531178,386,1400,utRho07
alsE,8617334,8617334,8616956,378,4,utRho07
alsK,8615990,8615990,8615598,392,0,utRho07
alx,6476740,6477160,6476740,420,0,utRho07
amiA,5104482,5104704,5104482,222,20,utRho07
amiC,5898378,5898378,5898020,358,48,utRho07
amn,4110062,4110122,4110062,60,0,utRho07
ampC,8758006,8758006,8757888,118,0,utRho07
ampD,237362,237466,237362,104,28,utRho07
ampG,907372,907372,907090,282,516,utRho07
ampH,792726,792726,792574,152,22,utRho07
amyA,4012230,4012312,4012230,82,110,utRho07
anmK,3439346,3439346,3439204,142,0,utRho07
ansB,6201580,6201580,6201456,124,0,utRho07
ansP,3052040,3052040,3051960,80,114,utRho07
apaG,104068,104068,103212,856,3968,utRho07
apaH,102586,102586,102444,142,2844,utRho07
apbE,4623188,4623188,4623068,120,22,utRho07
appA,2081198,2081234,2081198,36,0,utRho07
appC,2075420,2075480,2075420,60,0,utRho07
appY,1167134,1167362,1167134,228,0,utRho07
apt,982620,982824,982620,204,318,utRho07
aqpZ,1832424,1832424,1832094,330,0,utRho07
araB,140150,140150,140096,54,0,utRho07
araC,140482,140774,140482,292,144,utRho07
araE,5964416,5964416,5964364,52,0,utRho07
araF,3972476,3972476,3972256,220,0,utRho07
araH,3967120,3967120,3967086,34,0,utRho07
araJ,825058,825058,824962,96,2,utRho07
arcA,9281602,9281602,9280612,990,5304,utRho07
arcB,6706098,6706098,6706050,48,0,utRho07
arcZ,6701154,6701154,6701154,0,0,utRho07
arfA,6877346,6877346,6877298,48,0,utRho07
argA,5898312,5898484,5898312,172,36,utRho07
argC,8309770,8310002,8309770,232,30,utRho07
argD,6980442,6980442,6980360,82,8,utRho07
argE,8310156,8310156,8309694,462,118,utRho07
argF,580680,580680,580610,70,0,utRho07
argG,6637124,6637274,6637124,150,4,utRho07
argI,8956688,8956688,8956622,66,0,utRho07
argO,6137672,6137672,6137616,56,20,utRho07
argP,6119460,6119506,6119460,46,0,utRho07
argR,6769204,6769406,6769204,202,4,utRho07
argS,3920002,3920124,3920002,122,0,utRho07
argT,4855698,4855698,4855582,116,26,utRho07
argU,1129406,1129446,1129406,40,0,utRho07
argW,4932616,4932618,4932616,2,0,utRho07
argX,7964728,7964750,7964728,22,52,utRho07
aroF,5482402,5482402,5482300,102,0,utRho07
aroG,1571182,1571266,1571182,84,146,utRho07
aroH,3576636,3576870,3576636,234,350,utRho07
aroK,7038760,7038760,7038128,632,1298,utRho07
aroL,812560,812810,812560,250,94,utRho07
aroP,243342,243342,243102,240,0,utRho07
arpA,8445382,8445382,8444974,408,0,utRho07
arrS,7316108,7316108,7316108,0,0,utRho07
arsR,7297024,7297056,7297024,32,0,utRho07
artJ,1801252,1801252,1801150,102,0,utRho07
artP,1807686,1807686,1807468,218,0,utRho07
ascF,5678858,5679048,5678858,190,0,utRho07
ascG,5678574,5678574,5678528,46,0,utRho07
aslB,7965562,7965916,7965562,354,1246,utRho07
asnA,7854258,7854310,7854258,52,40,utRho07
asnB,1398444,1398444,1398354,90,170,utRho07
asnC,23562186,23562186,23562018,168,120,utRho07
asnS,1978088,1978088,1977970,118,8224,utRho07
asnT,4089082,4089098,4089082,16,160,utRho07
asnU,4119690,4119702,4119690,12,0,utRho07
asnV,4124504,4124520,4124504,16,24,utRho07
aspA,17473728,17473728,17473308,420,0,utRho07
aspC,1971486,1971486,1971418,68,700,utRho07
aspS,3901402,3901402,3901044,358,96,utRho07
aspT,7893560,7893744,7893560,184,120214,utRho07
aspV,473826,473862,473826,36,8,utRho07
asr,3342654,3342752,3342654,98,0,utRho07
astC,3664088,3664088,3663964,124,0,utRho07
astE,3654138,3654138,3653846,292,0,utRho07
atoD,4646824,4646894,4646824,70,0,utRho07
atpB,7844540,7844540,7844102,438,864,utRho07
atpC,7832118,7832118,7831944,174,3008,utRho07
atpI,7845050,7845050,7844880,170,108,utRho07
avtA,7479348,7479410,7479348,62,84,utRho07
azoR,2965982,2965982,2965720,262,84,utRho07
azuC,3976002,3976002,3975918,84,0,utRho07
bacA,6408350,6408350,6408262,88,2,utRho07
bamA,394052,395856,394052,1804,964,utRho07
bamB,5277950,5277950,5277304,646,2102,utRho07
bamC,5198028,5198028,5197730,298,1700,utRho07
bamD,5471922,5472292,5471922,370,7988,utRho07
bamE,5506972,5507210,5506972,238,192,utRho07
basS,8666954,8666954,8666544,410,334,utRho07
bax,7474468,7474468,7474354,114,22,utRho07
bcp,5200874,5200956,5200874,82,1824,utRho07
bcsB,7385346,7385346,7385214,132,48,utRho07
bcsE,7392644,7392916,7392644,272,0,utRho07
bdcA,8948128,8948128,8948106,22,6,utRho07
bdcR,8948192,8948248,8948192,56,0,utRho07
bdm,3112680,3112680,3112560,120,0,utRho07
betA,654522,654522,654494,28,250,utRho07
betI,658722,658722,658668,54,0,utRho07
betT,658842,658926,658842,84,0,utRho07
bfr,6933498,6933498,6933450,48,0,utRho07
bglG,23440182,23440182,23439402,780,0,utRho07
bglX,4444240,4444240,4443978,262,0,utRho07
bhsA,2337962,2338146,2337962,184,0,utRho07
bioA,1618584,1618584,1618514,70,0,utRho07
bioB,1618604,1618688,1618604,84,0,utRho07
bioH,7089716,7089716,7089688,28,0,utRho07
bisC,7433026,7433026,7432788,238,128,utRho07
blc,8755490,8755490,8755444,46,0,utRho07
blr,3409024,3409102,3409024,78,0,utRho07
bluF,2431226,2431226,2430950,276,160,utRho07
bluR,2428226,2428226,2428118,108,0,utRho07
bolA,908698,908944,908698,246,0,utRho07
borD,1157842,1157842,1157786,56,0,utRho07
brnQ,838976,839182,838976,206,652,utRho07
bssR,1756492,1756496,1756492,4,0,utRho07
bssS,2242116,2242116,2241910,206,66,utRho07
btuB,8326798,8327278,8326798,480,3342,utRho07
cadB,8720212,8720212,8720062,150,0,utRho07
cadC,8723926,8723926,8723868,58,0,utRho07
caiE,70998,70998,70742,256,0,utRho07
caiF,68436,68600,68436,164,16,utRho07
caiT,84074,84074,83862,212,0,utRho07
can,285406,285406,285340,66,0,utRho07
carA,59102,59302,59102,200,0,utRho07
carB,61550,61634,61550,84,158,utRho07
cas2,5757830,5757830,5757706,124,10,utRho07
casA,5768638,5768638,5768276,362,0,utRho07
cbl,4121882,4121882,4121828,54,0,utRho07
cbpA,2128074,2128074,2127550,524,66,utRho07
cbrA,7738628,7738754,7738628,126,0,utRho07
cbrB,7794958,7795012,7794958,54,2,utRho07
ccmH,4585242,4585242,4584820,422,0,utRho07
cdaR,364894,364926,364894,32,0,utRho07
cdd,4463638,4463688,4463638,50,0,utRho07
cdh,8219814,8219860,8219814,46,0,utRho07
cdsA,391110,391354,391110,244,1382,utRho07
cedA,3627484,3627484,3627326,158,10,utRho07
cfa,3482402,3482826,3482402,424,6,utRho07
chaC,2544844,2544972,2544844,128,0,utRho07
chbB,3643452,3643452,3643238,214,0,utRho07
chbG,3634624,3634624,3634270,354,0,utRho07
cheW,3946924,3946924,3946678,246,2130,utRho07
chiA,6939792,6939792,6939706,86,0,utRho07
chiP,1416472,1416668,1416472,196,4,utRho07
cho,3646984,3647030,3646984,46,32,utRho07
chpS,8896804,8896894,8896804,90,0,utRho07
cirA,4493884,4493884,4493538,346,20,utRho07
citC,1304078,1304078,1303712,366,0,utRho07
citT,1293264,1293264,1293160,104,0,utRho07
clcA,350104,350214,350104,110,0,utRho07
clpA,1846160,1846528,1846160,368,8,utRho07
clpB,5468410,5468410,5468346,64,14,utRho07
clpP,913154,913354,913154,200,248,utRho07
clpS,1845500,1845826,1845500,326,0,utRho07
clpX,914404,914852,914404,448,1184,utRho07
clsA,2617346,2617346,2617290,56,0,utRho07
clsC,2212584,2212710,2212584,126,260,utRho07
cmk,1922330,1922402,1922330,72,46,utRho07
cnu,3409522,3409898,3409522,376,314,utRho07
coaA,8350214,8350214,8350052,162,560,utRho07
cobC,1340092,1340092,1339814,278,176,utRho07
cobT,4129202,4129202,4128934,268,0,utRho07
cobU,4131944,4131944,4131528,416,0,utRho07
codB,709768,709844,709768,76,0,utRho07
comR,2337726,2337726,2337664,62,0,utRho07
copA,1022822,1022822,1022758,64,0,utRho07
corA,8002388,8002852,8002388,464,5350,utRho07
cpdB,8873258,8873258,8873130,128,176,utRho07
cptB,6082198,6082198,6082140,58,70,utRho07
cpxA,8210202,8210202,8209950,252,492,utRho07
cpxP,8211570,8211640,8211570,70,86,utRho07
cpxR,8211372,8211372,8211340,32,0,utRho07
cra,175894,176056,175894,162,12,utRho07
crcB,1316016,1316016,1315876,140,0,utRho07
creA,9270486,9271042,9270486,556,332,utRho07
creD,9276320,9276356,9276320,36,4,utRho07
crl,515620,515658,515620,38,750,utRho07
crp,6971906,6972240,6971906,334,3356,utRho07
crr,5070960,5071668,5070960,708,4574,utRho07
csdA,5886414,5886674,5886414,260,0,utRho07
csgB,2207718,2207902,2207718,184,0,utRho07
csgD,2206688,2206688,2206392,296,0,utRho07
csgG,2203510,2203510,2203368,142,40,utRho07
csiD,5577854,5577970,5577854,116,26,utRho07
csiE,5330802,5330870,5330802,68,0,utRho07
csiR,5590942,5591348,5590942,406,0,utRho07
cspA,7439778,7440098,7439778,320,33560,utRho07
cspB,3283430,3283430,3283108,322,0,utRho07
cspC,3815018,3815018,3814870,148,264,utRho07
cspD,1845352,1845352,1845180,172,728,utRho07
cspE,1314294,1314584,1314294,290,28,utRho07
cspF,3283380,3283710,3283380,330,26,utRho07
cspG,2102610,2102922,2102610,312,766,utRho07
cspH,2102746,2102746,2102350,396,56,utRho07
cspI,3277624,3277624,3277334,290,0,utRho07
csrA,5638746,5638746,5638292,454,1338,utRho07
csrB,5849048,5849048,5849048,0,0,utRho07
csrC,8102072,8102072,8102072,0,0,utRho07
csrD,6806850,6806850,6806664,186,92,utRho07
cstA,1259710,1259788,1259710,78,52,utRho07
cueO,274090,274166,274090,76,0,utRho07
cueR,1027948,1027986,1027948,38,0,utRho07
curA,3037784,3038054,3037784,270,0,utRho07
cusC,1191146,1191200,1191146,54,0,utRho07
cusR,1190924,1190924,1190886,38,54,utRho07
cutA,8730784,8730784,8730712,72,72,utRho07
cutC,3918534,3918534,3917920,614,30,utRho07
cvpA,4861600,4861600,4861526,74,104,utRho07
cvrA,2484328,2484328,2484142,186,80,utRho07
cyaA,7981548,7982306,7981548,758,218,utRho07
cyaR,4334228,4334224,4334228,4,16,utRho07
cyaY,7988166,7988166,7988118,48,0,utRho07
cybB,2981522,2981804,2981522,282,14,utRho07
cycA,8859560,8859728,8859560,168,238,utRho07
cydA,1542340,1542916,1542340,576,106,utRho07
cydC,1858800,1858800,1858390,410,148,utRho07
cydD,1862062,1862062,1861924,138,4,utRho07
cydX,1548300,1548392,1548300,92,102,utRho07
cynR,717418,717418,717380,38,0,utRho07
cynT,1435092,1435196,1435092,104,0,utRho07
cyoA,903306,903306,903220,86,2552,utRho07
cyoE,895540,895540,895410,130,416,utRho07
cysB,2667576,2667710,2667576,134,172,utRho07
cysC,5748056,5748056,5747984,72,0,utRho07
cysD,5752736,5752736,5752658,78,0,utRho07
cysE,7565362,7565362,7565124,238,528,utRho07
cysG,6995508,6995656,6995508,148,0,utRho07
cysJ,5783928,5783928,5783796,132,804,utRho07
cysK,5064688,5064818,5064688,130,36,utRho07
cysP,5087114,5087114,5087056,58,32,utRho07
cysS,1109154,1109222,1109154,68,68,utRho07
cysT,3984100,3984100,3983974,126,62,utRho07
cysZ,5062766,5062926,5062766,160,48,utRho07
cytR,8249018,8249018,8248912,106,0,utRho07
dacA,1328002,1328002,1327926,76,222,utRho07
dacB,6657714,6657926,6657714,212,22,utRho07
dacC,1761306,1761454,1761306,148,0,utRho07
dadA,2475018,2475142,2475018,124,78,utRho07
dam,7032504,7032504,7031826,678,2212,utRho07
damX,7035200,7035200,7034612,588,528,utRho07
dapA,5199568,5199568,5199520,48,0,utRho07
dapB,56576,56748,56576,172,76,utRho07
dapD,371954,371954,371894,60,144,utRho07
dapE,5183120,5183214,5183120,94,468,utRho07
dcp,3254844,3254844,3254760,84,36,utRho07
dcrB,7219534,7219910,7219534,376,54,utRho07
dctA,7366996,7366996,7366894,102,228,utRho07
dcuA,8733686,8733686,8733546,140,2,utRho07
dcuB,8698182,8698182,8697488,694,0,utRho07
dcuC,1312166,1312166,1311936,230,0,utRho07
dcuD,6749166,6749738,6749166,572,0,utRho07
dcuR,8701130,8701130,8700068,1062,418,utRho07
dcuS,8703370,8703370,8703324,46,24,utRho07
dcyD,3999016,3999016,3998960,56,0,utRho07
ddpX,3126498,3126498,3126152,346,0,utRho07
deaD,6615818,6615818,6615720,98,1374,utRho07
dedA,4869880,4869880,4869482,398,13180,utRho07
dedD,4863750,4863750,4863368,382,70,utRho07
def,6867300,6867380,6867300,80,0,utRho07
degP,361690,361768,361690,78,0,utRho07
degQ,6761308,6761486,6761308,178,500,utRho07
deoB,9239134,9239206,9239134,72,0,utRho07
deoC,9233358,9234646,9233358,1288,192,utRho07
dfp,7625406,7625462,7625406,56,0,utRho07
dgcZ,3247758,3247758,3247700,58,0,utRho07
dgkA,8512914,8513274,8512914,360,448,utRho07
dgt,358392,358474,358392,82,0,utRho07
dhaK,2501888,2501888,2501676,212,426,utRho07
dhaR,2502006,2502132,2502006,126,0,utRho07
dicB,3299194,3299218,3299194,24,0,utRho07
dicC,3295752,3295752,3295700,52,0,utRho07
dinB,501760,501796,501760,36,0,utRho07
dinD,7635398,7635520,7635398,122,132,utRho07
dinG,1666146,1666140,1666146,6,0,utRho07
dinI,2243018,2243018,2242974,44,6,utRho07
dinJ,493230,493230,493004,226,16,utRho07
dinQ,7295964,7295964,7295576,388,1420,utRho07
djlA,114536,114728,114536,192,0,utRho07
dkgA,6313142,6313246,6313142,104,36,utRho07
dkgB,458196,458334,458196,138,2,utRho07
dksA,321502,321502,321208,294,394,utRho07
dld,4444164,4444370,4444164,206,0,utRho07
dmlA,3763424,3763824,3763424,400,20,utRho07
dmlR,3763710,3763710,3763618,92,0,utRho07
dmsA,1881646,1881918,1881646,272,0,utRho07
dnaA,7767922,7767922,7767458,464,452,utRho07
dnaB,8528566,8528628,8528566,62,72,utRho07
dnaK,24096,24326,24096,230,346,utRho07
dnaN,7765466,7765466,7764642,824,560,utRho07
dnaQ,471868,472134,471868,266,522,utRho07
dnaT,18406460,18406460,18406068,392,16,utRho07
dnaX,984112,984184,984112,72,410,utRho07
dosP,3131486,3131486,3131466,20,40,utRho07
dpiB,1303968,1304470,1303968,502,0,utRho07
dppA,7415740,7415740,7415410,330,2116,utRho07
dps,1697900,1697900,1697822,78,0,utRho07
dsbA,8086754,8086836,8086754,82,2220,utRho07
dsbB,2466294,2466294,2466060,234,24,utRho07
dsbC,6079266,6079266,6077644,1622,790,utRho07
dsbG,1277600,1277600,1277146,454,256,utRho07
dsdA,4958242,4958404,4958242,162,60,utRho07
dsdC,4955492,4955492,4955258,234,0,utRho07
dsdX,4955642,4955694,4955642,52,0,utRho07
dsrA,4050626,4050626,4050626,0,0,utRho07
dsrB,4049686,4049686,4049646,40,0,utRho07
dtpD,1485340,1485340,1485112,228,82,utRho07
dusA,8523200,8523338,8523200,138,1192,utRho07
dusB,6820492,6820560,6820492,68,176,utRho07
dusC,4460790,4460790,4460770,20,0,utRho07
dut,7627704,7627864,7627704,160,1546,utRho07
dxr,386670,387042,386670,372,990,utRho07
ebgA,6445102,6445266,6445102,164,48,utRho07
ebgR,6442874,6442932,6442874,58,94,utRho07
ecnB,8753018,8753106,8753018,88,200,utRho07
eco,4607594,4607810,4607594,216,0,utRho07
ecpA,621594,621594,621342,252,0,utRho07
ecpB,620238,620238,620052,186,8,utRho07
ecpR,622964,622964,622672,292,0,utRho07
eda,3866218,3866218,3865512,706,118,utRho07
edd,3869426,3869426,3869208,218,138,utRho07
efeO,2164308,2164486,2164308,178,8,utRho07
efeU_1,2162614,2162712,2162614,98,80,utRho07
efp,8751134,8751398,8751134,264,2978,utRho07
elaA,4763372,4763372,4763086,286,174,utRho07
elaD,4765308,4765426,4765308,118,0,utRho07
elfA,1995530,1995736,1995530,206,0,utRho07
elfD,1996642,1996980,1996642,338,0,utRho07
emrD,7707690,7707844,7707690,154,2,utRho07
emrK,4966896,4966896,4966678,218,0,utRho07
emrY,4964668,4964668,4964352,316,44,utRho07
emtA,2486250,2486360,2486250,110,0,utRho07
endA,12361100,12361388,12361100,288,0,utRho07
eno,5817692,5817692,5815882,1810,4596,utRho07
entC,1249662,1249770,1249662,108,0,utRho07
entD,1220508,1220508,1220158,350,0,utRho07
entH,1258584,1258600,1258584,16,0,utRho07
entS,1244506,1244600,1244506,94,0,utRho07
envR,6827266,6827266,6826930,336,0,utRho07
epd,12295292,12295292,12294764,528,56,utRho07
epmA,8765236,8765286,8765236,50,0,utRho07
epmB,8751406,8751406,8751314,92,1528,utRho07
eptB,7421162,7421162,7420950,212,0,utRho07
eptC,8300622,8300622,8300530,92,24,utRho07
erfK,4126708,4126708,4126646,62,56,utRho07
erpA,353122,353220,353122,98,32,utRho07
esrE,8039956,8039956,8039956,0,0,utRho07
essD,1153746,1154796,1153746,1050,20,utRho07
etk,2088606,2088606,2088420,186,0,utRho07
evgA,4967262,4967510,4967262,248,42,utRho07
exbB,6304028,6304028,6303968,60,0,utRho07
exbD,6302780,6302780,6302486,294,0,utRho07
exuR,6493016,6493304,6493016,288,124,utRho07
exuT,6490004,6490208,6490004,204,0,utRho07
fabA,2032996,2032996,2032940,56,98,utRho07
fabB,4883282,4883282,4883210,72,0,utRho07
fabH,2297032,2297518,2297032,486,2802,utRho07
fabI,2702236,2702236,2702078,158,92,utRho07
fadB,8062026,8062026,8061942,84,0,utRho07
fadD,3779614,3779614,3779492,122,0,utRho07
fadE,486812,486812,486606,206,0,utRho07
fadH,6463248,6463330,6463248,82,0,utRho07
fadI,4921022,4921022,4920938,84,0,utRho07
fadL,4922410,4922600,4922410,190,0,utRho07
fadM,928720,928804,928720,84,0,utRho07
fadR,2469810,2469876,2469810,66,0,utRho07
fbaB,4357334,4357334,4357128,206,0,utRho07
fdhE,8162722,8162722,8162456,266,1332,utRho07
fdhF,8598814,8598814,8598732,82,0,utRho07
fdnG,3094744,3094802,3094744,58,0,utRho07
fdrA,1093012,1093360,1093012,348,0,utRho07
feaB,2894994,2895038,2894994,44,0,utRho07
feaR,2894734,2894734,2894566,168,28,utRho07
fecA,9033454,9033454,9033354,100,4,utRho07
fecE,9023288,9023288,9022914,374,4640,utRho07
fecI,9036564,9036564,9036470,94,0,utRho07
feoA,7080114,7080326,7080114,212,0,utRho07
fepA,1225334,1225334,1224988,346,0,utRho07
fepB,1249454,1249454,1249020,434,8,utRho07
fepD,1244468,1244468,1244378,90,0,utRho07
fes,1225374,1225630,1225374,256,2,utRho07
ffh,5495706,5495706,5495590,116,828,utRho07
ffs,952576,952848,952576,272,2,utRho07
fhuA,334884,334968,334884,84,0,utRho07
fhuE,2323294,2323294,2323102,192,0,utRho07
fhuF,9211504,9211504,9211326,178,140,utRho07
fic,6983296,6983296,6982926,370,230,utRho07
fieF,8212864,8212938,8212864,74,0,utRho07
fimA,9085388,9086230,9085388,842,32,utRho07
fimB,9081334,9081914,9081334,580,324,utRho07
fimE,9083742,9084074,9083742,332,78,utRho07
fimZ,1129214,1129214,1128960,254,0,utRho07
fiu,1683296,1683296,1683062,234,0,utRho07
fixA,84650,84806,84650,156,0,utRho07
fkpA,6955050,6955050,6954838,212,8020,utRho07
fldA,2846084,2846084,2845860,224,2576,utRho07
fldB,6079644,6079710,6079644,66,0,utRho07
flgA,2261770,2261770,2261726,44,2,utRho07
flgB,2261986,2262036,2261986,50,0,utRho07
flgK,2276702,2276756,2276702,54,1050,utRho07
flgM,2260330,2260330,2260256,74,388,utRho07
flgN,2259828,2259828,2259660,168,18,utRho07
flhB,3932432,3932432,3932382,50,290,utRho07
flhC,3955864,3955864,3955688,176,82,utRho07
flhD,3957154,3957154,3956394,760,204,utRho07
fliA,4003638,4003638,4003578,60,128,utRho07
fliC,4007352,4007352,4007212,140,1190,utRho07
fliD,4007634,4007744,4007634,110,298,utRho07
fliE,4026186,4026186,4026028,158,4,utRho07
fliF,4026292,4026458,4026292,166,324,utRho07
fliL,4039168,4039236,4039168,68,94,utRho07
flk,4875824,4875900,4875824,76,0,utRho07
flu,4142634,4143078,4142634,444,0,utRho07
flxA,3292776,3292810,3292776,34,42,utRho07
fnr,2799104,2799104,2799052,52,28,utRho07
fnrS,2818258,2818258,2818258,0,0,utRho07
focA,1909628,1909628,1908932,696,360,utRho07
folA,99598,99646,99598,48,0,utRho07
folB,6409296,6409296,6409178,118,0,utRho07
folD,1115562,1115562,1115482,80,196,utRho07
folE,4487696,4487696,4487304,392,2846,utRho07
fpr,8228998,8228998,8228944,54,0,utRho07
frc,4986878,4986878,4986508,370,0,utRho07
frdA,8764824,8764824,8764636,188,0,utRho07
frdD,8758948,8758948,8758732,216,588,utRho07
fre,8052886,8053054,8052886,168,1790,utRho07
frlA,6999518,6999820,6999518,302,0,utRho07
frr,385624,385744,385624,120,1132,utRho07
frsA,513004,513054,513004,50,118,utRho07
fruB,4527194,4527194,4526990,204,40,utRho07
frvR,8179804,8179804,8179710,94,0,utRho07
fryA,5008986,5008986,5008970,16,0,utRho07
fsaA,1727060,1727284,1727060,224,0,utRho07
fsr,1009710,1009710,1009392,318,68,utRho07
ftnA,3977364,3977432,3977364,68,0,utRho07
ftnB,3973550,3973850,3973550,300,0,utRho07
ftsA,207122,207964,207122,842,316,utRho07
ftsB,5745802,5745802,5745640,162,0,utRho07
ftsH,6654204,6654204,6653870,334,606,utRho07
ftsK,1865858,1866448,1865858,590,1544,utRho07
ftsL,181376,182064,181376,688,2094,utRho07
ftsP,6325732,6325732,6325338,394,288,utRho07
ftsQ,205484,206310,205484,826,508,utRho07
ftsX,7204512,7204512,7204172,340,712,utRho07
ftsZ,209272,210610,209272,1338,148,utRho07
fucA,5867708,5867708,5867376,332,0,utRho07
fucP,5868238,5868470,5868238,232,2,utRho07
fumA,6753760,6753760,6753508,252,4816,utRho07
fumB,8694696,8694696,8694652,44,14,utRho07
fumC,3373418,3373418,3373176,242,0,utRho07
fur,2842892,2842892,2842584,308,7868,utRho07
fusA,6947370,6947370,6947028,342,35414,utRho07
fxsA,8737206,8737328,8737206,122,0,utRho07
gabD,5581824,5582546,5581824,722,920,utRho07
gadA,7335214,7335214,7335160,54,0,utRho07
gadB,3144144,3144144,3144090,54,4,utRho07
gadC,3141168,3141168,3140978,190,0,utRho07
gadE,7315600,7316732,7315600,1132,4,utRho07
gadW,7329562,7329562,7329236,326,0,utRho07
gadX,14663356,14663356,14663240,116,0,utRho07
gadY,7329728,7329728,7329728,0,0,utRho07
galE,1584354,1584354,1584110,244,0,utRho07
galF,4228702,4228702,4228654,48,0,utRho07
galM,1577796,1577796,1577674,122,446,utRho07
galP,6176510,6176568,6176510,58,0,utRho07
galR,5953138,5953198,5953138,60,88,utRho07
galS,4483420,4483420,4483336,84,0,utRho07
galU,2582810,2582914,2582810,104,454,utRho07
gapA,3724480,3725542,3724480,1062,4720,utRho07
garP,6549868,6549868,6549814,54,54,utRho07
gatY,4354468,4354468,4354408,60,104,utRho07
gatZ,4352864,4352864,4352642,222,16220,utRho07
gcd,282558,282558,282450,108,0,utRho07
gcl,1067814,1067832,1067814,18,0,utRho07
gcvA,5885278,5885278,5885134,144,0,utRho07
gcvB,5885392,5885392,5885392,0,0,utRho07
gcvR,5199758,5199812,5199758,54,34,utRho07
gcvT,6101544,6101544,6101334,210,1532,utRho07
gdhA,3684616,3684742,3684616,126,26,utRho07
gfcA,2099668,2099668,2099488,180,8,utRho07
gfcD,2096236,2096236,2095890,346,0,utRho07
ghrA,2195648,2195772,2195648,124,2,utRho07
ghrB,7434378,7434620,7434378,242,530,utRho07
glcA,6242728,6242728,6242558,170,4,utRho07
glcC,6256412,6256544,6256412,132,14,utRho07
glcD,6256152,6256152,6256042,110,0,utRho07
gldA,8278092,8278092,8278070,22,40,utRho07
glgA,7136784,7136784,7136066,718,454,utRho07
glgB,7147314,7147314,7147004,310,22,utRho07
glgC,7139142,7139142,7138656,486,66,utRho07
glgP,7133546,7133546,7133162,384,0,utRho07
glgS,6384024,6384024,6383878,146,0,utRho07
glgX,7142838,7142838,7142638,200,0,utRho07
glk,5018922,5018922,5018852,70,22,utRho07
glmS,7827622,7827622,7827336,286,6100,utRho07
glmU,7830652,7830652,7830400,252,116,utRho07
glmY,10765360,10765360,10765360,0,0,utRho07
glmZ,7972864,7972864,7972864,0,0,utRho07
glnA,16232888,16232888,16232136,752,736,utRho07
glnB,5375052,5375052,5374816,236,172,utRho07
glnD,377310,377310,377300,10,0,utRho07
glnE,6399602,6399602,6399282,320,0,utRho07
glnH,1696396,1696396,1696008,388,60,utRho07
glnK,945112,945196,945112,84,0,utRho07
glnL,8112742,8112742,8112678,64,20,utRho07
glnQ,1693262,1693262,1692926,336,342,utRho07
glnS,1411998,1412186,1411998,188,464,utRho07
gloA,3455602,3455674,3455602,72,0,utRho07
gloB,469852,469852,469564,288,430,utRho07
glpA,4705166,4705294,4705166,128,42,utRho07
glpD,7123942,7124026,7123942,84,24,utRho07
glpE,7123698,7123698,7123646,52,38,utRho07
glpF,8236322,8236322,8236180,142,306,utRho07
glpG,7122960,7122960,7122904,56,392,utRho07
glpR,7121782,7121782,7121210,572,132,utRho07
glpT,4704902,4704902,4704748,154,238,utRho07
glpX,8231212,8231212,8231158,54,2926,utRho07
glrK,5382246,5382246,5382196,50,0,utRho07
gltA,1509534,1509534,1508936,598,11270,utRho07
gltB,6709018,6709264,6709018,246,232,utRho07
gltI,1375792,1375792,1375494,298,1900,utRho07
gltP,8588536,8588962,8588536,426,786,utRho07
gltS,7657382,7657382,7657330,52,320,utRho07
gltX,5041568,5041568,5041344,224,184,utRho07
gluQ,320286,320286,320224,62,104,utRho07
glyA,5371148,5371148,5371014,134,88,utRho07
glyQ,7450708,7450708,7450636,72,150,utRho07
glyS,7448990,7448990,7448794,196,4218,utRho07
glyU,5998128,5998128,5998114,14,0,utRho07
glyV,8784626,8784720,8784626,94,66,utRho07
glyW,3984360,3984360,3984234,126,0,utRho07
gmhB,445612,445666,445612,54,26,utRho07
gmk,7642776,7642856,7642776,80,42,utRho07
gmr,2693686,2693686,2693484,202,0,utRho07
gnd,4202648,4202648,4202536,112,784,utRho07
gnsB,3275692,3275692,3275564,128,0,utRho07
gntK,14310580,14310580,14310368,212,60,utRho07
gntP,9102668,9102668,9102592,76,0,utRho07
gntR,7157760,7157760,7157452,308,226,utRho07
gntT,7092810,7093118,7092810,308,0,utRho07
gntU,7154170,7154170,7154122,48,0,utRho07
gntX,7089334,7089764,7089334,430,0,utRho07
gor,7292224,7292598,7292224,374,1294,utRho07
gpmA,1575340,1575340,1575190,150,0,utRho07
gpmM,7570374,7570520,7570374,146,0,utRho07
gpsA,7567620,7567620,7567322,298,11290,utRho07
gpt,511828,511954,511828,126,1010,utRho07
grcA,5433046,5433046,5432898,148,28,utRho07
greA,6657728,6657728,6657430,298,1586,utRho07
greB,7073488,7073624,7073488,136,68,utRho07
groL,8741566,8742050,8741566,484,1732,utRho07
groS,8741232,8741376,8741232,144,750,utRho07
grpE,5501494,5501494,5501416,78,42,utRho07
grxA,1781552,1781552,1781506,46,0,utRho07
grxB,2248206,2248206,2248108,98,36,utRho07
grxC,7569152,7569152,7568884,268,8442,utRho07
grxD,3468324,3468324,3468202,122,9336,utRho07
gspA,6911268,6911268,6910796,472,4,utRho07
gspC,6910964,6911156,6910964,192,2,utRho07
gss,6277220,6277220,6277044,176,4,utRho07
gstA,3428654,3428754,3428654,100,0,utRho07
gstB,1761038,1761038,1760960,78,0,utRho07
guaB,5268214,5268214,5268140,74,136,utRho07
gudD,5839026,5839026,5838770,256,0,utRho07
gyrA,4678914,4678914,4678840,74,0,utRho07
gyrB,7760300,7760300,7760238,62,68,utRho07
hcaE,5337964,5338064,5337964,100,32,utRho07
hcaR,5337928,5337928,5337792,136,68,utRho07
hcaT,5336106,5336106,5335692,414,178,utRho07
hchA,4071260,4071670,4071260,410,44,utRho07
hcp,1828258,1828258,1827628,630,0,utRho07
hcr,1824400,1824400,1824300,100,0,utRho07
hdeA,7313582,7313582,7313480,102,0,utRho07
hdeD,7313920,7313990,7313920,70,0,utRho07
hdfR,7896320,7896320,7895934,386,68,utRho07
hdhA,3396244,3396244,3396080,164,80,utRho07
helD,2048876,2048942,2048876,66,0,utRho07
hemA,2527166,2527428,2527166,262,52,utRho07
hemB,779722,779722,779454,268,22,utRho07
hemF,5106410,5106450,5106410,40,44,utRho07
hemH,996062,996110,996062,48,32,utRho07
hemL,349882,349882,349764,118,16,utRho07
hemN,8103886,8104090,8103886,204,104,utRho07
hepA,127176,127176,126528,648,1146,utRho07
hflD,2385372,2385372,2385262,110,642,utRho07
hfq,8799602,8800576,8799602,974,3044,utRho07
hha,961006,961006,960616,390,28,utRho07
hicA,3018442,3018572,3018442,130,0,utRho07
higA,6468682,6468682,6468288,394,54,utRho07
higB,6468960,6468960,6468910,50,0,utRho07
hinT,2323642,2323770,2323642,128,12,utRho07
hipB,3184964,3184964,3184884,80,24,utRho07
hisB,4186720,4186936,4186720,216,814,utRho07
hisJ,4853674,4853674,4853576,98,52,utRho07
hisL,8359856,8359984,8359856,128,128,utRho07
hisS,5281284,5281284,5281150,134,246,utRho07
hlpA,400910,400964,400910,54,110,utRho07
hlyE,2460932,2460932,2460788,144,44,utRho07
hmp,5371594,5371670,5371594,76,0,utRho07
hns,2585916,2585916,2585844,72,1262,utRho07
hofM,7045856,7045856,7045502,354,0,utRho07
hokA,7441620,7441620,7441200,420,136,utRho07
hokC,33902,33902,33806,96,408,utRho07
hokE,1215462,1215672,1215462,210,0,utRho07
holC,8968546,8968546,8968560,14,850,utRho07
holD,9215562,9215606,9215562,44,26,utRho07
holE,3850040,3850216,3850040,176,194,utRho07
hpt,282720,282862,282720,142,24,utRho07
hrpB,324150,324210,324150,60,158,utRho07
hscB,5319048,5319048,5318934,114,1466,utRho07
hscC,1367188,1367188,1366786,402,458,utRho07
hsdS,9163004,9163004,9162924,80,38,utRho07
hslJ,2883560,2883560,2883486,74,126,utRho07
hslO,7059344,7059548,7059344,204,7650,utRho07
hslR,7058220,7058696,7058220,476,1534,utRho07
hslV,8244708,8244708,8244574,134,310,utRho07
hsrA,7881412,7881412,7881224,188,32,utRho07
htgA,21286,21660,21286,374,140,utRho07
htpG,989634,990240,989634,606,4820,utRho07
htpX,3825236,3825236,3825152,84,8,utRho07
htrE,311036,311036,310852,184,0,utRho07
htrL,7587668,7587668,7587366,302,24,utRho07
hupA,8400352,8400562,8400352,210,102,utRho07
hupB,1845220,1845804,1845220,584,308,utRho07
hyaA,2063968,2064278,2063968,310,0,utRho07
hybO,6292726,6292726,6292522,204,386,utRho07
hycA,5700922,5700922,5700870,52,0,utRho07
hycI,5686204,5686204,5686086,118,4,utRho07
hydN,5676264,5676264,5676210,54,0,utRho07
hyfA,5202342,5202402,5202342,60,0,utRho07
hypA,11402508,11402588,11402508,80,0,utRho07
hypB,11403356,11404004,11403356,648,268,utRho07
hypF,5676210,5676210,5674850,1360,290,utRho07
hypT,9116634,9116634,9116578,56,0,utRho07
hyuA,6019660,6020056,6019660,396,0,utRho07
iaaA,1733074,1733136,1733074,62,0,utRho07
iadA,9119074,9119074,9119052,22,32,utRho07
iap,5753072,5753162,5753072,90,20,utRho07
ibaG,6673966,6673966,6673606,360,336,utRho07
ibpA,7735036,7735036,7734844,192,46,utRho07
ibpB,7733962,7733962,7733794,168,124,utRho07
icd,2389922,2390246,2389922,324,430,utRho07
iclR,8447304,8447304,8447256,48,12,utRho07
idi,6065876,6066130,6065876,254,0,utRho07
idnD,8988870,8988870,8988812,58,0,utRho07
idnK,8989194,8989246,8989194,52,0,utRho07
ihfA,3591442,3591442,3591104,338,970,utRho07
ihfB,1927498,1927656,1927498,158,1000,utRho07
ileS,43666,44782,43666,1116,3864,utRho07
ileX,6431194,6431196,6431194,2,22,utRho07
ilvA,15820940,15821324,15820940,384,0,utRho07
ilvC,7915824,7915940,7915824,116,0,utRho07
ilvE,15809552,15809936,15809552,384,52,utRho07
ilvI,170840,171260,170840,420,0,utRho07
ilvL,23701308,23701932,23701308,624,12,utRho07
ilvY,7915734,7915734,7915640,94,0,utRho07
inaA,4698998,4698998,4698944,54,6,utRho07
infA,1853370,1853370,1852886,484,2502,utRho07
infC,3602692,3602692,3601276,1416,5316,utRho07
insA-5,3958452,3958452,3958430,22,2,utRho07
insA-7,9036758,9037054,9036758,296,36,utRho07
insC-5,6372080,6372284,6372080,204,98,utRho07
insEF-2,785238,785238,785820,582,64,utRho07
insEF-4,2190310,2190310,2190892,582,78,utRho07
insG,9007098,9007098,9006862,236,0,utRho07
insH-1,550596,550596,550234,362,32,utRho07
insH-11,7306538,7306538,7306396,142,38,utRho07
insH-2,1151548,1151548,1151506,42,26,utRho07
insH-3,1378444,1378444,1378026,418,36,utRho07
insH-4,2791942,2792152,2791942,210,28,utRho07
insH-5,2857852,2857852,2857452,400,0,utRho07
insH-6,4135022,4135022,4134642,380,0,utRho07
insH-7,4206186,4206186,4205822,364,5458,utRho07
insH-9,6260050,6260356,6260050,306,46,utRho07
insI-3,9017372,9017372,9017234,138,0,utRho07
insJ,7441188,7441360,7441188,172,48,utRho07
insK,7442130,7442308,7442130,178,0,utRho07
insL-1,30760,30890,30760,130,436,utRho07
insL-2,1216112,1216130,1216112,18,22,utRho07
insL-3,5028644,5028662,5028644,18,82,utRho07
insN-1,540452,540484,540452,32,0,utRho07
intD,1132202,1132202,1131956,246,8,utRho07
intR,2826520,2826520,2826470,50,0,utRho07
intS,4933026,4933090,4933026,64,94,utRho07
intZ,5117386,5117542,5117386,156,12,utRho07
iraD,9113152,9113986,9113152,834,0,utRho07
iraM,2424246,2424246,2424006,240,18,utRho07
iraP,802638,802772,802638,134,0,utRho07
iscA,5319924,5319924,5319772,152,2484,utRho07
iscR,5324398,5324398,5324262,136,15748,utRho07
iscX,5313834,5313834,5313472,362,3522,utRho07
ispF,5743968,5743968,5743560,408,1446,utRho07
ispG,5283908,5283908,5283608,300,574,utRho07
ispU,389568,389806,389568,238,288,utRho07
isrA,2811502,2811502,2811618,116,78,utRho07
istr-1,7706384,7706384,7706384,0,0,utRho07
istr-2,7706514,7706514,7706514,0,0,utRho07
ivbL,15412092,15412092,15411952,140,1112,utRho07
ivy,480638,480686,480638,48,0,utRho07
katE,3627628,3627734,3627628,106,30,utRho07
katG,8267624,8267670,8267624,46,12,utRho07
kbaZ,6557732,6557828,6557732,96,0,utRho07
kbl,7585154,7585154,7585102,52,384,utRho07
kch,2621046,2621046,2620538,508,0,utRho07
kdgR,3820506,3820506,3820198,308,22,utRho07
kdpE,1443788,1443788,1443466,322,0,utRho07
kdpF,1457698,1457698,1457642,56,0,utRho07
kdsA,2535708,2536330,2535708,622,1554,utRho07
kdsC,6683438,6684546,6683438,1108,2648,utRho07
kduI,5968388,5968388,5968248,140,148,utRho07
kefF,94160,94492,94160,332,52,utRho07
kgtP,5451624,5451624,5451492,132,36,utRho07
kup,7862206,7862632,7862206,426,12,utRho07
lacI,735076,735076,735020,56,0,utRho07
lacZ,1465508,1465508,1465220,288,0,utRho07
ldcA,2486394,2486394,2486160,234,46,utRho07
ldhA,2885830,2885830,2885686,144,0,utRho07
ldrA,2538954,2538954,2538550,404,504,utRho07
ldrB,2540024,2540024,2539620,404,36,utRho07
ldrC,2541092,2541092,2540690,402,310,utRho07
ldrD,7400544,7400544,7400174,370,166,utRho07
lepA,5414392,5414392,5414248,144,108,utRho07
lepB,5410928,5410928,5410618,310,1106,utRho07
leuD,159188,159188,158906,282,66,utRho07
leuE,3761600,3761600,3761518,82,0,utRho07
leuL,168048,168048,167416,632,0,utRho07
leuO,168308,168736,168308,428,0,utRho07
leuQ,9212864,9212864,9212802,62,2,utRho07
leuU,6644556,6644556,6644316,240,2392,utRho07
leuV,9212546,9212546,9212330,216,1300,utRho07
leuX,8992772,8992810,8992772,38,0,utRho07
lexA,8514174,8514230,8514174,56,2,utRho07
lhr,3456706,3458174,3456706,1468,2044,utRho07
ligA,5060402,5060402,5060352,50,0,utRho07
ligB,7642576,7642576,7642340,236,0,utRho07
lipA,1320602,1320602,1320432,170,24,utRho07
lipB,1324802,1324802,1324556,246,1184,utRho07
lit,2397032,2397390,2397032,358,40,utRho07
livJ,7199524,7199524,7199316,208,36,utRho07
livK,7195510,7195510,7195120,390,44,utRho07
lldP,7554578,7554798,7554578,220,2816,utRho07
lnt,1381968,1381968,1381762,206,288,utRho07
loiP,6163784,6163826,6163784,42,44,utRho07
lolA,1874656,1874738,1874656,82,396,utRho07
lolB,2527112,2527112,2527000,112,56,utRho07
lolC,2350748,2350854,2350748,106,0,utRho07
lon,917630,917776,917630,146,672,utRho07
lpcA,486936,487086,486936,150,20,utRho07
lpd,255434,255824,255434,390,2146,utRho07
lplA,9248476,9248476,9248234,242,1244,utRho07
lplT,5947878,5947878,5947724,154,36,utRho07
lpoA,6586422,6586800,6586422,378,34,utRho07
lpp,3514592,3514842,3514592,250,144,utRho07
lptA,6686598,6686760,6686598,162,762,utRho07
lptB,6686792,6687888,6686792,1096,1460,utRho07
lptD,114672,114672,114218,454,2476,utRho07
lptF,8972244,8972436,8972244,192,36,utRho07
lpxC,213016,213114,213016,98,7824,utRho07
lpxD,401920,401942,401920,22,64,utRho07
lpxL,2233418,2233418,2233164,254,24,utRho07
lpxM,3880456,3880456,3880386,70,32,utRho07
lpxP,4991156,4991290,4991156,134,132,utRho07
lrhA,4813312,4813312,4813282,30,0,utRho07
lrp,1864656,1865190,1864656,534,670,utRho07
lspA,50028,50414,50028,386,510,utRho07
lsrA,3202920,3202980,3202920,60,0,utRho07
lsrR,3202514,3202514,3202482,32,0,utRho07
ltaE,1818640,1818640,1818588,52,0,utRho07
luxS,5630130,5630130,5629466,664,828,utRho07
lysA,5957902,5957902,5957798,104,0,utRho07
lysC,8467232,8467232,8466466,766,196,utRho07
lysP,4497120,4497120,4497064,56,38,utRho07
lysR,5957900,5958042,5957900,142,0,utRho07
lysT,1561028,1561108,1561028,80,96,utRho07
lysU,8709610,8709610,8709434,176,0,utRho07
macB,1840188,1840694,1840188,506,348,utRho07
maeA,3111484,3111484,3111338,146,3524,utRho07
mak,820236,820288,820236,52,0,utRho07
malE,8492928,8492928,8492838,90,0,utRho07
malI,3398456,3398456,3398360,96,0,utRho07
malK,8493472,8493568,8493472,96,0,utRho07
malP,7105020,7105020,7104946,74,166,utRho07
malQ,7100798,7100798,7100140,658,38,utRho07
malS,14949880,14949988,14949880,108,0,utRho07
malT,7106048,7106170,7106048,122,118,utRho07
malX,3398626,3398710,3398626,84,0,utRho07
malZ,1689980,1690072,1689980,92,332,utRho07
manA,3377102,3377152,3377102,50,56,utRho07
manX,3803866,3804096,3803866,230,0,utRho07
marC,3237882,3237882,3237816,66,38,utRho07
marR,3238186,3238240,3238186,54,0,utRho07
matP,2036918,2036970,2036918,52,4,utRho07
mazE,5822736,5822736,5822678,58,46,utRho07
mazG,5821720,5821720,5821370,350,2236,utRho07
mcbA,1684306,1684306,1684112,194,0,utRho07
mcbR,3040192,3040524,3040192,332,0,utRho07
mcrA,2420278,2420692,2420278,414,0,utRho07
mcrC,9156124,9156124,9155916,208,142,utRho07
mdaB,6344814,6345060,6344814,246,0,utRho07
mdfA,1767138,1767346,1767138,208,0,utRho07
mdh,6768940,6768940,6768536,404,246,utRho07
mdoB,9198988,9198988,9198882,106,660,utRho07
mdoD,2993290,2993712,2993290,422,0,utRho07
mdoG,2218514,2218670,2218514,156,10,utRho07
mdtA,4307958,4308032,4307958,74,44,utRho07
mdtE,7318168,7318464,7318168,296,122,utRho07
mdtK,3486538,3486914,3486538,376,122,utRho07
mdtP,8602472,8602472,8602060,412,0,utRho07
melA,8683774,8683822,8683774,48,0,utRho07
melR,8683300,8683300,8683256,44,0,utRho07
menA,8240812,8240812,8240698,114,24,utRho07
menB,4753774,4753774,4753638,136,354,utRho07
mepH,3468714,3468870,3468714,156,0,utRho07
mepM,3883666,3883666,3883270,396,496,utRho07
mepS,4539840,4539958,4539840,118,118,utRho07
metA,8428318,8428560,8428318,242,0,utRho07
metB,8257272,8257344,8257272,72,1374,utRho07
metC,6304150,6304472,6304150,322,0,utRho07
metE,8025768,8026106,8025768,338,250,utRho07
metF,8265092,8265232,8265092,140,0,utRho07
metG,4388538,4388600,4388538,62,230,utRho07
metH,8447010,8447656,8447010,646,2048,utRho07
metJ,8257116,8257116,8256790,326,26,utRho07
metK,6173154,6173412,6173154,258,134,utRho07
metN,445428,445428,445290,138,0,utRho07
metR,8025710,8025710,8025632,78,0,utRho07
metT,1394326,1394326,1394266,60,158,utRho07
metY,19910250,19910250,19909734,516,654,utRho07
metZ,11789528,11789548,11789528,20,96,utRho07
mfd,2348056,2348056,2347928,128,16,utRho07
mglA,4478782,4478782,4478578,204,158,utRho07
mglB,4481132,4481132,4480696,436,7446,utRho07
mglC,4475918,4475918,4475506,412,72,utRho07
mgrB,3817584,3817584,3817532,52,0,utRho07
mgrR,3245828,3245828,3245828,0,0,utRho07
mgsA,2054082,2054082,2054030,52,36,utRho07
mgtL,8934560,8934862,8934560,302,22,utRho07
mhpA,737038,737222,737038,184,0,utRho07
mhpR,737072,737072,736840,232,0,utRho07
mhpT,750772,750918,750772,146,52,utRho07
miaA,8797964,8798504,8797964,540,356,utRho07
micA,5629604,5629604,5629604,0,0,utRho07
micC,2874242,2874238,2874242,4,0,utRho07
micF,4626168,4626168,4626168,0,0,utRho07
micM,1014408,1014408,1014408,0,0,utRho07
minE,2449422,2449422,2449090,332,1038,utRho07
mioC,7852950,7852950,7852910,40,0,utRho07
mipA,3733012,3733012,3732944,68,3428,utRho07
mlaA,4930270,4930270,4930014,256,0,utRho07
mlc,3337206,3337206,3337128,78,0,utRho07
mlrA,4429498,4429732,4429498,234,0,utRho07
mltA,5894546,5894546,5894356,190,0,utRho07
mltD,468050,468050,467910,140,28,utRho07
mltF,5391534,5391602,5391534,68,0,utRho07
mmuP,550238,550650,550238,412,32,utRho07
mngA,1531622,1531968,1531622,346,0,utRho07
mngR,1531852,1531852,1531750,102,0,utRho07
mnmG,7851348,7851348,7851266,82,1952,utRho07
mntH,5025470,5025470,5025412,58,0,utRho07
mntP,3810918,3811376,3810918,458,194,utRho07
mntR,1706160,1706366,1706160,206,0,utRho07
mntS,1706128,1706128,1705994,134,0,utRho07
moaA,1633654,1634088,1633654,434,336,utRho07
moaB,1635954,1636110,1635954,156,964,utRho07
mobA,8084242,8084242,8083998,244,0,utRho07
mocA,6030112,6030320,6030112,208,0,utRho07
modA,1589990,1590178,1589990,188,92,utRho07
moeA,1732788,1732788,1732728,60,128,utRho07
mokB,2984610,2984610,2984258,352,336,utRho07
molR_1,4392888,4392948,4392888,60,24,utRho07
motA,3954604,3954604,3954278,326,106,utRho07
mpaA,2781278,2781278,2781196,82,0,utRho07
mpl,8911456,8911570,8911456,114,0,utRho07
mppA,2786108,2786454,2786108,346,0,utRho07
mprA,5621494,5621540,5621494,46,276,utRho07
mqo,4613848,4613848,4613508,340,4,utRho07
mqsA,6336742,6336742,6336492,250,184,utRho07
mqsR,6337306,6337306,6337088,218,144,utRho07
mraZ,179192,179268,179192,76,0,utRho07
mrcA,7045652,7045742,7045652,90,0,utRho07
mrcB,329442,329460,329442,18,0,utRho07
mreB,13605424,13605424,13604348,1076,1928,utRho07
mreD,6798166,6798166,6797750,416,234,utRho07
mrp,4388360,4388360,4388336,24,0,utRho07
mscK,972984,973072,972984,88,0,utRho07
mscL,6876002,6876048,6876002,46,124,utRho07
mscS,6139742,6139742,6139614,128,30,utRho07
msrA,8884522,8884522,8884352,170,262,utRho07
msrB,3725168,3725168,3724858,310,20,utRho07
msyB,2228426,2228426,2228362,64,28,utRho07
mtfA,4087236,4087302,4087236,66,2228,utRho07
mtgA,6699662,6699662,6699618,44,32,utRho07
mtlA,30177504,30178248,30177504,744,1000,utRho07
mtn,358366,358366,358306,60,0,utRho07
mtr,6611864,6611864,6611634,230,6,utRho07
mug,6430992,6430992,6430946,46,0,utRho07
murQ,5091466,5091546,5091466,80,0,utRho07
murR,5091586,5091586,5091218,368,0,utRho07
mutH,5939164,5939324,5939164,160,288,utRho07
mutL,8794092,8794824,8794092,732,676,utRho07
mutM,7622554,7622554,7622304,250,1660,utRho07
mutS,5714038,5714186,5714038,148,788,utRho07
mutY,18617466,18618078,18617466,612,54,utRho07
nac,4123956,4123956,4123866,90,0,utRho07
nadA,1564122,1564170,1564122,48,0,utRho07
nadB,5420714,5420840,5420714,126,0,utRho07
nadC,237326,237326,237290,36,18,utRho07
nadE,3644604,3644916,3644604,312,0,utRho07
nadK,5501526,5501662,5501526,136,118,utRho07
nagA,1406350,1406350,1405502,848,4524,utRho07
nagB,1407416,1407416,1407222,194,28,utRho07
nagC,1404016,1404016,1403188,828,82,utRho07
nagE,1407680,1407888,1407680,208,0,utRho07
nagK,2357080,2357186,2357080,106,62,utRho07
nanA,6747240,6747240,6747152,88,34,utRho07
nanC,9079856,9079856,9079002,854,4,utRho07
nanR,6749406,6749406,6748978,428,36,utRho07
nanS,9075406,9075406,9075188,218,0,utRho07
napF,4607390,4607390,4606994,396,0,utRho07
narG,2559614,2559728,2559614,114,0,utRho07
narK,2555642,2555914,2555642,272,0,utRho07
narP,4580844,4581000,4580844,156,64,utRho07
narQ,5171154,5171462,5171154,308,2,utRho07
narU,3088326,3088326,3088120,206,0,utRho07
narW,3077374,3077374,3074618,2756,116,utRho07
narX,2555554,2555554,2555236,318,0,utRho07
narZ,3085380,3085380,3085180,200,0,utRho07
ndh,2331984,2332170,2331984,186,4,utRho07
ndk,5289920,5289920,5289728,192,98,utRho07
nemR,6904084,6904092,6904084,8,0,utRho07
nepI,7683542,7683542,7683478,64,2,utRho07
nfo,4501612,4501680,4501612,68,0,utRho07
nfsB,1210906,1210906,1210848,58,8,utRho07
nfuA,7090916,7091248,7090916,332,666,utRho07
nhaA,34634,34978,34634,344,22,utRho07
nhaB,2469534,2469534,2469434,100,0,utRho07
nhoA,3067926,3068048,3067926,122,0,utRho07
nikA,7226878,7227334,7226878,456,1142,utRho07
nikR,7237074,7237176,7237074,102,206,utRho07
nirB,6987974,6988022,6987974,48,0,utRho07
nlpA,7680034,7680034,7679986,48,0,utRho07
nlpC,3585654,3585654,3585462,192,50,utRho07
nlpD,5737658,5737658,5737506,152,6,utRho07
nlpI,6618080,6618080,6617848,232,40,utRho07
nmpC,1153740,1153740,1153650,90,36,utRho07
nohA,3273206,3273206,3272734,472,0,utRho07
norR,5664614,5664614,5664578,36,0,utRho07
norV,5664878,5664952,5664878,74,0,utRho07
nrdA,4689510,4689730,4689510,220,10384,utRho07
nrdD,8925676,8925676,8925320,356,1086,utRho07
nrdH,5601312,5601446,5601312,134,146,utRho07
nrdR,865954,866004,865954,50,0,utRho07
nrfA,8575342,8575528,8575342,186,0,utRho07
nsrR,8812088,8812380,8812088,292,854,utRho07
nudB,3897348,3897348,3897264,84,106,utRho07
nudC,8393428,8393806,8393428,378,64,utRho07
nudE,7052658,7052658,7052298,360,662,utRho07
nudG,3682876,3682980,3682876,104,0,utRho07
nudI,4729050,4729108,4729050,58,0,utRho07
nudJ,2388874,2388874,2388576,298,524,utRho07
nuoA,4810670,4810670,4810144,526,4490,utRho07
nuoN,4783434,4783434,4783010,424,1212,utRho07
nupC,5026018,5026084,5026018,66,0,utRho07
nupG,6211302,6211428,6211302,126,24,utRho07
ogrK,4335096,4335096,4335040,56,0,utRho07
ogt,2800568,2800568,2800472,96,72,utRho07
ohsC,5401036,5401040,5401036,4,0,utRho07
ompA,2040382,2040382,2040106,276,25358,utRho07
ompC,4625774,4625774,4625498,276,32,utRho07
ompF,1974184,1974184,1973964,220,318,utRho07
ompL,8128958,8128958,8128590,368,0,utRho07
ompN,2874158,2874158,2873786,372,0,utRho07
ompR,7073510,7073510,7073168,342,198,utRho07
ompT,1171330,1171330,1171266,64,0,utRho07
ompW,2627982,2628040,2627982,58,0,utRho07
ompX,1700418,1700900,1700418,482,798,utRho07
omrA,5952378,5952378,5952378,0,0,utRho07
omrB,5952770,5952770,5952770,0,0,utRho07
oppA,2602170,2602364,2602170,194,8196,utRho07
orn,8783168,8783208,8783168,40,54,utRho07
osmB,2686952,2686952,2686656,296,98,utRho07
osmC,3113192,3113250,3113192,58,4,utRho07
osmE,3644566,3644566,3644512,54,0,utRho07
osmF,4439046,4439046,4438962,84,690,utRho07
osmY,9222306,9222792,9222306,486,36,utRho07
otsA,3963302,3963302,3963224,78,34,utRho07
otsB,3964930,3964930,3964774,156,116,utRho07
oxc,4984288,4984288,4983900,388,48,utRho07
oxyR,8316914,8316980,8316914,66,0,utRho07
oxyS,8316788,8316788,8316788,0,0,utRho07
paaA,2907730,2907854,2907730,124,0,utRho07
paaX,2927018,2927078,2927018,60,0,utRho07
paaZ,2907340,2907340,2907284,56,0,utRho07
pabA,6981702,6981702,6981658,44,0,utRho07
pabB,3789256,3789610,3789256,354,176,utRho07
pabC,2306186,2306600,2306186,414,510,utRho07
pagP,1313052,1313114,1313052,62,0,utRho07
panB,299260,299260,299202,58,54,utRho07
panC,297840,297840,297590,250,586,utRho07
panD,293490,293490,293388,102,0,utRho07
panZ,7195656,7195968,7195656,312,18,utRho07
parC,6332060,6332060,6331946,114,118,utRho07
patA,6438916,6438988,6438916,72,0,utRho07
patD,3030830,3031156,3030830,326,0,utRho07
pbpC,5294986,5294986,5294650,336,16,utRho07
pbpG,4450132,4450132,4449740,392,0,utRho07
pck,7065358,7065636,7065358,278,3012,utRho07
pcnB,318782,318782,318252,530,420,utRho07
pdhR,244068,244184,244068,116,0,utRho07
pdxB,4875768,4875768,4875702,66,26,utRho07
pdxH,3436068,3436068,3436014,54,380,utRho07
pdxJ,5403626,5403626,5403458,168,66,utRho07
pdxK,5074638,5074638,5074474,164,0,utRho07
pepA,8972278,8972278,8971902,376,86,utRho07
pepD,511618,511618,511432,186,5776,utRho07
pepN,1981182,1981244,1981182,62,28,utRho07
pepQ,8062294,8062322,8062294,28,0,utRho07
pepT,2371646,2371688,2371646,42,0,utRho07
pfkA,8214948,8215104,8214948,156,300,utRho07
pfkB,3612646,3612740,3612646,94,0,utRho07
pflA,1902456,1902456,1902160,296,0,utRho07
pflB,1907850,1907850,1907108,742,874,utRho07
pflD,8287716,8287990,8287716,274,0,utRho07
pgaA,2185046,2185046,2184578,468,2,utRho07
pgi,8467444,8467516,8467444,72,0,utRho07
pgk,12291428,12291428,12290488,940,4184,utRho07
pgl,1597078,1597172,1597078,94,0,utRho07
pgpB,2678324,2678660,2678324,336,72,utRho07
pgpC,5397276,5397276,5397100,176,0,utRho07
pgrR,2783744,2783982,2783744,238,0,utRho07
pheL,5475158,5475198,5475158,40,0,utRho07
pheM,7197204,7197204,7197080,124,132,utRho07
pheP,1203858,1203918,1203858,60,0,utRho07
pheU,8725254,8725254,8725252,2,0,utRho07
pheV,6220730,6220732,6220730,2,0,utRho07
phnC,8650412,8650412,8650330,82,0,utRho07
phoA,803414,803494,803414,80,28,utRho07
phoB,834202,834284,834202,82,0,utRho07
phoE,520316,520316,520200,116,14,utRho07
phoH,2169730,2169984,2169730,254,0,utRho07
phoP,2381016,2381016,2380894,122,618,utRho07
phoQ,2379880,2379880,2379552,328,1498,utRho07
phoU,7815330,7815330,7815156,174,98,utRho07
phr,1478842,1479014,1478842,172,0,utRho07
pinE,2419054,2419370,2419054,316,0,utRho07
pinQ,3267168,3267244,3267168,76,0,utRho07
pinR,2867424,2867424,2867348,76,0,utRho07
pitA,7275224,7275284,7275224,60,0,utRho07
pitB,6272806,6272806,6272742,64,8,utRho07
pka,5439862,5439906,5439862,44,28,utRho07
plaP,4174476,4174476,4174124,352,1680,utRho07
pldA,8009628,8009724,8009628,96,0,utRho07
pldB,8018028,8018340,8018028,312,2,utRho07
plsB,8513196,8513196,8512932,264,318,utRho07
pmbA,8915890,8915918,8915890,28,0,utRho07
pmrD,4747148,4747148,4747076,72,0,utRho07
pncB,1980828,1980828,1980712,116,18,utRho07
pncC,5648788,5648788,5648692,96,0,utRho07
pnp,6622652,6622652,6622336,316,164,utRho07
pntA,3355950,3355950,3355806,144,0,utRho07
pntB,3353096,3353096,3352720,376,6,utRho07
polA,8093880,8093932,8093880,52,72,utRho07
polB,131606,131606,131560,46,0,utRho07
potD,2365700,2365700,2365658,42,50,utRho07
potE,1436688,1436688,1436530,158,0,utRho07
potF,1787268,1787568,1787268,300,0,utRho07
poxB,1822152,1822152,1822098,54,0,utRho07
ppa,8899372,8899372,8899304,68,166,utRho07
ppc,8306380,8306380,8306196,184,134,utRho07
ppdA,5928440,5928440,5928354,86,56,utRho07
ppdD,235410,235410,235098,312,64,utRho07
pphA,3846770,3846770,3845938,832,1962,utRho07
pphB,5719474,5719520,5719474,46,0,utRho07
ppiA,6984898,6984898,6984594,304,0,utRho07
ppiC,7919682,7919682,7919626,56,116,utRho07
ppiD,923638,923830,923638,192,1168,utRho07
ppk,5245748,5246088,5245748,340,354,utRho07
pppA,6228958,6228958,6228704,254,0,utRho07
ppsA,3574322,3574322,3574224,98,0,utRho07
ppsR,3574678,3574890,3574678,212,0,utRho07
pptA,3065716,3066104,3065716,388,8,utRho07
pqiA,2023318,2024002,2023318,684,140,utRho07
prc,3830054,3830054,3829632,422,30562,utRho07
preT,4467978,4468066,4467978,88,0,utRho07
prfC,9218688,9218828,9218688,140,1210,utRho07
prkB,6968622,6968980,6968622,358,966,utRho07
prlC,7290476,7290476,7290364,112,164,utRho07
prlF,6553944,6554004,6553944,60,42,utRho07
proB,520432,520776,520432,344,112,utRho07
proC,811372,811372,811288,84,0,utRho07
proK,7417388,7417388,7417384,4,2,utRho07
proL,4572414,4572422,4572414,8,0,utRho07
proP,8660640,8661004,8660640,364,378,utRho07
proS,437674,437674,437550,124,594,utRho07
proV,5609126,5609630,5609126,504,56,utRho07
prpB,697292,697364,697292,72,0,utRho07
prpR,696942,696942,696886,56,0,utRho07
prs,2524354,2524354,2523750,604,61380,utRho07
psd,8781276,8781276,8780720,556,2734,utRho07
psiE,8480600,8480650,8480600,50,0,utRho07
pspA,2736076,2736158,2736076,82,4,utRho07
pspF,2736080,2736080,2735824,256,0,utRho07
pspG,8525632,8525680,8525632,48,0,utRho07
pssA,5445156,5445454,5445156,298,1528,utRho07
pstB,7817112,7817112,7816732,380,52,utRho07
pstC,7821084,7821084,7820796,288,4,utRho07
pstS,23469408,23469408,23469150,258,0,utRho07
psuG,4517114,4517114,4516734,380,144,utRho07
psuT,4514992,4514992,4514670,322,0,utRho07
pth,2517084,2517084,2517026,58,0,utRho07
ptrA,5918022,5918022,5917768,254,0,utRho07
ptrB,3857730,3857730,3857678,52,462,utRho07
ptsG,2315252,2315738,2315252,486,1854,utRho07
ptsH,5066996,5067528,5066996,532,3426,utRho07
purA,8809328,8809374,8809328,46,8,utRho07
purC,5195562,5195562,5195236,326,88,utRho07
purD,8411972,8411972,8411862,110,26,utRho07
purE,1106284,1106284,1106200,84,802,utRho07
purH,8415254,8415254,8415064,190,52,utRho07
purL,5391178,5391178,5391086,92,370,utRho07
purM,5242306,5242394,5242306,88,68,utRho07
purR,3475378,3475688,3475378,310,472,utRho07
purT,3861438,3861762,3861438,324,0,utRho07
purU,2577512,2577512,2577248,264,646,utRho07
putA,2157850,2157850,2157764,86,0,utRho07
putP,2158336,2158610,2158336,274,518,utRho07
puuA,2721936,2721936,2721816,120,0,utRho07
puuC,2725456,2725486,2725456,30,0,utRho07
puuD,2722104,2722240,2722104,136,0,utRho07
puuP,2718746,2718746,2718374,372,374,utRho07
pykA,3874988,3875298,3874988,310,148,utRho07
pykF,3510934,3511396,3510934,462,1072,utRho07
pyrC,2245286,2245286,2245214,72,190,utRho07
pyrD,2009464,2009536,2009464,72,0,utRho07
pyrE,7631970,7631970,7631536,434,4,utRho07
pyrF,2683740,2683842,2683740,102,386,utRho07
pyrG,5819594,5819594,5819332,262,578,utRho07
pyrH,383624,383710,383624,86,2646,utRho07
pyrL,8945490,8945490,8945066,424,0,utRho07
qmcA,1031646,1031646,1031546,100,0,utRho07
qor,8528608,8528608,8528462,146,96,utRho07
qseB,6339502,6339656,6339502,154,0,utRho07
queA,849970,850022,849970,52,222,utRho07
queE,5811212,5811212,5810836,376,38,utRho07
queF,5850642,5850696,5850642,54,6,utRho07
queG,8788184,8788184,8788134,50,512,utRho07
racC,2835630,2835630,2835526,104,0,utRho07
racR,2840898,2840898,2840482,416,0,utRho07
raiA,5474208,5474308,5474208,100,0,utRho07
rarD,8008594,8008594,8008356,238,0,utRho07
ravA,7862256,7862256,7862186,70,0,utRho07
rayT,495088,495274,495088,186,0,utRho07
rbn,4763162,4763216,4763162,54,0,utRho07
rbsD,7866644,7866702,7866644,58,0,utRho07
rcnA,4371654,4371834,4371654,180,0,utRho07
rcnB,4373768,4373920,4373768,152,0,utRho07
rcnR,4371806,4371806,4371592,214,0,utRho07
rcsA,4047672,4047936,4047672,264,126,utRho07
rcsB,4631390,4632354,4631390,964,820,utRho07
rcsC,4640162,4640162,4639656,506,194,utRho07
rcsD,4626904,4626976,4626904,72,24,utRho07
rdgB,6193240,6193362,6193240,122,602,utRho07
rdlA,2538646,2538646,2538646,0,0,utRho07
rdlB,2539712,2539716,2539712,4,0,utRho07
rdlC,2540782,2540786,2540782,4,0,utRho07
rdlD,7400272,7400272,7400272,0,0,utRho07
rdoA,8084782,8084830,8084782,48,0,utRho07
recA,11295276,11295276,11295076,200,412,utRho07
recC,5925014,5925014,5924856,158,80,utRho07
recF,7763722,7763722,7762442,1280,8602,utRho07
recN,5503518,5503590,5503518,72,60,utRho07
recQ,8011666,8011728,8011666,62,50,utRho07
relA,5828554,5828554,5827302,1252,768,utRho07
relB,3291806,3291806,3291744,62,0,utRho07
rem,3289950,3289950,3289804,146,0,utRho07
rep,7921294,7921354,7921294,60,4,utRho07
rfaD,7587730,7587974,7587730,244,84,utRho07
rfaE,6393852,6393852,6393506,346,0,utRho07
rfaH,8049930,8049930,8049642,288,686,utRho07
rfbX,4219436,4219436,4219168,268,2196,utRho07
rfe,7935600,7935832,7935600,232,12,utRho07
rhaB,8194944,8194944,8194896,48,0,utRho07
rhaD,8188770,8188770,8188544,226,0,utRho07
rhaS,8195422,8195472,8195422,50,0,utRho07
rhaT,8201132,8201132,8201050,82,0,utRho07
rhlE,1661566,1661744,1661566,178,308,utRho07
rhoL,47593944,47594772,47593944,828,58272,utRho07
rhsB,7238006,7238384,7238006,378,4,utRho07
rhsC,1458758,1459166,1458758,408,0,utRho07
rhsD,1046132,1046522,1046132,390,0,utRho07
rhtA,1700608,1700608,1700194,414,32,utRho07
rhtC,8015478,8015514,8015478,36,752,utRho07
ribA,2678468,2678468,2678320,148,36,utRho07
ribC,3486916,3486916,3486484,432,122,utRho07
ribE,869008,869294,869008,286,7582,utRho07
ribF,42766,42814,42766,48,0,utRho07
ridA,8941892,8941892,8941826,66,0,utRho07
rihA,1369204,1369204,1368824,380,76,utRho07
rihB,4510504,4510504,4510372,132,0,utRho07
rimJ,2251044,2251124,2251044,80,0,utRho07
rimK,1783752,1783934,1783752,182,430,utRho07
rimL,2997486,2997876,2997486,390,92,utRho07
rimO,1756140,1756140,1756070,70,0,utRho07
rimP,6636350,6636350,6636012,338,178,utRho07
rlmA,3814172,3814172,3814120,52,322,utRho07
rlmD,5830086,5830086,5830000,86,8,utRho07
rlmE,6655520,6655520,6655328,192,1570,utRho07
rlmF,1684384,1684664,1684384,280,44,utRho07
rlmG,6471784,6471784,6471750,34,0,utRho07
rlmI,2060002,2060002,2059938,64,32,utRho07
rlmJ,7290700,7290770,7290700,70,168,utRho07
rlmL,2015344,2015688,2015344,344,984,utRho07
rlpA,1330444,1330444,1330380,64,228,utRho07
rluA,120900,120900,120692,208,436,utRho07
rluF,8460324,8460708,8460324,384,10,utRho07
rmf,2031006,2031430,2031006,424,374,utRho07
rna,1290068,1290068,1290006,62,0,utRho07
rnb,2698258,2698258,2697824,434,2502,utRho07
rnc,10816892,10816892,10816252,640,5332,utRho07
rnd,3776122,3776122,3775982,140,154,utRho07
rne,2289746,2289746,2288734,1012,10118,utRho07
rnhA,472082,472082,472004,78,148,utRho07
rnk,1288360,1288360,1287934,426,122,utRho07
rnlA,5531788,5531836,5531788,48,36,utRho07
rnlB,5533414,5533968,5533414,554,424,utRho07
rnpB,19623552,19623552,19623552,0,0,utRho07
rob,9270706,9270706,9270620,86,24,utRho07
rodZ,5285868,5285868,5285688,180,158,utRho07
rpe,7030306,7030306,7030118,188,36,utRho07
rph,15266320,15266320,15266196,124,192,utRho07
rpiA,6118706,6118706,6118650,56,28,utRho07
rpiB,8626514,8626700,8626514,186,82,utRho07
rpiR,8626274,8626274,8625982,292,0,utRho07
rplJ,8359246,8359992,8359246,746,10862,utRho07
rplK,8356708,8356894,8356708,186,542,utRho07
rplM,6757344,6757344,6757302,42,11584,utRho07
rplN,6896444,6896444,6896298,146,10192,utRho07
rplS,5489284,5489284,5489060,224,20568,utRho07
rplT,7199052,7199052,7198996,56,1124,utRho07
rplU,6667036,6667036,6666902,134,68,utRho07
rplY,4564866,4565034,4564866,168,40,utRho07
rpmA,6666450,6666450,6666238,212,1068,utRho07
rpmB,15247980,15247980,15246696,1284,175820,utRho07
rpmE,8253816,8254026,8253816,210,474,utRho07
rpmF,2294676,2294734,2294676,58,68294,utRho07
rpmH,7768130,7768672,7768130,542,6856,utRho07
rpmI,3600854,3600854,3599998,856,13748,utRho07
rpoB,8362126,8362490,8362126,364,606,utRho07
rpoD,6424946,6426094,6424946,1148,17992,utRho07
rpoE,5420372,5420372,5420024,348,0,utRho07
rpoH,7202006,7202006,7201566,440,2182,utRho07
rpoN,6689324,6689434,6689324,110,68,utRho07
rpoS,5736236,5736236,5735102,1134,3590,utRho07
rpoZ,7644154,7644212,7644154,58,846,utRho07
rppH,5937986,5937986,5937954,32,0,utRho07
rprA,3540744,3540744,3540744,0,0,utRho07
rpsA,1923434,1923990,1923434,556,193608,utRho07
rpsF,8850050,8850236,8850050,186,63298,utRho07
rpsI,6756580,6756580,6756414,166,13302,utRho07
rpsJ,6906884,6906884,6906540,344,12508,utRho07
rpsL,6949242,6949242,6949104,138,250,utRho07
rpsM,6885130,6885130,6884942,188,2398,utRho07
rpsO,13247144,13247144,13246736,408,1384,utRho07
rpsP,5492508,5492508,5492370,138,254,utRho07
rpsT,42420,42420,42156,264,496,utRho07
rpsU,12842584,12843124,12842584,540,2340,utRho07
rraA,8238716,8238716,8238660,56,190,utRho07
rraB,8956768,8956946,8956768,178,0,utRho07
rrsA,8070478,8071062,8070478,584,7834,utRho07
rrsB,16665468,16666636,16665468,1168,18080,utRho07
rrsC,7883032,7883616,7883032,584,9040,utRho07
rrsD,6858094,6858094,6857524,570,466,utRho07
rrsE,8415726,8416294,8415726,568,1338,utRho07
rrsG,5462896,5462896,5462314,582,7104,utRho07
rrsH,446970,447542,446970,572,1514,utRho07
rsd,8393908,8393908,8393616,292,32,utRho07
rseA,5419264,5419264,5418808,456,278,utRho07
rseP,392940,393092,392940,152,116,utRho07
rseX,4067298,4067298,4067298,0,0,utRho07
rsfS,1338144,1338144,1338072,72,396,utRho07
rsgA,8783132,8783132,8783018,114,96,utRho07
rsmA,105176,105176,104860,316,2880,utRho07
rsmB,6869982,6870414,6869982,432,578,utRho07
rsmC,9215736,9215736,9215400,336,710,utRho07
rsmD,7208594,7208786,7208594,192,100,utRho07
rsmE,6182036,6182268,6182036,232,140,utRho07
rsmG,7847512,7847512,7847360,152,714,utRho07
rsmH,180020,180188,180020,168,378,utRho07
rsmI,6587106,6587106,6586670,436,882,utRho07
rssA,2578212,2578412,2578212,200,306,utRho07
rssB,2580440,2580484,2580440,44,122,utRho07
rstA,3364276,3364300,3364276,24,0,utRho07
rsuA,4561096,4561096,4560966,130,176,utRho07
rsxA,3411510,3411534,3411510,24,26,utRho07
rtcA,7114004,7114004,7113698,306,0,utRho07
rtcB,7116214,7116214,7116158,56,0,utRho07
rtn,4541356,4541452,4541356,96,32,utRho07
rutA,2148052,2148052,2148022,30,0,utRho07
rutG,2140090,2140090,2139678,412,0,utRho07
rutR,2148226,2148484,2148226,258,0,utRho07
ruvA,7784096,7784096,7783904,192,40,utRho07
ruvB,7782176,7782176,7781424,752,880,utRho07
ruvC,3894878,3894878,3894752,126,6,utRho07
rybB,1776114,1776114,1776114,0,0,utRho07
rydB,3529860,3529860,3529322,538,120,utRho07
rydC,2983012,2983012,2983012,0,0,utRho07
ryfA,5307398,5307710,5307398,312,0,utRho07
ryfD,5468590,5468590,5468590,0,0,utRho07
ryhB,7162032,7162032,7162032,0,0,utRho07
ryjA,8556132,8556132,8556132,0,0,utRho07
ryjB,9055954,9055954,9055954,0,0,utRho07
sad,3229598,3229598,3229406,192,76,utRho07
safA,3168056,3168056,3167918,138,0,utRho07
sanA,4465368,4465756,4465368,388,120,utRho07
sapF,2705314,2705314,2705268,46,118,utRho07
sbcB,4165456,4165512,4165456,56,0,utRho07
sbcC,831694,831694,831506,188,134,utRho07
sbcD,833954,833954,833904,50,0,utRho07
sbmA,793106,793278,793106,172,4,utRho07
sbmC,4162650,4162650,4162524,126,0,utRho07
sdaA,3793618,3793864,3793618,246,162,utRho07
sdaC,5856070,5856458,5856070,388,1282,utRho07
sdhC,1509916,1510354,1509916,438,40116,utRho07
sdhD,1510808,1511120,1510808,312,10610,utRho07
sdiA,3993834,3993834,3993664,170,44,utRho07
secE,8354354,8354716,8354354,362,140,utRho07
secG,6645180,6645180,6645010,170,684,utRho07
selA,7522594,7522594,7522498,96,554,utRho07
selB,7519850,7519850,7519722,128,178,utRho07
selC,7672396,7672444,7672396,48,0,utRho07
selD,3696058,3696058,3696016,42,2664,utRho07
seqA,1425884,1425974,1425884,90,692,utRho07
serA,6117098,6117098,6116820,278,124,utRho07
serB,9249712,9249790,9249712,78,150,utRho07
serC,3830380,3830612,3830380,232,0,utRho07
serS,1878730,1878856,1878730,126,1060,utRho07
serT,2063438,2063438,2063424,14,0,utRho07
serU,4087124,4087124,4087114,10,184,utRho07
serV,5637394,5637394,5637290,104,0,utRho07
serW,1852014,1852014,1851942,72,158,utRho07
serX,2195352,2195352,2195304,48,0,utRho07
setB,4527426,4527726,4527426,300,0,utRho07
setC,7673488,7673906,7673488,418,0,utRho07
sfmA,1116124,1116424,1116124,300,0,utRho07
sfmC,1117606,1117948,1117606,342,0,utRho07
sfsA,323030,323030,322972,58,488,utRho07
sfsB,6669592,6669818,6669592,226,78,utRho07
sgrR,154676,154676,154598,78,32,utRho07
sgrS,154734,154734,154734,0,0,utRho07
shiA,4107068,4107286,4107068,218,0,utRho07
sibA,4306622,4306622,4306622,0,0,utRho07
sibB,4307292,4307292,4307292,0,0,utRho07
sibC,6113702,6113702,6113702,0,0,utRho07
sibD,6389730,6389730,6389730,0,0,utRho07
sibE,6390480,6390480,6390480,0,0,utRho07
sixA,4913998,4913998,4913624,374,0,utRho07
slp,7307872,7307922,7307872,50,0,utRho07
slt,9261400,9261466,9261400,66,0,utRho07
slyA,3442028,3442028,3441648,380,0,utRho07
slyB,3439496,3439752,3439496,256,0,utRho07
slyD,6957398,6957398,6956994,404,154,utRho07
slyX,6954862,6955280,6954862,418,8432,utRho07
smf,6867372,6867372,6867120,252,0,utRho07
smpB,5509534,5509792,5509534,258,456,utRho07
smrA,2811872,2811958,2811872,86,48,utRho07
smrB,4896872,4897212,4896872,340,18,utRho07
smtA,1946808,1947074,1946808,266,58,utRho07
sodA,8201518,8201620,8201518,102,13124,utRho07
sodB,3470646,3470756,3470646,110,52,utRho07
sodC,3449358,3449358,3449310,48,90,utRho07
sohB,2658568,2658664,2658568,96,0,utRho07
sokB,2984232,2984238,2984232,6,40,utRho07
solA,2241218,2241218,2241172,46,6,utRho07
soxR,8554894,8554938,8554894,44,0,utRho07
soxS,8554846,8554846,8554766,80,0,utRho07
speA,6172096,6172096,6171822,274,482,utRho07
speB,6167892,6167892,6167594,298,376,utRho07
speC,6218350,6218350,6218310,40,34,utRho07
spf,8099798,8099798,8099798,0,0,utRho07
sppA,3697422,3697674,3697422,252,40,utRho07
spy,3651376,3651376,3651250,126,0,utRho07
sra,3112092,3112092,3111926,166,0,utRho07
sraB,2293178,2293178,2293178,0,0,utRho07
sraC,3846132,3846132,3846132,0,0,utRho07
srlA,5651582,5651664,5651582,82,0,utRho07
srlR,5657720,5658094,5657720,374,264,utRho07
srmB,5425752,5425792,5425752,40,138,utRho07
sroA,151216,151216,151216,0,0,utRho07
sroG,6369436,6369436,6369436,0,0,utRho07
sroH,8380974,8380974,8380974,0,0,utRho07
ssb,8548022,8548250,8548022,228,0,utRho07
sseA,5304782,5304988,5304782,206,10666,utRho07
sspA,6755138,6755138,6754840,298,676,utRho07
ssrA,5511014,5511186,5511014,172,92,utRho07
ssrS,12223036,12223932,12223036,896,1028,utRho07
sstT,6479726,6479888,6479726,162,0,utRho07
ssuB,1988282,1988282,1988088,194,0,utRho07
ssuE,1995126,1995126,1995024,102,0,utRho07
sthA,8321604,8321604,8321580,24,1482,utRho07
stpA,5597156,5597156,5596990,166,0,utRho07
sucA,3034344,3034824,3034344,480,2908,utRho07
sufA,3528836,3528836,3528772,64,54,utRho07
sufE,3518962,3518962,3518580,382,138,utRho07
sugE,8753588,8753750,8753588,162,98,utRho07
sulA,2041894,2041894,2041838,56,212,utRho07
syd,5850738,5850738,5850560,178,100,utRho07
symE,9159834,9159834,9159680,154,0,utRho07
symR,9159670,9159670,9159670,0,0,utRho07
tabA,8949566,8949724,8949566,158,44,utRho07
talA,5157140,5157332,5157140,192,0,utRho07
talB,16382,16476,16382,94,9166,utRho07
tam,3214442,3214692,3214442,250,0,utRho07
tamA,8884540,8884764,8884540,224,86,utRho07
tar,3945432,3945432,3945382,50,88,utRho07
tas,5943138,5943194,5943138,56,106,utRho07
tatA,16087636,16087780,16087636,144,148,utRho07
tatE,1317742,1317894,1317742,152,0,utRho07
tauA,770410,770464,770410,54,0,utRho07
tdcA,6534186,6534186,6534130,56,0,utRho07
tdcG,6519652,6519652,6519298,354,0,utRho07
tdcR,6534380,6534760,6534380,380,0,utRho07
tdk,2586986,2587054,2586986,68,50,utRho07
tehA,3001072,3001146,3001072,74,0,utRho07
tesA,1039898,1039898,1039530,368,118,utRho07
tesB,950402,950402,950322,80,0,utRho07
tfaE,2418532,2418532,2418238,294,0,utRho07
tfaQ,3269912,3269912,3269770,142,24,utRho07
tff,379424,379256,379424,168,14,utRho07
tgt,852110,852274,852110,164,44,utRho07
thiD,4369346,4369346,4369032,314,24,utRho07
thiI,882936,883098,882936,162,190,utRho07
thiM,4370902,4370902,4370602,300,230,utRho07
thiQ,146170,146170,145854,316,0,utRho07
thrL,592,760,592,168,360,utRho07
thrS,7210932,7210932,7210280,652,996,utRho07
thrU,8350762,8350776,8350762,14,2,utRho07
thrV,6847414,6847414,6847310,104,211524,utRho07
thrW,525682,525742,525682,60,112,utRho07
thyA,5930696,5930696,5930310,386,2742,utRho07
tig,909986,910266,909986,280,1094,utRho07
tisB,7706674,7707106,7706674,432,390,utRho07
tktA,6163414,6163414,6163270,144,90,utRho07
tktB,5158616,5159272,5158616,656,710,utRho07
tldD,6784368,6784368,6784056,312,16,utRho07
tmcA,5191876,5191876,5191718,158,2,utRho07
tnaC,15553644,15553740,15553644,96,532,utRho07
tolB,1555074,1555480,1555074,406,248,utRho07
tolC,6356008,6356230,6356008,222,412,utRho07
tomB,961588,961588,961416,172,542,utRho07
tonB,2622108,2622178,2622108,70,0,utRho07
topA,2661578,2662096,2661578,518,340,utRho07
torC,2116112,2116168,2116112,56,22,utRho07
torR,2115968,2115968,2115908,60,22,utRho07
torS,2112364,2112364,2112356,8,0,utRho07
torT,2112414,2112522,2112414,108,0,utRho07
tpiA,8223138,8223138,8223014,124,20,utRho07
tppB,3425342,3425538,3425342,196,7984,utRho07
tpr,2574376,2574376,2574376,0,0,utRho07
tpx,2777688,2777688,2777622,66,650,utRho07
tqsA,3347780,3347826,3347780,46,0,utRho07
treA,2494850,2494850,2494752,98,12,utRho07
treB,8932420,8932420,8932360,60,40,utRho07
treF,7339102,7339184,7339102,82,32,utRho07
treR,8934694,8934694,8934492,202,0,utRho07
trg,2984878,2984940,2984878,62,0,utRho07
trkG,2847342,2847564,2847342,222,26,utRho07
trmA,8326590,8326590,8326540,50,78,utRho07
trpA,2634678,2634678,2634444,234,1516,utRho07
trpC,2639888,2639888,2639570,318,34,utRho07
trpL,5292432,5292432,5292328,104,0,utRho07
trpR,9265408,9265520,9265408,112,170,utRho07
trpS,7027394,7027394,7027276,118,1736,utRho07
trpT,7893560,7893914,7893560,354,120632,utRho07
trxA,7931294,7931522,7931294,228,642,utRho07
trxB,1864156,1864156,1864100,56,20,utRho07
trxC,5437350,5437470,5437350,120,158,utRho07
tsaD,6421256,6421256,6421086,170,0,utRho07
tsgA,6985038,6985136,6985038,98,0,utRho07
tsr,9182824,9183314,9182824,490,60,utRho07
tsx,864490,864490,864026,464,148,utRho07
ttcA,2823970,2823970,2823896,74,3056,utRho07
ttdA,6412848,6412926,6412848,78,0,utRho07
ttdR,6412760,6412760,6412512,248,0,utRho07
tufA,6943448,6943448,6942658,790,189218,utRho07
tus,3368346,3368518,3368346,172,0,utRho07
tusA,7218040,7218040,7217992,48,16,utRho07
tusB,6950218,6950218,6949930,288,760,utRho07
tynA,2902996,2902996,2902698,298,0,utRho07
typA,8116460,8116814,8116460,354,10878,utRho07
tyrB,8534164,8534228,8534164,64,2618,utRho07
tyrP,3979004,3979362,3979004,358,0,utRho07
tyrR,2773384,2773440,2773384,56,20,utRho07
tyrS,3434566,3434566,3434444,122,30,utRho07
tyrT,2575330,2575330,2575244,86,64,utRho07
uacT,6062378,6062734,6062378,356,0,utRho07
ubiC,8504886,8505012,8504886,126,0,utRho07
ubiD,8049618,8049976,8049618,358,726,utRho07
ubiE,8037494,8037710,8037494,216,114,utRho07
ubiG,4679078,4679134,4679078,56,0,utRho07
ucpA,5089342,5089342,5089246,96,0,utRho07
udp,8032782,8032862,8032782,80,12,utRho07
ugd,4199470,4199470,4199226,244,0,utRho07
ugpB,7184852,7184852,7184650,202,114,utRho07
ugpQ,7176600,7176600,7176226,374,0,utRho07
uhpT,7694396,7694396,7694334,62,0,utRho07
uidA,3392304,3392304,3392142,162,108,utRho07
uidC,3386012,3386012,3385702,310,0,utRho07
uidR,3394150,3394150,3394104,46,162,utRho07
ulaA,8839854,8839960,8839854,106,0,utRho07
ulaG,8839350,8839350,8839250,100,0,utRho07
ulaR,8837124,8837124,8836906,218,0,utRho07
umpG,5741372,5741372,5740548,824,84,utRho07
umpH,1400704,1400704,1400652,52,40,utRho07
umuD,2461476,2461534,2461476,58,0,utRho07
ung,5433476,5433508,5433476,32,0,utRho07
uof,2843316,2843316,2842900,416,7380,utRho07
upp,5241818,5241818,5241744,74,498,utRho07
usg,4873780,4873780,4873298,482,170,utRho07
ushA,1009772,1009828,1009772,56,0,utRho07
uspA,7279966,7280222,7279966,256,202,utRho07
uspB,7279696,7279696,7279440,256,42,utRho07
uspC,3959172,3959506,3959172,334,0,utRho07
uspE,2797318,2797318,2797244,74,24,utRho07
uspF,2871282,2871282,2871238,44,0,utRho07
uspG,1283806,1283806,1283734,72,254,utRho07
uvrA,8547872,8547872,8547742,130,86,utRho07
uvrB,1626304,1627052,1626304,748,432,utRho07
uvrC,3989758,3989758,3989412,346,86,utRho07
uvrD,7995814,7995966,7995814,152,38,utRho07
uvrY,3990812,3990812,3990718,94,0,utRho07
uxaB,3221474,3221474,3221360,114,26,utRho07
uxaC,6489714,6489714,6489482,232,16,utRho07
uxuA,9103036,9103272,9103036,236,468,utRho07
uxuR,9108916,9109152,9108916,236,32,utRho07
valS,8967854,8967854,8967674,180,602,utRho07
valU,5041848,5041862,5041848,14,2,utRho07
valV,3492830,3492870,3492830,40,44,utRho07
ves,3649968,3649968,3649874,94,0,utRho07
waaA,7616512,7617080,7616512,568,148,utRho07
waaH,7580298,7580298,7580162,136,0,utRho07
waaQ,7616476,7616476,7616196,280,102,utRho07
waaU,7598996,7598996,7598624,372,116,utRho07
waaY,7602272,7602272,7601930,342,6830,utRho07
wbbH,4214888,4214888,4214452,436,3864,utRho07
wbbK,4209212,4209212,4209018,194,204,utRho07
wcaM,4231868,4231868,4231792,76,0,utRho07
wrbA,2135516,2135516,2135416,100,0,utRho07
wza,4275166,4275166,4274486,680,0,utRho07
wzxC,4240674,4240674,4240316,358,0,utRho07
wzzB,4196950,4196950,4196602,348,108,utRho07
xanP,7657642,7657890,7657642,248,0,utRho07
xanQ,6048520,6048702,6048520,182,0,utRho07
xapA,5049820,5049820,5049756,64,0,utRho07
xapR,10090252,10090252,10089908,344,0,utRho07
xdhA,6000514,6000690,6000514,176,0,utRho07
xerD,6079702,6079702,6079486,216,0,utRho07
xseA,5268394,5268464,5268394,70,134,utRho07
xseB,882746,882746,882686,60,334,utRho07
xthA,3664798,3664856,3664798,58,0,utRho07
xylA,7461614,7461614,7461530,84,256,utRho07
xylE,8484540,8484540,8484508,32,0,utRho07
xylF,7462138,7462262,7462138,124,0,utRho07
xylR,7469812,7469958,7469812,146,0,utRho07
yaaA,13230,13230,12918,312,0,utRho07
yaaI,23876,23876,23572,304,0,utRho07
yaaJ,16034,16034,15918,116,0,utRho07
yaaU,91184,91614,91184,430,0,utRho07
yaaW,23084,23084,22712,372,52,utRho07
yaaX,10060,10468,10060,408,18,utRho07
yabI,142542,142702,142542,160,20,utRho07
yacC,273880,273880,273834,46,152,utRho07
yacH,262932,262932,262520,412,0,utRho07
yacL,268678,268776,268678,98,16,utRho07
yadD,293796,293936,293796,140,0,utRho07
yadE,289930,290162,289930,232,274,utRho07
yadN,314110,314110,313766,344,0,utRho07
yadS,355572,355572,355248,324,252,utRho07
yadV,312470,312470,312402,68,26,utRho07
yaeF,434270,434270,434006,264,40,utRho07
yaeP,428374,428374,428250,124,0,utRho07
yaeQ,428176,428582,428176,406,0,utRho07
yaeR,423716,423754,423716,38,24,utRho07
yafC,462166,462166,461762,404,22,utRho07
yafD,462128,462244,462128,116,34,utRho07
yafK,491986,491986,491610,376,1006,utRho07
yafL,493282,493424,493282,142,0,utRho07
yafN,503938,504010,503938,72,0,utRho07
yafS,469568,469632,469568,64,108,utRho07
yafT,474470,474670,474470,200,0,utRho07
yafV,480432,480432,480378,54,0,utRho07
yafZ,536052,536052,536010,42,0,utRho07
yagE,564446,564556,564446,110,40,utRho07
yagG,570414,570790,570414,376,4,utRho07
yagI,578384,578384,578324,60,0,utRho07
yagK,586236,586236,585896,340,2,utRho07
yagL,588062,588062,587836,226,0,utRho07
yagN,591342,591342,591158,184,372,utRho07
yahA,663746,664742,663746,996,152,utRho07
yahC,670136,670136,670044,92,2,utRho07
yahE,671478,671850,671478,372,0,utRho07
yahM,690504,690808,690504,304,0,utRho07
yahN,692872,692872,692674,198,0,utRho07
yahO,692864,692968,692864,104,0,utRho07
yaiE,816296,816354,816296,58,66,utRho07
yaiI,811396,811528,811396,132,0,utRho07
yaiO,761946,761946,761684,262,0,utRho07
yaiP,767970,767970,767870,100,0,utRho07
yaiS,769660,769660,769232,428,0,utRho07
yaiV,788922,788922,788922,0,0,utRho07
yaiY,799094,799094,798666,428,2,utRho07
yaiZ,798888,799186,798888,298,0,utRho07
yajC,854410,854574,854410,164,1578,utRho07
yajD,860938,861210,860938,272,290,utRho07
yajI,866068,866068,865702,366,316,utRho07
yajL,887496,887496,887282,214,462,utRho07
yajQ,889316,889366,889316,50,0,utRho07
yajR,893374,893374,893332,42,60,utRho07
ybaB,987418,988152,987418,734,3426,utRho07
ybaL,1006590,1006590,1006476,114,36,utRho07
ybaM,980648,980648,980542,106,154,utRho07
ybaN,981436,981764,981436,328,266,utRho07
ybaO,936704,936766,936704,62,0,utRho07
ybaP,1016568,1016568,1016160,408,326,utRho07
ybaQ,1016348,1016436,1016348,88,0,utRho07
ybaS,1023146,1023282,1023146,136,0,utRho07
ybaV,927504,927874,927504,370,130,utRho07
ybaY,950490,950758,950490,268,22,utRho07
ybbB,1062724,1062724,1062452,272,0,utRho07
ybbJ,1030154,1030154,1029718,436,404,utRho07
ybbL,1031784,1031838,1031784,54,0,utRho07
ybbN,1037136,1037136,1036558,578,1676,utRho07
ybbO,1038658,1038658,1038298,360,774,utRho07
ybbY,1080718,1081130,1080718,412,0,utRho07
ybcH,1176140,1176140,1175962,178,0,utRho07
ybcI,1113264,1113264,1113106,158,174,utRho07
ybcJ,1114050,1114050,1113746,304,202,utRho07
ybcK,1137502,1137804,1137502,302,0,utRho07
ybcL,1141690,1141786,1141690,96,0,utRho07
ybcN,1144628,1144932,1144628,304,0,utRho07
ybcQ,1147548,1147912,1147548,364,4,utRho07
ybcW,1159610,1159760,1159610,150,0,utRho07
ybdD,1263982,1264364,1263982,382,0,utRho07
ybdF,1212106,1212106,1211772,334,22,utRho07
ybdH,1267048,1267048,1266954,94,0,utRho07
ybdJ,1212822,1212822,1212398,424,0,utRho07
ybdK,1215122,1215122,1214766,356,4,utRho07
ybdL,1267114,1267172,1267114,58,0,utRho07
ybdM,1271110,1271110,1270752,358,48,utRho07
ybdN,1273372,1273372,1273138,234,0,utRho07
ybdR,1283844,1284176,1283844,332,380,utRho07
ybeD,1325412,1325412,1325284,128,158,utRho07
ybeF,1323090,1323090,1322756,334,86,utRho07
ybeL,1349986,1350036,1349986,50,44,utRho07
ybeQ,1353412,1353412,1353094,318,0,utRho07
ybeR,1353120,1353422,1353120,302,0,utRho07
ybeT,1358832,1358832,1358812,20,0,utRho07
ybeU,1358924,1359016,1358924,92,0,utRho07
ybeZ,1386938,1386938,1386834,104,5148,utRho07
ybfA,1458074,1458268,1458074,194,28,utRho07
ybfE,1423878,1423878,1423796,82,196,utRho07
ybfF,1425692,1425692,1425604,88,166,utRho07
ybfH,1433282,1433282,1433194,88,0,utRho07
ybgA,1477840,1478002,1477840,162,4,utRho07
ybgC,1549288,1549504,1549288,216,32,utRho07
ybgD,1505916,1505916,1505590,326,108,utRho07
ybgI,1485238,1485654,1485238,416,0,utRho07
ybgO,1498370,1498370,1497964,406,0,utRho07
ybgS,1570992,1570992,1570634,358,4,utRho07
ybhA,1597184,1597184,1596862,322,0,utRho07
ybhB,1616070,1616070,1615818,252,130,utRho07
ybhC,1614642,1614642,1614562,80,1854,utRho07
ybhD,1601418,1601418,1601276,142,0,utRho07
ybhH,1601104,1601518,1601104,414,0,utRho07
ybhK,1633384,1633384,1633294,90,24,utRho07
ybhM,1641556,1641586,1641556,30,0,utRho07
ybhN,1645296,1645296,1644996,300,0,utRho07
ybhQ,1649202,1649260,1649202,58,0,utRho07
ybiA,1665920,1665920,1665900,20,0,utRho07
ybiI,1676968,1676968,1676912,56,0,utRho07
ybiO,1691328,1691328,1690960,368,94,utRho07
ybiP,1705252,1705252,1705194,58,222,utRho07
ybiS,1711572,1711572,1711488,84,842,utRho07
ybiT,1711894,1711926,1711894,32,0,utRho07
ybiU,1718212,1718212,1718122,90,0,utRho07
ybiV,1720176,1720176,1720056,120,0,utRho07
ybiW,1725566,1725566,1725212,354,108,utRho07
ybiX,1678548,1678548,1678414,134,192,utRho07
ybjC,1781784,1781826,1781784,42,0,utRho07
ybjE,1830154,1830154,1829714,440,128,utRho07
ybjG,1767016,1767016,1766776,240,706,utRho07
ybjL,1779882,1779882,1779638,244,76,utRho07
ybjM,1779770,1780178,1779770,408,38,utRho07
ybjO,1795704,1795978,1795704,274,0,utRho07
ybjP,1809046,1809046,1808934,112,0,utRho07
ybjQ,1809034,1809186,1809034,152,0,utRho07
ybjS,1813796,1813796,1813506,290,24,utRho07
ybjX,1838206,1838206,1838168,38,0,utRho07
ycaD,1891438,1891742,1891438,304,0,utRho07
ycaI,1928210,1928640,1928210,430,152,utRho07
ycaK,1899094,1899336,1899094,242,0,utRho07
ycaL,1920264,1920528,1920264,264,0,utRho07
ycaM,1894240,1894458,1894240,218,22,utRho07
ycaR,1941284,1941346,1941284,62,744,utRho07
ycbB,1961862,1962094,1961862,232,0,utRho07
ycbJ,1943344,1943504,1943344,160,0,utRho07
ycbK,1966046,1966150,1966046,104,188,utRho07
ycbZ,2036920,2036920,2036598,322,0,utRho07
yccA,2062886,2062886,2062836,50,22,utRho07
yccF,2048730,2048730,2048696,34,0,utRho07
yccS,2047988,2047988,2047766,222,48,utRho07
yccT,2055674,2055674,2055546,128,0,utRho07
yccX,2059960,2060128,2059960,168,32,utRho07
ycdT,2185682,2185752,2185682,70,0,utRho07
ycdU,2191266,2191686,2191266,420,0,utRho07
ycdZ,2200504,2200592,2200504,88,58,utRho07
yceA,2233544,2233614,2233544,70,254,utRho07
yceD,2293298,2293588,2293298,290,9416,utRho07
yceF,2293522,2293522,2293190,332,5364,utRho07
yceH,2252154,2252314,2252154,160,1874,utRho07
yceI,2237282,2237282,2236952,330,304,utRho07
yceJ,2238142,2238142,2238092,50,0,utRho07
yceM,2253208,2253612,2253208,404,76,utRho07
yceO,2239264,2239264,2238894,370,104,utRho07
yceQ,2288760,2289004,2288760,244,8028,utRho07
ycfD,2376540,2376540,2376480,60,308,utRho07
ycfJ,2334814,2335198,2334814,384,8,utRho07
ycfS,2340834,2340834,2340748,86,0,utRho07
ycfT,2350658,2350658,2350330,328,4,utRho07
ycfZ,2362760,2362760,2362534,226,246,utRho07
ycgB,2474570,2474570,2474482,88,0,utRho07
ycgG,2434614,2434656,2434614,42,56,utRho07
ycgJ,2452956,2453200,2452956,244,0,utRho07
ycgL,2455218,2455362,2455218,144,0,utRho07
ycgN,2457366,2457660,2457366,294,0,utRho07
ycgR,2489112,2489112,2489054,58,0,utRho07
ycgV,2512222,2512222,2511904,318,102,utRho07
ycgX,2426568,2426568,2426214,354,4450,utRho07
ycgY,2490166,2490320,2490166,154,0,utRho07
ycgZ,2431504,2431578,2431504,74,0,utRho07
ychE,2596904,2597196,2596904,292,0,utRho07
ychF,2515764,2515764,2515624,140,0,utRho07
ychH,2517476,2517582,2517476,106,26,utRho07
ychJ,2578354,2578354,2578264,90,0,utRho07
ychN,2547310,2547310,2547198,112,0,utRho07
ychO,2547520,2547850,2547520,330,106,utRho07
ychQ,2533798,2533848,2533798,50,0,utRho07
yciA,2624828,2624828,2624492,336,250,utRho07
yciB,2626110,2626110,2625780,330,3068,utRho07
yciC,2627396,2627396,2627326,70,0,utRho07
yciE,2630794,2630794,2630448,346,0,utRho07
yciG,5264368,5264368,5264140,228,0,utRho07
yciI,2621784,2621784,2621730,54,6,utRho07
yciN,2661606,2661606,2661336,270,36,utRho07
yciS,2680270,2680486,2680270,216,0,utRho07
yciT,2689088,2689088,2688692,396,390,utRho07
yciU,2614718,2614718,2614300,418,622,utRho07
yciV,2646376,2646440,2646376,64,0,utRho07
yciW,2700472,2700472,2700214,258,206,utRho07
yciZ,2689276,2689276,2689218,58,126,utRho07
ycjD,2703792,2703792,2703520,272,0,utRho07
ycjG,2777748,2777860,2777748,112,86,utRho07
ycjM,2740006,2740432,2740006,426,62,utRho07
ycjW,2767982,2767982,2767922,60,20,utRho07
ycjX,2768138,2768234,2768138,96,0,utRho07
ycjY,5568288,5568288,5567460,828,0,utRho07
ydaE,2836438,2836438,2836016,422,0,utRho07
ydaN,2816048,2816100,2816048,52,0,utRho07
ydaS,2840340,2840730,2840340,390,44,utRho07
ydbC,2948376,2948442,2948376,66,0,utRho07
ydbD,2950132,2950288,2950132,156,0,utRho07
ydbH,2885800,2886102,2885800,302,0,utRho07
ydbJ,2881712,2882116,2881712,404,0,utRho07
ydbK,2881692,2881692,2881568,124,16,utRho07
ydcA,2983294,2983354,2983294,60,0,utRho07
ydcF,2974404,2974470,2974404,66,56,utRho07
ydcI,2990268,2990268,2990142,126,0,utRho07
ydcJ,2990266,2990576,2990266,310,0,utRho07
ydcK,3001280,3001280,3000898,382,0,utRho07
ydcL,3004646,3004914,3004646,268,16,utRho07
ydcN,3012308,3012344,3012308,36,32,utRho07
ydcP,3013508,3013562,3013508,54,84,utRho07
ydcR,3019956,3020006,3019956,50,36,utRho07
ydcS,3022906,3023308,3022906,402,0,utRho07
ydcX,3034442,3034778,3034442,336,8,utRho07
ydcY,3035220,3035296,3035220,76,0,utRho07
ydcZ,3036750,3036750,3036662,88,4,utRho07
yddB,3155332,3155332,3155238,94,0,utRho07
yddE,3071738,3071738,3071716,22,0,utRho07
yddG,3094410,3094410,3094338,72,0,utRho07
yddJ,3089732,3089732,3089438,294,0,utRho07
yddW,3137704,3137704,3137646,58,0,utRho07
ydeA,3233910,3234056,3233910,146,112,utRho07
ydeE,3242528,3242664,3242528,136,0,utRho07
ydeI,3249118,3249118,3248994,124,0,utRho07
ydeJ,3249376,3249546,3249376,170,0,utRho07
ydeN,3165458,3165458,3165048,410,0,utRho07
ydeP,3173328,3173328,3172972,356,0,utRho07
ydeR,3176596,3176596,3176592,4,0,utRho07
ydfA,3296872,3297016,3296872,144,8,utRho07
ydfG,3254982,3255034,3254982,52,0,utRho07
ydfH,3256652,3256704,3256652,52,56,utRho07
ydfK,3265446,3266144,3265446,698,300,utRho07
ydgA,3379588,3379704,3379588,116,20,utRho07
ydgC,3364124,3364124,3364060,64,0,utRho07
ydgD,3343906,3343920,3343906,14,2,utRho07
ydgH,3356754,3356854,3356754,100,0,utRho07
ydgJ,3408798,3408798,3408616,182,98,utRho07
ydgK,3410414,3410500,3410414,86,204,utRho07
ydhB,3479618,3479618,3479596,22,0,utRho07
ydhC,3479698,3479822,3479698,124,0,utRho07
ydhF,3451310,3451310,3451264,46,0,utRho07
ydhI,3441996,3442050,3441996,54,0,utRho07
ydhL,3451864,3451864,3451840,24,0,utRho07
ydhQ,3492404,3492404,3492254,150,0,utRho07
ydhS,3494136,3494262,3494136,126,0,utRho07
ydhT,3499138,3499138,3499118,20,2,utRho07
ydhY,3509284,3509284,3508954,330,0,utRho07
ydhZ,3510418,3510418,3510282,136,0,utRho07
ydiE,3579206,3579226,3579206,20,0,utRho07
ydiH,3530582,3530582,3530406,176,0,utRho07
ydiM,3541852,3542142,3541852,290,0,utRho07
ydiN,3544818,3545024,3544818,206,0,utRho07
ydiP,3558656,3558656,3558602,54,2,utRho07
ydiU,3582508,3582508,3582488,20,2,utRho07
ydiV,3584174,3584174,3584040,134,56,utRho07
ydiY,3612500,3612500,3612166,334,0,utRho07
ydjA,3697400,3697400,3697352,48,100,utRho07
ydjE,3708082,3708082,3707958,124,0,utRho07
ydjF,3709848,3709848,3709708,140,0,utRho07
ydjM,3620340,3620422,3620340,82,0,utRho07
ydjO,3626696,3626696,3626288,408,20,utRho07
ydjX,3666434,3666802,3666434,368,456,utRho07
yeaE,3731448,3731448,3731272,176,42,utRho07
yeaG,3733530,3733816,3733530,286,0,utRho07
yeaI,3740486,3740770,3740486,284,0,utRho07
yeaJ,3743874,3744082,3743874,208,24,utRho07
yeaL,3748646,3748704,3748646,58,96,utRho07
yeaM,3751296,3751296,3751152,144,0,utRho07
yeaN,3750926,3751346,3750926,420,24,utRho07
yeaO,3753554,3753818,3753554,264,0,utRho07
yeaP,3755314,3755430,3755314,116,494,utRho07
yeaQ,3758780,3758780,3758510,270,6,utRho07
yeaR,3759988,3759988,3759896,92,0,utRho07
yeaY,3781122,3781122,3781064,58,0,utRho07
yebB,3892220,3892502,3892220,282,46,utRho07
yebC,3896370,3896370,3896302,68,72,utRho07
yebE,3859464,3859464,3859414,50,16,utRho07
yebG,3861530,3861530,3861494,36,0,utRho07
yebK,3873180,3873304,3873180,124,86,utRho07
yebQ,3820314,3820552,3820314,238,22,utRho07
yebS,3832238,3832516,3832238,278,0,utRho07
yebV,3843430,3843560,3843430,130,0,utRho07
yebW,3843914,3844242,3843914,328,562,utRho07
yecC,3995646,3995646,3995628,18,0,utRho07
yecD,3901272,3901664,3901272,392,32,utRho07
yecF,3991434,3991636,3991434,202,0,utRho07
yecH,3979304,3979304,3978980,324,32,utRho07
yecJ,3975604,3975604,3975516,88,0,utRho07
yecM,3919968,3919968,3919692,276,0,utRho07
yecR,3976400,3976444,3976400,44,0,utRho07
yecT,3923862,3923944,3923862,82,38,utRho07
yedD,4016522,4016522,4016180,342,56,utRho07
yedE,4016310,4016554,4016310,244,84,utRho07
yedI,4058922,4058922,4058732,190,0,utRho07
yedJ,4066446,4066446,4066158,288,2,utRho07
yedV,4076404,4076404,4076304,100,48,utRho07
yedX,4077680,4077912,4077680,232,0,utRho07
yedY,4078572,4078956,4078572,384,0,utRho07
yeeA,4161322,4161322,4161182,140,0,utRho07
yeeE,4171104,4171104,4171050,54,0,utRho07
yeeJ,4089526,4089822,4089526,296,0,utRho07
yeeN,4113508,4113716,4113508,208,40,utRho07
yeeO,4119444,4119444,4119692,248,0,utRho07
yeeX,4158834,4158834,4158722,112,122,utRho07
yeeZ,4178422,4178422,4178256,166,16,utRho07
yefM,4179466,4179466,4179426,40,0,utRho07
yegD,4295288,4295348,4295288,60,0,utRho07
yegH,4275726,4275804,4275726,78,0,utRho07
yegI,4302154,4302154,4301970,184,0,utRho07
yegJ,4302032,4302370,4302032,338,0,utRho07
yegQ,4331182,4331336,4331182,154,0,utRho07
yegR,4336698,4336698,4336612,86,0,utRho07
yegS,4337086,4337424,4337086,338,0,utRho07
yegT,4357562,4357642,4357562,80,0,utRho07
yegX,4367640,4367640,4367302,338,0,utRho07
yehA,4376944,4376944,4376828,116,2,utRho07
yehE,4385818,4385818,4385592,226,0,utRho07
yehK,4407568,4407944,4407568,376,0,utRho07
yehL,4408804,4409192,4408804,388,0,utRho07
yeiB,4486146,4486146,4485934,212,150,utRho07
yeiE,4499422,4499422,4499236,186,0,utRho07
yeiG,4487776,4487820,4487776,44,406,utRho07
yeiH,4499332,4499434,4499332,102,14,utRho07
yeiI,4503306,4503400,4503306,94,192,utRho07
yeiL,4510580,4510710,4510580,130,0,utRho07
yeiP,4530834,4530900,4530834,66,504,utRho07
yeiQ,4532328,4532490,4532328,162,48,utRho07
yeiR,4535484,4535658,4535484,174,110,utRho07
yeiW,4530840,4530840,4530590,250,674,utRho07
yejA,4544624,4544728,4544624,104,0,utRho07
yejG,4556892,4556892,4556474,418,386,utRho07
yejH,4561244,4561264,4561244,20,0,utRho07
yejK,4568218,4568218,4567894,324,132,utRho07
yejO,4578352,4578352,4577800,552,66,utRho07
yfaD,4713380,4713808,4713380,428,30,utRho07
yfaE,4696676,4697028,4696676,352,502,utRho07
yfaL,4688568,4688568,4688338,230,0,utRho07
yfaP,4656398,4656398,4656286,112,0,utRho07
yfaU,4717892,4717892,4717690,202,0,utRho07
yfaY,4727310,4727310,4727266,44,0,utRho07
yfaZ,4728744,4728744,4728550,194,2,utRho07
yfbK,4771810,4771810,4771444,366,0,utRho07
yfbL,4771500,4771720,4771500,220,0,utRho07
yfbN,4777174,4777174,4776852,322,0,utRho07
yfbO,4776916,4777162,4776916,246,0,utRho07
yfbP,4777990,4778232,4777990,242,10,utRho07
yfbR,4817662,4817724,4817662,62,0,utRho07
yfcI,4847424,4847424,4847078,346,0,utRho07
yfcJ,4880482,4880482,4880240,242,92,utRho07
yfcL,4888502,4888502,4888338,164,58,utRho07
yfcV,4911642,4911642,4911292,350,2,utRho07
yfcZ,4921958,4921958,4921868,90,16,utRho07
yfdF,4925604,4926024,4925604,420,278,utRho07
yfdG,4935474,4935710,4935474,236,0,utRho07
yfdP,4946844,4947040,4946844,196,0,utRho07
yfdX,4988866,4988866,4988804,62,0,utRho07
yfdY,4990672,4990672,4990584,88,0,utRho07
yfeA,5035784,5035784,5035664,120,2640,utRho07
yfeC,5036668,5036934,5036668,266,142,utRho07
yfeH,5053818,5053892,5053818,74,0,utRho07
yfeK,5074630,5074684,5074630,54,0,utRho07
yfeO,5018906,5019260,5018906,354,150,utRho07
yfeR,5054078,5054078,5053712,366,12,utRho07
yfeX,5101356,5101356,5101090,266,0,utRho07
yfeY,5102486,5102486,5102432,54,0,utRho07
yfeZ,5103842,5103842,5103452,390,0,utRho07
yffO,5123804,5124222,5123804,418,0,utRho07
yffQ,5126778,5127154,5126778,376,0,utRho07
yffS,5128800,5128986,5128800,186,110,utRho07
yfgC,5232052,5232188,5232052,136,0,utRho07
yfgF,5258062,5258062,5257876,186,0,utRho07
yfgG,5258170,5258580,5258170,410,0,utRho07
yfgH,5259344,5259584,5259344,240,0,utRho07
yfgM,5278866,5278866,5278566,300,572,utRho07
yfhH,5397414,5397518,5397414,104,0,utRho07
yfhM,5304648,5304648,5304574,74,0,utRho07
yfhR,5328408,5328726,5328408,318,570,utRho07
yfiC,5425610,5425610,5425528,82,0,utRho07
yfiE,5430688,5430688,5430640,48,0,utRho07
yfiL,5482630,5482720,5482630,90,0,utRho07
yfiM,5448066,5448358,5448066,292,4834,utRho07
yfiR,5483354,5483750,5483354,396,76,utRho07
yfjH,5517326,5517326,5517200,126,14,utRho07
yfjI,5517710,5517970,5517710,260,0,utRho07
yfjJ,5521014,5521094,5521014,80,28,utRho07
yfjM,5531970,5531970,5531552,418,238,utRho07
yfjP,5535080,5535420,5535080,340,88,utRho07
yfjW,5546570,5546636,5546570,66,40,utRho07
yfjX,5551776,5551838,5551776,62,0,utRho07
ygaC,5601180,5601180,5599988,1192,8,utRho07
ygaM,5600242,5600292,5600242,50,2,utRho07
ygaU,5593628,5593628,5593572,56,0,utRho07
ygaZ,5619190,5619234,5619190,44,126,utRho07
ygbA,5713656,5713656,5713612,44,0,utRho07
ygbE,5746784,5746784,5746674,110,0,utRho07
ygbI,5722882,5722882,5722528,354,0,utRho07
ygbK,5724394,5724670,5724394,276,0,utRho07
ygbL,5727074,5727186,5727074,112,10,utRho07
ygbN,5729814,5730202,5729814,388,80,utRho07
ygcG,5811210,5811422,5811210,212,0,utRho07
ygcN,5785144,5785314,5785144,170,0,utRho07
ygcU,5799214,5799214,5798836,378,0,utRho07
ygcW,5800942,5800942,5800546,396,0,utRho07
ygdD,5883442,5883442,5883262,180,4,utRho07
ygdG,5861746,5861930,5861746,184,340,utRho07
ygdI,5886526,5886526,5886290,236,0,utRho07
ygdQ,5940784,5940840,5940784,56,0,utRho07
ygdR,5942494,5942542,5942494,48,0,utRho07
ygeA,5961606,5961606,5961270,336,0,utRho07
ygeH,5983758,5984188,5983758,430,0,utRho07
ygeI,5987162,5987276,5987162,114,0,utRho07
ygeR,6000078,6000078,5999782,296,104,utRho07
ygeV,6011694,6011694,6011572,122,24,utRho07
ygeW,6012234,6012524,6012234,290,0,utRho07
ygfB,6110946,6110946,6110888,58,2,utRho07
ygfK,6031984,6032120,6031984,136,0,utRho07
ygfS,6058328,6058328,6058024,304,0,utRho07
ygfZ,6082564,6082626,6082564,62,30,utRho07
yggC,6149512,6149512,6149378,134,146,utRho07
yggE,6136370,6136370,6136160,210,0,utRho07
yggI,6179176,6179510,6179176,334,58,utRho07
yggL,6204508,6204508,6204266,242,164,utRho07
yggM,6199514,6199514,6199130,384,120,utRho07
yggN,6203596,6203596,6203246,350,10,utRho07
yggX,18623958,18624558,18623958,600,378,utRho07
yghA,6298966,6299324,6298966,358,52,utRho07
yghB,6307058,6307126,6307058,68,10,utRho07
yghD,6222614,6222614,6222252,362,0,utRho07
yghF,6225798,6225798,6225840,42,0,utRho07
yghJ,6238640,6238640,6238224,416,0,utRho07
yghQ,6265186,6265186,6264816,370,0,utRho07
yghT,6267830,6268262,6267830,432,0,utRho07
yghU,6277400,6277454,6277400,54,16,utRho07
yghW,6293506,6293506,6293474,32,0,utRho07
yghZ,6295562,6295794,6295562,232,0,utRho07
ygiD,6365122,6365122,6364868,254,158,utRho07
ygiH,6409066,6409388,6409066,322,0,utRho07
ygiL,6370622,6370828,6370622,206,4,utRho07
ygiM,6402084,6402414,6402084,330,28,utRho07
ygiN,6346156,6346284,6346156,128,1058,utRho07
ygiQ,6322620,6322620,6322292,328,224,utRho07
ygiS,6335462,6335462,6335436,26,0,utRho07
ygiV,6338582,6338582,6338462,120,10,utRho07
ygiW,6339774,6339774,6339352,422,0,utRho07
ygiZ,6344506,6344506,6344422,84,0,utRho07
ygjH,6442528,6442528,6442494,34,0,utRho07
ygjI,6452140,6452468,6452140,328,0,utRho07
ygjQ,6472730,6473080,6472730,350,56,utRho07
ygjR,6474564,6474586,6474564,22,0,utRho07
ygjV,6483638,6483638,6483488,150,0,utRho07
yhaB,6535632,6535708,6535632,76,0,utRho07
yhaH,6504498,6504608,6504498,110,38,utRho07
yhaI,6505400,6505822,6505400,422,0,utRho07
yhaJ,6508560,6508560,6508428,132,40,utRho07
yhaK,6508538,6508638,6508538,100,0,utRho07
yhbQ,6599878,6599932,6599878,54,80,utRho07
yhbT,6602736,6602736,6602552,184,0,utRho07
yhbU,6602558,6602970,6602558,412,0,utRho07
yhbX,6643302,6643302,6643226,76,0,utRho07
yhbY,6655518,6655580,6655518,62,1120,utRho07
yhcA,6723956,6724224,6723956,268,0,utRho07
yhcB,6760364,6760382,6760364,18,74,utRho07
yhcC,6708470,6708470,6708100,370,44,utRho07
yhcF,6733440,6733852,6733440,412,20,utRho07
yhcH,6739124,6739124,6738956,168,12,utRho07
yhcM,6760312,6760312,6759994,318,24,utRho07
yhcN,6770812,6771076,6770812,264,168,utRho07
yhcO,6772606,6772606,6772258,348,0,utRho07
yhdH,6806560,6806968,6806560,408,104,utRho07
yhdJ,6823234,6823306,6823234,72,0,utRho07
yhdN,6879092,6879092,6879018,74,1774,utRho07
yhdT,6814702,6814750,6814702,48,362,utRho07
yhdU,6824994,6825242,6824994,248,60,utRho07
yhdV,6836392,6836780,6836392,388,0,utRho07
yhdW,6837944,6838298,6837944,354,2,utRho07
yheO,6953082,6953082,6952880,202,666,utRho07
yheV,6957970,6957970,6957584,386,138,utRho07
yhfA,6971902,6971902,6971636,266,126,utRho07
yhfG,6983294,6983294,6983240,54,122,utRho07
yhfL,6998622,6998896,6998622,274,0,utRho07
yhfY,7023244,7023244,7022844,400,84,utRho07
yhgA,7086294,7086334,7086294,40,0,utRho07
yhgE,7065176,7065176,7064878,298,20,utRho07
yhgF,7074352,7074770,7074352,418,1560,utRho07
yhhA,7173458,7173886,7173458,428,0,utRho07
yhhI,7248346,7248756,7248346,410,0,utRho07
yhhJ,7253696,7253696,7253606,90,0,utRho07
yhhM,7211588,7211588,7211220,368,44,utRho07
yhhN,7211150,7211502,7211150,352,44,utRho07
yhhQ,7218238,7218434,7218238,196,338,utRho07
yhhT,7223682,7223730,7223682,48,0,utRho07
yhhX,7162032,7162032,7161610,422,28,utRho07
yhhY,7162222,7162276,7162222,54,28,utRho07
yhhZ,7163516,7163726,7163516,210,0,utRho07
yhiD,7312220,7312220,7311804,416,1792,utRho07
yhiJ,7265190,7265190,7265180,10,0,utRho07
yhiM,7269270,7269682,7269270,412,0,utRho07
yhiN,7275000,7275000,7274820,180,82,utRho07
yhjA,7338522,7338522,7338376,146,0,utRho07
yhjB,7344090,7344090,7343788,302,0,utRho07
yhjC,7344272,7344684,7344272,412,0,utRho07
yhjD,7346660,7346724,7346660,64,42,utRho07
yhjE,7349274,7349572,7349274,298,16,utRho07
yhjG,7356824,7356824,7356730,94,40,utRho07
yhjH,7358458,7358458,7358374,84,80,utRho07
yhjJ,7364032,7364032,7363880,152,50,utRho07
yhjK,7371296,7371296,7371158,138,0,utRho07
yhjR,7392750,7392750,7392370,380,94,utRho07
yhjV,7400796,7401126,7400796,330,514,utRho07
yhjX,7424194,7424194,7424014,180,24,utRho07
yhjY,7425966,7425966,7425868,98,28,utRho07
yiaB,7455654,7455654,7455496,158,0,utRho07
yiaD,7432712,7433094,7432712,382,128,utRho07
yiaF,7438194,7438194,7438088,106,0,utRho07
yiaG,7438862,7438956,7438862,94,0,utRho07
yiaJ,7485236,7485236,7485064,172,0,utRho07
yiaK,7485348,7485466,7485348,118,2,utRho07
yiaT,7503924,7503924,7503736,188,0,utRho07
yiaU,7503792,7503984,7503792,192,0,utRho07
yiaY,7515856,7515856,7515654,202,0,utRho07
yibF,7523950,7523950,7523910,40,0,utRho07
yibG,7536128,7536354,7536128,226,0,utRho07
yibL,7553194,7553330,7553194,136,22,utRho07
yibN,7570112,7570112,7570030,82,700,utRho07
yibT,7552848,7552848,7552760,88,22,utRho07
yicC,7633290,7633352,7633290,62,60,utRho07
yicH,7660862,7660914,7660862,52,0,utRho07
yicJ,7673328,7673328,7671858,1470,196,utRho07
yicN,7685018,7685018,7684804,214,0,utRho07
yicO,7687914,7687914,7687578,336,0,utRho07
yicR,15250308,15250308,15250236,72,0,utRho07
yidB,7755230,7755230,7754930,300,0,utRho07
yidE,7732780,7732780,7732546,234,0,utRho07
yidF,7711580,7711580,7711222,358,0,utRho07
yidQ,7735088,7735456,7735088,368,856,utRho07
yidR,7738824,7738824,7738618,206,0,utRho07
yieE,7787658,7787738,7787658,80,2,utRho07
yieH,7793314,7793548,7793314,234,0,utRho07
yieK,7798928,7798928,7798786,142,0,utRho07
yifB,7900350,7900350,7899998,352,0,utRho07
yifL,7988984,7989044,7988984,60,6,utRho07
yigF,8005750,8005750,8005598,152,98,utRho07
yigI,8009448,8009448,8009394,54,2,utRho07
yigM,8022100,8022152,8022100,52,132,utRho07
yihA,8101970,8101970,8101458,512,218,utRho07
yihD,8084098,8084138,8084098,40,0,utRho07
yihF,8088110,8088398,8088110,288,0,utRho07
yihG,8093304,8093304,8093204,100,0,utRho07
yihI,8102616,8102694,8102616,78,0,utRho07
yihL,8120506,8120894,8120506,388,32,utRho07
yihN,8124332,8124494,8124332,162,0,utRho07
yihO,8131942,8131942,8131532,410,0,utRho07
yihQ,8138892,8138892,8138552,340,0,utRho07
yihV,8147064,8147478,8147064,414,0,utRho07
yihX,8151096,8151106,8151096,10,0,utRho07
yiiE,8158192,8158582,8158192,390,0,utRho07
yiiF,8159124,8159502,8159124,378,0,utRho07
yiiG,8173762,8174004,8173762,242,0,utRho07
yiiM,8205506,8205644,8205506,138,2,utRho07
yiiQ,8224624,8224624,8224428,196,28,utRho07
yiiS,8225738,8225934,8225738,196,24,utRho07
yijE,8272178,8272216,8272178,38,50,utRho07
yijF,8275728,8275728,8275314,414,0,utRho07
yijO,8296858,8296858,8296634,224,166,utRho07
yjaA,8426240,8426468,8426240,228,117772,utRho07
yjaB,8428312,8428312,8428246,66,0,utRho07
yjaG,8398746,8399008,8398746,262,1032,utRho07
yjaH,8401022,8401132,8401022,110,302,utRho07
yjaZ,8379506,8379572,8379506,66,0,utRho07
yjbB,8455204,8455462,8455204,258,0,utRho07
yjbE,16943432,16943624,16943432,192,0,utRho07
yjbL,8520318,8520642,8520318,324,0,utRho07
yjbQ,8540428,8540476,8540428,48,0,utRho07
yjcB,8550328,8550328,8550082,246,126,utRho07
yjcC,8550836,8550942,8550836,106,0,utRho07
yjcD,8556628,8556958,8556628,330,88,utRho07
yjcE,8559658,8559960,8559658,302,0,utRho07
yjcF,8566212,8566212,8566150,62,0,utRho07
yjcO,8594660,8594660,8594250,410,0,utRho07
yjdA,8654128,8654270,8654128,142,0,utRho07
yjdC,8726660,8726660,8726616,44,0,utRho07
yjdK,8704780,8705168,8704780,388,0,utRho07
yjdL,8713034,8713034,8712822,212,0,utRho07
yjdM,8653672,8653672,8653468,204,160,utRho07
yjeF,8787354,8788132,8787354,778,2590,utRho07
yjeI,8745522,8745618,8745522,96,24,utRho07
yjeJ,8748806,8748806,8748468,338,4,utRho07
yjeV,8785472,8785784,8785472,312,88,utRho07
yjfP,8833512,8833904,8833512,392,2,utRho07
yjfY,8849656,8849656,8849582,74,0,utRho07
yjfZ,8855052,8855052,8854844,208,0,utRho07
yjgA,8916162,8916162,8915730,432,84,utRho07
yjgL,8950802,8950874,8950802,72,0,utRho07
yjgM,8959342,8959342,8959074,268,0,utRho07
yjgN,8959132,8959460,8959132,328,0,utRho07
yjgR,8980170,8980170,8980126,44,66,utRho07
yjgZ,9002116,9002520,9002116,404,98,utRho07
yjhB,9007764,9008116,9007764,352,0,utRho07
yjhG,9048452,9048452,9048188,264,90,utRho07
yjhU,9041080,9041080,9040648,432,106,utRho07
yjiA,9178096,9178096,9177730,366,390,utRho07
yjiJ,9125364,9125364,9125350,14,0,utRho07
yjiK,9127270,9127270,9127422,152,22,utRho07
yjiL,9129604,9129604,9129378,226,0,utRho07
yjiS,9143410,9143502,9143410,92,0,utRho07
yjiY,9182734,9182734,9182558,176,384,utRho07
yjjA,9200674,9200674,9200378,296,44,utRho07
yjjB,18408708,18408708,18407800,908,184,utRho07
yjjJ,9243314,9243538,9243314,224,0,utRho07
yjjK,9261132,9261132,9261044,88,0,utRho07
yjjL,9189764,9189764,9189444,320,60,utRho07
yjjM,9191894,9191894,9191702,192,0,utRho07
yjjP,9206068,9206068,9205716,352,10,utRho07
yjjQ,9206638,9206954,9206638,316,2,utRho07
yjjX,9267798,9267798,9267490,308,1014,utRho07
yjjY,9280716,9280804,9280716,88,434,utRho07
yjjZ,9211554,9211608,9211554,54,112,utRho07
yjtD,9281676,9281884,9281676,208,16,utRho07
ykfB,532454,532454,532174,280,114,utRho07
ykfI,527636,527636,527338,298,0,utRho07
ykgB,637050,637050,636638,412,0,utRho07
ykgC,640430,640430,640002,428,0,utRho07
ykgD,640232,640454,640232,222,0,utRho07
ykgE,642962,643216,642962,254,0,utRho07
ykgJ,608524,608524,608364,160,0,utRho07
ykgL,623878,624224,623878,346,0,utRho07
ykgM,625610,625610,625554,56,0,utRho07
ykgR,626570,626570,626484,86,0,utRho07
ylaC,958576,958576,958502,74,574,utRho07
yliE,1745938,1745958,1745938,20,0,utRho07
ymcE,2103660,2103694,2103660,34,0,utRho07
ymdA,2210450,2210828,2210450,378,134,utRho07
ymdB,2211428,2211640,2211428,212,34,utRho07
ymfD,2395322,2395322,2395064,258,186,utRho07
ymfI,2402880,2402994,2402880,114,0,utRho07
ymfJ,2404518,2404518,2404168,350,170,utRho07
ymfK,2406176,2406176,2405866,310,0,utRho07
ymfT,2405766,2406048,2405766,282,0,utRho07
ymgE,2489110,2489456,2489110,346,0,utRho07
ymgF,2437628,2437966,2437628,338,0,utRho07
ymiA,2670112,2670320,2670112,208,80,utRho07
ymjA,2715620,2715620,2715336,284,406,utRho07
ynaI,2791946,2791946,2791844,102,0,utRho07
ynaK,2850438,2850754,2850438,316,0,utRho07
ynbA,2954924,2955242,2954924,318,0,utRho07
yncD,3046552,3046552,3046130,422,74,utRho07
yncE,3046454,3046614,3046454,160,0,utRho07
yncG,3052456,3052494,3052456,38,46,utRho07
yncL,3034492,3034492,3034388,104,22,utRho07
yneE,3218364,3218364,3218044,320,0,utRho07
yneF,3223748,3223748,3223708,40,0,utRho07
yneJ,3229560,3229608,3229560,48,38,utRho07
yneK,3231100,3231526,3231100,426,0,utRho07
yneM,3245176,3245292,3245176,116,0,utRho07
ynfA,3311398,3311398,3311346,52,0,utRho07
ynfB,3311418,3311616,3311418,198,246,utRho07
ynfC,3315094,3315094,3314914,180,0,utRho07
ynfD,3314828,3315130,3314828,302,0,utRho07
ynfE,3316006,3316138,3316006,132,0,utRho07
ynfK,3334670,3334670,3334438,232,210,utRho07
ynfL,3339304,3339304,3339184,120,0,utRho07
ynfM,3339260,3339398,3339260,138,0,utRho07
ynfN,3276598,3276598,3276218,380,10,utRho07
ynfO,3273454,3273512,3273454,58,0,utRho07
ynhG,3517890,3517890,3517450,440,88,utRho07
yniA,3615158,3615592,3615158,434,68,utRho07
yniB,3618526,3618526,3618466,60,0,utRho07
yniC,3618652,3618760,3618652,108,20,utRho07
yniD,3610202,3610330,3610202,128,0,utRho07
ynjE,3678880,3678934,3678880,54,0,utRho07
ynjF,3683222,3683222,3682806,416,56,utRho07
ynjH,3684376,3684376,3684270,106,16,utRho07
ynjI,3690022,3690022,3689742,280,2,utRho07
yoaB,3786642,3786734,3786642,92,28,utRho07
yoaC,3787932,3788146,3787932,214,58,utRho07
yoaE,3803544,3803544,3803170,374,76,utRho07
yoaF,3755444,3755444,3755064,380,518,utRho07
yoaH,3789866,3789866,3789462,404,306,utRho07
yobB,3850418,3850880,3850418,462,330,utRho07
yobF,3815586,3815586,3815182,404,72,utRho07
yobH,3817800,3817850,3817800,50,0,utRho07
yodB,4084352,4084736,4084352,384,0,utRho07
yodC,4057008,4057008,4056740,268,4,utRho07
yohC,4451358,4451358,4451262,96,0,utRho07
yohD,4451526,4451602,4451526,76,0,utRho07
yohJ,4460986,4461248,4460986,262,62,utRho07
yohO,4431172,4431314,4431172,142,80,utRho07
yojI,4617282,4617282,4617230,52,0,utRho07
ypdI,4988988,4989396,4988988,408,0,utRho07
ypfG,5165786,5165786,5165554,232,2,utRho07
ypfM,5182140,5182140,5181732,408,350,utRho07
yphB,5349590,5349590,5349376,214,4,utRho07
ypjA,5565644,5565644,5565452,192,0,utRho07
ypjB,5569636,5569636,5568858,778,0,utRho07
ypjD,5495860,5495774,5495860,86,0,utRho07
yqaE,5594170,5594170,5594056,114,0,utRho07
yqcA,5846100,5846100,5845968,132,62,utRho07
yqcE,5800944,5801184,5800944,240,0,utRho07
yqeC,6030468,6030468,6030114,354,0,utRho07
yqeF,5971618,5971618,5971184,434,102,utRho07
yqeG,5971438,5971694,5971438,256,66,utRho07
yqeH,5975016,5975072,5975016,56,4,utRho07
yqeI,5976688,5977004,5976688,316,0,utRho07
yqeK,5981140,5981140,5980720,420,0,utRho07
yqfA,6086728,6086728,6086296,432,274,utRho07
yqgA,6219042,6219106,6219042,64,0,utRho07
yqgB,6172500,6172500,6172102,398,3984,utRho07
yqgE,6185768,6185874,6185768,106,240,utRho07
yqhA,6299150,6299150,6298942,208,52,utRho07
yqhC,6310768,6310768,6310436,332,20,utRho07
yqhD,6310604,6310710,6310604,106,20,utRho07
yqhH,6316842,6317254,6316842,412,56,utRho07
yqiC,6369662,6369680,6369662,18,70,utRho07
yqiJ,6384108,6384416,6384108,308,0,utRho07
yqjA,6495096,6495546,6495096,450,740,utRho07
yqjF,6500932,6501124,6500932,192,20,utRho07
yqjG,6501948,6502048,6501948,100,0,utRho07
yqjH,6433078,6433078,6432982,96,0,utRho07
yqjI,6433506,6433558,6433506,52,0,utRho07
yraH,6574552,6574852,6574552,300,0,utRho07
yraP,6592144,6592818,6592144,674,416,utRho07
yraQ,6596414,6596414,6596276,138,0,utRho07
yraR,6598024,6598024,6597692,332,0,utRho07
yrbG,13360844,13361100,13360844,256,0,utRho07
yrbL,6696842,6696904,6696842,62,74,utRho07
yrbN,6616172,6616172,6615866,306,4364,utRho07
yrdB,6860176,6860176,6860046,130,98,utRho07
yrfF,7052548,7052938,7052548,390,304,utRho07
yrhB,7169440,7169518,7169440,78,0,utRho07
ysaB,7451804,7451804,7451424,380,0,utRho07
ysgA,8032686,8032686,8032338,348,26,utRho07
ytfB,8857638,8857638,8857434,204,20,utRho07
ytfE,8864018,8864018,8863966,52,0,utRho07
ytfF,8866296,8866296,8866130,166,8,utRho07
ytfH,8868164,8868226,8868164,62,0,utRho07
ytfI,8875234,8875414,8875234,180,0,utRho07
ytfJ,8878572,8878572,8878524,48,90,utRho07
ytfK,8879022,8879174,8879022,152,206,utRho07
ytfL,8882642,8882642,8882430,212,74,utRho07
ytfQ,8899634,8899924,8899634,290,26,utRho07
ytjB,9249598,9249598,9249578,20,0,utRho07
yzfA,8896588,8896588,8896490,98,0,utRho07
zapA,6111102,6111224,6111102,122,1722,utRho07
zapB,8236772,8237030,8236772,258,256,utRho07
zapC,2011700,2011904,2011700,204,0,utRho07
zinT,4082692,4082750,4082692,58,0,utRho07
zipA,5062814,5062814,5062466,348,0,utRho07
zitB,1569716,1569716,1569646,70,0,utRho07
zntA,7212844,7212902,7212844,58,0,utRho07
zntR,6878336,6878336,6878260,76,44,utRho07
znuA,3885322,3885322,3885166,156,0,utRho07
znuC,3885268,3885324,3885268,56,0,utRho07
zraP,8403424,8403424,8403376,48,0,utRho07
zraS,8403810,8403852,8403810,42,0,utRho07
zupT,6364866,6365100,6364866,234,158,utRho07
zur,8520282,8520282,8520006,276,354,utRho07
zwf,3872752,3872752,3872628,124,0,utRho07
C0343,2818676,2818728,2818676,52,0,utRho08
aaeB,6776526,6776526,6776376,150,0,utRho08
aaeR,6778762,6779040,6778762,278,84,utRho08
aaeX,6778860,6778860,6778674,186,84,utRho08
aat,1854920,1854920,1854864,56,0,utRho08
accA,416822,417242,416822,420,1972,utRho08
accB,6810280,6810872,6810280,592,9640,utRho08
accD,4868030,4868030,4867852,178,662,utRho08
aceB,8430804,8430956,8430804,152,0,utRho08
aceE,245938,246034,245938,96,520,utRho08
ackA,4826918,4826940,4826918,22,1802,utRho08
acnA,2670848,2671662,2670848,814,1306,utRho08
acnB,263038,263230,263038,192,548,utRho08
acpP,2303148,2303230,2303148,82,610,utRho08
acpS,5402324,5402324,5401996,328,74,utRho08
acrA,971396,971396,971238,158,278,utRho08
acrB,969370,969370,968806,564,2252,utRho08
acrD,5174950,5175190,5174950,240,0,utRho08
acrE,6827404,6827728,6827404,324,0,utRho08
acrR,971398,971522,971398,124,62,utRho08
acrZ,1589502,1589546,1589502,44,0,utRho08
acs,8575190,8575190,8574742,448,0,utRho08
actP,8569870,8569870,8569804,66,0,utRho08
ada,4620854,4620854,4620810,44,0,utRho08
add,3404404,3404466,3404404,62,162,utRho08
ade,7687802,7687928,7687802,126,0,utRho08
adhE,2596826,2596826,2596242,584,0,utRho08
adhP,3107988,3107988,3107676,312,1542,utRho08
adiA,8681112,8681112,8681042,70,58,utRho08
adiC,8674404,8674404,8674062,342,0,utRho08
adiY,8676084,8676084,8675858,226,0,utRho08
adk,994278,994350,994278,72,34,utRho08
adrA,807374,807406,807374,32,0,utRho08
aer,6438240,6438240,6438152,88,234,utRho08
aes,1000102,1000102,999946,156,0,utRho08
agaR,6557406,6557406,6557330,76,0,utRho08
agaS,6563778,6563952,6563778,174,0,utRho08
agp,2131118,2131170,2131118,52,70,utRho08
agrA,7296126,7296126,7296126,0,0,utRho08
agrB,7296588,7296588,7296588,0,0,utRho08
ahpC,1277386,1277890,1277386,504,366,utRho08
ahpF,1278004,1279506,1278004,1502,65844,utRho08
ahr,8992698,8992698,8992418,280,0,utRho08
aidB,8828494,8828550,8828494,56,0,utRho08
ais,4731512,4731512,4731240,272,0,utRho08
alaA,4814816,4815122,4814816,306,0,utRho08
alaC,4996798,4996798,4996590,208,0,utRho08
alaE,5598140,5598328,5598140,188,0,utRho08
alaS,5644180,5644180,5644022,158,1528,utRho08
alaW,5036612,5036612,5036462,150,8,utRho08
aldA,2976380,2976464,2976380,84,262,utRho08
aldB,7513070,7513070,7513022,48,0,utRho08
alkA,4295118,4295118,4295080,38,102,utRho08
alkB,4618890,4618890,4618682,208,2,utRho08
allA,1064780,1064902,1064780,122,0,utRho08
allD,1092822,1092822,1092726,96,0,utRho08
allE,1088112,1088112,1088092,20,0,utRho08
allS,1064600,1064600,1064442,158,0,utRho08
alr,8531178,8531564,8531178,386,1814,utRho08
alsE,8617334,8617334,8616956,378,0,utRho08
alsK,8615990,8615990,8615598,392,0,utRho08
alx,6476740,6477160,6476740,420,0,utRho08
amiA,5104482,5104704,5104482,222,0,utRho08
amiC,5898378,5898378,5898020,358,56,utRho08
amn,4110062,4110122,4110062,60,0,utRho08
ampC,8758006,8758006,8757888,118,0,utRho08
ampD,237362,237466,237362,104,114,utRho08
ampG,907372,907372,907090,282,668,utRho08
ampH,792726,792726,792574,152,76,utRho08
amyA,4012230,4012312,4012230,82,146,utRho08
anmK,3439346,3439346,3439204,142,0,utRho08
ansB,6201580,6201580,6201456,124,0,utRho08
ansP,3052040,3052040,3051960,80,254,utRho08
apaG,104068,104068,103212,856,4864,utRho08
apaH,102586,102586,102444,142,5266,utRho08
apbE,4623188,4623188,4623068,120,0,utRho08
appA,2081198,2081234,2081198,36,0,utRho08
appC,2075420,2075480,2075420,60,0,utRho08
appY,1167134,1167362,1167134,228,0,utRho08
apt,982620,982824,982620,204,964,utRho08
aqpZ,1832424,1832424,1832094,330,0,utRho08
araB,140150,140150,140096,54,0,utRho08
araC,140482,140774,140482,292,0,utRho08
araE,5964416,5964416,5964364,52,0,utRho08
araF,3972476,3972476,3972256,220,0,utRho08
araH,3967120,3967120,3967086,34,0,utRho08
araJ,825058,825058,824962,96,0,utRho08
arcA,9281602,9281602,9280612,990,5664,utRho08
arcB,6706098,6706098,6706050,48,0,utRho08
arcZ,6701154,6701154,6701154,0,0,utRho08
arfA,6877346,6877346,6877298,48,0,utRho08
argA,5898312,5898484,5898312,172,56,utRho08
argC,8309770,8310002,8309770,232,144,utRho08
argD,6980442,6980442,6980360,82,0,utRho08
argE,8310156,8310156,8309694,462,288,utRho08
argF,580680,580680,580610,70,0,utRho08
argG,6637124,6637274,6637124,150,0,utRho08
argI,8956688,8956688,8956622,66,22,utRho08
argO,6137672,6137672,6137616,56,66,utRho08
argP,6119460,6119506,6119460,46,2,utRho08
argR,6769204,6769406,6769204,202,0,utRho08
argS,3920002,3920124,3920002,122,0,utRho08
argT,4855698,4855698,4855582,116,0,utRho08
argU,1129406,1129446,1129406,40,0,utRho08
argW,4932616,4932618,4932616,2,0,utRho08
argX,7964728,7964750,7964728,22,46,utRho08
aroF,5482402,5482402,5482300,102,0,utRho08
aroG,1571182,1571266,1571182,84,124,utRho08
aroH,3576636,3576870,3576636,234,444,utRho08
aroK,7038760,7038760,7038128,632,1904,utRho08
aroL,812560,812810,812560,250,10,utRho08
aroP,243342,243342,243102,240,0,utRho08
arpA,8445382,8445382,8444974,408,0,utRho08
arrS,7316108,7316108,7316108,0,0,utRho08
arsR,7297024,7297056,7297024,32,0,utRho08
artJ,1801252,1801252,1801150,102,0,utRho08
artP,1807686,1807686,1807468,218,14,utRho08
ascF,5678858,5679048,5678858,190,0,utRho08
ascG,5678574,5678574,5678528,46,0,utRho08
aslB,7965562,7965916,7965562,354,1132,utRho08
asnA,7854258,7854310,7854258,52,0,utRho08
asnB,1398444,1398444,1398354,90,0,utRho08
asnC,23562186,23562186,23562018,168,0,utRho08
asnS,1978088,1978088,1977970,118,9496,utRho08
asnT,4089082,4089098,4089082,16,222,utRho08
asnU,4119690,4119702,4119690,12,0,utRho08
asnV,4124504,4124520,4124504,16,0,utRho08
aspA,17473728,17473728,17473308,420,0,utRho08
aspC,1971486,1971486,1971418,68,576,utRho08
aspS,3901402,3901402,3901044,358,414,utRho08
aspT,7893560,7893744,7893560,184,198184,utRho08
aspV,473826,473862,473826,36,96,utRho08
asr,3342654,3342752,3342654,98,0,utRho08
astC,3664088,3664088,3663964,124,0,utRho08
astE,3654138,3654138,3653846,292,0,utRho08
atoD,4646824,4646894,4646824,70,0,utRho08
atpB,7844540,7844540,7844102,438,1042,utRho08
atpC,7832118,7832118,7831944,174,2218,utRho08
atpI,7845050,7845050,7844880,170,300,utRho08
avtA,7479348,7479410,7479348,62,176,utRho08
azoR,2965982,2965982,2965720,262,148,utRho08
azuC,3976002,3976002,3975918,84,0,utRho08
bacA,6408350,6408350,6408262,88,0,utRho08
bamA,394052,395856,394052,1804,1082,utRho08
bamB,5277950,5277950,5277304,646,1634,utRho08
bamC,5198028,5198028,5197730,298,1184,utRho08
bamD,5471922,5472292,5471922,370,8382,utRho08
bamE,5506972,5507210,5506972,238,390,utRho08
basS,8666954,8666954,8666544,410,72,utRho08
bax,7474468,7474468,7474354,114,54,utRho08
bcp,5200874,5200956,5200874,82,3296,utRho08
bcsB,7385346,7385346,7385214,132,0,utRho08
bcsE,7392644,7392916,7392644,272,0,utRho08
bdcA,8948128,8948128,8948106,22,72,utRho08
bdcR,8948192,8948248,8948192,56,0,utRho08
bdm,3112680,3112680,3112560,120,0,utRho08
betA,654522,654522,654494,28,486,utRho08
betI,658722,658722,658668,54,0,utRho08
betT,658842,658926,658842,84,0,utRho08
bfr,6933498,6933498,6933450,48,40,utRho08
bglG,23440182,23440182,23439402,780,0,utRho08
bglX,4444240,4444240,4443978,262,0,utRho08
bhsA,2337962,2338146,2337962,184,0,utRho08
bioA,1618584,1618584,1618514,70,0,utRho08
bioB,1618604,1618688,1618604,84,0,utRho08
bioH,7089716,7089716,7089688,28,0,utRho08
bisC,7433026,7433026,7432788,238,204,utRho08
blc,8755490,8755490,8755444,46,0,utRho08
blr,3409024,3409102,3409024,78,54,utRho08
bluF,2431226,2431226,2430950,276,752,utRho08
bluR,2428226,2428226,2428118,108,0,utRho08
bolA,908698,908944,908698,246,0,utRho08
borD,1157842,1157842,1157786,56,0,utRho08
brnQ,838976,839182,838976,206,1196,utRho08
bssR,1756492,1756496,1756492,4,0,utRho08
bssS,2242116,2242116,2241910,206,0,utRho08
btuB,8326798,8327278,8326798,480,3922,utRho08
cadB,8720212,8720212,8720062,150,0,utRho08
cadC,8723926,8723926,8723868,58,0,utRho08
caiE,70998,70998,70742,256,0,utRho08
caiF,68436,68600,68436,164,0,utRho08
caiT,84074,84074,83862,212,0,utRho08
can,285406,285406,285340,66,106,utRho08
carA,59102,59302,59102,200,4,utRho08
carB,61550,61634,61550,84,140,utRho08
cas2,5757830,5757830,5757706,124,0,utRho08
casA,5768638,5768638,5768276,362,0,utRho08
cbl,4121882,4121882,4121828,54,0,utRho08
cbpA,2128074,2128074,2127550,524,144,utRho08
cbrA,7738628,7738754,7738628,126,0,utRho08
cbrB,7794958,7795012,7794958,54,12,utRho08
ccmH,4585242,4585242,4584820,422,0,utRho08
cdaR,364894,364926,364894,32,0,utRho08
cdd,4463638,4463688,4463638,50,0,utRho08
cdh,8219814,8219860,8219814,46,0,utRho08
cdsA,391110,391354,391110,244,704,utRho08
cedA,3627484,3627484,3627326,158,0,utRho08
cfa,3482402,3482826,3482402,424,14,utRho08
chaC,2544844,2544972,2544844,128,0,utRho08
chbB,3643452,3643452,3643238,214,0,utRho08
chbG,3634624,3634624,3634270,354,0,utRho08
cheW,3946924,3946924,3946678,246,1632,utRho08
chiA,6939792,6939792,6939706,86,0,utRho08
chiP,1416472,1416668,1416472,196,0,utRho08
cho,3646984,3647030,3646984,46,0,utRho08
chpS,8896804,8896894,8896804,90,0,utRho08
cirA,4493884,4493884,4493538,346,0,utRho08
citC,1304078,1304078,1303712,366,0,utRho08
citT,1293264,1293264,1293160,104,0,utRho08
clcA,350104,350214,350104,110,0,utRho08
clpA,1846160,1846528,1846160,368,0,utRho08
clpB,5468410,5468410,5468346,64,0,utRho08
clpP,913154,913354,913154,200,776,utRho08
clpS,1845500,1845826,1845500,326,0,utRho08
clpX,914404,914852,914404,448,1730,utRho08
clsA,2617346,2617346,2617290,56,0,utRho08
clsC,2212584,2212710,2212584,126,420,utRho08
cmk,1922330,1922402,1922330,72,140,utRho08
cnu,3409522,3409898,3409522,376,618,utRho08
coaA,8350214,8350214,8350052,162,572,utRho08
cobC,1340092,1340092,1339814,278,416,utRho08
cobT,4129202,4129202,4128934,268,0,utRho08
cobU,4131944,4131944,4131528,416,56,utRho08
codB,709768,709844,709768,76,0,utRho08
comR,2337726,2337726,2337664,62,0,utRho08
copA,1022822,1022822,1022758,64,0,utRho08
corA,8002388,8002852,8002388,464,8464,utRho08
cpdB,8873258,8873258,8873130,128,214,utRho08
cptB,6082198,6082198,6082140,58,94,utRho08
cpxA,8210202,8210202,8209950,252,768,utRho08
cpxP,8211570,8211640,8211570,70,72,utRho08
cpxR,8211372,8211372,8211340,32,72,utRho08
cra,175894,176056,175894,162,0,utRho08
crcB,1316016,1316016,1315876,140,108,utRho08
creA,9270486,9271042,9270486,556,170,utRho08
creD,9276320,9276356,9276320,36,0,utRho08
crl,515620,515658,515620,38,958,utRho08
crp,6971906,6972240,6971906,334,4518,utRho08
crr,5070960,5071668,5070960,708,4486,utRho08
csdA,5886414,5886674,5886414,260,0,utRho08
csgB,2207718,2207902,2207718,184,0,utRho08
csgD,2206688,2206688,2206392,296,0,utRho08
csgG,2203510,2203510,2203368,142,0,utRho08
csiD,5577854,5577970,5577854,116,80,utRho08
csiE,5330802,5330870,5330802,68,0,utRho08
csiR,5590942,5591348,5590942,406,0,utRho08
cspA,7439778,7440098,7439778,320,40584,utRho08
cspB,3283430,3283430,3283108,322,4,utRho08
cspC,3815018,3815018,3814870,148,116,utRho08
cspD,1845352,1845352,1845180,172,1614,utRho08
cspE,1314294,1314584,1314294,290,34,utRho08
cspF,3283380,3283710,3283380,330,44,utRho08
cspG,2102610,2102922,2102610,312,870,utRho08
cspH,2102746,2102746,2102350,396,274,utRho08
cspI,3277624,3277624,3277334,290,0,utRho08
csrA,5638746,5638746,5638292,454,994,utRho08
csrB,5849048,5849048,5849048,0,0,utRho08
csrC,8102072,8102072,8102072,0,0,utRho08
csrD,6806850,6806850,6806664,186,0,utRho08
cstA,1259710,1259788,1259710,78,0,utRho08
cueO,274090,274166,274090,76,0,utRho08
cueR,1027948,1027986,1027948,38,0,utRho08
curA,3037784,3038054,3037784,270,0,utRho08
cusC,1191146,1191200,1191146,54,0,utRho08
cusR,1190924,1190924,1190886,38,0,utRho08
cutA,8730784,8730784,8730712,72,64,utRho08
cutC,3918534,3918534,3917920,614,66,utRho08
cvpA,4861600,4861600,4861526,74,18,utRho08
cvrA,2484328,2484328,2484142,186,28,utRho08
cyaA,7981548,7982306,7981548,758,440,utRho08
cyaR,4334228,4334224,4334228,4,0,utRho08
cyaY,7988166,7988166,7988118,48,0,utRho08
cybB,2981522,2981804,2981522,282,0,utRho08
cycA,8859560,8859728,8859560,168,8,utRho08
cydA,1542340,1542916,1542340,576,0,utRho08
cydC,1858800,1858800,1858390,410,332,utRho08
cydD,1862062,1862062,1861924,138,80,utRho08
cydX,1548300,1548392,1548300,92,184,utRho08
cynR,717418,717418,717380,38,0,utRho08
cynT,1435092,1435196,1435092,104,0,utRho08
cyoA,903306,903306,903220,86,3332,utRho08
cyoE,895540,895540,895410,130,614,utRho08
cysB,2667576,2667710,2667576,134,146,utRho08
cysC,5748056,5748056,5747984,72,0,utRho08
cysD,5752736,5752736,5752658,78,0,utRho08
cysE,7565362,7565362,7565124,238,442,utRho08
cysG,6995508,6995656,6995508,148,0,utRho08
cysJ,5783928,5783928,5783796,132,1356,utRho08
cysK,5064688,5064818,5064688,130,36,utRho08
cysP,5087114,5087114,5087056,58,0,utRho08
cysS,1109154,1109222,1109154,68,500,utRho08
cysT,3984100,3984100,3983974,126,8,utRho08
cysZ,5062766,5062926,5062766,160,0,utRho08
cytR,8249018,8249018,8248912,106,108,utRho08
dacA,1328002,1328002,1327926,76,122,utRho08
dacB,6657714,6657926,6657714,212,120,utRho08
dacC,1761306,1761454,1761306,148,0,utRho08
dadA,2475018,2475142,2475018,124,0,utRho08
dam,7032504,7032504,7031826,678,1778,utRho08
damX,7035200,7035200,7034612,588,262,utRho08
dapA,5199568,5199568,5199520,48,0,utRho08
dapB,56576,56748,56576,172,288,utRho08
dapD,371954,371954,371894,60,428,utRho08
dapE,5183120,5183214,5183120,94,274,utRho08
dcp,3254844,3254844,3254760,84,46,utRho08
dcrB,7219534,7219910,7219534,376,8,utRho08
dctA,7366996,7366996,7366894,102,252,utRho08
dcuA,8733686,8733686,8733546,140,0,utRho08
dcuB,8698182,8698182,8697488,694,0,utRho08
dcuC,1312166,1312166,1311936,230,0,utRho08
dcuD,6749166,6749738,6749166,572,0,utRho08
dcuR,8701130,8701130,8700068,1062,376,utRho08
dcuS,8703370,8703370,8703324,46,0,utRho08
dcyD,3999016,3999016,3998960,56,0,utRho08
ddpX,3126498,3126498,3126152,346,0,utRho08
deaD,6615818,6615818,6615720,98,2130,utRho08
dedA,4869880,4869880,4869482,398,9102,utRho08
dedD,4863750,4863750,4863368,382,0,utRho08
def,6867300,6867380,6867300,80,0,utRho08
degP,361690,361768,361690,78,0,utRho08
degQ,6761308,6761486,6761308,178,724,utRho08
deoB,9239134,9239206,9239134,72,0,utRho08
deoC,9233358,9234646,9233358,1288,128,utRho08
dfp,7625406,7625462,7625406,56,0,utRho08
dgcZ,3247758,3247758,3247700,58,0,utRho08
dgkA,8512914,8513274,8512914,360,224,utRho08
dgt,358392,358474,358392,82,0,utRho08
dhaK,2501888,2501888,2501676,212,996,utRho08
dhaR,2502006,2502132,2502006,126,0,utRho08
dicB,3299194,3299218,3299194,24,0,utRho08
dicC,3295752,3295752,3295700,52,0,utRho08
dinB,501760,501796,501760,36,0,utRho08
dinD,7635398,7635520,7635398,122,4,utRho08
dinG,1666146,1666140,1666146,6,64,utRho08
dinI,2243018,2243018,2242974,44,0,utRho08
dinJ,493230,493230,493004,226,0,utRho08
dinQ,7295964,7295964,7295576,388,908,utRho08
djlA,114536,114728,114536,192,0,utRho08
dkgA,6313142,6313246,6313142,104,0,utRho08
dkgB,458196,458334,458196,138,46,utRho08
dksA,321502,321502,321208,294,1436,utRho08
dld,4444164,4444370,4444164,206,0,utRho08
dmlA,3763424,3763824,3763424,400,0,utRho08
dmlR,3763710,3763710,3763618,92,0,utRho08
dmsA,1881646,1881918,1881646,272,0,utRho08
dnaA,7767922,7767922,7767458,464,736,utRho08
dnaB,8528566,8528628,8528566,62,66,utRho08
dnaK,24096,24326,24096,230,408,utRho08
dnaN,7765466,7765466,7764642,824,1304,utRho08
dnaQ,471868,472134,471868,266,1068,utRho08
dnaT,18406460,18406460,18406068,392,0,utRho08
dnaX,984112,984184,984112,72,214,utRho08
dosP,3131486,3131486,3131466,20,0,utRho08
dpiB,1303968,1304470,1303968,502,0,utRho08
dppA,7415740,7415740,7415410,330,2278,utRho08
dps,1697900,1697900,1697822,78,0,utRho08
dsbA,8086754,8086836,8086754,82,2464,utRho08
dsbB,2466294,2466294,2466060,234,0,utRho08
dsbC,6079266,6079266,6077644,1622,1078,utRho08
dsbG,1277600,1277600,1277146,454,650,utRho08
dsdA,4958242,4958404,4958242,162,84,utRho08
dsdC,4955492,4955492,4955258,234,0,utRho08
dsdX,4955642,4955694,4955642,52,0,utRho08
dsrA,4050626,4050626,4050626,0,0,utRho08
dsrB,4049686,4049686,4049646,40,0,utRho08
dtpD,1485340,1485340,1485112,228,0,utRho08
dusA,8523200,8523338,8523200,138,1776,utRho08
dusB,6820492,6820560,6820492,68,278,utRho08
dusC,4460790,4460790,4460770,20,0,utRho08
dut,7627704,7627864,7627704,160,2006,utRho08
dxr,386670,387042,386670,372,1366,utRho08
ebgA,6445102,6445266,6445102,164,48,utRho08
ebgR,6442874,6442932,6442874,58,0,utRho08
ecnB,8753018,8753106,8753018,88,160,utRho08
eco,4607594,4607810,4607594,216,0,utRho08
ecpA,621594,621594,621342,252,0,utRho08
ecpB,620238,620238,620052,186,0,utRho08
ecpR,622964,622964,622672,292,0,utRho08
eda,3866218,3866218,3865512,706,176,utRho08
edd,3869426,3869426,3869208,218,216,utRho08
efeO,2164308,2164486,2164308,178,40,utRho08
efeU_1,2162614,2162712,2162614,98,0,utRho08
efp,8751134,8751398,8751134,264,4284,utRho08
elaA,4763372,4763372,4763086,286,32,utRho08
elaD,4765308,4765426,4765308,118,36,utRho08
elfA,1995530,1995736,1995530,206,0,utRho08
elfD,1996642,1996980,1996642,338,0,utRho08
emrD,7707690,7707844,7707690,154,0,utRho08
emrK,4966896,4966896,4966678,218,0,utRho08
emrY,4964668,4964668,4964352,316,0,utRho08
emtA,2486250,2486360,2486250,110,0,utRho08
endA,12361100,12361388,12361100,288,0,utRho08
eno,5817692,5817692,5815882,1810,4252,utRho08
entC,1249662,1249770,1249662,108,0,utRho08
entD,1220508,1220508,1220158,350,0,utRho08
entH,1258584,1258600,1258584,16,0,utRho08
entS,1244506,1244600,1244506,94,0,utRho08
envR,6827266,6827266,6826930,336,0,utRho08
epd,12295292,12295292,12294764,528,0,utRho08
epmA,8765236,8765286,8765236,50,0,utRho08
epmB,8751406,8751406,8751314,92,2588,utRho08
eptB,7421162,7421162,7420950,212,96,utRho08
eptC,8300622,8300622,8300530,92,54,utRho08
erfK,4126708,4126708,4126646,62,142,utRho08
erpA,353122,353220,353122,98,54,utRho08
esrE,8039956,8039956,8039956,0,0,utRho08
essD,1153746,1154796,1153746,1050,104,utRho08
etk,2088606,2088606,2088420,186,0,utRho08
evgA,4967262,4967510,4967262,248,0,utRho08
exbB,6304028,6304028,6303968,60,0,utRho08
exbD,6302780,6302780,6302486,294,0,utRho08
exuR,6493016,6493304,6493016,288,102,utRho08
exuT,6490004,6490208,6490004,204,0,utRho08
fabA,2032996,2032996,2032940,56,90,utRho08
fabB,4883282,4883282,4883210,72,0,utRho08
fabH,2297032,2297518,2297032,486,2252,utRho08
fabI,2702236,2702236,2702078,158,74,utRho08
fadB,8062026,8062026,8061942,84,0,utRho08
fadD,3779614,3779614,3779492,122,70,utRho08
fadE,486812,486812,486606,206,0,utRho08
fadH,6463248,6463330,6463248,82,0,utRho08
fadI,4921022,4921022,4920938,84,80,utRho08
fadL,4922410,4922600,4922410,190,0,utRho08
fadM,928720,928804,928720,84,0,utRho08
fadR,2469810,2469876,2469810,66,0,utRho08
fbaB,4357334,4357334,4357128,206,0,utRho08
fdhE,8162722,8162722,8162456,266,1578,utRho08
fdhF,8598814,8598814,8598732,82,0,utRho08
fdnG,3094744,3094802,3094744,58,0,utRho08
fdrA,1093012,1093360,1093012,348,0,utRho08
feaB,2894994,2895038,2894994,44,0,utRho08
feaR,2894734,2894734,2894566,168,0,utRho08
fecA,9033454,9033454,9033354,100,0,utRho08
fecE,9023288,9023288,9022914,374,4848,utRho08
fecI,9036564,9036564,9036470,94,0,utRho08
feoA,7080114,7080326,7080114,212,94,utRho08
fepA,1225334,1225334,1224988,346,0,utRho08
fepB,1249454,1249454,1249020,434,0,utRho08
fepD,1244468,1244468,1244378,90,0,utRho08
fes,1225374,1225630,1225374,256,30,utRho08
ffh,5495706,5495706,5495590,116,1608,utRho08
ffs,952576,952848,952576,272,0,utRho08
fhuA,334884,334968,334884,84,0,utRho08
fhuE,2323294,2323294,2323102,192,0,utRho08
fhuF,9211504,9211504,9211326,178,186,utRho08
fic,6983296,6983296,6982926,370,706,utRho08
fieF,8212864,8212938,8212864,74,0,utRho08
fimA,9085388,9086230,9085388,842,256,utRho08
fimB,9081334,9081914,9081334,580,840,utRho08
fimE,9083742,9084074,9083742,332,0,utRho08
fimZ,1129214,1129214,1128960,254,0,utRho08
fiu,1683296,1683296,1683062,234,0,utRho08
fixA,84650,84806,84650,156,0,utRho08
fkpA,6955050,6955050,6954838,212,10348,utRho08
fldA,2846084,2846084,2845860,224,2868,utRho08
fldB,6079644,6079710,6079644,66,0,utRho08
flgA,2261770,2261770,2261726,44,0,utRho08
flgB,2261986,2262036,2261986,50,0,utRho08
flgK,2276702,2276756,2276702,54,446,utRho08
flgM,2260330,2260330,2260256,74,412,utRho08
flgN,2259828,2259828,2259660,168,152,utRho08
flhB,3932432,3932432,3932382,50,698,utRho08
flhC,3955864,3955864,3955688,176,0,utRho08
flhD,3957154,3957154,3956394,760,120,utRho08
fliA,4003638,4003638,4003578,60,76,utRho08
fliC,4007352,4007352,4007212,140,1224,utRho08
fliD,4007634,4007744,4007634,110,138,utRho08
fliE,4026186,4026186,4026028,158,0,utRho08
fliF,4026292,4026458,4026292,166,158,utRho08
fliL,4039168,4039236,4039168,68,40,utRho08
flk,4875824,4875900,4875824,76,0,utRho08
flu,4142634,4143078,4142634,444,28,utRho08
flxA,3292776,3292810,3292776,34,100,utRho08
fnr,2799104,2799104,2799052,52,58,utRho08
fnrS,2818258,2818258,2818258,0,0,utRho08
focA,1909628,1909628,1908932,696,724,utRho08
folA,99598,99646,99598,48,0,utRho08
folB,6409296,6409296,6409178,118,28,utRho08
folD,1115562,1115562,1115482,80,102,utRho08
folE,4487696,4487696,4487304,392,3146,utRho08
fpr,8228998,8228998,8228944,54,0,utRho08
frc,4986878,4986878,4986508,370,0,utRho08
frdA,8764824,8764824,8764636,188,52,utRho08
frdD,8758948,8758948,8758732,216,1182,utRho08
fre,8052886,8053054,8052886,168,1870,utRho08
frlA,6999518,6999820,6999518,302,0,utRho08
frr,385624,385744,385624,120,1338,utRho08
frsA,513004,513054,513004,50,54,utRho08
fruB,4527194,4527194,4526990,204,0,utRho08
frvR,8179804,8179804,8179710,94,0,utRho08
fryA,5008986,5008986,5008970,16,0,utRho08
fsaA,1727060,1727284,1727060,224,0,utRho08
fsr,1009710,1009710,1009392,318,52,utRho08
ftnA,3977364,3977432,3977364,68,0,utRho08
ftnB,3973550,3973850,3973550,300,0,utRho08
ftsA,207122,207964,207122,842,850,utRho08
ftsB,5745802,5745802,5745640,162,142,utRho08
ftsH,6654204,6654204,6653870,334,676,utRho08
ftsK,1865858,1866448,1865858,590,2070,utRho08
ftsL,181376,182064,181376,688,2162,utRho08
ftsP,6325732,6325732,6325338,394,0,utRho08
ftsQ,205484,206310,205484,826,286,utRho08
ftsX,7204512,7204512,7204172,340,362,utRho08
ftsZ,209272,210610,209272,1338,124,utRho08
fucA,5867708,5867708,5867376,332,0,utRho08
fucP,5868238,5868470,5868238,232,0,utRho08
fumA,6753760,6753760,6753508,252,4112,utRho08
fumB,8694696,8694696,8694652,44,0,utRho08
fumC,3373418,3373418,3373176,242,20,utRho08
fur,2842892,2842892,2842584,308,7564,utRho08
fusA,6947370,6947370,6947028,342,27930,utRho08
fxsA,8737206,8737328,8737206,122,80,utRho08
gabD,5581824,5582546,5581824,722,1180,utRho08
gadA,7335214,7335214,7335160,54,0,utRho08
gadB,3144144,3144144,3144090,54,0,utRho08
gadC,3141168,3141168,3140978,190,0,utRho08
gadE,7315600,7316732,7315600,1132,0,utRho08
gadW,7329562,7329562,7329236,326,0,utRho08
gadX,14663356,14663356,14663240,116,0,utRho08
gadY,7329728,7329728,7329728,0,0,utRho08
galE,1584354,1584354,1584110,244,0,utRho08
galF,4228702,4228702,4228654,48,0,utRho08
galM,1577796,1577796,1577674,122,180,utRho08
galP,6176510,6176568,6176510,58,0,utRho08
galR,5953138,5953198,5953138,60,52,utRho08
galS,4483420,4483420,4483336,84,0,utRho08
galU,2582810,2582914,2582810,104,570,utRho08
gapA,3724480,3725542,3724480,1062,5134,utRho08
garP,6549868,6549868,6549814,54,60,utRho08
gatY,4354468,4354468,4354408,60,0,utRho08
gatZ,4352864,4352864,4352642,222,15474,utRho08
gcd,282558,282558,282450,108,0,utRho08
gcl,1067814,1067832,1067814,18,0,utRho08
gcvA,5885278,5885278,5885134,144,0,utRho08
gcvB,5885392,5885392,5885392,0,0,utRho08
gcvR,5199758,5199812,5199758,54,290,utRho08
gcvT,6101544,6101544,6101334,210,1768,utRho08
gdhA,3684616,3684742,3684616,126,0,utRho08
gfcA,2099668,2099668,2099488,180,0,utRho08
gfcD,2096236,2096236,2095890,346,0,utRho08
ghrA,2195648,2195772,2195648,124,0,utRho08
ghrB,7434378,7434620,7434378,242,656,utRho08
glcA,6242728,6242728,6242558,170,2,utRho08
glcC,6256412,6256544,6256412,132,0,utRho08
glcD,6256152,6256152,6256042,110,0,utRho08
gldA,8278092,8278092,8278070,22,0,utRho08
glgA,7136784,7136784,7136066,718,586,utRho08
glgB,7147314,7147314,7147004,310,0,utRho08
glgC,7139142,7139142,7138656,486,126,utRho08
glgP,7133546,7133546,7133162,384,460,utRho08
glgS,6384024,6384024,6383878,146,0,utRho08
glgX,7142838,7142838,7142638,200,0,utRho08
glk,5018922,5018922,5018852,70,50,utRho08
glmS,7827622,7827622,7827336,286,7516,utRho08
glmU,7830652,7830652,7830400,252,204,utRho08
glmY,10765360,10765360,10765360,0,0,utRho08
glmZ,7972864,7972864,7972864,0,0,utRho08
glnA,16232888,16232888,16232136,752,820,utRho08
glnB,5375052,5375052,5374816,236,196,utRho08
glnD,377310,377310,377300,10,16,utRho08
glnE,6399602,6399602,6399282,320,0,utRho08
glnH,1696396,1696396,1696008,388,0,utRho08
glnK,945112,945196,945112,84,0,utRho08
glnL,8112742,8112742,8112678,64,0,utRho08
glnQ,1693262,1693262,1692926,336,360,utRho08
glnS,1411998,1412186,1411998,188,1114,utRho08
gloA,3455602,3455674,3455602,72,16,utRho08
gloB,469852,469852,469564,288,314,utRho08
glpA,4705166,4705294,4705166,128,0,utRho08
glpD,7123942,7124026,7123942,84,0,utRho08
glpE,7123698,7123698,7123646,52,0,utRho08
glpF,8236322,8236322,8236180,142,208,utRho08
glpG,7122960,7122960,7122904,56,244,utRho08
glpR,7121782,7121782,7121210,572,182,utRho08
glpT,4704902,4704902,4704748,154,298,utRho08
glpX,8231212,8231212,8231158,54,4100,utRho08
glrK,5382246,5382246,5382196,50,132,utRho08
gltA,1509534,1509534,1508936,598,10724,utRho08
gltB,6709018,6709264,6709018,246,48,utRho08
gltI,1375792,1375792,1375494,298,2216,utRho08
gltP,8588536,8588962,8588536,426,1046,utRho08
gltS,7657382,7657382,7657330,52,468,utRho08
gltX,5041568,5041568,5041344,224,4,utRho08
gluQ,320286,320286,320224,62,334,utRho08
glyA,5371148,5371148,5371014,134,200,utRho08
glyQ,7450708,7450708,7450636,72,138,utRho08
glyS,7448990,7448990,7448794,196,4392,utRho08
glyU,5998128,5998128,5998114,14,0,utRho08
glyV,8784626,8784720,8784626,94,86,utRho08
glyW,3984360,3984360,3984234,126,0,utRho08
gmhB,445612,445666,445612,54,0,utRho08
gmk,7642776,7642856,7642776,80,112,utRho08
gmr,2693686,2693686,2693484,202,0,utRho08
gnd,4202648,4202648,4202536,112,964,utRho08
gnsB,3275692,3275692,3275564,128,0,utRho08
gntK,14310580,14310580,14310368,212,0,utRho08
gntP,9102668,9102668,9102592,76,0,utRho08
gntR,7157760,7157760,7157452,308,452,utRho08
gntT,7092810,7093118,7092810,308,0,utRho08
gntU,7154170,7154170,7154122,48,0,utRho08
gntX,7089334,7089764,7089334,430,0,utRho08
gor,7292224,7292598,7292224,374,1078,utRho08
gpmA,1575340,1575340,1575190,150,0,utRho08
gpmM,7570374,7570520,7570374,146,0,utRho08
gpsA,7567620,7567620,7567322,298,11234,utRho08
gpt,511828,511954,511828,126,1030,utRho08
grcA,5433046,5433046,5432898,148,0,utRho08
greA,6657728,6657728,6657430,298,2658,utRho08
greB,7073488,7073624,7073488,136,0,utRho08
groL,8741566,8742050,8741566,484,1424,utRho08
groS,8741232,8741376,8741232,144,1280,utRho08
grpE,5501494,5501494,5501416,78,292,utRho08
grxA,1781552,1781552,1781506,46,0,utRho08
grxB,2248206,2248206,2248108,98,0,utRho08
grxC,7569152,7569152,7568884,268,8510,utRho08
grxD,3468324,3468324,3468202,122,21890,utRho08
gspA,6911268,6911268,6910796,472,0,utRho08
gspC,6910964,6911156,6910964,192,0,utRho08
gss,6277220,6277220,6277044,176,170,utRho08
gstA,3428654,3428754,3428654,100,0,utRho08
gstB,1761038,1761038,1760960,78,0,utRho08
guaB,5268214,5268214,5268140,74,224,utRho08
gudD,5839026,5839026,5838770,256,0,utRho08
gyrA,4678914,4678914,4678840,74,0,utRho08
gyrB,7760300,7760300,7760238,62,4,utRho08
hcaE,5337964,5338064,5337964,100,0,utRho08
hcaR,5337928,5337928,5337792,136,44,utRho08
hcaT,5336106,5336106,5335692,414,204,utRho08
hchA,4071260,4071670,4071260,410,0,utRho08
hcp,1828258,1828258,1827628,630,32,utRho08
hcr,1824400,1824400,1824300,100,0,utRho08
hdeA,7313582,7313582,7313480,102,0,utRho08
hdeD,7313920,7313990,7313920,70,0,utRho08
hdfR,7896320,7896320,7895934,386,64,utRho08
hdhA,3396244,3396244,3396080,164,0,utRho08
helD,2048876,2048942,2048876,66,0,utRho08
hemA,2527166,2527428,2527166,262,56,utRho08
hemB,779722,779722,779454,268,62,utRho08
hemF,5106410,5106450,5106410,40,0,utRho08
hemH,996062,996110,996062,48,0,utRho08
hemL,349882,349882,349764,118,10,utRho08
hemN,8103886,8104090,8103886,204,0,utRho08
hepA,127176,127176,126528,648,1628,utRho08
hflD,2385372,2385372,2385262,110,482,utRho08
hfq,8799602,8800576,8799602,974,2538,utRho08
hha,961006,961006,960616,390,0,utRho08
hicA,3018442,3018572,3018442,130,0,utRho08
higA,6468682,6468682,6468288,394,0,utRho08
higB,6468960,6468960,6468910,50,0,utRho08
hinT,2323642,2323770,2323642,128,0,utRho08
hipB,3184964,3184964,3184884,80,0,utRho08
hisB,4186720,4186936,4186720,216,474,utRho08
hisJ,4853674,4853674,4853576,98,2,utRho08
hisL,8359856,8359984,8359856,128,256,utRho08
hisS,5281284,5281284,5281150,134,48,utRho08
hlpA,400910,400964,400910,54,138,utRho08
hlyE,2460932,2460932,2460788,144,0,utRho08
hmp,5371594,5371670,5371594,76,0,utRho08
hns,2585916,2585916,2585844,72,2108,utRho08
hofM,7045856,7045856,7045502,354,0,utRho08
hokA,7441620,7441620,7441200,420,96,utRho08
hokC,33902,33902,33806,96,302,utRho08
hokE,1215462,1215672,1215462,210,0,utRho08
holC,8968546,8968546,8968560,14,690,utRho08
holD,9215562,9215606,9215562,44,0,utRho08
holE,3850040,3850216,3850040,176,304,utRho08
hpt,282720,282862,282720,142,0,utRho08
hrpB,324150,324210,324150,60,0,utRho08
hscB,5319048,5319048,5318934,114,516,utRho08
hscC,1367188,1367188,1366786,402,294,utRho08
hsdS,9163004,9163004,9162924,80,0,utRho08
hslJ,2883560,2883560,2883486,74,240,utRho08
hslO,7059344,7059548,7059344,204,7694,utRho08
hslR,7058220,7058696,7058220,476,1190,utRho08
hslV,8244708,8244708,8244574,134,116,utRho08
hsrA,7881412,7881412,7881224,188,0,utRho08
htgA,21286,21660,21286,374,70,utRho08
htpG,989634,990240,989634,606,4624,utRho08
htpX,3825236,3825236,3825152,84,0,utRho08
htrE,311036,311036,310852,184,0,utRho08
htrL,7587668,7587668,7587366,302,0,utRho08
hupA,8400352,8400562,8400352,210,262,utRho08
hupB,1845220,1845804,1845220,584,560,utRho08
hyaA,2063968,2064278,2063968,310,0,utRho08
hybO,6292726,6292726,6292522,204,524,utRho08
hycA,5700922,5700922,5700870,52,0,utRho08
hycI,5686204,5686204,5686086,118,0,utRho08
hydN,5676264,5676264,5676210,54,0,utRho08
hyfA,5202342,5202402,5202342,60,0,utRho08
hypA,11402508,11402588,11402508,80,0,utRho08
hypB,11403356,11404004,11403356,648,180,utRho08
hypF,5676210,5676210,5674850,1360,400,utRho08
hypT,9116634,9116634,9116578,56,120,utRho08
hyuA,6019660,6020056,6019660,396,0,utRho08
iaaA,1733074,1733136,1733074,62,0,utRho08
iadA,9119074,9119074,9119052,22,0,utRho08
iap,5753072,5753162,5753072,90,0,utRho08
ibaG,6673966,6673966,6673606,360,334,utRho08
ibpA,7735036,7735036,7734844,192,4,utRho08
ibpB,7733962,7733962,7733794,168,284,utRho08
icd,2389922,2390246,2389922,324,416,utRho08
iclR,8447304,8447304,8447256,48,16,utRho08
idi,6065876,6066130,6065876,254,0,utRho08
idnD,8988870,8988870,8988812,58,0,utRho08
idnK,8989194,8989246,8989194,52,0,utRho08
ihfA,3591442,3591442,3591104,338,584,utRho08
ihfB,1927498,1927656,1927498,158,1246,utRho08
ileS,43666,44782,43666,1116,5116,utRho08
ileX,6431194,6431196,6431194,2,0,utRho08
ilvA,15820940,15821324,15820940,384,0,utRho08
ilvC,7915824,7915940,7915824,116,0,utRho08
ilvE,15809552,15809936,15809552,384,784,utRho08
ilvI,170840,171260,170840,420,36,utRho08
ilvL,23701308,23701932,23701308,624,0,utRho08
ilvY,7915734,7915734,7915640,94,0,utRho08
inaA,4698998,4698998,4698944,54,48,utRho08
infA,1853370,1853370,1852886,484,3718,utRho08
infC,3602692,3602692,3601276,1416,4952,utRho08
insA-5,3958452,3958452,3958430,22,0,utRho08
insA-7,9036758,9037054,9036758,296,0,utRho08
insC-5,6372080,6372284,6372080,204,22,utRho08
insEF-2,785238,785238,785820,582,210,utRho08
insEF-4,2190310,2190310,2190892,582,172,utRho08
insG,9007098,9007098,9006862,236,0,utRho08
insH-1,550596,550596,550234,362,18,utRho08
insH-11,7306538,7306538,7306396,142,12,utRho08
insH-2,1151548,1151548,1151506,42,24,utRho08
insH-3,1378444,1378444,1378026,418,24,utRho08
insH-4,2791942,2792152,2791942,210,34,utRho08
insH-5,2857852,2857852,2857452,400,30,utRho08
insH-6,4135022,4135022,4134642,380,6,utRho08
insH-7,4206186,4206186,4205822,364,5338,utRho08
insH-9,6260050,6260356,6260050,306,16,utRho08
insI-3,9017372,9017372,9017234,138,0,utRho08
insJ,7441188,7441360,7441188,172,48,utRho08
insK,7442130,7442308,7442130,178,0,utRho08
insL-1,30760,30890,30760,130,394,utRho08
insL-2,1216112,1216130,1216112,18,24,utRho08
insL-3,5028644,5028662,5028644,18,168,utRho08
insN-1,540452,540484,540452,32,0,utRho08
intD,1132202,1132202,1131956,246,0,utRho08
intR,2826520,2826520,2826470,50,0,utRho08
intS,4933026,4933090,4933026,64,2,utRho08
intZ,5117386,5117542,5117386,156,64,utRho08
iraD,9113152,9113986,9113152,834,0,utRho08
iraM,2424246,2424246,2424006,240,0,utRho08
iraP,802638,802772,802638,134,0,utRho08
iscA,5319924,5319924,5319772,152,1996,utRho08
iscR,5324398,5324398,5324262,136,19142,utRho08
iscX,5313834,5313834,5313472,362,3058,utRho08
ispF,5743968,5743968,5743560,408,880,utRho08
ispG,5283908,5283908,5283608,300,1204,utRho08
ispU,389568,389806,389568,238,96,utRho08
isrA,2811502,2811502,2811618,116,0,utRho08
istr-1,7706384,7706384,7706384,0,0,utRho08
istr-2,7706514,7706514,7706514,0,0,utRho08
ivbL,15412092,15412092,15411952,140,368,utRho08
ivy,480638,480686,480638,48,0,utRho08
katE,3627628,3627734,3627628,106,0,utRho08
katG,8267624,8267670,8267624,46,0,utRho08
kbaZ,6557732,6557828,6557732,96,0,utRho08
kbl,7585154,7585154,7585102,52,490,utRho08
kch,2621046,2621046,2620538,508,100,utRho08
kdgR,3820506,3820506,3820198,308,0,utRho08
kdpE,1443788,1443788,1443466,322,0,utRho08
kdpF,1457698,1457698,1457642,56,0,utRho08
kdsA,2535708,2536330,2535708,622,1834,utRho08
kdsC,6683438,6684546,6683438,1108,1742,utRho08
kduI,5968388,5968388,5968248,140,718,utRho08
kefF,94160,94492,94160,332,0,utRho08
kgtP,5451624,5451624,5451492,132,78,utRho08
kup,7862206,7862632,7862206,426,176,utRho08
lacI,735076,735076,735020,56,0,utRho08
lacZ,1465508,1465508,1465220,288,160,utRho08
ldcA,2486394,2486394,2486160,234,0,utRho08
ldhA,2885830,2885830,2885686,144,0,utRho08
ldrA,2538954,2538954,2538550,404,318,utRho08
ldrB,2540024,2540024,2539620,404,92,utRho08
ldrC,2541092,2541092,2540690,402,208,utRho08
ldrD,7400544,7400544,7400174,370,62,utRho08
lepA,5414392,5414392,5414248,144,56,utRho08
lepB,5410928,5410928,5410618,310,1168,utRho08
leuD,159188,159188,158906,282,110,utRho08
leuE,3761600,3761600,3761518,82,0,utRho08
leuL,168048,168048,167416,632,0,utRho08
leuO,168308,168736,168308,428,276,utRho08
leuQ,9212864,9212864,9212802,62,0,utRho08
leuU,6644556,6644556,6644316,240,1864,utRho08
leuV,9212546,9212546,9212330,216,1432,utRho08
leuX,8992772,8992810,8992772,38,0,utRho08
lexA,8514174,8514230,8514174,56,26,utRho08
lhr,3456706,3458174,3456706,1468,2730,utRho08
ligA,5060402,5060402,5060352,50,0,utRho08
ligB,7642576,7642576,7642340,236,0,utRho08
lipA,1320602,1320602,1320432,170,100,utRho08
lipB,1324802,1324802,1324556,246,1612,utRho08
lit,2397032,2397390,2397032,358,256,utRho08
livJ,7199524,7199524,7199316,208,62,utRho08
livK,7195510,7195510,7195120,390,0,utRho08
lldP,7554578,7554798,7554578,220,4314,utRho08
lnt,1381968,1381968,1381762,206,336,utRho08
loiP,6163784,6163826,6163784,42,0,utRho08
lolA,1874656,1874738,1874656,82,82,utRho08
lolB,2527112,2527112,2527000,112,56,utRho08
lolC,2350748,2350854,2350748,106,0,utRho08
lon,917630,917776,917630,146,572,utRho08
lpcA,486936,487086,486936,150,0,utRho08
lpd,255434,255824,255434,390,2350,utRho08
lplA,9248476,9248476,9248234,242,1178,utRho08
lplT,5947878,5947878,5947724,154,0,utRho08
lpoA,6586422,6586800,6586422,378,454,utRho08
lpp,3514592,3514842,3514592,250,0,utRho08
lptA,6686598,6686760,6686598,162,892,utRho08
lptB,6686792,6687888,6686792,1096,1344,utRho08
lptD,114672,114672,114218,454,2816,utRho08
lptF,8972244,8972436,8972244,192,0,utRho08
lpxC,213016,213114,213016,98,11250,utRho08
lpxD,401920,401942,401920,22,4,utRho08
lpxL,2233418,2233418,2233164,254,0,utRho08
lpxM,3880456,3880456,3880386,70,158,utRho08
lpxP,4991156,4991290,4991156,134,130,utRho08
lrhA,4813312,4813312,4813282,30,0,utRho08
lrp,1864656,1865190,1864656,534,772,utRho08
lspA,50028,50414,50028,386,870,utRho08
lsrA,3202920,3202980,3202920,60,0,utRho08
lsrR,3202514,3202514,3202482,32,0,utRho08
ltaE,1818640,1818640,1818588,52,0,utRho08
luxS,5630130,5630130,5629466,664,1154,utRho08
lysA,5957902,5957902,5957798,104,0,utRho08
lysC,8467232,8467232,8466466,766,242,utRho08
lysP,4497120,4497120,4497064,56,0,utRho08
lysR,5957900,5958042,5957900,142,0,utRho08
lysT,1561028,1561108,1561028,80,230,utRho08
lysU,8709610,8709610,8709434,176,0,utRho08
macB,1840188,1840694,1840188,506,212,utRho08
maeA,3111484,3111484,3111338,146,4792,utRho08
mak,820236,820288,820236,52,66,utRho08
malE,8492928,8492928,8492838,90,0,utRho08
malI,3398456,3398456,3398360,96,0,utRho08
malK,8493472,8493568,8493472,96,0,utRho08
malP,7105020,7105020,7104946,74,294,utRho08
malQ,7100798,7100798,7100140,658,0,utRho08
malS,14949880,14949988,14949880,108,0,utRho08
malT,7106048,7106170,7106048,122,304,utRho08
malX,3398626,3398710,3398626,84,0,utRho08
malZ,1689980,1690072,1689980,92,968,utRho08
manA,3377102,3377152,3377102,50,0,utRho08
manX,3803866,3804096,3803866,230,0,utRho08
marC,3237882,3237882,3237816,66,0,utRho08
marR,3238186,3238240,3238186,54,122,utRho08
matP,2036918,2036970,2036918,52,102,utRho08
mazE,5822736,5822736,5822678,58,56,utRho08
mazG,5821720,5821720,5821370,350,2798,utRho08
mcbA,1684306,1684306,1684112,194,0,utRho08
mcbR,3040192,3040524,3040192,332,0,utRho08
mcrA,2420278,2420692,2420278,414,0,utRho08
mcrC,9156124,9156124,9155916,208,160,utRho08
mdaB,6344814,6345060,6344814,246,0,utRho08
mdfA,1767138,1767346,1767138,208,0,utRho08
mdh,6768940,6768940,6768536,404,0,utRho08
mdoB,9198988,9198988,9198882,106,1454,utRho08
mdoD,2993290,2993712,2993290,422,0,utRho08
mdoG,2218514,2218670,2218514,156,0,utRho08
mdtA,4307958,4308032,4307958,74,0,utRho08
mdtE,7318168,7318464,7318168,296,0,utRho08
mdtK,3486538,3486914,3486538,376,318,utRho08
mdtP,8602472,8602472,8602060,412,0,utRho08
melA,8683774,8683822,8683774,48,0,utRho08
melR,8683300,8683300,8683256,44,38,utRho08
menA,8240812,8240812,8240698,114,20,utRho08
menB,4753774,4753774,4753638,136,226,utRho08
mepH,3468714,3468870,3468714,156,0,utRho08
mepM,3883666,3883666,3883270,396,326,utRho08
mepS,4539840,4539958,4539840,118,322,utRho08
metA,8428318,8428560,8428318,242,0,utRho08
metB,8257272,8257344,8257272,72,1360,utRho08
metC,6304150,6304472,6304150,322,0,utRho08
metE,8025768,8026106,8025768,338,302,utRho08
metF,8265092,8265232,8265092,140,0,utRho08
metG,4388538,4388600,4388538,62,0,utRho08
metH,8447010,8447656,8447010,646,2090,utRho08
metJ,8257116,8257116,8256790,326,0,utRho08
metK,6173154,6173412,6173154,258,0,utRho08
metN,445428,445428,445290,138,8,utRho08
metR,8025710,8025710,8025632,78,0,utRho08
metT,1394326,1394326,1394266,60,116,utRho08
metY,19910250,19910250,19909734,516,498,utRho08
metZ,11789528,11789548,11789528,20,0,utRho08
mfd,2348056,2348056,2347928,128,160,utRho08
mglA,4478782,4478782,4478578,204,158,utRho08
mglB,4481132,4481132,4480696,436,9404,utRho08
mglC,4475918,4475918,4475506,412,72,utRho08
mgrB,3817584,3817584,3817532,52,0,utRho08
mgrR,3245828,3245828,3245828,0,0,utRho08
mgsA,2054082,2054082,2054030,52,2,utRho08
mgtL,8934560,8934862,8934560,302,0,utRho08
mhpA,737038,737222,737038,184,0,utRho08
mhpR,737072,737072,736840,232,0,utRho08
mhpT,750772,750918,750772,146,0,utRho08
miaA,8797964,8798504,8797964,540,386,utRho08
micA,5629604,5629604,5629604,0,0,utRho08
micC,2874242,2874238,2874242,4,0,utRho08
micF,4626168,4626168,4626168,0,0,utRho08
micM,1014408,1014408,1014408,0,0,utRho08
minE,2449422,2449422,2449090,332,1138,utRho08
mioC,7852950,7852950,7852910,40,0,utRho08
mipA,3733012,3733012,3732944,68,4092,utRho08
mlaA,4930270,4930270,4930014,256,0,utRho08
mlc,3337206,3337206,3337128,78,0,utRho08
mlrA,4429498,4429732,4429498,234,0,utRho08
mltA,5894546,5894546,5894356,190,0,utRho08
mltD,468050,468050,467910,140,0,utRho08
mltF,5391534,5391602,5391534,68,0,utRho08
mmuP,550238,550650,550238,412,18,utRho08
mngA,1531622,1531968,1531622,346,0,utRho08
mngR,1531852,1531852,1531750,102,0,utRho08
mnmG,7851348,7851348,7851266,82,1824,utRho08
mntH,5025470,5025470,5025412,58,0,utRho08
mntP,3810918,3811376,3810918,458,392,utRho08
mntR,1706160,1706366,1706160,206,0,utRho08
mntS,1706128,1706128,1705994,134,0,utRho08
moaA,1633654,1634088,1633654,434,296,utRho08
moaB,1635954,1636110,1635954,156,1520,utRho08
mobA,8084242,8084242,8083998,244,32,utRho08
mocA,6030112,6030320,6030112,208,0,utRho08
modA,1589990,1590178,1589990,188,84,utRho08
moeA,1732788,1732788,1732728,60,144,utRho08
mokB,2984610,2984610,2984258,352,252,utRho08
molR_1,4392888,4392948,4392888,60,0,utRho08
motA,3954604,3954604,3954278,326,52,utRho08
mpaA,2781278,2781278,2781196,82,14,utRho08
mpl,8911456,8911570,8911456,114,0,utRho08
mppA,2786108,2786454,2786108,346,0,utRho08
mprA,5621494,5621540,5621494,46,516,utRho08
mqo,4613848,4613848,4613508,340,68,utRho08
mqsA,6336742,6336742,6336492,250,304,utRho08
mqsR,6337306,6337306,6337088,218,226,utRho08
mraZ,179192,179268,179192,76,0,utRho08
mrcA,7045652,7045742,7045652,90,0,utRho08
mrcB,329442,329460,329442,18,0,utRho08
mreB,13605424,13605424,13604348,1076,2308,utRho08
mreD,6798166,6798166,6797750,416,274,utRho08
mrp,4388360,4388360,4388336,24,60,utRho08
mscK,972984,973072,972984,88,16,utRho08
mscL,6876002,6876048,6876002,46,116,utRho08
mscS,6139742,6139742,6139614,128,0,utRho08
msrA,8884522,8884522,8884352,170,132,utRho08
msrB,3725168,3725168,3724858,310,0,utRho08
msyB,2228426,2228426,2228362,64,276,utRho08
mtfA,4087236,4087302,4087236,66,2624,utRho08
mtgA,6699662,6699662,6699618,44,114,utRho08
mtlA,30177504,30178248,30177504,744,832,utRho08
mtn,358366,358366,358306,60,0,utRho08
mtr,6611864,6611864,6611634,230,36,utRho08
mug,6430992,6430992,6430946,46,0,utRho08
murQ,5091466,5091546,5091466,80,100,utRho08
murR,5091586,5091586,5091218,368,100,utRho08
mutH,5939164,5939324,5939164,160,166,utRho08
mutL,8794092,8794824,8794092,732,392,utRho08
mutM,7622554,7622554,7622304,250,1264,utRho08
mutS,5714038,5714186,5714038,148,812,utRho08
mutY,18617466,18618078,18617466,612,426,utRho08
nac,4123956,4123956,4123866,90,0,utRho08
nadA,1564122,1564170,1564122,48,0,utRho08
nadB,5420714,5420840,5420714,126,0,utRho08
nadC,237326,237326,237290,36,0,utRho08
nadE,3644604,3644916,3644604,312,0,utRho08
nadK,5501526,5501662,5501526,136,306,utRho08
nagA,1406350,1406350,1405502,848,3038,utRho08
nagB,1407416,1407416,1407222,194,2,utRho08
nagC,1404016,1404016,1403188,828,220,utRho08
nagE,1407680,1407888,1407680,208,0,utRho08
nagK,2357080,2357186,2357080,106,0,utRho08
nanA,6747240,6747240,6747152,88,0,utRho08
nanC,9079856,9079856,9079002,854,0,utRho08
nanR,6749406,6749406,6748978,428,78,utRho08
nanS,9075406,9075406,9075188,218,0,utRho08
napF,4607390,4607390,4606994,396,4,utRho08
narG,2559614,2559728,2559614,114,62,utRho08
narK,2555642,2555914,2555642,272,0,utRho08
narP,4580844,4581000,4580844,156,0,utRho08
narQ,5171154,5171462,5171154,308,0,utRho08
narU,3088326,3088326,3088120,206,0,utRho08
narW,3077374,3077374,3074618,2756,0,utRho08
narX,2555554,2555554,2555236,318,0,utRho08
narZ,3085380,3085380,3085180,200,0,utRho08
ndh,2331984,2332170,2331984,186,2,utRho08
ndk,5289920,5289920,5289728,192,70,utRho08
nemR,6904084,6904092,6904084,8,0,utRho08
nepI,7683542,7683542,7683478,64,22,utRho08
nfo,4501612,4501680,4501612,68,0,utRho08
nfsB,1210906,1210906,1210848,58,24,utRho08
nfuA,7090916,7091248,7090916,332,558,utRho08
nhaA,34634,34978,34634,344,0,utRho08
nhaB,2469534,2469534,2469434,100,0,utRho08
nhoA,3067926,3068048,3067926,122,0,utRho08
nikA,7226878,7227334,7226878,456,1874,utRho08
nikR,7237074,7237176,7237074,102,152,utRho08
nirB,6987974,6988022,6987974,48,0,utRho08
nlpA,7680034,7680034,7679986,48,0,utRho08
nlpC,3585654,3585654,3585462,192,0,utRho08
nlpD,5737658,5737658,5737506,152,64,utRho08
nlpI,6618080,6618080,6617848,232,154,utRho08
nmpC,1153740,1153740,1153650,90,0,utRho08
nohA,3273206,3273206,3272734,472,0,utRho08
norR,5664614,5664614,5664578,36,0,utRho08
norV,5664878,5664952,5664878,74,0,utRho08
nrdA,4689510,4689730,4689510,220,16514,utRho08
nrdD,8925676,8925676,8925320,356,1174,utRho08
nrdH,5601312,5601446,5601312,134,32,utRho08
nrdR,865954,866004,865954,50,0,utRho08
nrfA,8575342,8575528,8575342,186,0,utRho08
nsrR,8812088,8812380,8812088,292,1880,utRho08
nudB,3897348,3897348,3897264,84,0,utRho08
nudC,8393428,8393806,8393428,378,28,utRho08
nudE,7052658,7052658,7052298,360,1150,utRho08
nudG,3682876,3682980,3682876,104,0,utRho08
nudI,4729050,4729108,4729050,58,0,utRho08
nudJ,2388874,2388874,2388576,298,1380,utRho08
nuoA,4810670,4810670,4810144,526,7002,utRho08
nuoN,4783434,4783434,4783010,424,824,utRho08
nupC,5026018,5026084,5026018,66,0,utRho08
nupG,6211302,6211428,6211302,126,0,utRho08
ogrK,4335096,4335096,4335040,56,0,utRho08
ogt,2800568,2800568,2800472,96,60,utRho08
ohsC,5401036,5401040,5401036,4,0,utRho08
ompA,2040382,2040382,2040106,276,29492,utRho08
ompC,4625774,4625774,4625498,276,0,utRho08
ompF,1974184,1974184,1973964,220,630,utRho08
ompL,8128958,8128958,8128590,368,0,utRho08
ompN,2874158,2874158,2873786,372,24,utRho08
ompR,7073510,7073510,7073168,342,0,utRho08
ompT,1171330,1171330,1171266,64,0,utRho08
ompW,2627982,2628040,2627982,58,0,utRho08
ompX,1700418,1700900,1700418,482,1188,utRho08
omrA,5952378,5952378,5952378,0,0,utRho08
omrB,5952770,5952770,5952770,0,0,utRho08
oppA,2602170,2602364,2602170,194,13012,utRho08
orn,8783168,8783208,8783168,40,0,utRho08
osmB,2686952,2686952,2686656,296,98,utRho08
osmC,3113192,3113250,3113192,58,0,utRho08
osmE,3644566,3644566,3644512,54,0,utRho08
osmF,4439046,4439046,4438962,84,1292,utRho08
osmY,9222306,9222792,9222306,486,0,utRho08
otsA,3963302,3963302,3963224,78,0,utRho08
otsB,3964930,3964930,3964774,156,0,utRho08
oxc,4984288,4984288,4983900,388,0,utRho08
oxyR,8316914,8316980,8316914,66,156,utRho08
oxyS,8316788,8316788,8316788,0,0,utRho08
paaA,2907730,2907854,2907730,124,0,utRho08
paaX,2927018,2927078,2927018,60,0,utRho08
paaZ,2907340,2907340,2907284,56,0,utRho08
pabA,6981702,6981702,6981658,44,0,utRho08
pabB,3789256,3789610,3789256,354,72,utRho08
pabC,2306186,2306600,2306186,414,160,utRho08
pagP,1313052,1313114,1313052,62,0,utRho08
panB,299260,299260,299202,58,0,utRho08
panC,297840,297840,297590,250,304,utRho08
panD,293490,293490,293388,102,158,utRho08
panZ,7195656,7195968,7195656,312,102,utRho08
parC,6332060,6332060,6331946,114,34,utRho08
patA,6438916,6438988,6438916,72,0,utRho08
patD,3030830,3031156,3030830,326,0,utRho08
pbpC,5294986,5294986,5294650,336,0,utRho08
pbpG,4450132,4450132,4449740,392,172,utRho08
pck,7065358,7065636,7065358,278,5622,utRho08
pcnB,318782,318782,318252,530,928,utRho08
pdhR,244068,244184,244068,116,0,utRho08
pdxB,4875768,4875768,4875702,66,0,utRho08
pdxH,3436068,3436068,3436014,54,630,utRho08
pdxJ,5403626,5403626,5403458,168,396,utRho08
pdxK,5074638,5074638,5074474,164,0,utRho08
pepA,8972278,8972278,8971902,376,264,utRho08
pepD,511618,511618,511432,186,4990,utRho08
pepN,1981182,1981244,1981182,62,94,utRho08
pepQ,8062294,8062322,8062294,28,24,utRho08
pepT,2371646,2371688,2371646,42,0,utRho08
pfkA,8214948,8215104,8214948,156,376,utRho08
pfkB,3612646,3612740,3612646,94,0,utRho08
pflA,1902456,1902456,1902160,296,102,utRho08
pflB,1907850,1907850,1907108,742,536,utRho08
pflD,8287716,8287990,8287716,274,66,utRho08
pgaA,2185046,2185046,2184578,468,0,utRho08
pgi,8467444,8467516,8467444,72,0,utRho08
pgk,12291428,12291428,12290488,940,2892,utRho08
pgl,1597078,1597172,1597078,94,80,utRho08
pgpB,2678324,2678660,2678324,336,0,utRho08
pgpC,5397276,5397276,5397100,176,0,utRho08
pgrR,2783744,2783982,2783744,238,0,utRho08
pheL,5475158,5475198,5475158,40,0,utRho08
pheM,7197204,7197204,7197080,124,96,utRho08
pheP,1203858,1203918,1203858,60,0,utRho08
pheU,8725254,8725254,8725252,2,0,utRho08
pheV,6220730,6220732,6220730,2,0,utRho08
phnC,8650412,8650412,8650330,82,0,utRho08
phoA,803414,803494,803414,80,0,utRho08
phoB,834202,834284,834202,82,0,utRho08
phoE,520316,520316,520200,116,0,utRho08
phoH,2169730,2169984,2169730,254,0,utRho08
phoP,2381016,2381016,2380894,122,1332,utRho08
phoQ,2379880,2379880,2379552,328,1052,utRho08
phoU,7815330,7815330,7815156,174,334,utRho08
phr,1478842,1479014,1478842,172,4,utRho08
pinE,2419054,2419370,2419054,316,0,utRho08
pinQ,3267168,3267244,3267168,76,0,utRho08
pinR,2867424,2867424,2867348,76,0,utRho08
pitA,7275224,7275284,7275224,60,0,utRho08
pitB,6272806,6272806,6272742,64,0,utRho08
pka,5439862,5439906,5439862,44,0,utRho08
plaP,4174476,4174476,4174124,352,1958,utRho08
pldA,8009628,8009724,8009628,96,58,utRho08
pldB,8018028,8018340,8018028,312,100,utRho08
plsB,8513196,8513196,8512932,264,108,utRho08
pmbA,8915890,8915918,8915890,28,0,utRho08
pmrD,4747148,4747148,4747076,72,0,utRho08
pncB,1980828,1980828,1980712,116,0,utRho08
pncC,5648788,5648788,5648692,96,0,utRho08
pnp,6622652,6622652,6622336,316,76,utRho08
pntA,3355950,3355950,3355806,144,0,utRho08
pntB,3353096,3353096,3352720,376,0,utRho08
polA,8093880,8093932,8093880,52,212,utRho08
polB,131606,131606,131560,46,0,utRho08
potD,2365700,2365700,2365658,42,0,utRho08
potE,1436688,1436688,1436530,158,0,utRho08
potF,1787268,1787568,1787268,300,0,utRho08
poxB,1822152,1822152,1822098,54,0,utRho08
ppa,8899372,8899372,8899304,68,376,utRho08
ppc,8306380,8306380,8306196,184,138,utRho08
ppdA,5928440,5928440,5928354,86,104,utRho08
ppdD,235410,235410,235098,312,0,utRho08
pphA,3846770,3846770,3845938,832,2214,utRho08
pphB,5719474,5719520,5719474,46,0,utRho08
ppiA,6984898,6984898,6984594,304,0,utRho08
ppiC,7919682,7919682,7919626,56,24,utRho08
ppiD,923638,923830,923638,192,1440,utRho08
ppk,5245748,5246088,5245748,340,588,utRho08
pppA,6228958,6228958,6228704,254,0,utRho08
ppsA,3574322,3574322,3574224,98,0,utRho08
ppsR,3574678,3574890,3574678,212,0,utRho08
pptA,3065716,3066104,3065716,388,0,utRho08
pqiA,2023318,2024002,2023318,684,36,utRho08
prc,3830054,3830054,3829632,422,35896,utRho08
preT,4467978,4468066,4467978,88,0,utRho08
prfC,9218688,9218828,9218688,140,904,utRho08
prkB,6968622,6968980,6968622,358,1052,utRho08
prlC,7290476,7290476,7290364,112,200,utRho08
prlF,6553944,6554004,6553944,60,0,utRho08
proB,520432,520776,520432,344,0,utRho08
proC,811372,811372,811288,84,0,utRho08
proK,7417388,7417388,7417384,4,0,utRho08
proL,4572414,4572422,4572414,8,64,utRho08
proP,8660640,8661004,8660640,364,102,utRho08
proS,437674,437674,437550,124,682,utRho08
proV,5609126,5609630,5609126,504,198,utRho08
prpB,697292,697364,697292,72,0,utRho08
prpR,696942,696942,696886,56,0,utRho08
prs,2524354,2524354,2523750,604,76456,utRho08
psd,8781276,8781276,8780720,556,2414,utRho08
psiE,8480600,8480650,8480600,50,0,utRho08
pspA,2736076,2736158,2736076,82,0,utRho08
pspF,2736080,2736080,2735824,256,0,utRho08
pspG,8525632,8525680,8525632,48,0,utRho08
pssA,5445156,5445454,5445156,298,2228,utRho08
pstB,7817112,7817112,7816732,380,50,utRho08
pstC,7821084,7821084,7820796,288,0,utRho08
pstS,23469408,23469408,23469150,258,0,utRho08
psuG,4517114,4517114,4516734,380,396,utRho08
psuT,4514992,4514992,4514670,322,32,utRho08
pth,2517084,2517084,2517026,58,62,utRho08
ptrA,5918022,5918022,5917768,254,0,utRho08
ptrB,3857730,3857730,3857678,52,912,utRho08
ptsG,2315252,2315738,2315252,486,2158,utRho08
ptsH,5066996,5067528,5066996,532,4650,utRho08
purA,8809328,8809374,8809328,46,0,utRho08
purC,5195562,5195562,5195236,326,0,utRho08
purD,8411972,8411972,8411862,110,52,utRho08
purE,1106284,1106284,1106200,84,1038,utRho08
purH,8415254,8415254,8415064,190,16,utRho08
purL,5391178,5391178,5391086,92,576,utRho08
purM,5242306,5242394,5242306,88,0,utRho08
purR,3475378,3475688,3475378,310,198,utRho08
purT,3861438,3861762,3861438,324,0,utRho08
purU,2577512,2577512,2577248,264,440,utRho08
putA,2157850,2157850,2157764,86,0,utRho08
putP,2158336,2158610,2158336,274,570,utRho08
puuA,2721936,2721936,2721816,120,0,utRho08
puuC,2725456,2725486,2725456,30,0,utRho08
puuD,2722104,2722240,2722104,136,0,utRho08
puuP,2718746,2718746,2718374,372,114,utRho08
pykA,3874988,3875298,3874988,310,376,utRho08
pykF,3510934,3511396,3510934,462,382,utRho08
pyrC,2245286,2245286,2245214,72,72,utRho08
pyrD,2009464,2009536,2009464,72,0,utRho08
pyrE,7631970,7631970,7631536,434,0,utRho08
pyrF,2683740,2683842,2683740,102,470,utRho08
pyrG,5819594,5819594,5819332,262,866,utRho08
pyrH,383624,383710,383624,86,2084,utRho08
pyrL,8945490,8945490,8945066,424,96,utRho08
qmcA,1031646,1031646,1031546,100,0,utRho08
qor,8528608,8528608,8528462,146,194,utRho08
qseB,6339502,6339656,6339502,154,0,utRho08
queA,849970,850022,849970,52,418,utRho08
queE,5811212,5811212,5810836,376,0,utRho08
queF,5850642,5850696,5850642,54,0,utRho08
queG,8788184,8788184,8788134,50,1152,utRho08
racC,2835630,2835630,2835526,104,0,utRho08
racR,2840898,2840898,2840482,416,0,utRho08
raiA,5474208,5474308,5474208,100,0,utRho08
rarD,8008594,8008594,8008356,238,144,utRho08
ravA,7862256,7862256,7862186,70,62,utRho08
rayT,495088,495274,495088,186,0,utRho08
rbn,4763162,4763216,4763162,54,0,utRho08
rbsD,7866644,7866702,7866644,58,0,utRho08
rcnA,4371654,4371834,4371654,180,0,utRho08
rcnB,4373768,4373920,4373768,152,0,utRho08
rcnR,4371806,4371806,4371592,214,0,utRho08
rcsA,4047672,4047936,4047672,264,122,utRho08
rcsB,4631390,4632354,4631390,964,2264,utRho08
rcsC,4640162,4640162,4639656,506,158,utRho08
rcsD,4626904,4626976,4626904,72,0,utRho08
rdgB,6193240,6193362,6193240,122,834,utRho08
rdlA,2538646,2538646,2538646,0,0,utRho08
rdlB,2539712,2539716,2539712,4,0,utRho08
rdlC,2540782,2540786,2540782,4,0,utRho08
rdlD,7400272,7400272,7400272,0,0,utRho08
rdoA,8084782,8084830,8084782,48,0,utRho08
recA,11295276,11295276,11295076,200,424,utRho08
recC,5925014,5925014,5924856,158,66,utRho08
recF,7763722,7763722,7762442,1280,8652,utRho08
recN,5503518,5503590,5503518,72,0,utRho08
recQ,8011666,8011728,8011666,62,0,utRho08
relA,5828554,5828554,5827302,1252,470,utRho08
relB,3291806,3291806,3291744,62,0,utRho08
rem,3289950,3289950,3289804,146,0,utRho08
rep,7921294,7921354,7921294,60,12,utRho08
rfaD,7587730,7587974,7587730,244,0,utRho08
rfaE,6393852,6393852,6393506,346,0,utRho08
rfaH,8049930,8049930,8049642,288,400,utRho08
rfbX,4219436,4219436,4219168,268,2014,utRho08
rfe,7935600,7935832,7935600,232,116,utRho08
rhaB,8194944,8194944,8194896,48,0,utRho08
rhaD,8188770,8188770,8188544,226,0,utRho08
rhaS,8195422,8195472,8195422,50,0,utRho08
rhaT,8201132,8201132,8201050,82,0,utRho08
rhlE,1661566,1661744,1661566,178,304,utRho08
rhoL,47593944,47594772,47593944,828,81276,utRho08
rhsB,7238006,7238384,7238006,378,0,utRho08
rhsC,1458758,1459166,1458758,408,0,utRho08
rhsD,1046132,1046522,1046132,390,0,utRho08
rhtA,1700608,1700608,1700194,414,0,utRho08
rhtC,8015478,8015514,8015478,36,1128,utRho08
ribA,2678468,2678468,2678320,148,0,utRho08
ribC,3486916,3486916,3486484,432,318,utRho08
ribE,869008,869294,869008,286,8230,utRho08
ribF,42766,42814,42766,48,0,utRho08
ridA,8941892,8941892,8941826,66,0,utRho08
rihA,1369204,1369204,1368824,380,84,utRho08
rihB,4510504,4510504,4510372,132,70,utRho08
rimJ,2251044,2251124,2251044,80,0,utRho08
rimK,1783752,1783934,1783752,182,312,utRho08
rimL,2997486,2997876,2997486,390,224,utRho08
rimO,1756140,1756140,1756070,70,14,utRho08
rimP,6636350,6636350,6636012,338,808,utRho08
rlmA,3814172,3814172,3814120,52,102,utRho08
rlmD,5830086,5830086,5830000,86,0,utRho08
rlmE,6655520,6655520,6655328,192,2086,utRho08
rlmF,1684384,1684664,1684384,280,0,utRho08
rlmG,6471784,6471784,6471750,34,0,utRho08
rlmI,2060002,2060002,2059938,64,4,utRho08
rlmJ,7290700,7290770,7290700,70,180,utRho08
rlmL,2015344,2015688,2015344,344,536,utRho08
rlpA,1330444,1330444,1330380,64,82,utRho08
rluA,120900,120900,120692,208,718,utRho08
rluF,8460324,8460708,8460324,384,0,utRho08
rmf,2031006,2031430,2031006,424,310,utRho08
rna,1290068,1290068,1290006,62,0,utRho08
rnb,2698258,2698258,2697824,434,1360,utRho08
rnc,10816892,10816892,10816252,640,7256,utRho08
rnd,3776122,3776122,3775982,140,34,utRho08
rne,2289746,2289746,2288734,1012,9480,utRho08
rnhA,472082,472082,472004,78,478,utRho08
rnk,1288360,1288360,1287934,426,56,utRho08
rnlA,5531788,5531836,5531788,48,0,utRho08
rnlB,5533414,5533968,5533414,554,502,utRho08
rnpB,19623552,19623552,19623552,0,0,utRho08
rob,9270706,9270706,9270620,86,56,utRho08
rodZ,5285868,5285868,5285688,180,26,utRho08
rpe,7030306,7030306,7030118,188,246,utRho08
rph,15266320,15266320,15266196,124,0,utRho08
rpiA,6118706,6118706,6118650,56,46,utRho08
rpiB,8626514,8626700,8626514,186,0,utRho08
rpiR,8626274,8626274,8625982,292,0,utRho08
rplJ,8359246,8359992,8359246,746,13504,utRho08
rplK,8356708,8356894,8356708,186,968,utRho08
rplM,6757344,6757344,6757302,42,15816,utRho08
rplN,6896444,6896444,6896298,146,12016,utRho08
rplS,5489284,5489284,5489060,224,30446,utRho08
rplT,7199052,7199052,7198996,56,1000,utRho08
rplU,6667036,6667036,6666902,134,116,utRho08
rplY,4564866,4565034,4564866,168,298,utRho08
rpmA,6666450,6666450,6666238,212,1210,utRho08
rpmB,15247980,15247980,15246696,1284,241696,utRho08
rpmE,8253816,8254026,8253816,210,1026,utRho08
rpmF,2294676,2294734,2294676,58,80744,utRho08
rpmH,7768130,7768672,7768130,542,8466,utRho08
rpmI,3600854,3600854,3599998,856,14622,utRho08
rpoB,8362126,8362490,8362126,364,750,utRho08
rpoD,6424946,6426094,6424946,1148,18072,utRho08
rpoE,5420372,5420372,5420024,348,0,utRho08
rpoH,7202006,7202006,7201566,440,3222,utRho08
rpoN,6689324,6689434,6689324,110,0,utRho08
rpoS,5736236,5736236,5735102,1134,2664,utRho08
rpoZ,7644154,7644212,7644154,58,1134,utRho08
rppH,5937986,5937986,5937954,32,0,utRho08
rprA,3540744,3540744,3540744,0,0,utRho08
rpsA,1923434,1923990,1923434,556,238240,utRho08
rpsF,8850050,8850236,8850050,186,61468,utRho08
rpsI,6756580,6756580,6756414,166,12538,utRho08
rpsJ,6906884,6906884,6906540,344,11818,utRho08
rpsL,6949242,6949242,6949104,138,818,utRho08
rpsM,6885130,6885130,6884942,188,2716,utRho08
rpsO,13247144,13247144,13246736,408,2212,utRho08
rpsP,5492508,5492508,5492370,138,234,utRho08
rpsT,42420,42420,42156,264,550,utRho08
rpsU,12842584,12843124,12842584,540,4200,utRho08
rraA,8238716,8238716,8238660,56,372,utRho08
rraB,8956768,8956946,8956768,178,28,utRho08
rrsA,8070478,8071062,8070478,584,11514,utRho08
rrsB,16665468,16666636,16665468,1168,23504,utRho08
rrsC,7883032,7883616,7883032,584,13068,utRho08
rrsD,6858094,6858094,6857524,570,562,utRho08
rrsE,8415726,8416294,8415726,568,2042,utRho08
rrsG,5462896,5462896,5462314,582,10050,utRho08
rrsH,446970,447542,446970,572,2022,utRho08
rsd,8393908,8393908,8393616,292,56,utRho08
rseA,5419264,5419264,5418808,456,204,utRho08
rseP,392940,393092,392940,152,0,utRho08
rseX,4067298,4067298,4067298,0,0,utRho08
rsfS,1338144,1338144,1338072,72,600,utRho08
rsgA,8783132,8783132,8783018,114,138,utRho08
rsmA,105176,105176,104860,316,2322,utRho08
rsmB,6869982,6870414,6869982,432,204,utRho08
rsmC,9215736,9215736,9215400,336,436,utRho08
rsmD,7208594,7208786,7208594,192,0,utRho08
rsmE,6182036,6182268,6182036,232,254,utRho08
rsmG,7847512,7847512,7847360,152,526,utRho08
rsmH,180020,180188,180020,168,604,utRho08
rsmI,6587106,6587106,6586670,436,1206,utRho08
rssA,2578212,2578412,2578212,200,330,utRho08
rssB,2580440,2580484,2580440,44,136,utRho08
rstA,3364276,3364300,3364276,24,0,utRho08
rsuA,4561096,4561096,4560966,130,194,utRho08
rsxA,3411510,3411534,3411510,24,0,utRho08
rtcA,7114004,7114004,7113698,306,0,utRho08
rtcB,7116214,7116214,7116158,56,0,utRho08
rtn,4541356,4541452,4541356,96,60,utRho08
rutA,2148052,2148052,2148022,30,0,utRho08
rutG,2140090,2140090,2139678,412,0,utRho08
rutR,2148226,2148484,2148226,258,0,utRho08
ruvA,7784096,7784096,7783904,192,0,utRho08
ruvB,7782176,7782176,7781424,752,732,utRho08
ruvC,3894878,3894878,3894752,126,0,utRho08
rybB,1776114,1776114,1776114,0,0,utRho08
rydB,3529860,3529860,3529322,538,80,utRho08
rydC,2983012,2983012,2983012,0,0,utRho08
ryfA,5307398,5307710,5307398,312,0,utRho08
ryfD,5468590,5468590,5468590,0,0,utRho08
ryhB,7162032,7162032,7162032,0,0,utRho08
ryjA,8556132,8556132,8556132,0,0,utRho08
ryjB,9055954,9055954,9055954,0,0,utRho08
sad,3229598,3229598,3229406,192,0,utRho08
safA,3168056,3168056,3167918,138,0,utRho08
sanA,4465368,4465756,4465368,388,0,utRho08
sapF,2705314,2705314,2705268,46,62,utRho08
sbcB,4165456,4165512,4165456,56,0,utRho08
sbcC,831694,831694,831506,188,184,utRho08
sbcD,833954,833954,833904,50,86,utRho08
sbmA,793106,793278,793106,172,0,utRho08
sbmC,4162650,4162650,4162524,126,0,utRho08
sdaA,3793618,3793864,3793618,246,16,utRho08
sdaC,5856070,5856458,5856070,388,2342,utRho08
sdhC,1509916,1510354,1509916,438,58956,utRho08
sdhD,1510808,1511120,1510808,312,11938,utRho08
sdiA,3993834,3993834,3993664,170,292,utRho08
secE,8354354,8354716,8354354,362,0,utRho08
secG,6645180,6645180,6645010,170,916,utRho08
selA,7522594,7522594,7522498,96,754,utRho08
selB,7519850,7519850,7519722,128,324,utRho08
selC,7672396,7672444,7672396,48,0,utRho08
selD,3696058,3696058,3696016,42,2564,utRho08
seqA,1425884,1425974,1425884,90,794,utRho08
serA,6117098,6117098,6116820,278,0,utRho08
serB,9249712,9249790,9249712,78,134,utRho08
serC,3830380,3830612,3830380,232,0,utRho08
serS,1878730,1878856,1878730,126,1392,utRho08
serT,2063438,2063438,2063424,14,0,utRho08
serU,4087124,4087124,4087114,10,202,utRho08
serV,5637394,5637394,5637290,104,0,utRho08
serW,1852014,1852014,1851942,72,188,utRho08
serX,2195352,2195352,2195304,48,20,utRho08
setB,4527426,4527726,4527426,300,0,utRho08
setC,7673488,7673906,7673488,418,2,utRho08
sfmA,1116124,1116424,1116124,300,0,utRho08
sfmC,1117606,1117948,1117606,342,0,utRho08
sfsA,323030,323030,322972,58,298,utRho08
sfsB,6669592,6669818,6669592,226,182,utRho08
sgrR,154676,154676,154598,78,0,utRho08
sgrS,154734,154734,154734,0,0,utRho08
shiA,4107068,4107286,4107068,218,0,utRho08
sibA,4306622,4306622,4306622,0,0,utRho08
sibB,4307292,4307292,4307292,0,0,utRho08
sibC,6113702,6113702,6113702,0,0,utRho08
sibD,6389730,6389730,6389730,0,0,utRho08
sibE,6390480,6390480,6390480,0,0,utRho08
sixA,4913998,4913998,4913624,374,0,utRho08
slp,7307872,7307922,7307872,50,0,utRho08
slt,9261400,9261466,9261400,66,0,utRho08
slyA,3442028,3442028,3441648,380,0,utRho08
slyB,3439496,3439752,3439496,256,0,utRho08
slyD,6957398,6957398,6956994,404,204,utRho08
slyX,6954862,6955280,6954862,418,10878,utRho08
smf,6867372,6867372,6867120,252,0,utRho08
smpB,5509534,5509792,5509534,258,922,utRho08
smrA,2811872,2811958,2811872,86,0,utRho08
smrB,4896872,4897212,4896872,340,22,utRho08
smtA,1946808,1947074,1946808,266,0,utRho08
sodA,8201518,8201620,8201518,102,15780,utRho08
sodB,3470646,3470756,3470646,110,104,utRho08
sodC,3449358,3449358,3449310,48,0,utRho08
sohB,2658568,2658664,2658568,96,0,utRho08
sokB,2984232,2984238,2984232,6,54,utRho08
solA,2241218,2241218,2241172,46,66,utRho08
soxR,8554894,8554938,8554894,44,0,utRho08
soxS,8554846,8554846,8554766,80,0,utRho08
speA,6172096,6172096,6171822,274,546,utRho08
speB,6167892,6167892,6167594,298,132,utRho08
speC,6218350,6218350,6218310,40,0,utRho08
spf,8099798,8099798,8099798,0,0,utRho08
sppA,3697422,3697674,3697422,252,0,utRho08
spy,3651376,3651376,3651250,126,0,utRho08
sra,3112092,3112092,3111926,166,0,utRho08
sraB,2293178,2293178,2293178,0,0,utRho08
sraC,3846132,3846132,3846132,0,0,utRho08
srlA,5651582,5651664,5651582,82,92,utRho08
srlR,5657720,5658094,5657720,374,852,utRho08
srmB,5425752,5425792,5425752,40,0,utRho08
sroA,151216,151216,151216,0,0,utRho08
sroG,6369436,6369436,6369436,0,0,utRho08
sroH,8380974,8380974,8380974,0,0,utRho08
ssb,8548022,8548250,8548022,228,12,utRho08
sseA,5304782,5304988,5304782,206,13134,utRho08
sspA,6755138,6755138,6754840,298,1432,utRho08
ssrA,5511014,5511186,5511014,172,2,utRho08
ssrS,12223036,12223932,12223036,896,796,utRho08
sstT,6479726,6479888,6479726,162,0,utRho08
ssuB,1988282,1988282,1988088,194,0,utRho08
ssuE,1995126,1995126,1995024,102,0,utRho08
sthA,8321604,8321604,8321580,24,974,utRho08
stpA,5597156,5597156,5596990,166,0,utRho08
sucA,3034344,3034824,3034344,480,2952,utRho08
sufA,3528836,3528836,3528772,64,0,utRho08
sufE,3518962,3518962,3518580,382,106,utRho08
sugE,8753588,8753750,8753588,162,110,utRho08
sulA,2041894,2041894,2041838,56,174,utRho08
syd,5850738,5850738,5850560,178,42,utRho08
symE,9159834,9159834,9159680,154,0,utRho08
symR,9159670,9159670,9159670,0,0,utRho08
tabA,8949566,8949724,8949566,158,0,utRho08
talA,5157140,5157332,5157140,192,0,utRho08
talB,16382,16476,16382,94,14040,utRho08
tam,3214442,3214692,3214442,250,60,utRho08
tamA,8884540,8884764,8884540,224,22,utRho08
tar,3945432,3945432,3945382,50,62,utRho08
tas,5943138,5943194,5943138,56,172,utRho08
tatA,16087636,16087780,16087636,144,188,utRho08
tatE,1317742,1317894,1317742,152,0,utRho08
tauA,770410,770464,770410,54,0,utRho08
tdcA,6534186,6534186,6534130,56,0,utRho08
tdcG,6519652,6519652,6519298,354,84,utRho08
tdcR,6534380,6534760,6534380,380,0,utRho08
tdk,2586986,2587054,2586986,68,0,utRho08
tehA,3001072,3001146,3001072,74,0,utRho08
tesA,1039898,1039898,1039530,368,300,utRho08
tesB,950402,950402,950322,80,0,utRho08
tfaE,2418532,2418532,2418238,294,0,utRho08
tfaQ,3269912,3269912,3269770,142,0,utRho08
tff,379424,379256,379424,168,0,utRho08
tgt,852110,852274,852110,164,0,utRho08
thiD,4369346,4369346,4369032,314,0,utRho08
thiI,882936,883098,882936,162,770,utRho08
thiM,4370902,4370902,4370602,300,308,utRho08
thiQ,146170,146170,145854,316,186,utRho08
thrL,592,760,592,168,168,utRho08
thrS,7210932,7210932,7210280,652,1316,utRho08
thrU,8350762,8350776,8350762,14,0,utRho08
thrV,6847414,6847414,6847310,104,324938,utRho08
thrW,525682,525742,525682,60,0,utRho08
thyA,5930696,5930696,5930310,386,2920,utRho08
tig,909986,910266,909986,280,1806,utRho08
tisB,7706674,7707106,7706674,432,72,utRho08
tktA,6163414,6163414,6163270,144,512,utRho08
tktB,5158616,5159272,5158616,656,360,utRho08
tldD,6784368,6784368,6784056,312,0,utRho08
tmcA,5191876,5191876,5191718,158,0,utRho08
tnaC,15553644,15553740,15553644,96,792,utRho08
tolB,1555074,1555480,1555074,406,176,utRho08
tolC,6356008,6356230,6356008,222,940,utRho08
tomB,961588,961588,961416,172,706,utRho08
tonB,2622108,2622178,2622108,70,0,utRho08
topA,2661578,2662096,2661578,518,736,utRho08
torC,2116112,2116168,2116112,56,108,utRho08
torR,2115968,2115968,2115908,60,372,utRho08
torS,2112364,2112364,2112356,8,0,utRho08
torT,2112414,2112522,2112414,108,0,utRho08
tpiA,8223138,8223138,8223014,124,186,utRho08
tppB,3425342,3425538,3425342,196,11270,utRho08
tpr,2574376,2574376,2574376,0,0,utRho08
tpx,2777688,2777688,2777622,66,684,utRho08
tqsA,3347780,3347826,3347780,46,0,utRho08
treA,2494850,2494850,2494752,98,0,utRho08
treB,8932420,8932420,8932360,60,0,utRho08
treF,7339102,7339184,7339102,82,0,utRho08
treR,8934694,8934694,8934492,202,0,utRho08
trg,2984878,2984940,2984878,62,0,utRho08
trkG,2847342,2847564,2847342,222,16,utRho08
trmA,8326590,8326590,8326540,50,100,utRho08
trpA,2634678,2634678,2634444,234,1138,utRho08
trpC,2639888,2639888,2639570,318,84,utRho08
trpL,5292432,5292432,5292328,104,0,utRho08
trpR,9265408,9265520,9265408,112,88,utRho08
trpS,7027394,7027394,7027276,118,2092,utRho08
trpT,7893560,7893914,7893560,354,198908,utRho08
trxA,7931294,7931522,7931294,228,418,utRho08
trxB,1864156,1864156,1864100,56,0,utRho08
trxC,5437350,5437470,5437350,120,236,utRho08
tsaD,6421256,6421256,6421086,170,0,utRho08
tsgA,6985038,6985136,6985038,98,0,utRho08
tsr,9182824,9183314,9182824,490,200,utRho08
tsx,864490,864490,864026,464,328,utRho08
ttcA,2823970,2823970,2823896,74,5430,utRho08
ttdA,6412848,6412926,6412848,78,0,utRho08
ttdR,6412760,6412760,6412512,248,0,utRho08
tufA,6943448,6943448,6942658,790,167656,utRho08
tus,3368346,3368518,3368346,172,0,utRho08
tusA,7218040,7218040,7217992,48,0,utRho08
tusB,6950218,6950218,6949930,288,1348,utRho08
tynA,2902996,2902996,2902698,298,0,utRho08
typA,8116460,8116814,8116460,354,12384,utRho08
tyrB,8534164,8534228,8534164,64,3466,utRho08
tyrP,3979004,3979362,3979004,358,0,utRho08
tyrR,2773384,2773440,2773384,56,70,utRho08
tyrS,3434566,3434566,3434444,122,0,utRho08
tyrT,2575330,2575330,2575244,86,218,utRho08
uacT,6062378,6062734,6062378,356,0,utRho08
ubiC,8504886,8505012,8504886,126,0,utRho08
ubiD,8049618,8049976,8049618,358,466,utRho08
ubiE,8037494,8037710,8037494,216,84,utRho08
ubiG,4679078,4679134,4679078,56,0,utRho08
ucpA,5089342,5089342,5089246,96,84,utRho08
udp,8032782,8032862,8032782,80,48,utRho08
ugd,4199470,4199470,4199226,244,0,utRho08
ugpB,7184852,7184852,7184650,202,56,utRho08
ugpQ,7176600,7176600,7176226,374,2,utRho08
uhpT,7694396,7694396,7694334,62,0,utRho08
uidA,3392304,3392304,3392142,162,0,utRho08
uidC,3386012,3386012,3385702,310,0,utRho08
uidR,3394150,3394150,3394104,46,174,utRho08
ulaA,8839854,8839960,8839854,106,134,utRho08
ulaG,8839350,8839350,8839250,100,0,utRho08
ulaR,8837124,8837124,8836906,218,0,utRho08
umpG,5741372,5741372,5740548,824,0,utRho08
umpH,1400704,1400704,1400652,52,0,utRho08
umuD,2461476,2461534,2461476,58,0,utRho08
ung,5433476,5433508,5433476,32,0,utRho08
uof,2843316,2843316,2842900,416,8000,utRho08
upp,5241818,5241818,5241744,74,654,utRho08
usg,4873780,4873780,4873298,482,122,utRho08
ushA,1009772,1009828,1009772,56,0,utRho08
uspA,7279966,7280222,7279966,256,266,utRho08
uspB,7279696,7279696,7279440,256,76,utRho08
uspC,3959172,3959506,3959172,334,0,utRho08
uspE,2797318,2797318,2797244,74,58,utRho08
uspF,2871282,2871282,2871238,44,74,utRho08
uspG,1283806,1283806,1283734,72,218,utRho08
uvrA,8547872,8547872,8547742,130,126,utRho08
uvrB,1626304,1627052,1626304,748,168,utRho08
uvrC,3989758,3989758,3989412,346,226,utRho08
uvrD,7995814,7995966,7995814,152,112,utRho08
uvrY,3990812,3990812,3990718,94,0,utRho08
uxaB,3221474,3221474,3221360,114,0,utRho08
uxaC,6489714,6489714,6489482,232,0,utRho08
uxuA,9103036,9103272,9103036,236,124,utRho08
uxuR,9108916,9109152,9108916,236,112,utRho08
valS,8967854,8967854,8967674,180,548,utRho08
valU,5041848,5041862,5041848,14,84,utRho08
valV,3492830,3492870,3492830,40,0,utRho08
ves,3649968,3649968,3649874,94,0,utRho08
waaA,7616512,7617080,7616512,568,84,utRho08
waaH,7580298,7580298,7580162,136,0,utRho08
waaQ,7616476,7616476,7616196,280,144,utRho08
waaU,7598996,7598996,7598624,372,134,utRho08
waaY,7602272,7602272,7601930,342,6810,utRho08
wbbH,4214888,4214888,4214452,436,2966,utRho08
wbbK,4209212,4209212,4209018,194,162,utRho08
wcaM,4231868,4231868,4231792,76,0,utRho08
wrbA,2135516,2135516,2135416,100,0,utRho08
wza,4275166,4275166,4274486,680,0,utRho08
wzxC,4240674,4240674,4240316,358,0,utRho08
wzzB,4196950,4196950,4196602,348,76,utRho08
xanP,7657642,7657890,7657642,248,0,utRho08
xanQ,6048520,6048702,6048520,182,0,utRho08
xapA,5049820,5049820,5049756,64,0,utRho08
xapR,10090252,10090252,10089908,344,0,utRho08
xdhA,6000514,6000690,6000514,176,0,utRho08
xerD,6079702,6079702,6079486,216,0,utRho08
xseA,5268394,5268464,5268394,70,306,utRho08
xseB,882746,882746,882686,60,54,utRho08
xthA,3664798,3664856,3664798,58,0,utRho08
xylA,7461614,7461614,7461530,84,300,utRho08
xylE,8484540,8484540,8484508,32,0,utRho08
xylF,7462138,7462262,7462138,124,0,utRho08
xylR,7469812,7469958,7469812,146,96,utRho08
yaaA,13230,13230,12918,312,0,utRho08
yaaI,23876,23876,23572,304,0,utRho08
yaaJ,16034,16034,15918,116,0,utRho08
yaaU,91184,91614,91184,430,108,utRho08
yaaW,23084,23084,22712,372,0,utRho08
yaaX,10060,10468,10060,408,0,utRho08
yabI,142542,142702,142542,160,0,utRho08
yacC,273880,273880,273834,46,158,utRho08
yacH,262932,262932,262520,412,0,utRho08
yacL,268678,268776,268678,98,0,utRho08
yadD,293796,293936,293796,140,0,utRho08
yadE,289930,290162,289930,232,140,utRho08
yadN,314110,314110,313766,344,0,utRho08
yadS,355572,355572,355248,324,4,utRho08
yadV,312470,312470,312402,68,66,utRho08
yaeF,434270,434270,434006,264,0,utRho08
yaeP,428374,428374,428250,124,0,utRho08
yaeQ,428176,428582,428176,406,52,utRho08
yaeR,423716,423754,423716,38,0,utRho08
yafC,462166,462166,461762,404,64,utRho08
yafD,462128,462244,462128,116,76,utRho08
yafK,491986,491986,491610,376,578,utRho08
yafL,493282,493424,493282,142,0,utRho08
yafN,503938,504010,503938,72,0,utRho08
yafS,469568,469632,469568,64,170,utRho08
yafT,474470,474670,474470,200,0,utRho08
yafV,480432,480432,480378,54,0,utRho08
yafZ,536052,536052,536010,42,12,utRho08
yagE,564446,564556,564446,110,108,utRho08
yagG,570414,570790,570414,376,0,utRho08
yagI,578384,578384,578324,60,0,utRho08
yagK,586236,586236,585896,340,52,utRho08
yagL,588062,588062,587836,226,0,utRho08
yagN,591342,591342,591158,184,498,utRho08
yahA,663746,664742,663746,996,404,utRho08
yahC,670136,670136,670044,92,0,utRho08
yahE,671478,671850,671478,372,0,utRho08
yahM,690504,690808,690504,304,0,utRho08
yahN,692872,692872,692674,198,0,utRho08
yahO,692864,692968,692864,104,0,utRho08
yaiE,816296,816354,816296,58,16,utRho08
yaiI,811396,811528,811396,132,0,utRho08
yaiO,761946,761946,761684,262,0,utRho08
yaiP,767970,767970,767870,100,0,utRho08
yaiS,769660,769660,769232,428,0,utRho08
yaiV,788922,788922,788922,0,0,utRho08
yaiY,799094,799094,798666,428,0,utRho08
yaiZ,798888,799186,798888,298,54,utRho08
yajC,854410,854574,854410,164,1432,utRho08
yajD,860938,861210,860938,272,436,utRho08
yajI,866068,866068,865702,366,284,utRho08
yajL,887496,887496,887282,214,604,utRho08
yajQ,889316,889366,889316,50,0,utRho08
yajR,893374,893374,893332,42,56,utRho08
ybaB,987418,988152,987418,734,3256,utRho08
ybaL,1006590,1006590,1006476,114,12,utRho08
ybaM,980648,980648,980542,106,52,utRho08
ybaN,981436,981764,981436,328,464,utRho08
ybaO,936704,936766,936704,62,0,utRho08
ybaP,1016568,1016568,1016160,408,328,utRho08
ybaQ,1016348,1016436,1016348,88,0,utRho08
ybaS,1023146,1023282,1023146,136,56,utRho08
ybaV,927504,927874,927504,370,50,utRho08
ybaY,950490,950758,950490,268,0,utRho08
ybbB,1062724,1062724,1062452,272,0,utRho08
ybbJ,1030154,1030154,1029718,436,204,utRho08
ybbL,1031784,1031838,1031784,54,0,utRho08
ybbN,1037136,1037136,1036558,578,1740,utRho08
ybbO,1038658,1038658,1038298,360,1304,utRho08
ybbY,1080718,1081130,1080718,412,0,utRho08
ybcH,1176140,1176140,1175962,178,0,utRho08
ybcI,1113264,1113264,1113106,158,654,utRho08
ybcJ,1114050,1114050,1113746,304,144,utRho08
ybcK,1137502,1137804,1137502,302,0,utRho08
ybcL,1141690,1141786,1141690,96,0,utRho08
ybcN,1144628,1144932,1144628,304,0,utRho08
ybcQ,1147548,1147912,1147548,364,0,utRho08
ybcW,1159610,1159760,1159610,150,0,utRho08
ybdD,1263982,1264364,1263982,382,144,utRho08
ybdF,1212106,1212106,1211772,334,96,utRho08
ybdH,1267048,1267048,1266954,94,0,utRho08
ybdJ,1212822,1212822,1212398,424,0,utRho08
ybdK,1215122,1215122,1214766,356,0,utRho08
ybdL,1267114,1267172,1267114,58,0,utRho08
ybdM,1271110,1271110,1270752,358,42,utRho08
ybdN,1273372,1273372,1273138,234,0,utRho08
ybdR,1283844,1284176,1283844,332,202,utRho08
ybeD,1325412,1325412,1325284,128,464,utRho08
ybeF,1323090,1323090,1322756,334,68,utRho08
ybeL,1349986,1350036,1349986,50,106,utRho08
ybeQ,1353412,1353412,1353094,318,0,utRho08
ybeR,1353120,1353422,1353120,302,0,utRho08
ybeT,1358832,1358832,1358812,20,0,utRho08
ybeU,1358924,1359016,1358924,92,0,utRho08
ybeZ,1386938,1386938,1386834,104,5498,utRho08
ybfA,1458074,1458268,1458074,194,0,utRho08
ybfE,1423878,1423878,1423796,82,284,utRho08
ybfF,1425692,1425692,1425604,88,428,utRho08
ybfH,1433282,1433282,1433194,88,0,utRho08
ybgA,1477840,1478002,1477840,162,0,utRho08
ybgC,1549288,1549504,1549288,216,0,utRho08
ybgD,1505916,1505916,1505590,326,0,utRho08
ybgI,1485238,1485654,1485238,416,0,utRho08
ybgO,1498370,1498370,1497964,406,0,utRho08
ybgS,1570992,1570992,1570634,358,0,utRho08
ybhA,1597184,1597184,1596862,322,80,utRho08
ybhB,1616070,1616070,1615818,252,376,utRho08
ybhC,1614642,1614642,1614562,80,1972,utRho08
ybhD,1601418,1601418,1601276,142,0,utRho08
ybhH,1601104,1601518,1601104,414,0,utRho08
ybhK,1633384,1633384,1633294,90,92,utRho08
ybhM,1641556,1641586,1641556,30,0,utRho08
ybhN,1645296,1645296,1644996,300,0,utRho08
ybhQ,1649202,1649260,1649202,58,4,utRho08
ybiA,1665920,1665920,1665900,20,0,utRho08
ybiI,1676968,1676968,1676912,56,120,utRho08
ybiO,1691328,1691328,1690960,368,0,utRho08
ybiP,1705252,1705252,1705194,58,6,utRho08
ybiS,1711572,1711572,1711488,84,636,utRho08
ybiT,1711894,1711926,1711894,32,0,utRho08
ybiU,1718212,1718212,1718122,90,0,utRho08
ybiV,1720176,1720176,1720056,120,0,utRho08
ybiW,1725566,1725566,1725212,354,172,utRho08
ybiX,1678548,1678548,1678414,134,464,utRho08
ybjC,1781784,1781826,1781784,42,0,utRho08
ybjE,1830154,1830154,1829714,440,72,utRho08
ybjG,1767016,1767016,1766776,240,1112,utRho08
ybjL,1779882,1779882,1779638,244,100,utRho08
ybjM,1779770,1780178,1779770,408,62,utRho08
ybjO,1795704,1795978,1795704,274,0,utRho08
ybjP,1809046,1809046,1808934,112,72,utRho08
ybjQ,1809034,1809186,1809034,152,148,utRho08
ybjS,1813796,1813796,1813506,290,344,utRho08
ybjX,1838206,1838206,1838168,38,0,utRho08
ycaD,1891438,1891742,1891438,304,0,utRho08
ycaI,1928210,1928640,1928210,430,0,utRho08
ycaK,1899094,1899336,1899094,242,0,utRho08
ycaL,1920264,1920528,1920264,264,0,utRho08
ycaM,1894240,1894458,1894240,218,0,utRho08
ycaR,1941284,1941346,1941284,62,404,utRho08
ycbB,1961862,1962094,1961862,232,0,utRho08
ycbJ,1943344,1943504,1943344,160,0,utRho08
ycbK,1966046,1966150,1966046,104,320,utRho08
ycbZ,2036920,2036920,2036598,322,70,utRho08
yccA,2062886,2062886,2062836,50,0,utRho08
yccF,2048730,2048730,2048696,34,0,utRho08
yccS,2047988,2047988,2047766,222,0,utRho08
yccT,2055674,2055674,2055546,128,0,utRho08
yccX,2059960,2060128,2059960,168,2,utRho08
ycdT,2185682,2185752,2185682,70,0,utRho08
ycdU,2191266,2191686,2191266,420,0,utRho08
ycdZ,2200504,2200592,2200504,88,364,utRho08
yceA,2233544,2233614,2233544,70,164,utRho08
yceD,2293298,2293588,2293298,290,11748,utRho08
yceF,2293522,2293522,2293190,332,7240,utRho08
yceH,2252154,2252314,2252154,160,1778,utRho08
yceI,2237282,2237282,2236952,330,324,utRho08
yceJ,2238142,2238142,2238092,50,0,utRho08
yceM,2253208,2253612,2253208,404,16,utRho08
yceO,2239264,2239264,2238894,370,220,utRho08
yceQ,2288760,2289004,2288760,244,6714,utRho08
ycfD,2376540,2376540,2376480,60,96,utRho08
ycfJ,2334814,2335198,2334814,384,276,utRho08
ycfS,2340834,2340834,2340748,86,0,utRho08
ycfT,2350658,2350658,2350330,328,0,utRho08
ycfZ,2362760,2362760,2362534,226,362,utRho08
ycgB,2474570,2474570,2474482,88,0,utRho08
ycgG,2434614,2434656,2434614,42,0,utRho08
ycgJ,2452956,2453200,2452956,244,0,utRho08
ycgL,2455218,2455362,2455218,144,0,utRho08
ycgN,2457366,2457660,2457366,294,116,utRho08
ycgR,2489112,2489112,2489054,58,0,utRho08
ycgV,2512222,2512222,2511904,318,86,utRho08
ycgX,2426568,2426568,2426214,354,5418,utRho08
ycgY,2490166,2490320,2490166,154,0,utRho08
ycgZ,2431504,2431578,2431504,74,0,utRho08
ychE,2596904,2597196,2596904,292,148,utRho08
ychF,2515764,2515764,2515624,140,0,utRho08
ychH,2517476,2517582,2517476,106,60,utRho08
ychJ,2578354,2578354,2578264,90,0,utRho08
ychN,2547310,2547310,2547198,112,0,utRho08
ychO,2547520,2547850,2547520,330,152,utRho08
ychQ,2533798,2533848,2533798,50,160,utRho08
yciA,2624828,2624828,2624492,336,220,utRho08
yciB,2626110,2626110,2625780,330,5382,utRho08
yciC,2627396,2627396,2627326,70,0,utRho08
yciE,2630794,2630794,2630448,346,0,utRho08
yciG,5264368,5264368,5264140,228,0,utRho08
yciI,2621784,2621784,2621730,54,0,utRho08
yciN,2661606,2661606,2661336,270,0,utRho08
yciS,2680270,2680486,2680270,216,0,utRho08
yciT,2689088,2689088,2688692,396,180,utRho08
yciU,2614718,2614718,2614300,418,1296,utRho08
yciV,2646376,2646440,2646376,64,0,utRho08
yciW,2700472,2700472,2700214,258,0,utRho08
yciZ,2689276,2689276,2689218,58,122,utRho08
ycjD,2703792,2703792,2703520,272,0,utRho08
ycjG,2777748,2777860,2777748,112,22,utRho08
ycjM,2740006,2740432,2740006,426,44,utRho08
ycjW,2767982,2767982,2767922,60,0,utRho08
ycjX,2768138,2768234,2768138,96,0,utRho08
ycjY,5568288,5568288,5567460,828,0,utRho08
ydaE,2836438,2836438,2836016,422,0,utRho08
ydaN,2816048,2816100,2816048,52,0,utRho08
ydaS,2840340,2840730,2840340,390,0,utRho08
ydbC,2948376,2948442,2948376,66,0,utRho08
ydbD,2950132,2950288,2950132,156,0,utRho08
ydbH,2885800,2886102,2885800,302,4,utRho08
ydbJ,2881712,2882116,2881712,404,0,utRho08
ydbK,2881692,2881692,2881568,124,54,utRho08
ydcA,2983294,2983354,2983294,60,0,utRho08
ydcF,2974404,2974470,2974404,66,0,utRho08
ydcI,2990268,2990268,2990142,126,0,utRho08
ydcJ,2990266,2990576,2990266,310,0,utRho08
ydcK,3001280,3001280,3000898,382,0,utRho08
ydcL,3004646,3004914,3004646,268,0,utRho08
ydcN,3012308,3012344,3012308,36,0,utRho08
ydcP,3013508,3013562,3013508,54,190,utRho08
ydcR,3019956,3020006,3019956,50,0,utRho08
ydcS,3022906,3023308,3022906,402,0,utRho08
ydcX,3034442,3034778,3034442,336,60,utRho08
ydcY,3035220,3035296,3035220,76,0,utRho08
ydcZ,3036750,3036750,3036662,88,0,utRho08
yddB,3155332,3155332,3155238,94,0,utRho08
yddE,3071738,3071738,3071716,22,0,utRho08
yddG,3094410,3094410,3094338,72,0,utRho08
yddJ,3089732,3089732,3089438,294,0,utRho08
yddW,3137704,3137704,3137646,58,46,utRho08
ydeA,3233910,3234056,3233910,146,46,utRho08
ydeE,3242528,3242664,3242528,136,0,utRho08
ydeI,3249118,3249118,3248994,124,0,utRho08
ydeJ,3249376,3249546,3249376,170,0,utRho08
ydeN,3165458,3165458,3165048,410,0,utRho08
ydeP,3173328,3173328,3172972,356,0,utRho08
ydeR,3176596,3176596,3176592,4,0,utRho08
ydfA,3296872,3297016,3296872,144,0,utRho08
ydfG,3254982,3255034,3254982,52,32,utRho08
ydfH,3256652,3256704,3256652,52,0,utRho08
ydfK,3265446,3266144,3265446,698,700,utRho08
ydgA,3379588,3379704,3379588,116,0,utRho08
ydgC,3364124,3364124,3364060,64,0,utRho08
ydgD,3343906,3343920,3343906,14,0,utRho08
ydgH,3356754,3356854,3356754,100,0,utRho08
ydgJ,3408798,3408798,3408616,182,0,utRho08
ydgK,3410414,3410500,3410414,86,302,utRho08
ydhB,3479618,3479618,3479596,22,0,utRho08
ydhC,3479698,3479822,3479698,124,0,utRho08
ydhF,3451310,3451310,3451264,46,0,utRho08
ydhI,3441996,3442050,3441996,54,0,utRho08
ydhL,3451864,3451864,3451840,24,0,utRho08
ydhQ,3492404,3492404,3492254,150,0,utRho08
ydhS,3494136,3494262,3494136,126,0,utRho08
ydhT,3499138,3499138,3499118,20,0,utRho08
ydhY,3509284,3509284,3508954,330,0,utRho08
ydhZ,3510418,3510418,3510282,136,0,utRho08
ydiE,3579206,3579226,3579206,20,0,utRho08
ydiH,3530582,3530582,3530406,176,0,utRho08
ydiM,3541852,3542142,3541852,290,0,utRho08
ydiN,3544818,3545024,3544818,206,0,utRho08
ydiP,3558656,3558656,3558602,54,0,utRho08
ydiU,3582508,3582508,3582488,20,42,utRho08
ydiV,3584174,3584174,3584040,134,44,utRho08
ydiY,3612500,3612500,3612166,334,0,utRho08
ydjA,3697400,3697400,3697352,48,88,utRho08
ydjE,3708082,3708082,3707958,124,0,utRho08
ydjF,3709848,3709848,3709708,140,0,utRho08
ydjM,3620340,3620422,3620340,82,0,utRho08
ydjO,3626696,3626696,3626288,408,0,utRho08
ydjX,3666434,3666802,3666434,368,780,utRho08
yeaE,3731448,3731448,3731272,176,264,utRho08
yeaG,3733530,3733816,3733530,286,0,utRho08
yeaI,3740486,3740770,3740486,284,0,utRho08
yeaJ,3743874,3744082,3743874,208,74,utRho08
yeaL,3748646,3748704,3748646,58,316,utRho08
yeaM,3751296,3751296,3751152,144,0,utRho08
yeaN,3750926,3751346,3750926,420,0,utRho08
yeaO,3753554,3753818,3753554,264,0,utRho08
yeaP,3755314,3755430,3755314,116,644,utRho08
yeaQ,3758780,3758780,3758510,270,0,utRho08
yeaR,3759988,3759988,3759896,92,0,utRho08
yeaY,3781122,3781122,3781064,58,12,utRho08
yebB,3892220,3892502,3892220,282,0,utRho08
yebC,3896370,3896370,3896302,68,0,utRho08
yebE,3859464,3859464,3859414,50,0,utRho08
yebG,3861530,3861530,3861494,36,0,utRho08
yebK,3873180,3873304,3873180,124,0,utRho08
yebQ,3820314,3820552,3820314,238,0,utRho08
yebS,3832238,3832516,3832238,278,0,utRho08
yebV,3843430,3843560,3843430,130,0,utRho08
yebW,3843914,3844242,3843914,328,828,utRho08
yecC,3995646,3995646,3995628,18,0,utRho08
yecD,3901272,3901664,3901272,392,192,utRho08
yecF,3991434,3991636,3991434,202,0,utRho08
yecH,3979304,3979304,3978980,324,0,utRho08
yecJ,3975604,3975604,3975516,88,0,utRho08
yecM,3919968,3919968,3919692,276,0,utRho08
yecR,3976400,3976444,3976400,44,0,utRho08
yecT,3923862,3923944,3923862,82,98,utRho08
yedD,4016522,4016522,4016180,342,6,utRho08
yedE,4016310,4016554,4016310,244,12,utRho08
yedI,4058922,4058922,4058732,190,0,utRho08
yedJ,4066446,4066446,4066158,288,40,utRho08
yedV,4076404,4076404,4076304,100,0,utRho08
yedX,4077680,4077912,4077680,232,0,utRho08
yedY,4078572,4078956,4078572,384,0,utRho08
yeeA,4161322,4161322,4161182,140,152,utRho08
yeeE,4171104,4171104,4171050,54,0,utRho08
yeeJ,4089526,4089822,4089526,296,52,utRho08
yeeN,4113508,4113716,4113508,208,144,utRho08
yeeO,4119444,4119444,4119692,248,0,utRho08
yeeX,4158834,4158834,4158722,112,12,utRho08
yeeZ,4178422,4178422,4178256,166,0,utRho08
yefM,4179466,4179466,4179426,40,0,utRho08
yegD,4295288,4295348,4295288,60,100,utRho08
yegH,4275726,4275804,4275726,78,0,utRho08
yegI,4302154,4302154,4301970,184,0,utRho08
yegJ,4302032,4302370,4302032,338,0,utRho08
yegQ,4331182,4331336,4331182,154,32,utRho08
yegR,4336698,4336698,4336612,86,0,utRho08
yegS,4337086,4337424,4337086,338,0,utRho08
yegT,4357562,4357642,4357562,80,0,utRho08
yegX,4367640,4367640,4367302,338,148,utRho08
yehA,4376944,4376944,4376828,116,0,utRho08
yehE,4385818,4385818,4385592,226,0,utRho08
yehK,4407568,4407944,4407568,376,0,utRho08
yehL,4408804,4409192,4408804,388,0,utRho08
yeiB,4486146,4486146,4485934,212,92,utRho08
yeiE,4499422,4499422,4499236,186,0,utRho08
yeiG,4487776,4487820,4487776,44,252,utRho08
yeiH,4499332,4499434,4499332,102,0,utRho08
yeiI,4503306,4503400,4503306,94,96,utRho08
yeiL,4510580,4510710,4510580,130,0,utRho08
yeiP,4530834,4530900,4530834,66,652,utRho08
yeiQ,4532328,4532490,4532328,162,0,utRho08
yeiR,4535484,4535658,4535484,174,146,utRho08
yeiW,4530840,4530840,4530590,250,788,utRho08
yejA,4544624,4544728,4544624,104,0,utRho08
yejG,4556892,4556892,4556474,418,462,utRho08
yejH,4561244,4561264,4561244,20,2,utRho08
yejK,4568218,4568218,4567894,324,360,utRho08
yejO,4578352,4578352,4577800,552,30,utRho08
yfaD,4713380,4713808,4713380,428,316,utRho08
yfaE,4696676,4697028,4696676,352,926,utRho08
yfaL,4688568,4688568,4688338,230,0,utRho08
yfaP,4656398,4656398,4656286,112,0,utRho08
yfaU,4717892,4717892,4717690,202,0,utRho08
yfaY,4727310,4727310,4727266,44,0,utRho08
yfaZ,4728744,4728744,4728550,194,0,utRho08
yfbK,4771810,4771810,4771444,366,0,utRho08
yfbL,4771500,4771720,4771500,220,0,utRho08
yfbN,4777174,4777174,4776852,322,0,utRho08
yfbO,4776916,4777162,4776916,246,0,utRho08
yfbP,4777990,4778232,4777990,242,146,utRho08
yfbR,4817662,4817724,4817662,62,112,utRho08
yfcI,4847424,4847424,4847078,346,0,utRho08
yfcJ,4880482,4880482,4880240,242,0,utRho08
yfcL,4888502,4888502,4888338,164,0,utRho08
yfcV,4911642,4911642,4911292,350,0,utRho08
yfcZ,4921958,4921958,4921868,90,0,utRho08
yfdF,4925604,4926024,4925604,420,296,utRho08
yfdG,4935474,4935710,4935474,236,0,utRho08
yfdP,4946844,4947040,4946844,196,0,utRho08
yfdX,4988866,4988866,4988804,62,0,utRho08
yfdY,4990672,4990672,4990584,88,0,utRho08
yfeA,5035784,5035784,5035664,120,6226,utRho08
yfeC,5036668,5036934,5036668,266,232,utRho08
yfeH,5053818,5053892,5053818,74,0,utRho08
yfeK,5074630,5074684,5074630,54,0,utRho08
yfeO,5018906,5019260,5018906,354,162,utRho08
yfeR,5054078,5054078,5053712,366,56,utRho08
yfeX,5101356,5101356,5101090,266,0,utRho08
yfeY,5102486,5102486,5102432,54,0,utRho08
yfeZ,5103842,5103842,5103452,390,68,utRho08
yffO,5123804,5124222,5123804,418,0,utRho08
yffQ,5126778,5127154,5126778,376,20,utRho08
yffS,5128800,5128986,5128800,186,178,utRho08
yfgC,5232052,5232188,5232052,136,0,utRho08
yfgF,5258062,5258062,5257876,186,0,utRho08
yfgG,5258170,5258580,5258170,410,0,utRho08
yfgH,5259344,5259584,5259344,240,0,utRho08
yfgM,5278866,5278866,5278566,300,28,utRho08
yfhH,5397414,5397518,5397414,104,0,utRho08
yfhM,5304648,5304648,5304574,74,0,utRho08
yfhR,5328408,5328726,5328408,318,404,utRho08
yfiC,5425610,5425610,5425528,82,0,utRho08
yfiE,5430688,5430688,5430640,48,0,utRho08
yfiL,5482630,5482720,5482630,90,0,utRho08
yfiM,5448066,5448358,5448066,292,7476,utRho08
yfiR,5483354,5483750,5483354,396,0,utRho08
yfjH,5517326,5517326,5517200,126,0,utRho08
yfjI,5517710,5517970,5517710,260,0,utRho08
yfjJ,5521014,5521094,5521014,80,0,utRho08
yfjM,5531970,5531970,5531552,418,272,utRho08
yfjP,5535080,5535420,5535080,340,64,utRho08
yfjW,5546570,5546636,5546570,66,0,utRho08
yfjX,5551776,5551838,5551776,62,0,utRho08
ygaC,5601180,5601180,5599988,1192,0,utRho08
ygaM,5600242,5600292,5600242,50,0,utRho08
ygaU,5593628,5593628,5593572,56,0,utRho08
ygaZ,5619190,5619234,5619190,44,26,utRho08
ygbA,5713656,5713656,5713612,44,0,utRho08
ygbE,5746784,5746784,5746674,110,72,utRho08
ygbI,5722882,5722882,5722528,354,0,utRho08
ygbK,5724394,5724670,5724394,276,20,utRho08
ygbL,5727074,5727186,5727074,112,0,utRho08
ygbN,5729814,5730202,5729814,388,92,utRho08
ygcG,5811210,5811422,5811210,212,48,utRho08
ygcN,5785144,5785314,5785144,170,0,utRho08
ygcU,5799214,5799214,5798836,378,0,utRho08
ygcW,5800942,5800942,5800546,396,0,utRho08
ygdD,5883442,5883442,5883262,180,218,utRho08
ygdG,5861746,5861930,5861746,184,116,utRho08
ygdI,5886526,5886526,5886290,236,0,utRho08
ygdQ,5940784,5940840,5940784,56,0,utRho08
ygdR,5942494,5942542,5942494,48,0,utRho08
ygeA,5961606,5961606,5961270,336,0,utRho08
ygeH,5983758,5984188,5983758,430,0,utRho08
ygeI,5987162,5987276,5987162,114,0,utRho08
ygeR,6000078,6000078,5999782,296,58,utRho08
ygeV,6011694,6011694,6011572,122,0,utRho08
ygeW,6012234,6012524,6012234,290,0,utRho08
ygfB,6110946,6110946,6110888,58,34,utRho08
ygfK,6031984,6032120,6031984,136,0,utRho08
ygfS,6058328,6058328,6058024,304,0,utRho08
ygfZ,6082564,6082626,6082564,62,74,utRho08
yggC,6149512,6149512,6149378,134,134,utRho08
yggE,6136370,6136370,6136160,210,70,utRho08
yggI,6179176,6179510,6179176,334,8,utRho08
yggL,6204508,6204508,6204266,242,322,utRho08
yggM,6199514,6199514,6199130,384,4,utRho08
yggN,6203596,6203596,6203246,350,128,utRho08
yggX,18623958,18624558,18623958,600,1182,utRho08
yghA,6298966,6299324,6298966,358,0,utRho08
yghB,6307058,6307126,6307058,68,0,utRho08
yghD,6222614,6222614,6222252,362,100,utRho08
yghF,6225798,6225798,6225840,42,0,utRho08
yghJ,6238640,6238640,6238224,416,0,utRho08
yghQ,6265186,6265186,6264816,370,0,utRho08
yghT,6267830,6268262,6267830,432,0,utRho08
yghU,6277400,6277454,6277400,54,0,utRho08
yghW,6293506,6293506,6293474,32,0,utRho08
yghZ,6295562,6295794,6295562,232,0,utRho08
ygiD,6365122,6365122,6364868,254,126,utRho08
ygiH,6409066,6409388,6409066,322,56,utRho08
ygiL,6370622,6370828,6370622,206,0,utRho08
ygiM,6402084,6402414,6402084,330,132,utRho08
ygiN,6346156,6346284,6346156,128,1072,utRho08
ygiQ,6322620,6322620,6322292,328,374,utRho08
ygiS,6335462,6335462,6335436,26,0,utRho08
ygiV,6338582,6338582,6338462,120,42,utRho08
ygiW,6339774,6339774,6339352,422,0,utRho08
ygiZ,6344506,6344506,6344422,84,0,utRho08
ygjH,6442528,6442528,6442494,34,0,utRho08
ygjI,6452140,6452468,6452140,328,0,utRho08
ygjQ,6472730,6473080,6472730,350,248,utRho08
ygjR,6474564,6474586,6474564,22,0,utRho08
ygjV,6483638,6483638,6483488,150,0,utRho08
yhaB,6535632,6535708,6535632,76,0,utRho08
yhaH,6504498,6504608,6504498,110,4,utRho08
yhaI,6505400,6505822,6505400,422,0,utRho08
yhaJ,6508560,6508560,6508428,132,46,utRho08
yhaK,6508538,6508638,6508538,100,0,utRho08
yhbQ,6599878,6599932,6599878,54,0,utRho08
yhbT,6602736,6602736,6602552,184,82,utRho08
yhbU,6602558,6602970,6602558,412,82,utRho08
yhbX,6643302,6643302,6643226,76,0,utRho08
yhbY,6655518,6655580,6655518,62,1440,utRho08
yhcA,6723956,6724224,6723956,268,0,utRho08
yhcB,6760364,6760382,6760364,18,400,utRho08
yhcC,6708470,6708470,6708100,370,0,utRho08
yhcF,6733440,6733852,6733440,412,24,utRho08
yhcH,6739124,6739124,6738956,168,128,utRho08
yhcM,6760312,6760312,6759994,318,66,utRho08
yhcN,6770812,6771076,6770812,264,116,utRho08
yhcO,6772606,6772606,6772258,348,0,utRho08
yhdH,6806560,6806968,6806560,408,132,utRho08
yhdJ,6823234,6823306,6823234,72,0,utRho08
yhdN,6879092,6879092,6879018,74,1560,utRho08
yhdT,6814702,6814750,6814702,48,252,utRho08
yhdU,6824994,6825242,6824994,248,0,utRho08
yhdV,6836392,6836780,6836392,388,20,utRho08
yhdW,6837944,6838298,6837944,354,0,utRho08
yheO,6953082,6953082,6952880,202,652,utRho08
yheV,6957970,6957970,6957584,386,18,utRho08
yhfA,6971902,6971902,6971636,266,0,utRho08
yhfG,6983294,6983294,6983240,54,300,utRho08
yhfL,6998622,6998896,6998622,274,0,utRho08
yhfY,7023244,7023244,7022844,400,132,utRho08
yhgA,7086294,7086334,7086294,40,0,utRho08
yhgE,7065176,7065176,7064878,298,128,utRho08
yhgF,7074352,7074770,7074352,418,992,utRho08
yhhA,7173458,7173886,7173458,428,0,utRho08
yhhI,7248346,7248756,7248346,410,0,utRho08
yhhJ,7253696,7253696,7253606,90,0,utRho08
yhhM,7211588,7211588,7211220,368,84,utRho08
yhhN,7211150,7211502,7211150,352,86,utRho08
yhhQ,7218238,7218434,7218238,196,246,utRho08
yhhT,7223682,7223730,7223682,48,104,utRho08
yhhX,7162032,7162032,7161610,422,0,utRho08
yhhY,7162222,7162276,7162222,54,0,utRho08
yhhZ,7163516,7163726,7163516,210,0,utRho08
yhiD,7312220,7312220,7311804,416,1914,utRho08
yhiJ,7265190,7265190,7265180,10,0,utRho08
yhiM,7269270,7269682,7269270,412,0,utRho08
yhiN,7275000,7275000,7274820,180,36,utRho08
yhjA,7338522,7338522,7338376,146,0,utRho08
yhjB,7344090,7344090,7343788,302,60,utRho08
yhjC,7344272,7344684,7344272,412,0,utRho08
yhjD,7346660,7346724,7346660,64,0,utRho08
yhjE,7349274,7349572,7349274,298,0,utRho08
yhjG,7356824,7356824,7356730,94,54,utRho08
yhjH,7358458,7358458,7358374,84,200,utRho08
yhjJ,7364032,7364032,7363880,152,82,utRho08
yhjK,7371296,7371296,7371158,138,44,utRho08
yhjR,7392750,7392750,7392370,380,114,utRho08
yhjV,7400796,7401126,7400796,330,130,utRho08
yhjX,7424194,7424194,7424014,180,0,utRho08
yhjY,7425966,7425966,7425868,98,0,utRho08
yiaB,7455654,7455654,7455496,158,0,utRho08
yiaD,7432712,7433094,7432712,382,204,utRho08
yiaF,7438194,7438194,7438088,106,0,utRho08
yiaG,7438862,7438956,7438862,94,0,utRho08
yiaJ,7485236,7485236,7485064,172,0,utRho08
yiaK,7485348,7485466,7485348,118,32,utRho08
yiaT,7503924,7503924,7503736,188,0,utRho08
yiaU,7503792,7503984,7503792,192,0,utRho08
yiaY,7515856,7515856,7515654,202,0,utRho08
yibF,7523950,7523950,7523910,40,0,utRho08
yibG,7536128,7536354,7536128,226,0,utRho08
yibL,7553194,7553330,7553194,136,44,utRho08
yibN,7570112,7570112,7570030,82,386,utRho08
yibT,7552848,7552848,7552760,88,0,utRho08
yicC,7633290,7633352,7633290,62,40,utRho08
yicH,7660862,7660914,7660862,52,0,utRho08
yicJ,7673328,7673328,7671858,1470,454,utRho08
yicN,7685018,7685018,7684804,214,0,utRho08
yicO,7687914,7687914,7687578,336,0,utRho08
yicR,15250308,15250308,15250236,72,0,utRho08
yidB,7755230,7755230,7754930,300,0,utRho08
yidE,7732780,7732780,7732546,234,0,utRho08
yidF,7711580,7711580,7711222,358,132,utRho08
yidQ,7735088,7735456,7735088,368,854,utRho08
yidR,7738824,7738824,7738618,206,0,utRho08
yieE,7787658,7787738,7787658,80,4,utRho08
yieH,7793314,7793548,7793314,234,0,utRho08
yieK,7798928,7798928,7798786,142,0,utRho08
yifB,7900350,7900350,7899998,352,0,utRho08
yifL,7988984,7989044,7988984,60,4,utRho08
yigF,8005750,8005750,8005598,152,188,utRho08
yigI,8009448,8009448,8009394,54,0,utRho08
yigM,8022100,8022152,8022100,52,0,utRho08
yihA,8101970,8101970,8101458,512,222,utRho08
yihD,8084098,8084138,8084098,40,0,utRho08
yihF,8088110,8088398,8088110,288,0,utRho08
yihG,8093304,8093304,8093204,100,0,utRho08
yihI,8102616,8102694,8102616,78,0,utRho08
yihL,8120506,8120894,8120506,388,332,utRho08
yihN,8124332,8124494,8124332,162,0,utRho08
yihO,8131942,8131942,8131532,410,0,utRho08
yihQ,8138892,8138892,8138552,340,0,utRho08
yihV,8147064,8147478,8147064,414,0,utRho08
yihX,8151096,8151106,8151096,10,34,utRho08
yiiE,8158192,8158582,8158192,390,0,utRho08
yiiF,8159124,8159502,8159124,378,0,utRho08
yiiG,8173762,8174004,8173762,242,0,utRho08
yiiM,8205506,8205644,8205506,138,118,utRho08
yiiQ,8224624,8224624,8224428,196,0,utRho08
yiiS,8225738,8225934,8225738,196,0,utRho08
yijE,8272178,8272216,8272178,38,20,utRho08
yijF,8275728,8275728,8275314,414,0,utRho08
yijO,8296858,8296858,8296634,224,32,utRho08
yjaA,8426240,8426468,8426240,228,190776,utRho08
yjaB,8428312,8428312,8428246,66,0,utRho08
yjaG,8398746,8399008,8398746,262,1074,utRho08
yjaH,8401022,8401132,8401022,110,258,utRho08
yjaZ,8379506,8379572,8379506,66,0,utRho08
yjbB,8455204,8455462,8455204,258,0,utRho08
yjbE,16943432,16943624,16943432,192,0,utRho08
yjbL,8520318,8520642,8520318,324,0,utRho08
yjbQ,8540428,8540476,8540428,48,0,utRho08
yjcB,8550328,8550328,8550082,246,98,utRho08
yjcC,8550836,8550942,8550836,106,0,utRho08
yjcD,8556628,8556958,8556628,330,160,utRho08
yjcE,8559658,8559960,8559658,302,0,utRho08
yjcF,8566212,8566212,8566150,62,0,utRho08
yjcO,8594660,8594660,8594250,410,22,utRho08
yjdA,8654128,8654270,8654128,142,0,utRho08
yjdC,8726660,8726660,8726616,44,0,utRho08
yjdK,8704780,8705168,8704780,388,298,utRho08
yjdL,8713034,8713034,8712822,212,0,utRho08
yjdM,8653672,8653672,8653468,204,68,utRho08
yjeF,8787354,8788132,8787354,778,4374,utRho08
yjeI,8745522,8745618,8745522,96,0,utRho08
yjeJ,8748806,8748806,8748468,338,0,utRho08
yjeV,8785472,8785784,8785472,312,142,utRho08
yjfP,8833512,8833904,8833512,392,0,utRho08
yjfY,8849656,8849656,8849582,74,0,utRho08
yjfZ,8855052,8855052,8854844,208,10,utRho08
yjgA,8916162,8916162,8915730,432,18,utRho08
yjgL,8950802,8950874,8950802,72,0,utRho08
yjgM,8959342,8959342,8959074,268,0,utRho08
yjgN,8959132,8959460,8959132,328,0,utRho08
yjgR,8980170,8980170,8980126,44,0,utRho08
yjgZ,9002116,9002520,9002116,404,272,utRho08
yjhB,9007764,9008116,9007764,352,0,utRho08
yjhG,9048452,9048452,9048188,264,274,utRho08
yjhU,9041080,9041080,9040648,432,104,utRho08
yjiA,9178096,9178096,9177730,366,260,utRho08
yjiJ,9125364,9125364,9125350,14,0,utRho08
yjiK,9127270,9127270,9127422,152,0,utRho08
yjiL,9129604,9129604,9129378,226,0,utRho08
yjiS,9143410,9143502,9143410,92,0,utRho08
yjiY,9182734,9182734,9182558,176,182,utRho08
yjjA,9200674,9200674,9200378,296,162,utRho08
yjjB,18408708,18408708,18407800,908,0,utRho08
yjjJ,9243314,9243538,9243314,224,0,utRho08
yjjK,9261132,9261132,9261044,88,2,utRho08
yjjL,9189764,9189764,9189444,320,0,utRho08
yjjM,9191894,9191894,9191702,192,0,utRho08
yjjP,9206068,9206068,9205716,352,8,utRho08
yjjQ,9206638,9206954,9206638,316,0,utRho08
yjjX,9267798,9267798,9267490,308,738,utRho08
yjjY,9280716,9280804,9280716,88,706,utRho08
yjjZ,9211554,9211608,9211554,54,172,utRho08
yjtD,9281676,9281884,9281676,208,64,utRho08
ykfB,532454,532454,532174,280,30,utRho08
ykfI,527636,527636,527338,298,0,utRho08
ykgB,637050,637050,636638,412,0,utRho08
ykgC,640430,640430,640002,428,0,utRho08
ykgD,640232,640454,640232,222,0,utRho08
ykgE,642962,643216,642962,254,0,utRho08
ykgJ,608524,608524,608364,160,0,utRho08
ykgL,623878,624224,623878,346,0,utRho08
ykgM,625610,625610,625554,56,4,utRho08
ykgR,626570,626570,626484,86,0,utRho08
ylaC,958576,958576,958502,74,662,utRho08
yliE,1745938,1745958,1745938,20,0,utRho08
ymcE,2103660,2103694,2103660,34,2,utRho08
ymdA,2210450,2210828,2210450,378,108,utRho08
ymdB,2211428,2211640,2211428,212,0,utRho08
ymfD,2395322,2395322,2395064,258,676,utRho08
ymfI,2402880,2402994,2402880,114,0,utRho08
ymfJ,2404518,2404518,2404168,350,138,utRho08
ymfK,2406176,2406176,2405866,310,0,utRho08
ymfT,2405766,2406048,2405766,282,0,utRho08
ymgE,2489110,2489456,2489110,346,180,utRho08
ymgF,2437628,2437966,2437628,338,0,utRho08
ymiA,2670112,2670320,2670112,208,48,utRho08
ymjA,2715620,2715620,2715336,284,722,utRho08
ynaI,2791946,2791946,2791844,102,0,utRho08
ynaK,2850438,2850754,2850438,316,0,utRho08
ynbA,2954924,2955242,2954924,318,0,utRho08
yncD,3046552,3046552,3046130,422,170,utRho08
yncE,3046454,3046614,3046454,160,0,utRho08
yncG,3052456,3052494,3052456,38,128,utRho08
yncL,3034492,3034492,3034388,104,60,utRho08
yneE,3218364,3218364,3218044,320,0,utRho08
yneF,3223748,3223748,3223708,40,10,utRho08
yneJ,3229560,3229608,3229560,48,0,utRho08
yneK,3231100,3231526,3231100,426,0,utRho08
yneM,3245176,3245292,3245176,116,160,utRho08
ynfA,3311398,3311398,3311346,52,0,utRho08
ynfB,3311418,3311616,3311418,198,230,utRho08
ynfC,3315094,3315094,3314914,180,0,utRho08
ynfD,3314828,3315130,3314828,302,0,utRho08
ynfE,3316006,3316138,3316006,132,0,utRho08
ynfK,3334670,3334670,3334438,232,40,utRho08
ynfL,3339304,3339304,3339184,120,0,utRho08
ynfM,3339260,3339398,3339260,138,0,utRho08
ynfN,3276598,3276598,3276218,380,0,utRho08
ynfO,3273454,3273512,3273454,58,0,utRho08
ynhG,3517890,3517890,3517450,440,432,utRho08
yniA,3615158,3615592,3615158,434,4,utRho08
yniB,3618526,3618526,3618466,60,0,utRho08
yniC,3618652,3618760,3618652,108,0,utRho08
yniD,3610202,3610330,3610202,128,0,utRho08
ynjE,3678880,3678934,3678880,54,0,utRho08
ynjF,3683222,3683222,3682806,416,0,utRho08
ynjH,3684376,3684376,3684270,106,34,utRho08
ynjI,3690022,3690022,3689742,280,150,utRho08
yoaB,3786642,3786734,3786642,92,80,utRho08
yoaC,3787932,3788146,3787932,214,270,utRho08
yoaE,3803544,3803544,3803170,374,2,utRho08
yoaF,3755444,3755444,3755064,380,666,utRho08
yoaH,3789866,3789866,3789462,404,188,utRho08
yobB,3850418,3850880,3850418,462,392,utRho08
yobF,3815586,3815586,3815182,404,0,utRho08
yobH,3817800,3817850,3817800,50,0,utRho08
yodB,4084352,4084736,4084352,384,0,utRho08
yodC,4057008,4057008,4056740,268,0,utRho08
yohC,4451358,4451358,4451262,96,0,utRho08
yohD,4451526,4451602,4451526,76,0,utRho08
yohJ,4460986,4461248,4460986,262,0,utRho08
yohO,4431172,4431314,4431172,142,0,utRho08
yojI,4617282,4617282,4617230,52,0,utRho08
ypdI,4988988,4989396,4988988,408,0,utRho08
ypfG,5165786,5165786,5165554,232,2,utRho08
ypfM,5182140,5182140,5181732,408,320,utRho08
yphB,5349590,5349590,5349376,214,0,utRho08
ypjA,5565644,5565644,5565452,192,0,utRho08
ypjB,5569636,5569636,5568858,778,0,utRho08
ypjD,5495860,5495774,5495860,86,0,utRho08
yqaE,5594170,5594170,5594056,114,0,utRho08
yqcA,5846100,5846100,5845968,132,0,utRho08
yqcE,5800944,5801184,5800944,240,0,utRho08
yqeC,6030468,6030468,6030114,354,0,utRho08
yqeF,5971618,5971618,5971184,434,0,utRho08
yqeG,5971438,5971694,5971438,256,0,utRho08
yqeH,5975016,5975072,5975016,56,0,utRho08
yqeI,5976688,5977004,5976688,316,0,utRho08
yqeK,5981140,5981140,5980720,420,0,utRho08
yqfA,6086728,6086728,6086296,432,498,utRho08
yqgA,6219042,6219106,6219042,64,0,utRho08
yqgB,6172500,6172500,6172102,398,3694,utRho08
yqgE,6185768,6185874,6185768,106,552,utRho08
yqhA,6299150,6299150,6298942,208,0,utRho08
yqhC,6310768,6310768,6310436,332,118,utRho08
yqhD,6310604,6310710,6310604,106,96,utRho08
yqhH,6316842,6317254,6316842,412,208,utRho08
yqiC,6369662,6369680,6369662,18,38,utRho08
yqiJ,6384108,6384416,6384108,308,0,utRho08
yqjA,6495096,6495546,6495096,450,830,utRho08
yqjF,6500932,6501124,6500932,192,0,utRho08
yqjG,6501948,6502048,6501948,100,0,utRho08
yqjH,6433078,6433078,6432982,96,0,utRho08
yqjI,6433506,6433558,6433506,52,0,utRho08
yraH,6574552,6574852,6574552,300,0,utRho08
yraP,6592144,6592818,6592144,674,42,utRho08
yraQ,6596414,6596414,6596276,138,0,utRho08
yraR,6598024,6598024,6597692,332,0,utRho08
yrbG,13360844,13361100,13360844,256,152,utRho08
yrbL,6696842,6696904,6696842,62,0,utRho08
yrbN,6616172,6616172,6615866,306,4956,utRho08
yrdB,6860176,6860176,6860046,130,0,utRho08
yrfF,7052548,7052938,7052548,390,258,utRho08
yrhB,7169440,7169518,7169440,78,0,utRho08
ysaB,7451804,7451804,7451424,380,0,utRho08
ysgA,8032686,8032686,8032338,348,106,utRho08
ytfB,8857638,8857638,8857434,204,176,utRho08
ytfE,8864018,8864018,8863966,52,0,utRho08
ytfF,8866296,8866296,8866130,166,0,utRho08
ytfH,8868164,8868226,8868164,62,0,utRho08
ytfI,8875234,8875414,8875234,180,0,utRho08
ytfJ,8878572,8878572,8878524,48,244,utRho08
ytfK,8879022,8879174,8879022,152,132,utRho08
ytfL,8882642,8882642,8882430,212,0,utRho08
ytfQ,8899634,8899924,8899634,290,82,utRho08
ytjB,9249598,9249598,9249578,20,0,utRho08
yzfA,8896588,8896588,8896490,98,0,utRho08
zapA,6111102,6111224,6111102,122,2814,utRho08
zapB,8236772,8237030,8236772,258,0,utRho08
zapC,2011700,2011904,2011700,204,12,utRho08
zinT,4082692,4082750,4082692,58,0,utRho08
zipA,5062814,5062814,5062466,348,68,utRho08
zitB,1569716,1569716,1569646,70,0,utRho08
zntA,7212844,7212902,7212844,58,0,utRho08
zntR,6878336,6878336,6878260,76,6,utRho08
znuA,3885322,3885322,3885166,156,144,utRho08
znuC,3885268,3885324,3885268,56,72,utRho08
zraP,8403424,8403424,8403376,48,0,utRho08
zraS,8403810,8403852,8403810,42,0,utRho08
zupT,6364866,6365100,6364866,234,126,utRho08
zur,8520282,8520282,8520006,276,686,utRho08
zwf,3872752,3872752,3872628,124,86,utRho08
C0343,2818676,2818728,2818676,52,0,utRho09
aaeB,6776526,6776526,6776376,150,0,utRho09
aaeR,6778762,6779040,6778762,278,44,utRho09
aaeX,6778860,6778860,6778674,186,82,utRho09
aat,1854920,1854920,1854864,56,64,utRho09
accA,416822,417242,416822,420,2118,utRho09
accB,6810280,6810872,6810280,592,8024,utRho09
accD,4868030,4868030,4867852,178,1046,utRho09
aceB,8430804,8430956,8430804,152,4,utRho09
aceE,245938,246034,245938,96,166,utRho09
ackA,4826918,4826940,4826918,22,2822,utRho09
acnA,2670848,2671662,2670848,814,836,utRho09
acnB,263038,263230,263038,192,752,utRho09
acpP,2303148,2303230,2303148,82,722,utRho09
acpS,5402324,5402324,5401996,328,446,utRho09
acrA,971396,971396,971238,158,426,utRho09
acrB,969370,969370,968806,564,2812,utRho09
acrD,5174950,5175190,5174950,240,6,utRho09
acrE,6827404,6827728,6827404,324,0,utRho09
acrR,971398,971522,971398,124,180,utRho09
acrZ,1589502,1589546,1589502,44,34,utRho09
acs,8575190,8575190,8574742,448,16,utRho09
actP,8569870,8569870,8569804,66,0,utRho09
ada,4620854,4620854,4620810,44,0,utRho09
add,3404404,3404466,3404404,62,82,utRho09
ade,7687802,7687928,7687802,126,52,utRho09
adhE,2596826,2596826,2596242,584,172,utRho09
adhP,3107988,3107988,3107676,312,970,utRho09
adiA,8681112,8681112,8681042,70,50,utRho09
adiC,8674404,8674404,8674062,342,2,utRho09
adiY,8676084,8676084,8675858,226,0,utRho09
adk,994278,994350,994278,72,30,utRho09
adrA,807374,807406,807374,32,0,utRho09
aer,6438240,6438240,6438152,88,72,utRho09
aes,1000102,1000102,999946,156,58,utRho09
agaR,6557406,6557406,6557330,76,0,utRho09
agaS,6563778,6563952,6563778,174,0,utRho09
agp,2131118,2131170,2131118,52,0,utRho09
agrA,7296126,7296126,7296126,0,0,utRho09
agrB,7296588,7296588,7296588,0,0,utRho09
ahpC,1277386,1277890,1277386,504,758,utRho09
ahpF,1278004,1279506,1278004,1502,79074,utRho09
ahr,8992698,8992698,8992418,280,0,utRho09
aidB,8828494,8828550,8828494,56,0,utRho09
ais,4731512,4731512,4731240,272,2,utRho09
alaA,4814816,4815122,4814816,306,114,utRho09
alaC,4996798,4996798,4996590,208,0,utRho09
alaE,5598140,5598328,5598140,188,34,utRho09
alaS,5644180,5644180,5644022,158,2848,utRho09
alaW,5036612,5036612,5036462,150,0,utRho09
aldA,2976380,2976464,2976380,84,384,utRho09
aldB,7513070,7513070,7513022,48,0,utRho09
alkA,4295118,4295118,4295080,38,44,utRho09
alkB,4618890,4618890,4618682,208,0,utRho09
allA,1064780,1064902,1064780,122,0,utRho09
allD,1092822,1092822,1092726,96,0,utRho09
allE,1088112,1088112,1088092,20,72,utRho09
allS,1064600,1064600,1064442,158,2,utRho09
alr,8531178,8531564,8531178,386,2290,utRho09
alsE,8617334,8617334,8616956,378,132,utRho09
alsK,8615990,8615990,8615598,392,0,utRho09
alx,6476740,6477160,6476740,420,4,utRho09
amiA,5104482,5104704,5104482,222,4,utRho09
amiC,5898378,5898378,5898020,358,2,utRho09
amn,4110062,4110122,4110062,60,0,utRho09
ampC,8758006,8758006,8757888,118,0,utRho09
ampD,237362,237466,237362,104,98,utRho09
ampG,907372,907372,907090,282,548,utRho09
ampH,792726,792726,792574,152,56,utRho09
amyA,4012230,4012312,4012230,82,0,utRho09
anmK,3439346,3439346,3439204,142,0,utRho09
ansB,6201580,6201580,6201456,124,8,utRho09
ansP,3052040,3052040,3051960,80,16,utRho09
apaG,104068,104068,103212,856,6018,utRho09
apaH,102586,102586,102444,142,5282,utRho09
apbE,4623188,4623188,4623068,120,0,utRho09
appA,2081198,2081234,2081198,36,32,utRho09
appC,2075420,2075480,2075420,60,0,utRho09
appY,1167134,1167362,1167134,228,0,utRho09
apt,982620,982824,982620,204,274,utRho09
aqpZ,1832424,1832424,1832094,330,6,utRho09
araB,140150,140150,140096,54,0,utRho09
araC,140482,140774,140482,292,2,utRho09
araE,5964416,5964416,5964364,52,0,utRho09
araF,3972476,3972476,3972256,220,54,utRho09
araH,3967120,3967120,3967086,34,0,utRho09
araJ,825058,825058,824962,96,12,utRho09
arcA,9281602,9281602,9280612,990,4828,utRho09
arcB,6706098,6706098,6706050,48,2,utRho09
arcZ,6701154,6701154,6701154,0,0,utRho09
arfA,6877346,6877346,6877298,48,2,utRho09
argA,5898312,5898484,5898312,172,0,utRho09
argC,8309770,8310002,8309770,232,22,utRho09
argD,6980442,6980442,6980360,82,2,utRho09
argE,8310156,8310156,8309694,462,76,utRho09
argF,580680,580680,580610,70,0,utRho09
argG,6637124,6637274,6637124,150,0,utRho09
argI,8956688,8956688,8956622,66,0,utRho09
argO,6137672,6137672,6137616,56,26,utRho09
argP,6119460,6119506,6119460,46,0,utRho09
argR,6769204,6769406,6769204,202,58,utRho09
argS,3920002,3920124,3920002,122,0,utRho09
argT,4855698,4855698,4855582,116,0,utRho09
argU,1129406,1129446,1129406,40,0,utRho09
argW,4932616,4932618,4932616,2,0,utRho09
argX,7964728,7964750,7964728,22,4,utRho09
aroF,5482402,5482402,5482300,102,0,utRho09
aroG,1571182,1571266,1571182,84,78,utRho09
aroH,3576636,3576870,3576636,234,570,utRho09
aroK,7038760,7038760,7038128,632,1906,utRho09
aroL,812560,812810,812560,250,48,utRho09
aroP,243342,243342,243102,240,0,utRho09
arpA,8445382,8445382,8444974,408,44,utRho09
arrS,7316108,7316108,7316108,0,0,utRho09
arsR,7297024,7297056,7297024,32,0,utRho09
artJ,1801252,1801252,1801150,102,0,utRho09
artP,1807686,1807686,1807468,218,8,utRho09
ascF,5678858,5679048,5678858,190,0,utRho09
ascG,5678574,5678574,5678528,46,0,utRho09
aslB,7965562,7965916,7965562,354,1480,utRho09
asnA,7854258,7854310,7854258,52,0,utRho09
asnB,1398444,1398444,1398354,90,40,utRho09
asnC,23562186,23562186,23562018,168,6,utRho09
asnS,1978088,1978088,1977970,118,10814,utRho09
asnT,4089082,4089098,4089082,16,218,utRho09
asnU,4119690,4119702,4119690,12,0,utRho09
asnV,4124504,4124520,4124504,16,0,utRho09
aspA,17473728,17473728,17473308,420,56,utRho09
aspC,1971486,1971486,1971418,68,508,utRho09
aspS,3901402,3901402,3901044,358,32,utRho09
aspT,7893560,7893744,7893560,184,132274,utRho09
aspV,473826,473862,473826,36,42,utRho09
asr,3342654,3342752,3342654,98,0,utRho09
astC,3664088,3664088,3663964,124,0,utRho09
astE,3654138,3654138,3653846,292,2,utRho09
atoD,4646824,4646894,4646824,70,16,utRho09
atpB,7844540,7844540,7844102,438,616,utRho09
atpC,7832118,7832118,7831944,174,2826,utRho09
atpI,7845050,7845050,7844880,170,42,utRho09
avtA,7479348,7479410,7479348,62,52,utRho09
azoR,2965982,2965982,2965720,262,58,utRho09
azuC,3976002,3976002,3975918,84,0,utRho09
bacA,6408350,6408350,6408262,88,76,utRho09
bamA,394052,395856,394052,1804,1360,utRho09
bamB,5277950,5277950,5277304,646,1444,utRho09
bamC,5198028,5198028,5197730,298,1364,utRho09
bamD,5471922,5472292,5471922,370,8354,utRho09
bamE,5506972,5507210,5506972,238,288,utRho09
basS,8666954,8666954,8666544,410,230,utRho09
bax,7474468,7474468,7474354,114,2,utRho09
bcp,5200874,5200956,5200874,82,2828,utRho09
bcsB,7385346,7385346,7385214,132,0,utRho09
bcsE,7392644,7392916,7392644,272,0,utRho09
bdcA,8948128,8948128,8948106,22,10,utRho09
bdcR,8948192,8948248,8948192,56,0,utRho09
bdm,3112680,3112680,3112560,120,0,utRho09
betA,654522,654522,654494,28,612,utRho09
betI,658722,658722,658668,54,0,utRho09
betT,658842,658926,658842,84,0,utRho09
bfr,6933498,6933498,6933450,48,0,utRho09
bglG,23440182,23440182,23439402,780,0,utRho09
bglX,4444240,4444240,4443978,262,0,utRho09
bhsA,2337962,2338146,2337962,184,0,utRho09
bioA,1618584,1618584,1618514,70,10,utRho09
bioB,1618604,1618688,1618604,84,0,utRho09
bioH,7089716,7089716,7089688,28,0,utRho09
bisC,7433026,7433026,7432788,238,2,utRho09
blc,8755490,8755490,8755444,46,0,utRho09
blr,3409024,3409102,3409024,78,28,utRho09
bluF,2431226,2431226,2430950,276,602,utRho09
bluR,2428226,2428226,2428118,108,34,utRho09
bolA,908698,908944,908698,246,0,utRho09
borD,1157842,1157842,1157786,56,0,utRho09
brnQ,838976,839182,838976,206,938,utRho09
bssR,1756492,1756496,1756492,4,0,utRho09
bssS,2242116,2242116,2241910,206,104,utRho09
btuB,8326798,8327278,8326798,480,4456,utRho09
cadB,8720212,8720212,8720062,150,0,utRho09
cadC,8723926,8723926,8723868,58,0,utRho09
caiE,70998,70998,70742,256,0,utRho09
caiF,68436,68600,68436,164,10,utRho09
caiT,84074,84074,83862,212,0,utRho09
can,285406,285406,285340,66,34,utRho09
carA,59102,59302,59102,200,2,utRho09
carB,61550,61634,61550,84,262,utRho09
cas2,5757830,5757830,5757706,124,4,utRho09
casA,5768638,5768638,5768276,362,2,utRho09
cbl,4121882,4121882,4121828,54,2,utRho09
cbpA,2128074,2128074,2127550,524,22,utRho09
cbrA,7738628,7738754,7738628,126,0,utRho09
cbrB,7794958,7795012,7794958,54,48,utRho09
ccmH,4585242,4585242,4584820,422,0,utRho09
cdaR,364894,364926,364894,32,0,utRho09
cdd,4463638,4463688,4463638,50,108,utRho09
cdh,8219814,8219860,8219814,46,4,utRho09
cdsA,391110,391354,391110,244,1838,utRho09
cedA,3627484,3627484,3627326,158,22,utRho09
cfa,3482402,3482826,3482402,424,132,utRho09
chaC,2544844,2544972,2544844,128,38,utRho09
chbB,3643452,3643452,3643238,214,0,utRho09
chbG,3634624,3634624,3634270,354,0,utRho09
cheW,3946924,3946924,3946678,246,2286,utRho09
chiA,6939792,6939792,6939706,86,4,utRho09
chiP,1416472,1416668,1416472,196,0,utRho09
cho,3646984,3647030,3646984,46,0,utRho09
chpS,8896804,8896894,8896804,90,0,utRho09
cirA,4493884,4493884,4493538,346,62,utRho09
citC,1304078,1304078,1303712,366,0,utRho09
citT,1293264,1293264,1293160,104,4,utRho09
clcA,350104,350214,350104,110,36,utRho09
clpA,1846160,1846528,1846160,368,4,utRho09
clpB,5468410,5468410,5468346,64,30,utRho09
clpP,913154,913354,913154,200,592,utRho09
clpS,1845500,1845826,1845500,326,2,utRho09
clpX,914404,914852,914404,448,1860,utRho09
clsA,2617346,2617346,2617290,56,2,utRho09
clsC,2212584,2212710,2212584,126,780,utRho09
cmk,1922330,1922402,1922330,72,46,utRho09
cnu,3409522,3409898,3409522,376,664,utRho09
coaA,8350214,8350214,8350052,162,496,utRho09
cobC,1340092,1340092,1339814,278,302,utRho09
cobT,4129202,4129202,4128934,268,70,utRho09
cobU,4131944,4131944,4131528,416,204,utRho09
codB,709768,709844,709768,76,42,utRho09
comR,2337726,2337726,2337664,62,0,utRho09
copA,1022822,1022822,1022758,64,0,utRho09
corA,8002388,8002852,8002388,464,8572,utRho09
cpdB,8873258,8873258,8873130,128,126,utRho09
cptB,6082198,6082198,6082140,58,32,utRho09
cpxA,8210202,8210202,8209950,252,188,utRho09
cpxP,8211570,8211640,8211570,70,80,utRho09
cpxR,8211372,8211372,8211340,32,0,utRho09
cra,175894,176056,175894,162,4,utRho09
crcB,1316016,1316016,1315876,140,0,utRho09
creA,9270486,9271042,9270486,556,278,utRho09
creD,9276320,9276356,9276320,36,64,utRho09
crl,515620,515658,515620,38,614,utRho09
crp,6971906,6972240,6971906,334,4180,utRho09
crr,5070960,5071668,5070960,708,4924,utRho09
csdA,5886414,5886674,5886414,260,0,utRho09
csgB,2207718,2207902,2207718,184,0,utRho09
csgD,2206688,2206688,2206392,296,4,utRho09
csgG,2203510,2203510,2203368,142,64,utRho09
csiD,5577854,5577970,5577854,116,0,utRho09
csiE,5330802,5330870,5330802,68,0,utRho09
csiR,5590942,5591348,5590942,406,0,utRho09
cspA,7439778,7440098,7439778,320,53992,utRho09
cspB,3283430,3283430,3283108,322,22,utRho09
cspC,3815018,3815018,3814870,148,426,utRho09
cspD,1845352,1845352,1845180,172,1774,utRho09
cspE,1314294,1314584,1314294,290,36,utRho09
cspF,3283380,3283710,3283380,330,60,utRho09
cspG,2102610,2102922,2102610,312,1266,utRho09
cspH,2102746,2102746,2102350,396,42,utRho09
cspI,3277624,3277624,3277334,290,40,utRho09
csrA,5638746,5638746,5638292,454,886,utRho09
csrB,5849048,5849048,5849048,0,0,utRho09
csrC,8102072,8102072,8102072,0,0,utRho09
csrD,6806850,6806850,6806664,186,66,utRho09
cstA,1259710,1259788,1259710,78,30,utRho09
cueO,274090,274166,274090,76,38,utRho09
cueR,1027948,1027986,1027948,38,0,utRho09
curA,3037784,3038054,3037784,270,0,utRho09
cusC,1191146,1191200,1191146,54,0,utRho09
cusR,1190924,1190924,1190886,38,0,utRho09
cutA,8730784,8730784,8730712,72,88,utRho09
cutC,3918534,3918534,3917920,614,308,utRho09
cvpA,4861600,4861600,4861526,74,32,utRho09
cvrA,2484328,2484328,2484142,186,84,utRho09
cyaA,7981548,7982306,7981548,758,444,utRho09
cyaR,4334228,4334224,4334228,4,42,utRho09
cyaY,7988166,7988166,7988118,48,20,utRho09
cybB,2981522,2981804,2981522,282,148,utRho09
cycA,8859560,8859728,8859560,168,240,utRho09
cydA,1542340,1542916,1542340,576,134,utRho09
cydC,1858800,1858800,1858390,410,0,utRho09
cydD,1862062,1862062,1861924,138,102,utRho09
cydX,1548300,1548392,1548300,92,292,utRho09
cynR,717418,717418,717380,38,0,utRho09
cynT,1435092,1435196,1435092,104,0,utRho09
cyoA,903306,903306,903220,86,3112,utRho09
cyoE,895540,895540,895410,130,1086,utRho09
cysB,2667576,2667710,2667576,134,326,utRho09
cysC,5748056,5748056,5747984,72,0,utRho09
cysD,5752736,5752736,5752658,78,0,utRho09
cysE,7565362,7565362,7565124,238,700,utRho09
cysG,6995508,6995656,6995508,148,36,utRho09
cysJ,5783928,5783928,5783796,132,736,utRho09
cysK,5064688,5064818,5064688,130,0,utRho09
cysP,5087114,5087114,5087056,58,2,utRho09
cysS,1109154,1109222,1109154,68,170,utRho09
cysT,3984100,3984100,3983974,126,114,utRho09
cysZ,5062766,5062926,5062766,160,70,utRho09
cytR,8249018,8249018,8248912,106,8,utRho09
dacA,1328002,1328002,1327926,76,34,utRho09
dacB,6657714,6657926,6657714,212,0,utRho09
dacC,1761306,1761454,1761306,148,2,utRho09
dadA,2475018,2475142,2475018,124,22,utRho09
dam,7032504,7032504,7031826,678,1824,utRho09
damX,7035200,7035200,7034612,588,280,utRho09
dapA,5199568,5199568,5199520,48,0,utRho09
dapB,56576,56748,56576,172,148,utRho09
dapD,371954,371954,371894,60,186,utRho09
dapE,5183120,5183214,5183120,94,490,utRho09
dcp,3254844,3254844,3254760,84,48,utRho09
dcrB,7219534,7219910,7219534,376,6,utRho09
dctA,7366996,7366996,7366894,102,570,utRho09
dcuA,8733686,8733686,8733546,140,6,utRho09
dcuB,8698182,8698182,8697488,694,216,utRho09
dcuC,1312166,1312166,1311936,230,0,utRho09
dcuD,6749166,6749738,6749166,572,48,utRho09
dcuR,8701130,8701130,8700068,1062,590,utRho09
dcuS,8703370,8703370,8703324,46,0,utRho09
dcyD,3999016,3999016,3998960,56,0,utRho09
ddpX,3126498,3126498,3126152,346,0,utRho09
deaD,6615818,6615818,6615720,98,1940,utRho09
dedA,4869880,4869880,4869482,398,13714,utRho09
dedD,4863750,4863750,4863368,382,124,utRho09
def,6867300,6867380,6867300,80,0,utRho09
degP,361690,361768,361690,78,0,utRho09
degQ,6761308,6761486,6761308,178,816,utRho09
deoB,9239134,9239206,9239134,72,0,utRho09
deoC,9233358,9234646,9233358,1288,70,utRho09
dfp,7625406,7625462,7625406,56,62,utRho09
dgcZ,3247758,3247758,3247700,58,2,utRho09
dgkA,8512914,8513274,8512914,360,366,utRho09
dgt,358392,358474,358392,82,22,utRho09
dhaK,2501888,2501888,2501676,212,596,utRho09
dhaR,2502006,2502132,2502006,126,54,utRho09
dicB,3299194,3299218,3299194,24,0,utRho09
dicC,3295752,3295752,3295700,52,0,utRho09
dinB,501760,501796,501760,36,0,utRho09
dinD,7635398,7635520,7635398,122,152,utRho09
dinG,1666146,1666140,1666146,6,12,utRho09
dinI,2243018,2243018,2242974,44,50,utRho09
dinJ,493230,493230,493004,226,22,utRho09
dinQ,7295964,7295964,7295576,388,996,utRho09
djlA,114536,114728,114536,192,2,utRho09
dkgA,6313142,6313246,6313142,104,10,utRho09
dkgB,458196,458334,458196,138,2,utRho09
dksA,321502,321502,321208,294,1042,utRho09
dld,4444164,4444370,4444164,206,0,utRho09
dmlA,3763424,3763824,3763424,400,64,utRho09
dmlR,3763710,3763710,3763618,92,28,utRho09
dmsA,1881646,1881918,1881646,272,0,utRho09
dnaA,7767922,7767922,7767458,464,1000,utRho09
dnaB,8528566,8528628,8528566,62,112,utRho09
dnaK,24096,24326,24096,230,398,utRho09
dnaN,7765466,7765466,7764642,824,910,utRho09
dnaQ,471868,472134,471868,266,368,utRho09
dnaT,18406460,18406460,18406068,392,48,utRho09
dnaX,984112,984184,984112,72,160,utRho09
dosP,3131486,3131486,3131466,20,0,utRho09
dpiB,1303968,1304470,1303968,502,4,utRho09
dppA,7415740,7415740,7415410,330,2076,utRho09
dps,1697900,1697900,1697822,78,0,utRho09
dsbA,8086754,8086836,8086754,82,2180,utRho09
dsbB,2466294,2466294,2466060,234,0,utRho09
dsbC,6079266,6079266,6077644,1622,938,utRho09
dsbG,1277600,1277600,1277146,454,424,utRho09
dsdA,4958242,4958404,4958242,162,40,utRho09
dsdC,4955492,4955492,4955258,234,0,utRho09
dsdX,4955642,4955694,4955642,52,2,utRho09
dsrA,4050626,4050626,4050626,0,0,utRho09
dsrB,4049686,4049686,4049646,40,0,utRho09
dtpD,1485340,1485340,1485112,228,30,utRho09
dusA,8523200,8523338,8523200,138,1420,utRho09
dusB,6820492,6820560,6820492,68,186,utRho09
dusC,4460790,4460790,4460770,20,0,utRho09
dut,7627704,7627864,7627704,160,2000,utRho09
dxr,386670,387042,386670,372,1114,utRho09
ebgA,6445102,6445266,6445102,164,92,utRho09
ebgR,6442874,6442932,6442874,58,116,utRho09
ecnB,8753018,8753106,8753018,88,142,utRho09
eco,4607594,4607810,4607594,216,12,utRho09
ecpA,621594,621594,621342,252,0,utRho09
ecpB,620238,620238,620052,186,18,utRho09
ecpR,622964,622964,622672,292,0,utRho09
eda,3866218,3866218,3865512,706,20,utRho09
edd,3869426,3869426,3869208,218,0,utRho09
efeO,2164308,2164486,2164308,178,0,utRho09
efeU_1,2162614,2162712,2162614,98,2,utRho09
efp,8751134,8751398,8751134,264,2604,utRho09
elaA,4763372,4763372,4763086,286,108,utRho09
elaD,4765308,4765426,4765308,118,0,utRho09
elfA,1995530,1995736,1995530,206,0,utRho09
elfD,1996642,1996980,1996642,338,44,utRho09
emrD,7707690,7707844,7707690,154,20,utRho09
emrK,4966896,4966896,4966678,218,0,utRho09
emrY,4964668,4964668,4964352,316,48,utRho09
emtA,2486250,2486360,2486250,110,0,utRho09
endA,12361100,12361388,12361100,288,4,utRho09
eno,5817692,5817692,5815882,1810,4744,utRho09
entC,1249662,1249770,1249662,108,0,utRho09
entD,1220508,1220508,1220158,350,4,utRho09
entH,1258584,1258600,1258584,16,22,utRho09
entS,1244506,1244600,1244506,94,0,utRho09
envR,6827266,6827266,6826930,336,0,utRho09
epd,12295292,12295292,12294764,528,0,utRho09
epmA,8765236,8765286,8765236,50,0,utRho09
epmB,8751406,8751406,8751314,92,1386,utRho09
eptB,7421162,7421162,7420950,212,120,utRho09
eptC,8300622,8300622,8300530,92,196,utRho09
erfK,4126708,4126708,4126646,62,82,utRho09
erpA,353122,353220,353122,98,60,utRho09
esrE,8039956,8039956,8039956,0,0,utRho09
essD,1153746,1154796,1153746,1050,34,utRho09
etk,2088606,2088606,2088420,186,0,utRho09
evgA,4967262,4967510,4967262,248,106,utRho09
exbB,6304028,6304028,6303968,60,2,utRho09
exbD,6302780,6302780,6302486,294,40,utRho09
exuR,6493016,6493304,6493016,288,142,utRho09
exuT,6490004,6490208,6490004,204,0,utRho09
fabA,2032996,2032996,2032940,56,240,utRho09
fabB,4883282,4883282,4883210,72,30,utRho09
fabH,2297032,2297518,2297032,486,2368,utRho09
fabI,2702236,2702236,2702078,158,190,utRho09
fadB,8062026,8062026,8061942,84,0,utRho09
fadD,3779614,3779614,3779492,122,44,utRho09
fadE,486812,486812,486606,206,0,utRho09
fadH,6463248,6463330,6463248,82,0,utRho09
fadI,4921022,4921022,4920938,84,6,utRho09
fadL,4922410,4922600,4922410,190,124,utRho09
fadM,928720,928804,928720,84,0,utRho09
fadR,2469810,2469876,2469810,66,0,utRho09
fbaB,4357334,4357334,4357128,206,0,utRho09
fdhE,8162722,8162722,8162456,266,1756,utRho09
fdhF,8598814,8598814,8598732,82,0,utRho09
fdnG,3094744,3094802,3094744,58,0,utRho09
fdrA,1093012,1093360,1093012,348,0,utRho09
feaB,2894994,2895038,2894994,44,0,utRho09
feaR,2894734,2894734,2894566,168,0,utRho09
fecA,9033454,9033454,9033354,100,8,utRho09
fecE,9023288,9023288,9022914,374,4550,utRho09
fecI,9036564,9036564,9036470,94,2,utRho09
feoA,7080114,7080326,7080114,212,6,utRho09
fepA,1225334,1225334,1224988,346,0,utRho09
fepB,1249454,1249454,1249020,434,0,utRho09
fepD,1244468,1244468,1244378,90,0,utRho09
fes,1225374,1225630,1225374,256,42,utRho09
ffh,5495706,5495706,5495590,116,938,utRho09
ffs,952576,952848,952576,272,8,utRho09
fhuA,334884,334968,334884,84,40,utRho09
fhuE,2323294,2323294,2323102,192,4,utRho09
fhuF,9211504,9211504,9211326,178,212,utRho09
fic,6983296,6983296,6982926,370,656,utRho09
fieF,8212864,8212938,8212864,74,2,utRho09
fimA,9085388,9086230,9085388,842,168,utRho09
fimB,9081334,9081914,9081334,580,470,utRho09
fimE,9083742,9084074,9083742,332,6,utRho09
fimZ,1129214,1129214,1128960,254,2,utRho09
fiu,1683296,1683296,1683062,234,2,utRho09
fixA,84650,84806,84650,156,0,utRho09
fkpA,6955050,6955050,6954838,212,12500,utRho09
fldA,2846084,2846084,2845860,224,3592,utRho09
fldB,6079644,6079710,6079644,66,116,utRho09
flgA,2261770,2261770,2261726,44,2,utRho09
flgB,2261986,2262036,2261986,50,30,utRho09
flgK,2276702,2276756,2276702,54,870,utRho09
flgM,2260330,2260330,2260256,74,480,utRho09
flgN,2259828,2259828,2259660,168,78,utRho09
flhB,3932432,3932432,3932382,50,538,utRho09
flhC,3955864,3955864,3955688,176,66,utRho09
flhD,3957154,3957154,3956394,760,144,utRho09
fliA,4003638,4003638,4003578,60,122,utRho09
fliC,4007352,4007352,4007212,140,1508,utRho09
fliD,4007634,4007744,4007634,110,352,utRho09
fliE,4026186,4026186,4026028,158,0,utRho09
fliF,4026292,4026458,4026292,166,372,utRho09
fliL,4039168,4039236,4039168,68,160,utRho09
flk,4875824,4875900,4875824,76,0,utRho09
flu,4142634,4143078,4142634,444,2,utRho09
flxA,3292776,3292810,3292776,34,58,utRho09
fnr,2799104,2799104,2799052,52,68,utRho09
fnrS,2818258,2818258,2818258,0,0,utRho09
focA,1909628,1909628,1908932,696,442,utRho09
folA,99598,99646,99598,48,0,utRho09
folB,6409296,6409296,6409178,118,12,utRho09
folD,1115562,1115562,1115482,80,242,utRho09
folE,4487696,4487696,4487304,392,3262,utRho09
fpr,8228998,8228998,8228944,54,4,utRho09
frc,4986878,4986878,4986508,370,4,utRho09
frdA,8764824,8764824,8764636,188,180,utRho09
frdD,8758948,8758948,8758732,216,818,utRho09
fre,8052886,8053054,8052886,168,1564,utRho09
frlA,6999518,6999820,6999518,302,4,utRho09
frr,385624,385744,385624,120,1570,utRho09
frsA,513004,513054,513004,50,98,utRho09
fruB,4527194,4527194,4526990,204,4,utRho09
frvR,8179804,8179804,8179710,94,0,utRho09
fryA,5008986,5008986,5008970,16,2,utRho09
fsaA,1727060,1727284,1727060,224,2,utRho09
fsr,1009710,1009710,1009392,318,32,utRho09
ftnA,3977364,3977432,3977364,68,14,utRho09
ftnB,3973550,3973850,3973550,300,124,utRho09
ftsA,207122,207964,207122,842,1188,utRho09
ftsB,5745802,5745802,5745640,162,48,utRho09
ftsH,6654204,6654204,6653870,334,588,utRho09
ftsK,1865858,1866448,1865858,590,2338,utRho09
ftsL,181376,182064,181376,688,2340,utRho09
ftsP,6325732,6325732,6325338,394,414,utRho09
ftsQ,205484,206310,205484,826,524,utRho09
ftsX,7204512,7204512,7204172,340,342,utRho09
ftsZ,209272,210610,209272,1338,98,utRho09
fucA,5867708,5867708,5867376,332,24,utRho09
fucP,5868238,5868470,5868238,232,4,utRho09
fumA,6753760,6753760,6753508,252,4720,utRho09
fumB,8694696,8694696,8694652,44,0,utRho09
fumC,3373418,3373418,3373176,242,0,utRho09
fur,2842892,2842892,2842584,308,7876,utRho09
fusA,6947370,6947370,6947028,342,40118,utRho09
fxsA,8737206,8737328,8737206,122,42,utRho09
gabD,5581824,5582546,5581824,722,820,utRho09
gadA,7335214,7335214,7335160,54,0,utRho09
gadB,3144144,3144144,3144090,54,0,utRho09
gadC,3141168,3141168,3140978,190,4,utRho09
gadE,7315600,7316732,7315600,1132,2,utRho09
gadW,7329562,7329562,7329236,326,2,utRho09
gadX,14663356,14663356,14663240,116,0,utRho09
gadY,7329728,7329728,7329728,0,0,utRho09
galE,1584354,1584354,1584110,244,2,utRho09
galF,4228702,4228702,4228654,48,2,utRho09
galM,1577796,1577796,1577674,122,614,utRho09
galP,6176510,6176568,6176510,58,4,utRho09
galR,5953138,5953198,5953138,60,108,utRho09
galS,4483420,4483420,4483336,84,0,utRho09
galU,2582810,2582914,2582810,104,444,utRho09
gapA,3724480,3725542,3724480,1062,6048,utRho09
garP,6549868,6549868,6549814,54,82,utRho09
gatY,4354468,4354468,4354408,60,38,utRho09
gatZ,4352864,4352864,4352642,222,16972,utRho09
gcd,282558,282558,282450,108,0,utRho09
gcl,1067814,1067832,1067814,18,0,utRho09
gcvA,5885278,5885278,5885134,144,0,utRho09
gcvB,5885392,5885392,5885392,0,0,utRho09
gcvR,5199758,5199812,5199758,54,36,utRho09
gcvT,6101544,6101544,6101334,210,1488,utRho09
gdhA,3684616,3684742,3684616,126,0,utRho09
gfcA,2099668,2099668,2099488,180,20,utRho09
gfcD,2096236,2096236,2095890,346,34,utRho09
ghrA,2195648,2195772,2195648,124,2,utRho09
ghrB,7434378,7434620,7434378,242,456,utRho09
glcA,6242728,6242728,6242558,170,118,utRho09
glcC,6256412,6256544,6256412,132,2,utRho09
glcD,6256152,6256152,6256042,110,0,utRho09
gldA,8278092,8278092,8278070,22,10,utRho09
glgA,7136784,7136784,7136066,718,302,utRho09
glgB,7147314,7147314,7147004,310,112,utRho09
glgC,7139142,7139142,7138656,486,706,utRho09
glgP,7133546,7133546,7133162,384,6,utRho09
glgS,6384024,6384024,6383878,146,4,utRho09
glgX,7142838,7142838,7142638,200,0,utRho09
glk,5018922,5018922,5018852,70,18,utRho09
glmS,7827622,7827622,7827336,286,6924,utRho09
glmU,7830652,7830652,7830400,252,106,utRho09
glmY,10765360,10765360,10765360,0,0,utRho09
glmZ,7972864,7972864,7972864,0,0,utRho09
glnA,16232888,16232888,16232136,752,1156,utRho09
glnB,5375052,5375052,5374816,236,246,utRho09
glnD,377310,377310,377300,10,2,utRho09
glnE,6399602,6399602,6399282,320,60,utRho09
glnH,1696396,1696396,1696008,388,14,utRho09
glnK,945112,945196,945112,84,4,utRho09
glnL,8112742,8112742,8112678,64,0,utRho09
glnQ,1693262,1693262,1692926,336,558,utRho09
glnS,1411998,1412186,1411998,188,1022,utRho09
gloA,3455602,3455674,3455602,72,72,utRho09
gloB,469852,469852,469564,288,514,utRho09
glpA,4705166,4705294,4705166,128,0,utRho09
glpD,7123942,7124026,7123942,84,32,utRho09
glpE,7123698,7123698,7123646,52,40,utRho09
glpF,8236322,8236322,8236180,142,254,utRho09
glpG,7122960,7122960,7122904,56,344,utRho09
glpR,7121782,7121782,7121210,572,196,utRho09
glpT,4704902,4704902,4704748,154,164,utRho09
glpX,8231212,8231212,8231158,54,3776,utRho09
glrK,5382246,5382246,5382196,50,132,utRho09
gltA,1509534,1509534,1508936,598,12986,utRho09
gltB,6709018,6709264,6709018,246,48,utRho09
gltI,1375792,1375792,1375494,298,2042,utRho09
gltP,8588536,8588962,8588536,426,808,utRho09
gltS,7657382,7657382,7657330,52,418,utRho09
gltX,5041568,5041568,5041344,224,114,utRho09
gluQ,320286,320286,320224,62,100,utRho09
glyA,5371148,5371148,5371014,134,192,utRho09
glyQ,7450708,7450708,7450636,72,200,utRho09
glyS,7448990,7448990,7448794,196,5264,utRho09
glyU,5998128,5998128,5998114,14,38,utRho09
glyV,8784626,8784720,8784626,94,44,utRho09
glyW,3984360,3984360,3984234,126,0,utRho09
gmhB,445612,445666,445612,54,0,utRho09
gmk,7642776,7642856,7642776,80,36,utRho09
gmr,2693686,2693686,2693484,202,52,utRho09
gnd,4202648,4202648,4202536,112,856,utRho09
gnsB,3275692,3275692,3275564,128,0,utRho09
gntK,14310580,14310580,14310368,212,148,utRho09
gntP,9102668,9102668,9102592,76,4,utRho09
gntR,7157760,7157760,7157452,308,540,utRho09
gntT,7092810,7093118,7092810,308,106,utRho09
gntU,7154170,7154170,7154122,48,2,utRho09
gntX,7089334,7089764,7089334,430,0,utRho09
gor,7292224,7292598,7292224,374,1308,utRho09
gpmA,1575340,1575340,1575190,150,0,utRho09
gpmM,7570374,7570520,7570374,146,0,utRho09
gpsA,7567620,7567620,7567322,298,17134,utRho09
gpt,511828,511954,511828,126,1496,utRho09
grcA,5433046,5433046,5432898,148,2,utRho09
greA,6657728,6657728,6657430,298,2314,utRho09
greB,7073488,7073624,7073488,136,0,utRho09
groL,8741566,8742050,8741566,484,1758,utRho09
groS,8741232,8741376,8741232,144,1594,utRho09
grpE,5501494,5501494,5501416,78,128,utRho09
grxA,1781552,1781552,1781506,46,0,utRho09
grxB,2248206,2248206,2248108,98,80,utRho09
grxC,7569152,7569152,7568884,268,10296,utRho09
grxD,3468324,3468324,3468202,122,17370,utRho09
gspA,6911268,6911268,6910796,472,2,utRho09
gspC,6910964,6911156,6910964,192,0,utRho09
gss,6277220,6277220,6277044,176,104,utRho09
gstA,3428654,3428754,3428654,100,0,utRho09
gstB,1761038,1761038,1760960,78,0,utRho09
guaB,5268214,5268214,5268140,74,348,utRho09
gudD,5839026,5839026,5838770,256,2,utRho09
gyrA,4678914,4678914,4678840,74,60,utRho09
gyrB,7760300,7760300,7760238,62,236,utRho09
hcaE,5337964,5338064,5337964,100,8,utRho09
hcaR,5337928,5337928,5337792,136,2,utRho09
hcaT,5336106,5336106,5335692,414,36,utRho09
hchA,4071260,4071670,4071260,410,0,utRho09
hcp,1828258,1828258,1827628,630,64,utRho09
hcr,1824400,1824400,1824300,100,0,utRho09
hdeA,7313582,7313582,7313480,102,0,utRho09
hdeD,7313920,7313990,7313920,70,12,utRho09
hdfR,7896320,7896320,7895934,386,2,utRho09
hdhA,3396244,3396244,3396080,164,14,utRho09
helD,2048876,2048942,2048876,66,0,utRho09
hemA,2527166,2527428,2527166,262,64,utRho09
hemB,779722,779722,779454,268,6,utRho09
hemF,5106410,5106450,5106410,40,22,utRho09
hemH,996062,996110,996062,48,2,utRho09
hemL,349882,349882,349764,118,84,utRho09
hemN,8103886,8104090,8103886,204,2,utRho09
hepA,127176,127176,126528,648,1380,utRho09
hflD,2385372,2385372,2385262,110,568,utRho09
hfq,8799602,8800576,8799602,974,2926,utRho09
hha,961006,961006,960616,390,144,utRho09
hicA,3018442,3018572,3018442,130,0,utRho09
higA,6468682,6468682,6468288,394,106,utRho09
higB,6468960,6468960,6468910,50,4,utRho09
hinT,2323642,2323770,2323642,128,0,utRho09
hipB,3184964,3184964,3184884,80,0,utRho09
hisB,4186720,4186936,4186720,216,854,utRho09
hisJ,4853674,4853674,4853576,98,14,utRho09
hisL,8359856,8359984,8359856,128,220,utRho09
hisS,5281284,5281284,5281150,134,430,utRho09
hlpA,400910,400964,400910,54,28,utRho09
hlyE,2460932,2460932,2460788,144,2,utRho09
hmp,5371594,5371670,5371594,76,0,utRho09
hns,2585916,2585916,2585844,72,2274,utRho09
hofM,7045856,7045856,7045502,354,6,utRho09
hokA,7441620,7441620,7441200,420,248,utRho09
hokC,33902,33902,33806,96,302,utRho09
hokE,1215462,1215672,1215462,210,0,utRho09
holC,8968546,8968546,8968560,14,816,utRho09
holD,9215562,9215606,9215562,44,2,utRho09
holE,3850040,3850216,3850040,176,280,utRho09
hpt,282720,282862,282720,142,120,utRho09
hrpB,324150,324210,324150,60,20,utRho09
hscB,5319048,5319048,5318934,114,1428,utRho09
hscC,1367188,1367188,1366786,402,516,utRho09
hsdS,9163004,9163004,9162924,80,16,utRho09
hslJ,2883560,2883560,2883486,74,124,utRho09
hslO,7059344,7059548,7059344,204,9224,utRho09
hslR,7058220,7058696,7058220,476,834,utRho09
hslV,8244708,8244708,8244574,134,42,utRho09
hsrA,7881412,7881412,7881224,188,24,utRho09
htgA,21286,21660,21286,374,82,utRho09
htpG,989634,990240,989634,606,5454,utRho09
htpX,3825236,3825236,3825152,84,0,utRho09
htrE,311036,311036,310852,184,4,utRho09
htrL,7587668,7587668,7587366,302,26,utRho09
hupA,8400352,8400562,8400352,210,42,utRho09
hupB,1845220,1845804,1845220,584,540,utRho09
hyaA,2063968,2064278,2063968,310,0,utRho09
hybO,6292726,6292726,6292522,204,526,utRho09
hycA,5700922,5700922,5700870,52,0,utRho09
hycI,5686204,5686204,5686086,118,14,utRho09
hydN,5676264,5676264,5676210,54,2,utRho09
hyfA,5202342,5202402,5202342,60,0,utRho09
hypA,11402508,11402588,11402508,80,8,utRho09
hypB,11403356,11404004,11403356,648,228,utRho09
hypF,5676210,5676210,5674850,1360,540,utRho09
hypT,9116634,9116634,9116578,56,0,utRho09
hyuA,6019660,6020056,6019660,396,0,utRho09
iaaA,1733074,1733136,1733074,62,0,utRho09
iadA,9119074,9119074,9119052,22,48,utRho09
iap,5753072,5753162,5753072,90,0,utRho09
ibaG,6673966,6673966,6673606,360,194,utRho09
ibpA,7735036,7735036,7734844,192,52,utRho09
ibpB,7733962,7733962,7733794,168,830,utRho09
icd,2389922,2390246,2389922,324,438,utRho09
iclR,8447304,8447304,8447256,48,0,utRho09
idi,6065876,6066130,6065876,254,0,utRho09
idnD,8988870,8988870,8988812,58,0,utRho09
idnK,8989194,8989246,8989194,52,2,utRho09
ihfA,3591442,3591442,3591104,338,864,utRho09
ihfB,1927498,1927656,1927498,158,1226,utRho09
ileS,43666,44782,43666,1116,5710,utRho09
ileX,6431194,6431196,6431194,2,0,utRho09
ilvA,15820940,15821324,15820940,384,228,utRho09
ilvC,7915824,7915940,7915824,116,0,utRho09
ilvE,15809552,15809936,15809552,384,152,utRho09
ilvI,170840,171260,170840,420,0,utRho09
ilvL,23701308,23701932,23701308,624,6,utRho09
ilvY,7915734,7915734,7915640,94,0,utRho09
inaA,4698998,4698998,4698944,54,0,utRho09
infA,1853370,1853370,1852886,484,2374,utRho09
infC,3602692,3602692,3601276,1416,6976,utRho09
insA-5,3958452,3958452,3958430,22,10,utRho09
insA-7,9036758,9037054,9036758,296,158,utRho09
insC-5,6372080,6372284,6372080,204,180,utRho09
insEF-2,785238,785238,785820,582,140,utRho09
insEF-4,2190310,2190310,2190892,582,132,utRho09
insG,9007098,9007098,9006862,236,22,utRho09
insH-1,550596,550596,550234,362,54,utRho09
insH-11,7306538,7306538,7306396,142,26,utRho09
insH-2,1151548,1151548,1151506,42,28,utRho09
insH-3,1378444,1378444,1378026,418,58,utRho09
insH-4,2791942,2792152,2791942,210,54,utRho09
insH-5,2857852,2857852,2857452,400,0,utRho09
insH-6,4135022,4135022,4134642,380,4,utRho09
insH-7,4206186,4206186,4205822,364,7450,utRho09
insH-9,6260050,6260356,6260050,306,46,utRho09
insI-3,9017372,9017372,9017234,138,6,utRho09
insJ,7441188,7441360,7441188,172,82,utRho09
insK,7442130,7442308,7442130,178,0,utRho09
insL-1,30760,30890,30760,130,504,utRho09
insL-2,1216112,1216130,1216112,18,28,utRho09
insL-3,5028644,5028662,5028644,18,32,utRho09
insN-1,540452,540484,540452,32,0,utRho09
intD,1132202,1132202,1131956,246,20,utRho09
intR,2826520,2826520,2826470,50,0,utRho09
intS,4933026,4933090,4933026,64,18,utRho09
intZ,5117386,5117542,5117386,156,8,utRho09
iraD,9113152,9113986,9113152,834,0,utRho09
iraM,2424246,2424246,2424006,240,0,utRho09
iraP,802638,802772,802638,134,0,utRho09
iscA,5319924,5319924,5319772,152,2680,utRho09
iscR,5324398,5324398,5324262,136,14748,utRho09
iscX,5313834,5313834,5313472,362,3892,utRho09
ispF,5743968,5743968,5743560,408,1532,utRho09
ispG,5283908,5283908,5283608,300,1228,utRho09
ispU,389568,389806,389568,238,228,utRho09
isrA,2811502,2811502,2811618,116,54,utRho09
istr-1,7706384,7706384,7706384,0,0,utRho09
istr-2,7706514,7706514,7706514,0,0,utRho09
ivbL,15412092,15412092,15411952,140,888,utRho09
ivy,480638,480686,480638,48,0,utRho09
katE,3627628,3627734,3627628,106,20,utRho09
katG,8267624,8267670,8267624,46,2,utRho09
kbaZ,6557732,6557828,6557732,96,0,utRho09
kbl,7585154,7585154,7585102,52,606,utRho09
kch,2621046,2621046,2620538,508,0,utRho09
kdgR,3820506,3820506,3820198,308,0,utRho09
kdpE,1443788,1443788,1443466,322,26,utRho09
kdpF,1457698,1457698,1457642,56,0,utRho09
kdsA,2535708,2536330,2535708,622,2570,utRho09
kdsC,6683438,6684546,6683438,1108,3076,utRho09
kduI,5968388,5968388,5968248,140,388,utRho09
kefF,94160,94492,94160,332,6,utRho09
kgtP,5451624,5451624,5451492,132,10,utRho09
kup,7862206,7862632,7862206,426,76,utRho09
lacI,735076,735076,735020,56,2,utRho09
lacZ,1465508,1465508,1465220,288,236,utRho09
ldcA,2486394,2486394,2486160,234,0,utRho09
ldhA,2885830,2885830,2885686,144,6,utRho09
ldrA,2538954,2538954,2538550,404,450,utRho09
ldrB,2540024,2540024,2539620,404,70,utRho09
ldrC,2541092,2541092,2540690,402,440,utRho09
ldrD,7400544,7400544,7400174,370,80,utRho09
lepA,5414392,5414392,5414248,144,242,utRho09
lepB,5410928,5410928,5410618,310,822,utRho09
leuD,159188,159188,158906,282,100,utRho09
leuE,3761600,3761600,3761518,82,2,utRho09
leuL,168048,168048,167416,632,4,utRho09
leuO,168308,168736,168308,428,8,utRho09
leuQ,9212864,9212864,9212802,62,2,utRho09
leuU,6644556,6644556,6644316,240,2524,utRho09
leuV,9212546,9212546,9212330,216,1180,utRho09
leuX,8992772,8992810,8992772,38,2,utRho09
lexA,8514174,8514230,8514174,56,36,utRho09
lhr,3456706,3458174,3456706,1468,2120,utRho09
ligA,5060402,5060402,5060352,50,0,utRho09
ligB,7642576,7642576,7642340,236,2,utRho09
lipA,1320602,1320602,1320432,170,74,utRho09
lipB,1324802,1324802,1324556,246,1378,utRho09
lit,2397032,2397390,2397032,358,66,utRho09
livJ,7199524,7199524,7199316,208,20,utRho09
livK,7195510,7195510,7195120,390,8,utRho09
lldP,7554578,7554798,7554578,220,4494,utRho09
lnt,1381968,1381968,1381762,206,484,utRho09
loiP,6163784,6163826,6163784,42,0,utRho09
lolA,1874656,1874738,1874656,82,334,utRho09
lolB,2527112,2527112,2527000,112,50,utRho09
lolC,2350748,2350854,2350748,106,0,utRho09
lon,917630,917776,917630,146,764,utRho09
lpcA,486936,487086,486936,150,0,utRho09
lpd,255434,255824,255434,390,2644,utRho09
lplA,9248476,9248476,9248234,242,1512,utRho09
lplT,5947878,5947878,5947724,154,0,utRho09
lpoA,6586422,6586800,6586422,378,320,utRho09
lpp,3514592,3514842,3514592,250,132,utRho09
lptA,6686598,6686760,6686598,162,986,utRho09
lptB,6686792,6687888,6686792,1096,1868,utRho09
lptD,114672,114672,114218,454,4542,utRho09
lptF,8972244,8972436,8972244,192,80,utRho09
lpxC,213016,213114,213016,98,11142,utRho09
lpxD,401920,401942,401920,22,38,utRho09
lpxL,2233418,2233418,2233164,254,118,utRho09
lpxM,3880456,3880456,3880386,70,46,utRho09
lpxP,4991156,4991290,4991156,134,146,utRho09
lrhA,4813312,4813312,4813282,30,20,utRho09
lrp,1864656,1865190,1864656,534,1000,utRho09
lspA,50028,50414,50028,386,932,utRho09
lsrA,3202920,3202980,3202920,60,0,utRho09
lsrR,3202514,3202514,3202482,32,0,utRho09
ltaE,1818640,1818640,1818588,52,12,utRho09
luxS,5630130,5630130,5629466,664,1828,utRho09
lysA,5957902,5957902,5957798,104,2,utRho09
lysC,8467232,8467232,8466466,766,208,utRho09
lysP,4497120,4497120,4497064,56,20,utRho09
lysR,5957900,5958042,5957900,142,0,utRho09
lysT,1561028,1561108,1561028,80,272,utRho09
lysU,8709610,8709610,8709434,176,0,utRho09
macB,1840188,1840694,1840188,506,224,utRho09
maeA,3111484,3111484,3111338,146,3874,utRho09
mak,820236,820288,820236,52,10,utRho09
malE,8492928,8492928,8492838,90,0,utRho09
malI,3398456,3398456,3398360,96,0,utRho09
malK,8493472,8493568,8493472,96,0,utRho09
malP,7105020,7105020,7104946,74,264,utRho09
malQ,7100798,7100798,7100140,658,144,utRho09
malS,14949880,14949988,14949880,108,0,utRho09
malT,7106048,7106170,7106048,122,108,utRho09
malX,3398626,3398710,3398626,84,0,utRho09
malZ,1689980,1690072,1689980,92,704,utRho09
manA,3377102,3377152,3377102,50,0,utRho09
manX,3803866,3804096,3803866,230,72,utRho09
marC,3237882,3237882,3237816,66,44,utRho09
marR,3238186,3238240,3238186,54,0,utRho09
matP,2036918,2036970,2036918,52,2,utRho09
mazE,5822736,5822736,5822678,58,6,utRho09
mazG,5821720,5821720,5821370,350,2708,utRho09
mcbA,1684306,1684306,1684112,194,0,utRho09
mcbR,3040192,3040524,3040192,332,0,utRho09
mcrA,2420278,2420692,2420278,414,28,utRho09
mcrC,9156124,9156124,9155916,208,62,utRho09
mdaB,6344814,6345060,6344814,246,0,utRho09
mdfA,1767138,1767346,1767138,208,0,utRho09
mdh,6768940,6768940,6768536,404,180,utRho09
mdoB,9198988,9198988,9198882,106,746,utRho09
mdoD,2993290,2993712,2993290,422,4,utRho09
mdoG,2218514,2218670,2218514,156,112,utRho09
mdtA,4307958,4308032,4307958,74,0,utRho09
mdtE,7318168,7318464,7318168,296,22,utRho09
mdtK,3486538,3486914,3486538,376,140,utRho09
mdtP,8602472,8602472,8602060,412,42,utRho09
melA,8683774,8683822,8683774,48,0,utRho09
melR,8683300,8683300,8683256,44,8,utRho09
menA,8240812,8240812,8240698,114,0,utRho09
menB,4753774,4753774,4753638,136,400,utRho09
mepH,3468714,3468870,3468714,156,4,utRho09
mepM,3883666,3883666,3883270,396,486,utRho09
mepS,4539840,4539958,4539840,118,202,utRho09
metA,8428318,8428560,8428318,242,0,utRho09
metB,8257272,8257344,8257272,72,916,utRho09
metC,6304150,6304472,6304150,322,84,utRho09
metE,8025768,8026106,8025768,338,176,utRho09
metF,8265092,8265232,8265092,140,0,utRho09
metG,4388538,4388600,4388538,62,148,utRho09
metH,8447010,8447656,8447010,646,2096,utRho09
metJ,8257116,8257116,8256790,326,38,utRho09
metK,6173154,6173412,6173154,258,188,utRho09
metN,445428,445428,445290,138,40,utRho09
metR,8025710,8025710,8025632,78,0,utRho09
metT,1394326,1394326,1394266,60,226,utRho09
metY,19910250,19910250,19909734,516,1494,utRho09
metZ,11789528,11789548,11789528,20,12,utRho09
mfd,2348056,2348056,2347928,128,108,utRho09
mglA,4478782,4478782,4478578,204,70,utRho09
mglB,4481132,4481132,4480696,436,11164,utRho09
mglC,4475918,4475918,4475506,412,144,utRho09
mgrB,3817584,3817584,3817532,52,0,utRho09
mgrR,3245828,3245828,3245828,0,0,utRho09
mgsA,2054082,2054082,2054030,52,98,utRho09
mgtL,8934560,8934862,8934560,302,74,utRho09
mhpA,737038,737222,737038,184,0,utRho09
mhpR,737072,737072,736840,232,0,utRho09
mhpT,750772,750918,750772,146,0,utRho09
miaA,8797964,8798504,8797964,540,442,utRho09
micA,5629604,5629604,5629604,0,0,utRho09
micC,2874242,2874238,2874242,4,0,utRho09
micF,4626168,4626168,4626168,0,0,utRho09
micM,1014408,1014408,1014408,0,0,utRho09
minE,2449422,2449422,2449090,332,1924,utRho09
mioC,7852950,7852950,7852910,40,0,utRho09
mipA,3733012,3733012,3732944,68,3716,utRho09
mlaA,4930270,4930270,4930014,256,2,utRho09
mlc,3337206,3337206,3337128,78,2,utRho09
mlrA,4429498,4429732,4429498,234,2,utRho09
mltA,5894546,5894546,5894356,190,6,utRho09
mltD,468050,468050,467910,140,60,utRho09
mltF,5391534,5391602,5391534,68,0,utRho09
mmuP,550238,550650,550238,412,58,utRho09
mngA,1531622,1531968,1531622,346,68,utRho09
mngR,1531852,1531852,1531750,102,0,utRho09
mnmG,7851348,7851348,7851266,82,2576,utRho09
mntH,5025470,5025470,5025412,58,0,utRho09
mntP,3810918,3811376,3810918,458,322,utRho09
mntR,1706160,1706366,1706160,206,0,utRho09
mntS,1706128,1706128,1705994,134,38,utRho09
moaA,1633654,1634088,1633654,434,408,utRho09
moaB,1635954,1636110,1635954,156,1110,utRho09
mobA,8084242,8084242,8083998,244,30,utRho09
mocA,6030112,6030320,6030112,208,20,utRho09
modA,1589990,1590178,1589990,188,0,utRho09
moeA,1732788,1732788,1732728,60,168,utRho09
mokB,2984610,2984610,2984258,352,224,utRho09
molR_1,4392888,4392948,4392888,60,22,utRho09
motA,3954604,3954604,3954278,326,142,utRho09
mpaA,2781278,2781278,2781196,82,26,utRho09
mpl,8911456,8911570,8911456,114,0,utRho09
mppA,2786108,2786454,2786108,346,0,utRho09
mprA,5621494,5621540,5621494,46,636,utRho09
mqo,4613848,4613848,4613508,340,150,utRho09
mqsA,6336742,6336742,6336492,250,124,utRho09
mqsR,6337306,6337306,6337088,218,60,utRho09
mraZ,179192,179268,179192,76,2,utRho09
mrcA,7045652,7045742,7045652,90,2,utRho09
mrcB,329442,329460,329442,18,0,utRho09
mreB,13605424,13605424,13604348,1076,3164,utRho09
mreD,6798166,6798166,6797750,416,402,utRho09
mrp,4388360,4388360,4388336,24,2,utRho09
mscK,972984,973072,972984,88,2,utRho09
mscL,6876002,6876048,6876002,46,50,utRho09
mscS,6139742,6139742,6139614,128,108,utRho09
msrA,8884522,8884522,8884352,170,224,utRho09
msrB,3725168,3725168,3724858,310,0,utRho09
msyB,2228426,2228426,2228362,64,80,utRho09
mtfA,4087236,4087302,4087236,66,2386,utRho09
mtgA,6699662,6699662,6699618,44,64,utRho09
mtlA,30177504,30178248,30177504,744,256,utRho09
mtn,358366,358366,358306,60,44,utRho09
mtr,6611864,6611864,6611634,230,42,utRho09
mug,6430992,6430992,6430946,46,4,utRho09
murQ,5091466,5091546,5091466,80,62,utRho09
murR,5091586,5091586,5091218,368,128,utRho09
mutH,5939164,5939324,5939164,160,64,utRho09
mutL,8794092,8794824,8794092,732,750,utRho09
mutM,7622554,7622554,7622304,250,1258,utRho09
mutS,5714038,5714186,5714038,148,1116,utRho09
mutY,18617466,18618078,18617466,612,6,utRho09
nac,4123956,4123956,4123866,90,2,utRho09
nadA,1564122,1564170,1564122,48,0,utRho09
nadB,5420714,5420840,5420714,126,0,utRho09
nadC,237326,237326,237290,36,0,utRho09
nadE,3644604,3644916,3644604,312,38,utRho09
nadK,5501526,5501662,5501526,136,116,utRho09
nagA,1406350,1406350,1405502,848,4436,utRho09
nagB,1407416,1407416,1407222,194,36,utRho09
nagC,1404016,1404016,1403188,828,34,utRho09
nagE,1407680,1407888,1407680,208,6,utRho09
nagK,2357080,2357186,2357080,106,52,utRho09
nanA,6747240,6747240,6747152,88,72,utRho09
nanC,9079856,9079856,9079002,854,4,utRho09
nanR,6749406,6749406,6748978,428,166,utRho09
nanS,9075406,9075406,9075188,218,2,utRho09
napF,4607390,4607390,4606994,396,0,utRho09
narG,2559614,2559728,2559614,114,0,utRho09
narK,2555642,2555914,2555642,272,4,utRho09
narP,4580844,4581000,4580844,156,0,utRho09
narQ,5171154,5171462,5171154,308,30,utRho09
narU,3088326,3088326,3088120,206,0,utRho09
narW,3077374,3077374,3074618,2756,28,utRho09
narX,2555554,2555554,2555236,318,0,utRho09
narZ,3085380,3085380,3085180,200,0,utRho09
ndh,2331984,2332170,2331984,186,12,utRho09
ndk,5289920,5289920,5289728,192,74,utRho09
nemR,6904084,6904092,6904084,8,0,utRho09
nepI,7683542,7683542,7683478,64,84,utRho09
nfo,4501612,4501680,4501612,68,0,utRho09
nfsB,1210906,1210906,1210848,58,32,utRho09
nfuA,7090916,7091248,7090916,332,600,utRho09
nhaA,34634,34978,34634,344,32,utRho09
nhaB,2469534,2469534,2469434,100,8,utRho09
nhoA,3067926,3068048,3067926,122,2,utRho09
nikA,7226878,7227334,7226878,456,1924,utRho09
nikR,7237074,7237176,7237074,102,124,utRho09
nirB,6987974,6988022,6987974,48,36,utRho09
nlpA,7680034,7680034,7679986,48,0,utRho09
nlpC,3585654,3585654,3585462,192,38,utRho09
nlpD,5737658,5737658,5737506,152,18,utRho09
nlpI,6618080,6618080,6617848,232,108,utRho09
nmpC,1153740,1153740,1153650,90,0,utRho09
nohA,3273206,3273206,3272734,472,38,utRho09
norR,5664614,5664614,5664578,36,0,utRho09
norV,5664878,5664952,5664878,74,0,utRho09
nrdA,4689510,4689730,4689510,220,14846,utRho09
nrdD,8925676,8925676,8925320,356,1162,utRho09
nrdH,5601312,5601446,5601312,134,92,utRho09
nrdR,865954,866004,865954,50,110,utRho09
nrfA,8575342,8575528,8575342,186,0,utRho09
nsrR,8812088,8812380,8812088,292,1656,utRho09
nudB,3897348,3897348,3897264,84,34,utRho09
nudC,8393428,8393806,8393428,378,0,utRho09
nudE,7052658,7052658,7052298,360,734,utRho09
nudG,3682876,3682980,3682876,104,2,utRho09
nudI,4729050,4729108,4729050,58,0,utRho09
nudJ,2388874,2388874,2388576,298,544,utRho09
nuoA,4810670,4810670,4810144,526,7956,utRho09
nuoN,4783434,4783434,4783010,424,1214,utRho09
nupC,5026018,5026084,5026018,66,0,utRho09
nupG,6211302,6211428,6211302,126,0,utRho09
ogrK,4335096,4335096,4335040,56,0,utRho09
ogt,2800568,2800568,2800472,96,2,utRho09
ohsC,5401036,5401040,5401036,4,0,utRho09
ompA,2040382,2040382,2040106,276,29974,utRho09
ompC,4625774,4625774,4625498,276,16,utRho09
ompF,1974184,1974184,1973964,220,586,utRho09
ompL,8128958,8128958,8128590,368,10,utRho09
ompN,2874158,2874158,2873786,372,16,utRho09
ompR,7073510,7073510,7073168,342,128,utRho09
ompT,1171330,1171330,1171266,64,0,utRho09
ompW,2627982,2628040,2627982,58,2,utRho09
ompX,1700418,1700900,1700418,482,1214,utRho09
omrA,5952378,5952378,5952378,0,0,utRho09
omrB,5952770,5952770,5952770,0,0,utRho09
oppA,2602170,2602364,2602170,194,15344,utRho09
orn,8783168,8783208,8783168,40,0,utRho09
osmB,2686952,2686952,2686656,296,184,utRho09
osmC,3113192,3113250,3113192,58,116,utRho09
osmE,3644566,3644566,3644512,54,0,utRho09
osmF,4439046,4439046,4438962,84,812,utRho09
osmY,9222306,9222792,9222306,486,36,utRho09
otsA,3963302,3963302,3963224,78,0,utRho09
otsB,3964930,3964930,3964774,156,2,utRho09
oxc,4984288,4984288,4983900,388,44,utRho09
oxyR,8316914,8316980,8316914,66,4,utRho09
oxyS,8316788,8316788,8316788,0,0,utRho09
paaA,2907730,2907854,2907730,124,0,utRho09
paaX,2927018,2927078,2927018,60,0,utRho09
paaZ,2907340,2907340,2907284,56,0,utRho09
pabA,6981702,6981702,6981658,44,0,utRho09
pabB,3789256,3789610,3789256,354,34,utRho09
pabC,2306186,2306600,2306186,414,320,utRho09
pagP,1313052,1313114,1313052,62,0,utRho09
panB,299260,299260,299202,58,130,utRho09
panC,297840,297840,297590,250,386,utRho09
panD,293490,293490,293388,102,2,utRho09
panZ,7195656,7195968,7195656,312,58,utRho09
parC,6332060,6332060,6331946,114,170,utRho09
patA,6438916,6438988,6438916,72,0,utRho09
patD,3030830,3031156,3030830,326,0,utRho09
pbpC,5294986,5294986,5294650,336,2,utRho09
pbpG,4450132,4450132,4449740,392,130,utRho09
pck,7065358,7065636,7065358,278,4838,utRho09
pcnB,318782,318782,318252,530,360,utRho09
pdhR,244068,244184,244068,116,22,utRho09
pdxB,4875768,4875768,4875702,66,14,utRho09
pdxH,3436068,3436068,3436014,54,684,utRho09
pdxJ,5403626,5403626,5403458,168,82,utRho09
pdxK,5074638,5074638,5074474,164,0,utRho09
pepA,8972278,8972278,8971902,376,292,utRho09
pepD,511618,511618,511432,186,6138,utRho09
pepN,1981182,1981244,1981182,62,74,utRho09
pepQ,8062294,8062322,8062294,28,0,utRho09
pepT,2371646,2371688,2371646,42,6,utRho09
pfkA,8214948,8215104,8214948,156,328,utRho09
pfkB,3612646,3612740,3612646,94,0,utRho09
pflA,1902456,1902456,1902160,296,0,utRho09
pflB,1907850,1907850,1907108,742,658,utRho09
pflD,8287716,8287990,8287716,274,0,utRho09
pgaA,2185046,2185046,2184578,468,6,utRho09
pgi,8467444,8467516,8467444,72,2,utRho09
pgk,12291428,12291428,12290488,940,5264,utRho09
pgl,1597078,1597172,1597078,94,26,utRho09
pgpB,2678324,2678660,2678324,336,26,utRho09
pgpC,5397276,5397276,5397100,176,0,utRho09
pgrR,2783744,2783982,2783744,238,0,utRho09
pheL,5475158,5475198,5475158,40,2,utRho09
pheM,7197204,7197204,7197080,124,4,utRho09
pheP,1203858,1203918,1203858,60,0,utRho09
pheU,8725254,8725254,8725252,2,0,utRho09
pheV,6220730,6220732,6220730,2,0,utRho09
phnC,8650412,8650412,8650330,82,2,utRho09
phoA,803414,803494,803414,80,0,utRho09
phoB,834202,834284,834202,82,0,utRho09
phoE,520316,520316,520200,116,0,utRho09
phoH,2169730,2169984,2169730,254,2,utRho09
phoP,2381016,2381016,2380894,122,1260,utRho09
phoQ,2379880,2379880,2379552,328,980,utRho09
phoU,7815330,7815330,7815156,174,266,utRho09
phr,1478842,1479014,1478842,172,0,utRho09
pinE,2419054,2419370,2419054,316,0,utRho09
pinQ,3267168,3267244,3267168,76,2,utRho09
pinR,2867424,2867424,2867348,76,8,utRho09
pitA,7275224,7275284,7275224,60,0,utRho09
pitB,6272806,6272806,6272742,64,2,utRho09
pka,5439862,5439906,5439862,44,2,utRho09
plaP,4174476,4174476,4174124,352,2314,utRho09
pldA,8009628,8009724,8009628,96,2,utRho09
pldB,8018028,8018340,8018028,312,74,utRho09
plsB,8513196,8513196,8512932,264,270,utRho09
pmbA,8915890,8915918,8915890,28,4,utRho09
pmrD,4747148,4747148,4747076,72,0,utRho09
pncB,1980828,1980828,1980712,116,22,utRho09
pncC,5648788,5648788,5648692,96,0,utRho09
pnp,6622652,6622652,6622336,316,200,utRho09
pntA,3355950,3355950,3355806,144,0,utRho09
pntB,3353096,3353096,3352720,376,0,utRho09
polA,8093880,8093932,8093880,52,52,utRho09
polB,131606,131606,131560,46,0,utRho09
potD,2365700,2365700,2365658,42,4,utRho09
potE,1436688,1436688,1436530,158,0,utRho09
potF,1787268,1787568,1787268,300,54,utRho09
poxB,1822152,1822152,1822098,54,0,utRho09
ppa,8899372,8899372,8899304,68,62,utRho09
ppc,8306380,8306380,8306196,184,190,utRho09
ppdA,5928440,5928440,5928354,86,174,utRho09
ppdD,235410,235410,235098,312,28,utRho09
pphA,3846770,3846770,3845938,832,3340,utRho09
pphB,5719474,5719520,5719474,46,0,utRho09
ppiA,6984898,6984898,6984594,304,84,utRho09
ppiC,7919682,7919682,7919626,56,0,utRho09
ppiD,923638,923830,923638,192,1348,utRho09
ppk,5245748,5246088,5245748,340,300,utRho09
pppA,6228958,6228958,6228704,254,0,utRho09
ppsA,3574322,3574322,3574224,98,0,utRho09
ppsR,3574678,3574890,3574678,212,0,utRho09
pptA,3065716,3066104,3065716,388,42,utRho09
pqiA,2023318,2024002,2023318,684,168,utRho09
prc,3830054,3830054,3829632,422,34124,utRho09
preT,4467978,4468066,4467978,88,24,utRho09
prfC,9218688,9218828,9218688,140,534,utRho09
prkB,6968622,6968980,6968622,358,898,utRho09
prlC,7290476,7290476,7290364,112,54,utRho09
prlF,6553944,6554004,6553944,60,30,utRho09
proB,520432,520776,520432,344,22,utRho09
proC,811372,811372,811288,84,0,utRho09
proK,7417388,7417388,7417384,4,0,utRho09
proL,4572414,4572422,4572414,8,22,utRho09
proP,8660640,8661004,8660640,364,264,utRho09
proS,437674,437674,437550,124,528,utRho09
proV,5609126,5609630,5609126,504,48,utRho09
prpB,697292,697364,697292,72,0,utRho09
prpR,696942,696942,696886,56,0,utRho09
prs,2524354,2524354,2523750,604,82966,utRho09
psd,8781276,8781276,8780720,556,2574,utRho09
psiE,8480600,8480650,8480600,50,0,utRho09
pspA,2736076,2736158,2736076,82,0,utRho09
pspF,2736080,2736080,2735824,256,0,utRho09
pspG,8525632,8525680,8525632,48,2,utRho09
pssA,5445156,5445454,5445156,298,2464,utRho09
pstB,7817112,7817112,7816732,380,0,utRho09
pstC,7821084,7821084,7820796,288,0,utRho09
pstS,23469408,23469408,23469150,258,6,utRho09
psuG,4517114,4517114,4516734,380,270,utRho09
psuT,4514992,4514992,4514670,322,0,utRho09
pth,2517084,2517084,2517026,58,86,utRho09
ptrA,5918022,5918022,5917768,254,0,utRho09
ptrB,3857730,3857730,3857678,52,448,utRho09
ptsG,2315252,2315738,2315252,486,2756,utRho09
ptsH,5066996,5067528,5066996,532,4906,utRho09
purA,8809328,8809374,8809328,46,96,utRho09
purC,5195562,5195562,5195236,326,14,utRho09
purD,8411972,8411972,8411862,110,0,utRho09
purE,1106284,1106284,1106200,84,808,utRho09
purH,8415254,8415254,8415064,190,16,utRho09
purL,5391178,5391178,5391086,92,418,utRho09
purM,5242306,5242394,5242306,88,34,utRho09
purR,3475378,3475688,3475378,310,854,utRho09
purT,3861438,3861762,3861438,324,4,utRho09
purU,2577512,2577512,2577248,264,774,utRho09
putA,2157850,2157850,2157764,86,0,utRho09
putP,2158336,2158610,2158336,274,342,utRho09
puuA,2721936,2721936,2721816,120,0,utRho09
puuC,2725456,2725486,2725456,30,0,utRho09
puuD,2722104,2722240,2722104,136,0,utRho09
puuP,2718746,2718746,2718374,372,236,utRho09
pykA,3874988,3875298,3874988,310,570,utRho09
pykF,3510934,3511396,3510934,462,758,utRho09
pyrC,2245286,2245286,2245214,72,182,utRho09
pyrD,2009464,2009536,2009464,72,32,utRho09
pyrE,7631970,7631970,7631536,434,84,utRho09
pyrF,2683740,2683842,2683740,102,296,utRho09
pyrG,5819594,5819594,5819332,262,574,utRho09
pyrH,383624,383710,383624,86,2764,utRho09
pyrL,8945490,8945490,8945066,424,92,utRho09
qmcA,1031646,1031646,1031546,100,8,utRho09
qor,8528608,8528608,8528462,146,148,utRho09
qseB,6339502,6339656,6339502,154,6,utRho09
queA,849970,850022,849970,52,186,utRho09
queE,5811212,5811212,5810836,376,78,utRho09
queF,5850642,5850696,5850642,54,0,utRho09
queG,8788184,8788184,8788134,50,848,utRho09
racC,2835630,2835630,2835526,104,0,utRho09
racR,2840898,2840898,2840482,416,0,utRho09
raiA,5474208,5474308,5474208,100,16,utRho09
rarD,8008594,8008594,8008356,238,338,utRho09
ravA,7862256,7862256,7862186,70,34,utRho09
rayT,495088,495274,495088,186,12,utRho09
rbn,4763162,4763216,4763162,54,0,utRho09
rbsD,7866644,7866702,7866644,58,0,utRho09
rcnA,4371654,4371834,4371654,180,22,utRho09
rcnB,4373768,4373920,4373768,152,20,utRho09
rcnR,4371806,4371806,4371592,214,46,utRho09
rcsA,4047672,4047936,4047672,264,8,utRho09
rcsB,4631390,4632354,4631390,964,1208,utRho09
rcsC,4640162,4640162,4639656,506,318,utRho09
rcsD,4626904,4626976,4626904,72,188,utRho09
rdgB,6193240,6193362,6193240,122,832,utRho09
rdlA,2538646,2538646,2538646,0,0,utRho09
rdlB,2539712,2539716,2539712,4,0,utRho09
rdlC,2540782,2540786,2540782,4,0,utRho09
rdlD,7400272,7400272,7400272,0,0,utRho09
rdoA,8084782,8084830,8084782,48,0,utRho09
recA,11295276,11295276,11295076,200,732,utRho09
recC,5925014,5925014,5924856,158,62,utRho09
recF,7763722,7763722,7762442,1280,7538,utRho09
recN,5503518,5503590,5503518,72,0,utRho09
recQ,8011666,8011728,8011666,62,0,utRho09
relA,5828554,5828554,5827302,1252,552,utRho09
relB,3291806,3291806,3291744,62,0,utRho09
rem,3289950,3289950,3289804,146,0,utRho09
rep,7921294,7921354,7921294,60,48,utRho09
rfaD,7587730,7587974,7587730,244,216,utRho09
rfaE,6393852,6393852,6393506,346,56,utRho09
rfaH,8049930,8049930,8049642,288,396,utRho09
rfbX,4219436,4219436,4219168,268,3852,utRho09
rfe,7935600,7935832,7935600,232,78,utRho09
rhaB,8194944,8194944,8194896,48,0,utRho09
rhaD,8188770,8188770,8188544,226,0,utRho09
rhaS,8195422,8195472,8195422,50,0,utRho09
rhaT,8201132,8201132,8201050,82,0,utRho09
rhlE,1661566,1661744,1661566,178,298,utRho09
rhoL,47593944,47594772,47593944,828,70344,utRho09
rhsB,7238006,7238384,7238006,378,32,utRho09
rhsC,1458758,1459166,1458758,408,0,utRho09
rhsD,1046132,1046522,1046132,390,0,utRho09
rhtA,1700608,1700608,1700194,414,18,utRho09
rhtC,8015478,8015514,8015478,36,738,utRho09
ribA,2678468,2678468,2678320,148,26,utRho09
ribC,3486916,3486916,3486484,432,140,utRho09
ribE,869008,869294,869008,286,9460,utRho09
ribF,42766,42814,42766,48,36,utRho09
ridA,8941892,8941892,8941826,66,10,utRho09
rihA,1369204,1369204,1368824,380,254,utRho09
rihB,4510504,4510504,4510372,132,4,utRho09
rimJ,2251044,2251124,2251044,80,0,utRho09
rimK,1783752,1783934,1783752,182,346,utRho09
rimL,2997486,2997876,2997486,390,0,utRho09
rimO,1756140,1756140,1756070,70,34,utRho09
rimP,6636350,6636350,6636012,338,866,utRho09
rlmA,3814172,3814172,3814120,52,572,utRho09
rlmD,5830086,5830086,5830000,86,24,utRho09
rlmE,6655520,6655520,6655328,192,1060,utRho09
rlmF,1684384,1684664,1684384,280,2,utRho09
rlmG,6471784,6471784,6471750,34,0,utRho09
rlmI,2060002,2060002,2059938,64,0,utRho09
rlmJ,7290700,7290770,7290700,70,148,utRho09
rlmL,2015344,2015688,2015344,344,966,utRho09
rlpA,1330444,1330444,1330380,64,86,utRho09
rluA,120900,120900,120692,208,274,utRho09
rluF,8460324,8460708,8460324,384,0,utRho09
rmf,2031006,2031430,2031006,424,150,utRho09
rna,1290068,1290068,1290006,62,0,utRho09
rnb,2698258,2698258,2697824,434,3416,utRho09
rnc,10816892,10816892,10816252,640,8564,utRho09
rnd,3776122,3776122,3775982,140,342,utRho09
rne,2289746,2289746,2288734,1012,9796,utRho09
rnhA,472082,472082,472004,78,80,utRho09
rnk,1288360,1288360,1287934,426,114,utRho09
rnlA,5531788,5531836,5531788,48,14,utRho09
rnlB,5533414,5533968,5533414,554,736,utRho09
rnpB,19623552,19623552,19623552,0,0,utRho09
rob,9270706,9270706,9270620,86,22,utRho09
rodZ,5285868,5285868,5285688,180,126,utRho09
rpe,7030306,7030306,7030118,188,142,utRho09
rph,15266320,15266320,15266196,124,152,utRho09
rpiA,6118706,6118706,6118650,56,8,utRho09
rpiB,8626514,8626700,8626514,186,20,utRho09
rpiR,8626274,8626274,8625982,292,0,utRho09
rplJ,8359246,8359992,8359246,746,13608,utRho09
rplK,8356708,8356894,8356708,186,518,utRho09
rplM,6757344,6757344,6757302,42,12256,utRho09
rplN,6896444,6896444,6896298,146,12568,utRho09
rplS,5489284,5489284,5489060,224,27568,utRho09
rplT,7199052,7199052,7198996,56,2028,utRho09
rplU,6667036,6667036,6666902,134,140,utRho09
rplY,4564866,4565034,4564866,168,258,utRho09
rpmA,6666450,6666450,6666238,212,1410,utRho09
rpmB,15247980,15247980,15246696,1284,228356,utRho09
rpmE,8253816,8254026,8253816,210,954,utRho09
rpmF,2294676,2294734,2294676,58,86940,utRho09
rpmH,7768130,7768672,7768130,542,9972,utRho09
rpmI,3600854,3600854,3599998,856,13788,utRho09
rpoB,8362126,8362490,8362126,364,892,utRho09
rpoD,6424946,6426094,6424946,1148,23720,utRho09
rpoE,5420372,5420372,5420024,348,0,utRho09
rpoH,7202006,7202006,7201566,440,3438,utRho09
rpoN,6689324,6689434,6689324,110,70,utRho09
rpoS,5736236,5736236,5735102,1134,4072,utRho09
rpoZ,7644154,7644212,7644154,58,1234,utRho09
rppH,5937986,5937986,5937954,32,2,utRho09
rprA,3540744,3540744,3540744,0,0,utRho09
rpsA,1923434,1923990,1923434,556,271806,utRho09
rpsF,8850050,8850236,8850050,186,64310,utRho09
rpsI,6756580,6756580,6756414,166,20408,utRho09
rpsJ,6906884,6906884,6906540,344,15140,utRho09
rpsL,6949242,6949242,6949104,138,224,utRho09
rpsM,6885130,6885130,6884942,188,2294,utRho09
rpsO,13247144,13247144,13246736,408,1120,utRho09
rpsP,5492508,5492508,5492370,138,118,utRho09
rpsT,42420,42420,42156,264,862,utRho09
rpsU,12842584,12843124,12842584,540,4904,utRho09
rraA,8238716,8238716,8238660,56,302,utRho09
rraB,8956768,8956946,8956768,178,0,utRho09
rrsA,8070478,8071062,8070478,584,10266,utRho09
rrsB,16665468,16666636,16665468,1168,20920,utRho09
rrsC,7883032,7883616,7883032,584,12060,utRho09
rrsD,6858094,6858094,6857524,570,660,utRho09
rrsE,8415726,8416294,8415726,568,1930,utRho09
rrsG,5462896,5462896,5462314,582,8960,utRho09
rrsH,446970,447542,446970,572,2552,utRho09
rsd,8393908,8393908,8393616,292,0,utRho09
rseA,5419264,5419264,5418808,456,54,utRho09
rseP,392940,393092,392940,152,244,utRho09
rseX,4067298,4067298,4067298,0,0,utRho09
rsfS,1338144,1338144,1338072,72,440,utRho09
rsgA,8783132,8783132,8783018,114,0,utRho09
rsmA,105176,105176,104860,316,2732,utRho09
rsmB,6869982,6870414,6869982,432,450,utRho09
rsmC,9215736,9215736,9215400,336,588,utRho09
rsmD,7208594,7208786,7208594,192,2,utRho09
rsmE,6182036,6182268,6182036,232,104,utRho09
rsmG,7847512,7847512,7847360,152,506,utRho09
rsmH,180020,180188,180020,168,308,utRho09
rsmI,6587106,6587106,6586670,436,1216,utRho09
rssA,2578212,2578412,2578212,200,252,utRho09
rssB,2580440,2580484,2580440,44,54,utRho09
rstA,3364276,3364300,3364276,24,0,utRho09
rsuA,4561096,4561096,4560966,130,132,utRho09
rsxA,3411510,3411534,3411510,24,0,utRho09
rtcA,7114004,7114004,7113698,306,8,utRho09
rtcB,7116214,7116214,7116158,56,0,utRho09
rtn,4541356,4541452,4541356,96,0,utRho09
rutA,2148052,2148052,2148022,30,0,utRho09
rutG,2140090,2140090,2139678,412,0,utRho09
rutR,2148226,2148484,2148226,258,0,utRho09
ruvA,7784096,7784096,7783904,192,88,utRho09
ruvB,7782176,7782176,7781424,752,588,utRho09
ruvC,3894878,3894878,3894752,126,0,utRho09
rybB,1776114,1776114,1776114,0,0,utRho09
rydB,3529860,3529860,3529322,538,80,utRho09
rydC,2983012,2983012,2983012,0,0,utRho09
ryfA,5307398,5307710,5307398,312,0,utRho09
ryfD,5468590,5468590,5468590,0,0,utRho09
ryhB,7162032,7162032,7162032,0,0,utRho09
ryjA,8556132,8556132,8556132,0,0,utRho09
ryjB,9055954,9055954,9055954,0,0,utRho09
sad,3229598,3229598,3229406,192,30,utRho09
safA,3168056,3168056,3167918,138,6,utRho09
sanA,4465368,4465756,4465368,388,26,utRho09
sapF,2705314,2705314,2705268,46,36,utRho09
sbcB,4165456,4165512,4165456,56,0,utRho09
sbcC,831694,831694,831506,188,262,utRho09
sbcD,833954,833954,833904,50,4,utRho09
sbmA,793106,793278,793106,172,10,utRho09
sbmC,4162650,4162650,4162524,126,0,utRho09
sdaA,3793618,3793864,3793618,246,210,utRho09
sdaC,5856070,5856458,5856070,388,2002,utRho09
sdhC,1509916,1510354,1509916,438,63342,utRho09
sdhD,1510808,1511120,1510808,312,13390,utRho09
sdiA,3993834,3993834,3993664,170,108,utRho09
secE,8354354,8354716,8354354,362,4,utRho09
secG,6645180,6645180,6645010,170,868,utRho09
selA,7522594,7522594,7522498,96,284,utRho09
selB,7519850,7519850,7519722,128,344,utRho09
selC,7672396,7672444,7672396,48,22,utRho09
selD,3696058,3696058,3696016,42,3204,utRho09
seqA,1425884,1425974,1425884,90,1216,utRho09
serA,6117098,6117098,6116820,278,112,utRho09
serB,9249712,9249790,9249712,78,0,utRho09
serC,3830380,3830612,3830380,232,0,utRho09
serS,1878730,1878856,1878730,126,1658,utRho09
serT,2063438,2063438,2063424,14,0,utRho09
serU,4087124,4087124,4087114,10,226,utRho09
serV,5637394,5637394,5637290,104,0,utRho09
serW,1852014,1852014,1851942,72,310,utRho09
serX,2195352,2195352,2195304,48,0,utRho09
setB,4527426,4527726,4527426,300,2,utRho09
setC,7673488,7673906,7673488,418,30,utRho09
sfmA,1116124,1116424,1116124,300,0,utRho09
sfmC,1117606,1117948,1117606,342,0,utRho09
sfsA,323030,323030,322972,58,248,utRho09
sfsB,6669592,6669818,6669592,226,26,utRho09
sgrR,154676,154676,154598,78,2,utRho09
sgrS,154734,154734,154734,0,0,utRho09
shiA,4107068,4107286,4107068,218,0,utRho09
sibA,4306622,4306622,4306622,0,0,utRho09
sibB,4307292,4307292,4307292,0,0,utRho09
sibC,6113702,6113702,6113702,0,0,utRho09
sibD,6389730,6389730,6389730,0,0,utRho09
sibE,6390480,6390480,6390480,0,0,utRho09
sixA,4913998,4913998,4913624,374,2,utRho09
slp,7307872,7307922,7307872,50,2,utRho09
slt,9261400,9261466,9261400,66,0,utRho09
slyA,3442028,3442028,3441648,380,0,utRho09
slyB,3439496,3439752,3439496,256,16,utRho09
slyD,6957398,6957398,6956994,404,376,utRho09
slyX,6954862,6955280,6954862,418,12574,utRho09
smf,6867372,6867372,6867120,252,6,utRho09
smpB,5509534,5509792,5509534,258,466,utRho09
smrA,2811872,2811958,2811872,86,66,utRho09
smrB,4896872,4897212,4896872,340,0,utRho09
smtA,1946808,1947074,1946808,266,0,utRho09
sodA,8201518,8201620,8201518,102,17492,utRho09
sodB,3470646,3470756,3470646,110,120,utRho09
sodC,3449358,3449358,3449310,48,48,utRho09
sohB,2658568,2658664,2658568,96,0,utRho09
sokB,2984232,2984238,2984232,6,142,utRho09
solA,2241218,2241218,2241172,46,2,utRho09
soxR,8554894,8554938,8554894,44,6,utRho09
soxS,8554846,8554846,8554766,80,0,utRho09
speA,6172096,6172096,6171822,274,410,utRho09
speB,6167892,6167892,6167594,298,468,utRho09
speC,6218350,6218350,6218310,40,120,utRho09
spf,8099798,8099798,8099798,0,0,utRho09
sppA,3697422,3697674,3697422,252,2,utRho09
spy,3651376,3651376,3651250,126,0,utRho09
sra,3112092,3112092,3111926,166,0,utRho09
sraB,2293178,2293178,2293178,0,0,utRho09
sraC,3846132,3846132,3846132,0,0,utRho09
srlA,5651582,5651664,5651582,82,2,utRho09
srlR,5657720,5658094,5657720,374,924,utRho09
srmB,5425752,5425792,5425752,40,302,utRho09
sroA,151216,151216,151216,0,0,utRho09
sroG,6369436,6369436,6369436,0,0,utRho09
sroH,8380974,8380974,8380974,0,0,utRho09
ssb,8548022,8548250,8548022,228,84,utRho09
sseA,5304782,5304988,5304782,206,11578,utRho09
sspA,6755138,6755138,6754840,298,758,utRho09
ssrA,5511014,5511186,5511014,172,102,utRho09
ssrS,12223036,12223932,12223036,896,696,utRho09
sstT,6479726,6479888,6479726,162,4,utRho09
ssuB,1988282,1988282,1988088,194,4,utRho09
ssuE,1995126,1995126,1995024,102,0,utRho09
sthA,8321604,8321604,8321580,24,1470,utRho09
stpA,5597156,5597156,5596990,166,4,utRho09
sucA,3034344,3034824,3034344,480,3136,utRho09
sufA,3528836,3528836,3528772,64,0,utRho09
sufE,3518962,3518962,3518580,382,246,utRho09
sugE,8753588,8753750,8753588,162,192,utRho09
sulA,2041894,2041894,2041838,56,314,utRho09
syd,5850738,5850738,5850560,178,92,utRho09
symE,9159834,9159834,9159680,154,0,utRho09
symR,9159670,9159670,9159670,0,0,utRho09
tabA,8949566,8949724,8949566,158,0,utRho09
talA,5157140,5157332,5157140,192,0,utRho09
talB,16382,16476,16382,94,10810,utRho09
tam,3214442,3214692,3214442,250,14,utRho09
tamA,8884540,8884764,8884540,224,46,utRho09
tar,3945432,3945432,3945382,50,48,utRho09
tas,5943138,5943194,5943138,56,90,utRho09
tatA,16087636,16087780,16087636,144,212,utRho09
tatE,1317742,1317894,1317742,152,34,utRho09
tauA,770410,770464,770410,54,0,utRho09
tdcA,6534186,6534186,6534130,56,0,utRho09
tdcG,6519652,6519652,6519298,354,2,utRho09
tdcR,6534380,6534760,6534380,380,8,utRho09
tdk,2586986,2587054,2586986,68,0,utRho09
tehA,3001072,3001146,3001072,74,0,utRho09
tesA,1039898,1039898,1039530,368,74,utRho09
tesB,950402,950402,950322,80,0,utRho09
tfaE,2418532,2418532,2418238,294,8,utRho09
tfaQ,3269912,3269912,3269770,142,0,utRho09
tff,379424,379256,379424,168,2,utRho09
tgt,852110,852274,852110,164,12,utRho09
thiD,4369346,4369346,4369032,314,4,utRho09
thiI,882936,883098,882936,162,346,utRho09
thiM,4370902,4370902,4370602,300,210,utRho09
thiQ,146170,146170,145854,316,114,utRho09
thrL,592,760,592,168,68,utRho09
thrS,7210932,7210932,7210280,652,1204,utRho09
thrU,8350762,8350776,8350762,14,8,utRho09
thrV,6847414,6847414,6847310,104,201320,utRho09
thrW,525682,525742,525682,60,130,utRho09
thyA,5930696,5930696,5930310,386,3240,utRho09
tig,909986,910266,909986,280,1522,utRho09
tisB,7706674,7707106,7706674,432,314,utRho09
tktA,6163414,6163414,6163270,144,168,utRho09
tktB,5158616,5159272,5158616,656,242,utRho09
tldD,6784368,6784368,6784056,312,0,utRho09
tmcA,5191876,5191876,5191718,158,6,utRho09
tnaC,15553644,15553740,15553644,96,664,utRho09
tolB,1555074,1555480,1555074,406,230,utRho09
tolC,6356008,6356230,6356008,222,472,utRho09
tomB,961588,961588,961416,172,806,utRho09
tonB,2622108,2622178,2622108,70,2,utRho09
topA,2661578,2662096,2661578,518,674,utRho09
torC,2116112,2116168,2116112,56,92,utRho09
torR,2115968,2115968,2115908,60,200,utRho09
torS,2112364,2112364,2112356,8,0,utRho09
torT,2112414,2112522,2112414,108,0,utRho09
tpiA,8223138,8223138,8223014,124,32,utRho09
tppB,3425342,3425538,3425342,196,8578,utRho09
tpr,2574376,2574376,2574376,0,0,utRho09
tpx,2777688,2777688,2777622,66,462,utRho09
tqsA,3347780,3347826,3347780,46,0,utRho09
treA,2494850,2494850,2494752,98,106,utRho09
treB,8932420,8932420,8932360,60,24,utRho09
treF,7339102,7339184,7339102,82,52,utRho09
treR,8934694,8934694,8934492,202,6,utRho09
trg,2984878,2984940,2984878,62,0,utRho09
trkG,2847342,2847564,2847342,222,2,utRho09
trmA,8326590,8326590,8326540,50,44,utRho09
trpA,2634678,2634678,2634444,234,1340,utRho09
trpC,2639888,2639888,2639570,318,8,utRho09
trpL,5292432,5292432,5292328,104,0,utRho09
trpR,9265408,9265520,9265408,112,0,utRho09
trpS,7027394,7027394,7027276,118,2446,utRho09
trpT,7893560,7893914,7893560,354,132974,utRho09
trxA,7931294,7931522,7931294,228,440,utRho09
trxB,1864156,1864156,1864100,56,64,utRho09
trxC,5437350,5437470,5437350,120,170,utRho09
tsaD,6421256,6421256,6421086,170,12,utRho09
tsgA,6985038,6985136,6985038,98,8,utRho09
tsr,9182824,9183314,9182824,490,126,utRho09
tsx,864490,864490,864026,464,464,utRho09
ttcA,2823970,2823970,2823896,74,4760,utRho09
ttdA,6412848,6412926,6412848,78,0,utRho09
ttdR,6412760,6412760,6412512,248,6,utRho09
tufA,6943448,6943448,6942658,790,202382,utRho09
tus,3368346,3368518,3368346,172,180,utRho09
tusA,7218040,7218040,7217992,48,56,utRho09
tusB,6950218,6950218,6949930,288,1610,utRho09
tynA,2902996,2902996,2902698,298,60,utRho09
typA,8116460,8116814,8116460,354,11628,utRho09
tyrB,8534164,8534228,8534164,64,3296,utRho09
tyrP,3979004,3979362,3979004,358,4,utRho09
tyrR,2773384,2773440,2773384,56,0,utRho09
tyrS,3434566,3434566,3434444,122,22,utRho09
tyrT,2575330,2575330,2575244,86,62,utRho09
uacT,6062378,6062734,6062378,356,0,utRho09
ubiC,8504886,8505012,8504886,126,2,utRho09
ubiD,8049618,8049976,8049618,358,424,utRho09
ubiE,8037494,8037710,8037494,216,54,utRho09
ubiG,4679078,4679134,4679078,56,0,utRho09
ucpA,5089342,5089342,5089246,96,0,utRho09
udp,8032782,8032862,8032782,80,0,utRho09
ugd,4199470,4199470,4199226,244,0,utRho09
ugpB,7184852,7184852,7184650,202,132,utRho09
ugpQ,7176600,7176600,7176226,374,0,utRho09
uhpT,7694396,7694396,7694334,62,2,utRho09
uidA,3392304,3392304,3392142,162,0,utRho09
uidC,3386012,3386012,3385702,310,0,utRho09
uidR,3394150,3394150,3394104,46,104,utRho09
ulaA,8839854,8839960,8839854,106,2,utRho09
ulaG,8839350,8839350,8839250,100,2,utRho09
ulaR,8837124,8837124,8836906,218,0,utRho09
umpG,5741372,5741372,5740548,824,200,utRho09
umpH,1400704,1400704,1400652,52,2,utRho09
umuD,2461476,2461534,2461476,58,0,utRho09
ung,5433476,5433508,5433476,32,2,utRho09
uof,2843316,2843316,2842900,416,7928,utRho09
upp,5241818,5241818,5241744,74,768,utRho09
usg,4873780,4873780,4873298,482,224,utRho09
ushA,1009772,1009828,1009772,56,0,utRho09
uspA,7279966,7280222,7279966,256,274,utRho09
uspB,7279696,7279696,7279440,256,8,utRho09
uspC,3959172,3959506,3959172,334,0,utRho09
uspE,2797318,2797318,2797244,74,0,utRho09
uspF,2871282,2871282,2871238,44,0,utRho09
uspG,1283806,1283806,1283734,72,122,utRho09
uvrA,8547872,8547872,8547742,130,54,utRho09
uvrB,1626304,1627052,1626304,748,578,utRho09
uvrC,3989758,3989758,3989412,346,296,utRho09
uvrD,7995814,7995966,7995814,152,88,utRho09
uvrY,3990812,3990812,3990718,94,20,utRho09
uxaB,3221474,3221474,3221360,114,10,utRho09
uxaC,6489714,6489714,6489482,232,68,utRho09
uxuA,9103036,9103272,9103036,236,488,utRho09
uxuR,9108916,9109152,9108916,236,0,utRho09
valS,8967854,8967854,8967674,180,428,utRho09
valU,5041848,5041862,5041848,14,0,utRho09
valV,3492830,3492870,3492830,40,18,utRho09
ves,3649968,3649968,3649874,94,0,utRho09
waaA,7616512,7617080,7616512,568,80,utRho09
waaH,7580298,7580298,7580162,136,12,utRho09
waaQ,7616476,7616476,7616196,280,170,utRho09
waaU,7598996,7598996,7598624,372,130,utRho09
waaY,7602272,7602272,7601930,342,11426,utRho09
wbbH,4214888,4214888,4214452,436,5086,utRho09
wbbK,4209212,4209212,4209018,194,270,utRho09
wcaM,4231868,4231868,4231792,76,0,utRho09
wrbA,2135516,2135516,2135416,100,0,utRho09
wza,4275166,4275166,4274486,680,4,utRho09
wzxC,4240674,4240674,4240316,358,0,utRho09
wzzB,4196950,4196950,4196602,348,150,utRho09
xanP,7657642,7657890,7657642,248,0,utRho09
xanQ,6048520,6048702,6048520,182,0,utRho09
xapA,5049820,5049820,5049756,64,0,utRho09
xapR,10090252,10090252,10089908,344,0,utRho09
xdhA,6000514,6000690,6000514,176,56,utRho09
xerD,6079702,6079702,6079486,216,188,utRho09
xseA,5268394,5268464,5268394,70,72,utRho09
xseB,882746,882746,882686,60,204,utRho09
xthA,3664798,3664856,3664798,58,0,utRho09
xylA,7461614,7461614,7461530,84,198,utRho09
xylE,8484540,8484540,8484508,32,0,utRho09
xylF,7462138,7462262,7462138,124,0,utRho09
xylR,7469812,7469958,7469812,146,0,utRho09
yaaA,13230,13230,12918,312,106,utRho09
yaaI,23876,23876,23572,304,10,utRho09
yaaJ,16034,16034,15918,116,62,utRho09
yaaU,91184,91614,91184,430,4,utRho09
yaaW,23084,23084,22712,372,122,utRho09
yaaX,10060,10468,10060,408,42,utRho09
yabI,142542,142702,142542,160,0,utRho09
yacC,273880,273880,273834,46,278,utRho09
yacH,262932,262932,262520,412,0,utRho09
yacL,268678,268776,268678,98,72,utRho09
yadD,293796,293936,293796,140,2,utRho09
yadE,289930,290162,289930,232,196,utRho09
yadN,314110,314110,313766,344,0,utRho09
yadS,355572,355572,355248,324,128,utRho09
yadV,312470,312470,312402,68,62,utRho09
yaeF,434270,434270,434006,264,2,utRho09
yaeP,428374,428374,428250,124,4,utRho09
yaeQ,428176,428582,428176,406,54,utRho09
yaeR,423716,423754,423716,38,0,utRho09
yafC,462166,462166,461762,404,24,utRho09
yafD,462128,462244,462128,116,34,utRho09
yafK,491986,491986,491610,376,670,utRho09
yafL,493282,493424,493282,142,0,utRho09
yafN,503938,504010,503938,72,0,utRho09
yafS,469568,469632,469568,64,184,utRho09
yafT,474470,474670,474470,200,0,utRho09
yafV,480432,480432,480378,54,0,utRho09
yafZ,536052,536052,536010,42,0,utRho09
yagE,564446,564556,564446,110,0,utRho09
yagG,570414,570790,570414,376,0,utRho09
yagI,578384,578384,578324,60,0,utRho09
yagK,586236,586236,585896,340,38,utRho09
yagL,588062,588062,587836,226,0,utRho09
yagN,591342,591342,591158,184,726,utRho09
yahA,663746,664742,663746,996,86,utRho09
yahC,670136,670136,670044,92,2,utRho09
yahE,671478,671850,671478,372,0,utRho09
yahM,690504,690808,690504,304,62,utRho09
yahN,692872,692872,692674,198,64,utRho09
yahO,692864,692968,692864,104,32,utRho09
yaiE,816296,816354,816296,58,2,utRho09
yaiI,811396,811528,811396,132,2,utRho09
yaiO,761946,761946,761684,262,2,utRho09
yaiP,767970,767970,767870,100,0,utRho09
yaiS,769660,769660,769232,428,4,utRho09
yaiV,788922,788922,788922,0,0,utRho09
yaiY,799094,799094,798666,428,2,utRho09
yaiZ,798888,799186,798888,298,20,utRho09
yajC,854410,854574,854410,164,1622,utRho09
yajD,860938,861210,860938,272,276,utRho09
yajI,866068,866068,865702,366,558,utRho09
yajL,887496,887496,887282,214,344,utRho09
yajQ,889316,889366,889316,50,2,utRho09
yajR,893374,893374,893332,42,148,utRho09
ybaB,987418,988152,987418,734,3716,utRho09
ybaL,1006590,1006590,1006476,114,32,utRho09
ybaM,980648,980648,980542,106,402,utRho09
ybaN,981436,981764,981436,328,368,utRho09
ybaO,936704,936766,936704,62,0,utRho09
ybaP,1016568,1016568,1016160,408,252,utRho09
ybaQ,1016348,1016436,1016348,88,0,utRho09
ybaS,1023146,1023282,1023146,136,16,utRho09
ybaV,927504,927874,927504,370,112,utRho09
ybaY,950490,950758,950490,268,138,utRho09
ybbB,1062724,1062724,1062452,272,14,utRho09
ybbJ,1030154,1030154,1029718,436,330,utRho09
ybbL,1031784,1031838,1031784,54,0,utRho09
ybbN,1037136,1037136,1036558,578,2232,utRho09
ybbO,1038658,1038658,1038298,360,1506,utRho09
ybbY,1080718,1081130,1080718,412,2,utRho09
ybcH,1176140,1176140,1175962,178,2,utRho09
ybcI,1113264,1113264,1113106,158,314,utRho09
ybcJ,1114050,1114050,1113746,304,380,utRho09
ybcK,1137502,1137804,1137502,302,34,utRho09
ybcL,1141690,1141786,1141690,96,0,utRho09
ybcN,1144628,1144932,1144628,304,2,utRho09
ybcQ,1147548,1147912,1147548,364,0,utRho09
ybcW,1159610,1159760,1159610,150,0,utRho09
ybdD,1263982,1264364,1263982,382,4,utRho09
ybdF,1212106,1212106,1211772,334,76,utRho09
ybdH,1267048,1267048,1266954,94,0,utRho09
ybdJ,1212822,1212822,1212398,424,0,utRho09
ybdK,1215122,1215122,1214766,356,0,utRho09
ybdL,1267114,1267172,1267114,58,2,utRho09
ybdM,1271110,1271110,1270752,358,78,utRho09
ybdN,1273372,1273372,1273138,234,2,utRho09
ybdR,1283844,1284176,1283844,332,128,utRho09
ybeD,1325412,1325412,1325284,128,396,utRho09
ybeF,1323090,1323090,1322756,334,48,utRho09
ybeL,1349986,1350036,1349986,50,16,utRho09
ybeQ,1353412,1353412,1353094,318,2,utRho09
ybeR,1353120,1353422,1353120,302,2,utRho09
ybeT,1358832,1358832,1358812,20,0,utRho09
ybeU,1358924,1359016,1358924,92,0,utRho09
ybeZ,1386938,1386938,1386834,104,6160,utRho09
ybfA,1458074,1458268,1458074,194,12,utRho09
ybfE,1423878,1423878,1423796,82,338,utRho09
ybfF,1425692,1425692,1425604,88,166,utRho09
ybfH,1433282,1433282,1433194,88,2,utRho09
ybgA,1477840,1478002,1477840,162,0,utRho09
ybgC,1549288,1549504,1549288,216,4,utRho09
ybgD,1505916,1505916,1505590,326,202,utRho09
ybgI,1485238,1485654,1485238,416,0,utRho09
ybgO,1498370,1498370,1497964,406,0,utRho09
ybgS,1570992,1570992,1570634,358,0,utRho09
ybhA,1597184,1597184,1596862,322,26,utRho09
ybhB,1616070,1616070,1615818,252,272,utRho09
ybhC,1614642,1614642,1614562,80,1702,utRho09
ybhD,1601418,1601418,1601276,142,0,utRho09
ybhH,1601104,1601518,1601104,414,0,utRho09
ybhK,1633384,1633384,1633294,90,2,utRho09
ybhM,1641556,1641586,1641556,30,2,utRho09
ybhN,1645296,1645296,1644996,300,0,utRho09
ybhQ,1649202,1649260,1649202,58,14,utRho09
ybiA,1665920,1665920,1665900,20,0,utRho09
ybiI,1676968,1676968,1676912,56,36,utRho09
ybiO,1691328,1691328,1690960,368,22,utRho09
ybiP,1705252,1705252,1705194,58,150,utRho09
ybiS,1711572,1711572,1711488,84,784,utRho09
ybiT,1711894,1711926,1711894,32,0,utRho09
ybiU,1718212,1718212,1718122,90,2,utRho09
ybiV,1720176,1720176,1720056,120,0,utRho09
ybiW,1725566,1725566,1725212,354,86,utRho09
ybiX,1678548,1678548,1678414,134,256,utRho09
ybjC,1781784,1781826,1781784,42,0,utRho09
ybjE,1830154,1830154,1829714,440,112,utRho09
ybjG,1767016,1767016,1766776,240,1104,utRho09
ybjL,1779882,1779882,1779638,244,86,utRho09
ybjM,1779770,1780178,1779770,408,74,utRho09
ybjO,1795704,1795978,1795704,274,0,utRho09
ybjP,1809046,1809046,1808934,112,0,utRho09
ybjQ,1809034,1809186,1809034,152,0,utRho09
ybjS,1813796,1813796,1813506,290,192,utRho09
ybjX,1838206,1838206,1838168,38,20,utRho09
ycaD,1891438,1891742,1891438,304,0,utRho09
ycaI,1928210,1928640,1928210,430,174,utRho09
ycaK,1899094,1899336,1899094,242,0,utRho09
ycaL,1920264,1920528,1920264,264,56,utRho09
ycaM,1894240,1894458,1894240,218,4,utRho09
ycaR,1941284,1941346,1941284,62,840,utRho09
ycbB,1961862,1962094,1961862,232,0,utRho09
ycbJ,1943344,1943504,1943344,160,0,utRho09
ycbK,1966046,1966150,1966046,104,200,utRho09
ycbZ,2036920,2036920,2036598,322,0,utRho09
yccA,2062886,2062886,2062836,50,2,utRho09
yccF,2048730,2048730,2048696,34,2,utRho09
yccS,2047988,2047988,2047766,222,34,utRho09
yccT,2055674,2055674,2055546,128,36,utRho09
yccX,2059960,2060128,2059960,168,2,utRho09
ycdT,2185682,2185752,2185682,70,0,utRho09
ycdU,2191266,2191686,2191266,420,2,utRho09
ycdZ,2200504,2200592,2200504,88,82,utRho09
yceA,2233544,2233614,2233544,70,194,utRho09
yceD,2293298,2293588,2293298,290,9036,utRho09
yceF,2293522,2293522,2293190,332,5566,utRho09
yceH,2252154,2252314,2252154,160,1660,utRho09
yceI,2237282,2237282,2236952,330,192,utRho09
yceJ,2238142,2238142,2238092,50,12,utRho09
yceM,2253208,2253612,2253208,404,44,utRho09
yceO,2239264,2239264,2238894,370,88,utRho09
yceQ,2288760,2289004,2288760,244,7912,utRho09
ycfD,2376540,2376540,2376480,60,140,utRho09
ycfJ,2334814,2335198,2334814,384,144,utRho09
ycfS,2340834,2340834,2340748,86,0,utRho09
ycfT,2350658,2350658,2350330,328,0,utRho09
ycfZ,2362760,2362760,2362534,226,142,utRho09
ycgB,2474570,2474570,2474482,88,0,utRho09
ycgG,2434614,2434656,2434614,42,38,utRho09
ycgJ,2452956,2453200,2452956,244,0,utRho09
ycgL,2455218,2455362,2455218,144,0,utRho09
ycgN,2457366,2457660,2457366,294,24,utRho09
ycgR,2489112,2489112,2489054,58,0,utRho09
ycgV,2512222,2512222,2511904,318,286,utRho09
ycgX,2426568,2426568,2426214,354,3580,utRho09
ycgY,2490166,2490320,2490166,154,0,utRho09
ycgZ,2431504,2431578,2431504,74,0,utRho09
ychE,2596904,2597196,2596904,292,12,utRho09
ychF,2515764,2515764,2515624,140,2,utRho09
ychH,2517476,2517582,2517476,106,114,utRho09
ychJ,2578354,2578354,2578264,90,26,utRho09
ychN,2547310,2547310,2547198,112,0,utRho09
ychO,2547520,2547850,2547520,330,56,utRho09
ychQ,2533798,2533848,2533798,50,28,utRho09
yciA,2624828,2624828,2624492,336,216,utRho09
yciB,2626110,2626110,2625780,330,6176,utRho09
yciC,2627396,2627396,2627326,70,2,utRho09
yciE,2630794,2630794,2630448,346,38,utRho09
yciG,5264368,5264368,5264140,228,0,utRho09
yciI,2621784,2621784,2621730,54,0,utRho09
yciN,2661606,2661606,2661336,270,36,utRho09
yciS,2680270,2680486,2680270,216,104,utRho09
yciT,2689088,2689088,2688692,396,480,utRho09
yciU,2614718,2614718,2614300,418,550,utRho09
yciV,2646376,2646440,2646376,64,0,utRho09
yciW,2700472,2700472,2700214,258,98,utRho09
yciZ,2689276,2689276,2689218,58,154,utRho09
ycjD,2703792,2703792,2703520,272,166,utRho09
ycjG,2777748,2777860,2777748,112,90,utRho09
ycjM,2740006,2740432,2740006,426,36,utRho09
ycjW,2767982,2767982,2767922,60,64,utRho09
ycjX,2768138,2768234,2768138,96,40,utRho09
ycjY,5568288,5568288,5567460,828,0,utRho09
ydaE,2836438,2836438,2836016,422,0,utRho09
ydaN,2816048,2816100,2816048,52,0,utRho09
ydaS,2840340,2840730,2840340,390,62,utRho09
ydbC,2948376,2948442,2948376,66,0,utRho09
ydbD,2950132,2950288,2950132,156,0,utRho09
ydbH,2885800,2886102,2885800,302,98,utRho09
ydbJ,2881712,2882116,2881712,404,8,utRho09
ydbK,2881692,2881692,2881568,124,50,utRho09
ydcA,2983294,2983354,2983294,60,16,utRho09
ydcF,2974404,2974470,2974404,66,0,utRho09
ydcI,2990268,2990268,2990142,126,14,utRho09
ydcJ,2990266,2990576,2990266,310,2,utRho09
ydcK,3001280,3001280,3000898,382,4,utRho09
ydcL,3004646,3004914,3004646,268,0,utRho09
ydcN,3012308,3012344,3012308,36,8,utRho09
ydcP,3013508,3013562,3013508,54,44,utRho09
ydcR,3019956,3020006,3019956,50,0,utRho09
ydcS,3022906,3023308,3022906,402,0,utRho09
ydcX,3034442,3034778,3034442,336,10,utRho09
ydcY,3035220,3035296,3035220,76,104,utRho09
ydcZ,3036750,3036750,3036662,88,32,utRho09
yddB,3155332,3155332,3155238,94,0,utRho09
yddE,3071738,3071738,3071716,22,0,utRho09
yddG,3094410,3094410,3094338,72,0,utRho09
yddJ,3089732,3089732,3089438,294,4,utRho09
yddW,3137704,3137704,3137646,58,0,utRho09
ydeA,3233910,3234056,3233910,146,78,utRho09
ydeE,3242528,3242664,3242528,136,2,utRho09
ydeI,3249118,3249118,3248994,124,0,utRho09
ydeJ,3249376,3249546,3249376,170,0,utRho09
ydeN,3165458,3165458,3165048,410,0,utRho09
ydeP,3173328,3173328,3172972,356,0,utRho09
ydeR,3176596,3176596,3176592,4,0,utRho09
ydfA,3296872,3297016,3296872,144,0,utRho09
ydfG,3254982,3255034,3254982,52,0,utRho09
ydfH,3256652,3256704,3256652,52,96,utRho09
ydfK,3265446,3266144,3265446,698,578,utRho09
ydgA,3379588,3379704,3379588,116,36,utRho09
ydgC,3364124,3364124,3364060,64,56,utRho09
ydgD,3343906,3343920,3343906,14,2,utRho09
ydgH,3356754,3356854,3356754,100,114,utRho09
ydgJ,3408798,3408798,3408616,182,26,utRho09
ydgK,3410414,3410500,3410414,86,174,utRho09
ydhB,3479618,3479618,3479596,22,0,utRho09
ydhC,3479698,3479822,3479698,124,0,utRho09
ydhF,3451310,3451310,3451264,46,0,utRho09
ydhI,3441996,3442050,3441996,54,0,utRho09
ydhL,3451864,3451864,3451840,24,4,utRho09
ydhQ,3492404,3492404,3492254,150,0,utRho09
ydhS,3494136,3494262,3494136,126,4,utRho09
ydhT,3499138,3499138,3499118,20,0,utRho09
ydhY,3509284,3509284,3508954,330,0,utRho09
ydhZ,3510418,3510418,3510282,136,4,utRho09
ydiE,3579206,3579226,3579206,20,0,utRho09
ydiH,3530582,3530582,3530406,176,0,utRho09
ydiM,3541852,3542142,3541852,290,0,utRho09
ydiN,3544818,3545024,3544818,206,0,utRho09
ydiP,3558656,3558656,3558602,54,0,utRho09
ydiU,3582508,3582508,3582488,20,4,utRho09
ydiV,3584174,3584174,3584040,134,152,utRho09
ydiY,3612500,3612500,3612166,334,0,utRho09
ydjA,3697400,3697400,3697352,48,2,utRho09
ydjE,3708082,3708082,3707958,124,0,utRho09
ydjF,3709848,3709848,3709708,140,4,utRho09
ydjM,3620340,3620422,3620340,82,0,utRho09
ydjO,3626696,3626696,3626288,408,0,utRho09
ydjX,3666434,3666802,3666434,368,396,utRho09
yeaE,3731448,3731448,3731272,176,142,utRho09
yeaG,3733530,3733816,3733530,286,0,utRho09
yeaI,3740486,3740770,3740486,284,4,utRho09
yeaJ,3743874,3744082,3743874,208,4,utRho09
yeaL,3748646,3748704,3748646,58,98,utRho09
yeaM,3751296,3751296,3751152,144,0,utRho09
yeaN,3750926,3751346,3750926,420,2,utRho09
yeaO,3753554,3753818,3753554,264,42,utRho09
yeaP,3755314,3755430,3755314,116,306,utRho09
yeaQ,3758780,3758780,3758510,270,0,utRho09
yeaR,3759988,3759988,3759896,92,20,utRho09
yeaY,3781122,3781122,3781064,58,166,utRho09
yebB,3892220,3892502,3892220,282,32,utRho09
yebC,3896370,3896370,3896302,68,148,utRho09
yebE,3859464,3859464,3859414,50,6,utRho09
yebG,3861530,3861530,3861494,36,0,utRho09
yebK,3873180,3873304,3873180,124,38,utRho09
yebQ,3820314,3820552,3820314,238,0,utRho09
yebS,3832238,3832516,3832238,278,0,utRho09
yebV,3843430,3843560,3843430,130,0,utRho09
yebW,3843914,3844242,3843914,328,770,utRho09
yecC,3995646,3995646,3995628,18,22,utRho09
yecD,3901272,3901664,3901272,392,18,utRho09
yecF,3991434,3991636,3991434,202,6,utRho09
yecH,3979304,3979304,3978980,324,2,utRho09
yecJ,3975604,3975604,3975516,88,0,utRho09
yecM,3919968,3919968,3919692,276,30,utRho09
yecR,3976400,3976444,3976400,44,0,utRho09
yecT,3923862,3923944,3923862,82,0,utRho09
yedD,4016522,4016522,4016180,342,144,utRho09
yedE,4016310,4016554,4016310,244,156,utRho09
yedI,4058922,4058922,4058732,190,0,utRho09
yedJ,4066446,4066446,4066158,288,6,utRho09
yedV,4076404,4076404,4076304,100,90,utRho09
yedX,4077680,4077912,4077680,232,0,utRho09
yedY,4078572,4078956,4078572,384,2,utRho09
yeeA,4161322,4161322,4161182,140,96,utRho09
yeeE,4171104,4171104,4171050,54,4,utRho09
yeeJ,4089526,4089822,4089526,296,112,utRho09
yeeN,4113508,4113716,4113508,208,60,utRho09
yeeO,4119444,4119444,4119692,248,0,utRho09
yeeX,4158834,4158834,4158722,112,168,utRho09
yeeZ,4178422,4178422,4178256,166,0,utRho09
yefM,4179466,4179466,4179426,40,2,utRho09
yegD,4295288,4295348,4295288,60,44,utRho09
yegH,4275726,4275804,4275726,78,0,utRho09
yegI,4302154,4302154,4301970,184,0,utRho09
yegJ,4302032,4302370,4302032,338,0,utRho09
yegQ,4331182,4331336,4331182,154,88,utRho09
yegR,4336698,4336698,4336612,86,20,utRho09
yegS,4337086,4337424,4337086,338,8,utRho09
yegT,4357562,4357642,4357562,80,0,utRho09
yegX,4367640,4367640,4367302,338,0,utRho09
yehA,4376944,4376944,4376828,116,0,utRho09
yehE,4385818,4385818,4385592,226,0,utRho09
yehK,4407568,4407944,4407568,376,4,utRho09
yehL,4408804,4409192,4408804,388,0,utRho09
yeiB,4486146,4486146,4485934,212,28,utRho09
yeiE,4499422,4499422,4499236,186,2,utRho09
yeiG,4487776,4487820,4487776,44,506,utRho09
yeiH,4499332,4499434,4499332,102,2,utRho09
yeiI,4503306,4503400,4503306,94,56,utRho09
yeiL,4510580,4510710,4510580,130,0,utRho09
yeiP,4530834,4530900,4530834,66,460,utRho09
yeiQ,4532328,4532490,4532328,162,0,utRho09
yeiR,4535484,4535658,4535484,174,170,utRho09
yeiW,4530840,4530840,4530590,250,1122,utRho09
yejA,4544624,4544728,4544624,104,0,utRho09
yejG,4556892,4556892,4556474,418,476,utRho09
yejH,4561244,4561264,4561244,20,0,utRho09
yejK,4568218,4568218,4567894,324,222,utRho09
yejO,4578352,4578352,4577800,552,68,utRho09
yfaD,4713380,4713808,4713380,428,136,utRho09
yfaE,4696676,4697028,4696676,352,514,utRho09
yfaL,4688568,4688568,4688338,230,0,utRho09
yfaP,4656398,4656398,4656286,112,0,utRho09
yfaU,4717892,4717892,4717690,202,0,utRho09
yfaY,4727310,4727310,4727266,44,4,utRho09
yfaZ,4728744,4728744,4728550,194,2,utRho09
yfbK,4771810,4771810,4771444,366,4,utRho09
yfbL,4771500,4771720,4771500,220,2,utRho09
yfbN,4777174,4777174,4776852,322,20,utRho09
yfbO,4776916,4777162,4776916,246,20,utRho09
yfbP,4777990,4778232,4777990,242,72,utRho09
yfbR,4817662,4817724,4817662,62,12,utRho09
yfcI,4847424,4847424,4847078,346,16,utRho09
yfcJ,4880482,4880482,4880240,242,284,utRho09
yfcL,4888502,4888502,4888338,164,8,utRho09
yfcV,4911642,4911642,4911292,350,4,utRho09
yfcZ,4921958,4921958,4921868,90,8,utRho09
yfdF,4925604,4926024,4925604,420,196,utRho09
yfdG,4935474,4935710,4935474,236,0,utRho09
yfdP,4946844,4947040,4946844,196,0,utRho09
yfdX,4988866,4988866,4988804,62,0,utRho09
yfdY,4990672,4990672,4990584,88,4,utRho09
yfeA,5035784,5035784,5035664,120,5038,utRho09
yfeC,5036668,5036934,5036668,266,42,utRho09
yfeH,5053818,5053892,5053818,74,0,utRho09
yfeK,5074630,5074684,5074630,54,0,utRho09
yfeO,5018906,5019260,5018906,354,104,utRho09
yfeR,5054078,5054078,5053712,366,60,utRho09
yfeX,5101356,5101356,5101090,266,0,utRho09
yfeY,5102486,5102486,5102432,54,0,utRho09
yfeZ,5103842,5103842,5103452,390,50,utRho09
yffO,5123804,5124222,5123804,418,0,utRho09
yffQ,5126778,5127154,5126778,376,16,utRho09
yffS,5128800,5128986,5128800,186,26,utRho09
yfgC,5232052,5232188,5232052,136,0,utRho09
yfgF,5258062,5258062,5257876,186,54,utRho09
yfgG,5258170,5258580,5258170,410,148,utRho09
yfgH,5259344,5259584,5259344,240,0,utRho09
yfgM,5278866,5278866,5278566,300,250,utRho09
yfhH,5397414,5397518,5397414,104,0,utRho09
yfhM,5304648,5304648,5304574,74,0,utRho09
yfhR,5328408,5328726,5328408,318,928,utRho09
yfiC,5425610,5425610,5425528,82,0,utRho09
yfiE,5430688,5430688,5430640,48,4,utRho09
yfiL,5482630,5482720,5482630,90,0,utRho09
yfiM,5448066,5448358,5448066,292,6360,utRho09
yfiR,5483354,5483750,5483354,396,74,utRho09
yfjH,5517326,5517326,5517200,126,2,utRho09
yfjI,5517710,5517970,5517710,260,0,utRho09
yfjJ,5521014,5521094,5521014,80,0,utRho09
yfjM,5531970,5531970,5531552,418,238,utRho09
yfjP,5535080,5535420,5535080,340,56,utRho09
yfjW,5546570,5546636,5546570,66,34,utRho09
yfjX,5551776,5551838,5551776,62,0,utRho09
ygaC,5601180,5601180,5599988,1192,116,utRho09
ygaM,5600242,5600292,5600242,50,34,utRho09
ygaU,5593628,5593628,5593572,56,14,utRho09
ygaZ,5619190,5619234,5619190,44,46,utRho09
ygbA,5713656,5713656,5713612,44,0,utRho09
ygbE,5746784,5746784,5746674,110,2,utRho09
ygbI,5722882,5722882,5722528,354,0,utRho09
ygbK,5724394,5724670,5724394,276,6,utRho09
ygbL,5727074,5727186,5727074,112,74,utRho09
ygbN,5729814,5730202,5729814,388,92,utRho09
ygcG,5811210,5811422,5811210,212,44,utRho09
ygcN,5785144,5785314,5785144,170,44,utRho09
ygcU,5799214,5799214,5798836,378,106,utRho09
ygcW,5800942,5800942,5800546,396,0,utRho09
ygdD,5883442,5883442,5883262,180,0,utRho09
ygdG,5861746,5861930,5861746,184,280,utRho09
ygdI,5886526,5886526,5886290,236,0,utRho09
ygdQ,5940784,5940840,5940784,56,0,utRho09
ygdR,5942494,5942542,5942494,48,12,utRho09
ygeA,5961606,5961606,5961270,336,10,utRho09
ygeH,5983758,5984188,5983758,430,0,utRho09
ygeI,5987162,5987276,5987162,114,10,utRho09
ygeR,6000078,6000078,5999782,296,84,utRho09
ygeV,6011694,6011694,6011572,122,52,utRho09
ygeW,6012234,6012524,6012234,290,70,utRho09
ygfB,6110946,6110946,6110888,58,42,utRho09
ygfK,6031984,6032120,6031984,136,0,utRho09
ygfS,6058328,6058328,6058024,304,0,utRho09
ygfZ,6082564,6082626,6082564,62,0,utRho09
yggC,6149512,6149512,6149378,134,58,utRho09
yggE,6136370,6136370,6136160,210,2,utRho09
yggI,6179176,6179510,6179176,334,20,utRho09
yggL,6204508,6204508,6204266,242,278,utRho09
yggM,6199514,6199514,6199130,384,140,utRho09
yggN,6203596,6203596,6203246,350,4,utRho09
yggX,18623958,18624558,18623958,600,624,utRho09
yghA,6298966,6299324,6298966,358,4,utRho09
yghB,6307058,6307126,6307058,68,2,utRho09
yghD,6222614,6222614,6222252,362,0,utRho09
yghF,6225798,6225798,6225840,42,0,utRho09
yghJ,6238640,6238640,6238224,416,0,utRho09
yghQ,6265186,6265186,6264816,370,0,utRho09
yghT,6267830,6268262,6267830,432,14,utRho09
yghU,6277400,6277454,6277400,54,36,utRho09
yghW,6293506,6293506,6293474,32,0,utRho09
yghZ,6295562,6295794,6295562,232,0,utRho09
ygiD,6365122,6365122,6364868,254,182,utRho09
ygiH,6409066,6409388,6409066,322,36,utRho09
ygiL,6370622,6370828,6370622,206,0,utRho09
ygiM,6402084,6402414,6402084,330,136,utRho09
ygiN,6346156,6346284,6346156,128,1378,utRho09
ygiQ,6322620,6322620,6322292,328,322,utRho09
ygiS,6335462,6335462,6335436,26,0,utRho09
ygiV,6338582,6338582,6338462,120,18,utRho09
ygiW,6339774,6339774,6339352,422,8,utRho09
ygiZ,6344506,6344506,6344422,84,0,utRho09
ygjH,6442528,6442528,6442494,34,0,utRho09
ygjI,6452140,6452468,6452140,328,0,utRho09
ygjQ,6472730,6473080,6472730,350,262,utRho09
ygjR,6474564,6474586,6474564,22,4,utRho09
ygjV,6483638,6483638,6483488,150,0,utRho09
yhaB,6535632,6535708,6535632,76,2,utRho09
yhaH,6504498,6504608,6504498,110,16,utRho09
yhaI,6505400,6505822,6505400,422,18,utRho09
yhaJ,6508560,6508560,6508428,132,0,utRho09
yhaK,6508538,6508638,6508538,100,0,utRho09
yhbQ,6599878,6599932,6599878,54,34,utRho09
yhbT,6602736,6602736,6602552,184,46,utRho09
yhbU,6602558,6602970,6602558,412,48,utRho09
yhbX,6643302,6643302,6643226,76,2,utRho09
yhbY,6655518,6655580,6655518,62,660,utRho09
yhcA,6723956,6724224,6723956,268,8,utRho09
yhcB,6760364,6760382,6760364,18,98,utRho09
yhcC,6708470,6708470,6708100,370,70,utRho09
yhcF,6733440,6733852,6733440,412,70,utRho09
yhcH,6739124,6739124,6738956,168,8,utRho09
yhcM,6760312,6760312,6759994,318,72,utRho09
yhcN,6770812,6771076,6770812,264,180,utRho09
yhcO,6772606,6772606,6772258,348,0,utRho09
yhdH,6806560,6806968,6806560,408,120,utRho09
yhdJ,6823234,6823306,6823234,72,0,utRho09
yhdN,6879092,6879092,6879018,74,1466,utRho09
yhdT,6814702,6814750,6814702,48,312,utRho09
yhdU,6824994,6825242,6824994,248,2,utRho09
yhdV,6836392,6836780,6836392,388,12,utRho09
yhdW,6837944,6838298,6837944,354,0,utRho09
yheO,6953082,6953082,6952880,202,916,utRho09
yheV,6957970,6957970,6957584,386,58,utRho09
yhfA,6971902,6971902,6971636,266,154,utRho09
yhfG,6983294,6983294,6983240,54,412,utRho09
yhfL,6998622,6998896,6998622,274,72,utRho09
yhfY,7023244,7023244,7022844,400,36,utRho09
yhgA,7086294,7086334,7086294,40,0,utRho09
yhgE,7065176,7065176,7064878,298,204,utRho09
yhgF,7074352,7074770,7074352,418,986,utRho09
yhhA,7173458,7173886,7173458,428,46,utRho09
yhhI,7248346,7248756,7248346,410,2,utRho09
yhhJ,7253696,7253696,7253606,90,0,utRho09
yhhM,7211588,7211588,7211220,368,2,utRho09
yhhN,7211150,7211502,7211150,352,2,utRho09
yhhQ,7218238,7218434,7218238,196,198,utRho09
yhhT,7223682,7223730,7223682,48,10,utRho09
yhhX,7162032,7162032,7161610,422,24,utRho09
yhhY,7162222,7162276,7162222,54,0,utRho09
yhhZ,7163516,7163726,7163516,210,2,utRho09
yhiD,7312220,7312220,7311804,416,2176,utRho09
yhiJ,7265190,7265190,7265180,10,0,utRho09
yhiM,7269270,7269682,7269270,412,16,utRho09
yhiN,7275000,7275000,7274820,180,8,utRho09
yhjA,7338522,7338522,7338376,146,2,utRho09
yhjB,7344090,7344090,7343788,302,0,utRho09
yhjC,7344272,7344684,7344272,412,0,utRho09
yhjD,7346660,7346724,7346660,64,0,utRho09
yhjE,7349274,7349572,7349274,298,64,utRho09
yhjG,7356824,7356824,7356730,94,2,utRho09
yhjH,7358458,7358458,7358374,84,214,utRho09
yhjJ,7364032,7364032,7363880,152,184,utRho09
yhjK,7371296,7371296,7371158,138,0,utRho09
yhjR,7392750,7392750,7392370,380,0,utRho09
yhjV,7400796,7401126,7400796,330,170,utRho09
yhjX,7424194,7424194,7424014,180,18,utRho09
yhjY,7425966,7425966,7425868,98,0,utRho09
yiaB,7455654,7455654,7455496,158,6,utRho09
yiaD,7432712,7433094,7432712,382,14,utRho09
yiaF,7438194,7438194,7438088,106,0,utRho09
yiaG,7438862,7438956,7438862,94,68,utRho09
yiaJ,7485236,7485236,7485064,172,2,utRho09
yiaK,7485348,7485466,7485348,118,0,utRho09
yiaT,7503924,7503924,7503736,188,0,utRho09
yiaU,7503792,7503984,7503792,192,0,utRho09
yiaY,7515856,7515856,7515654,202,6,utRho09
yibF,7523950,7523950,7523910,40,0,utRho09
yibG,7536128,7536354,7536128,226,12,utRho09
yibL,7553194,7553330,7553194,136,36,utRho09
yibN,7570112,7570112,7570030,82,442,utRho09
yibT,7552848,7552848,7552760,88,152,utRho09
yicC,7633290,7633352,7633290,62,112,utRho09
yicH,7660862,7660914,7660862,52,22,utRho09
yicJ,7673328,7673328,7671858,1470,608,utRho09
yicN,7685018,7685018,7684804,214,20,utRho09
yicO,7687914,7687914,7687578,336,0,utRho09
yicR,15250308,15250308,15250236,72,0,utRho09
yidB,7755230,7755230,7754930,300,8,utRho09
yidE,7732780,7732780,7732546,234,0,utRho09
yidF,7711580,7711580,7711222,358,64,utRho09
yidQ,7735088,7735456,7735088,368,980,utRho09
yidR,7738824,7738824,7738618,206,0,utRho09
yieE,7787658,7787738,7787658,80,30,utRho09
yieH,7793314,7793548,7793314,234,4,utRho09
yieK,7798928,7798928,7798786,142,2,utRho09
yifB,7900350,7900350,7899998,352,36,utRho09
yifL,7988984,7989044,7988984,60,38,utRho09
yigF,8005750,8005750,8005598,152,124,utRho09
yigI,8009448,8009448,8009394,54,30,utRho09
yigM,8022100,8022152,8022100,52,2,utRho09
yihA,8101970,8101970,8101458,512,120,utRho09
yihD,8084098,8084138,8084098,40,0,utRho09
yihF,8088110,8088398,8088110,288,2,utRho09
yihG,8093304,8093304,8093204,100,4,utRho09
yihI,8102616,8102694,8102616,78,32,utRho09
yihL,8120506,8120894,8120506,388,56,utRho09
yihN,8124332,8124494,8124332,162,2,utRho09
yihO,8131942,8131942,8131532,410,2,utRho09
yihQ,8138892,8138892,8138552,340,0,utRho09
yihV,8147064,8147478,8147064,414,0,utRho09
yihX,8151096,8151106,8151096,10,4,utRho09
yiiE,8158192,8158582,8158192,390,8,utRho09
yiiF,8159124,8159502,8159124,378,0,utRho09
yiiG,8173762,8174004,8173762,242,0,utRho09
yiiM,8205506,8205644,8205506,138,20,utRho09
yiiQ,8224624,8224624,8224428,196,0,utRho09
yiiS,8225738,8225934,8225738,196,0,utRho09
yijE,8272178,8272216,8272178,38,0,utRho09
yijF,8275728,8275728,8275314,414,2,utRho09
yijO,8296858,8296858,8296634,224,0,utRho09
yjaA,8426240,8426468,8426240,228,127184,utRho09
yjaB,8428312,8428312,8428246,66,6,utRho09
yjaG,8398746,8399008,8398746,262,1228,utRho09
yjaH,8401022,8401132,8401022,110,430,utRho09
yjaZ,8379506,8379572,8379506,66,40,utRho09
yjbB,8455204,8455462,8455204,258,0,utRho09
yjbE,16943432,16943624,16943432,192,32,utRho09
yjbL,8520318,8520642,8520318,324,0,utRho09
yjbQ,8540428,8540476,8540428,48,0,utRho09
yjcB,8550328,8550328,8550082,246,266,utRho09
yjcC,8550836,8550942,8550836,106,44,utRho09
yjcD,8556628,8556958,8556628,330,82,utRho09
yjcE,8559658,8559960,8559658,302,2,utRho09
yjcF,8566212,8566212,8566150,62,0,utRho09
yjcO,8594660,8594660,8594250,410,0,utRho09
yjdA,8654128,8654270,8654128,142,0,utRho09
yjdC,8726660,8726660,8726616,44,30,utRho09
yjdK,8704780,8705168,8704780,388,58,utRho09
yjdL,8713034,8713034,8712822,212,0,utRho09
yjdM,8653672,8653672,8653468,204,52,utRho09
yjeF,8787354,8788132,8787354,778,3186,utRho09
yjeI,8745522,8745618,8745522,96,4,utRho09
yjeJ,8748806,8748806,8748468,338,64,utRho09
yjeV,8785472,8785784,8785472,312,132,utRho09
yjfP,8833512,8833904,8833512,392,46,utRho09
yjfY,8849656,8849656,8849582,74,0,utRho09
yjfZ,8855052,8855052,8854844,208,2,utRho09
yjgA,8916162,8916162,8915730,432,28,utRho09
yjgL,8950802,8950874,8950802,72,0,utRho09
yjgM,8959342,8959342,8959074,268,0,utRho09
yjgN,8959132,8959460,8959132,328,0,utRho09
yjgR,8980170,8980170,8980126,44,172,utRho09
yjgZ,9002116,9002520,9002116,404,142,utRho09
yjhB,9007764,9008116,9007764,352,2,utRho09
yjhG,9048452,9048452,9048188,264,218,utRho09
yjhU,9041080,9041080,9040648,432,160,utRho09
yjiA,9178096,9178096,9177730,366,582,utRho09
yjiJ,9125364,9125364,9125350,14,0,utRho09
yjiK,9127270,9127270,9127422,152,142,utRho09
yjiL,9129604,9129604,9129378,226,0,utRho09
yjiS,9143410,9143502,9143410,92,0,utRho09
yjiY,9182734,9182734,9182558,176,358,utRho09
yjjA,9200674,9200674,9200378,296,182,utRho09
yjjB,18408708,18408708,18407800,908,16,utRho09
yjjJ,9243314,9243538,9243314,224,46,utRho09
yjjK,9261132,9261132,9261044,88,2,utRho09
yjjL,9189764,9189764,9189444,320,0,utRho09
yjjM,9191894,9191894,9191702,192,8,utRho09
yjjP,9206068,9206068,9205716,352,102,utRho09
yjjQ,9206638,9206954,9206638,316,32,utRho09
yjjX,9267798,9267798,9267490,308,860,utRho09
yjjY,9280716,9280804,9280716,88,636,utRho09
yjjZ,9211554,9211608,9211554,54,50,utRho09
yjtD,9281676,9281884,9281676,208,2,utRho09
ykfB,532454,532454,532174,280,170,utRho09
ykfI,527636,527636,527338,298,88,utRho09
ykgB,637050,637050,636638,412,0,utRho09
ykgC,640430,640430,640002,428,0,utRho09
ykgD,640232,640454,640232,222,0,utRho09
ykgE,642962,643216,642962,254,12,utRho09
ykgJ,608524,608524,608364,160,14,utRho09
ykgL,623878,624224,623878,346,16,utRho09
ykgM,625610,625610,625554,56,0,utRho09
ykgR,626570,626570,626484,86,2,utRho09
ylaC,958576,958576,958502,74,630,utRho09
yliE,1745938,1745958,1745938,20,0,utRho09
ymcE,2103660,2103694,2103660,34,68,utRho09
ymdA,2210450,2210828,2210450,378,142,utRho09
ymdB,2211428,2211640,2211428,212,38,utRho09
ymfD,2395322,2395322,2395064,258,404,utRho09
ymfI,2402880,2402994,2402880,114,0,utRho09
ymfJ,2404518,2404518,2404168,350,278,utRho09
ymfK,2406176,2406176,2405866,310,0,utRho09
ymfT,2405766,2406048,2405766,282,2,utRho09
ymgE,2489110,2489456,2489110,346,4,utRho09
ymgF,2437628,2437966,2437628,338,4,utRho09
ymiA,2670112,2670320,2670112,208,134,utRho09
ymjA,2715620,2715620,2715336,284,444,utRho09
ynaI,2791946,2791946,2791844,102,0,utRho09
ynaK,2850438,2850754,2850438,316,4,utRho09
ynbA,2954924,2955242,2954924,318,2,utRho09
yncD,3046552,3046552,3046130,422,70,utRho09
yncE,3046454,3046614,3046454,160,0,utRho09
yncG,3052456,3052494,3052456,38,44,utRho09
yncL,3034492,3034492,3034388,104,10,utRho09
yneE,3218364,3218364,3218044,320,0,utRho09
yneF,3223748,3223748,3223708,40,0,utRho09
yneJ,3229560,3229608,3229560,48,16,utRho09
yneK,3231100,3231526,3231100,426,2,utRho09
yneM,3245176,3245292,3245176,116,72,utRho09
ynfA,3311398,3311398,3311346,52,12,utRho09
ynfB,3311418,3311616,3311418,198,352,utRho09
ynfC,3315094,3315094,3314914,180,2,utRho09
ynfD,3314828,3315130,3314828,302,60,utRho09
ynfE,3316006,3316138,3316006,132,40,utRho09
ynfK,3334670,3334670,3334438,232,160,utRho09
ynfL,3339304,3339304,3339184,120,0,utRho09
ynfM,3339260,3339398,3339260,138,2,utRho09
ynfN,3276598,3276598,3276218,380,18,utRho09
ynfO,3273454,3273512,3273454,58,0,utRho09
ynhG,3517890,3517890,3517450,440,224,utRho09
yniA,3615158,3615592,3615158,434,4,utRho09
yniB,3618526,3618526,3618466,60,2,utRho09
yniC,3618652,3618760,3618652,108,2,utRho09
yniD,3610202,3610330,3610202,128,0,utRho09
ynjE,3678880,3678934,3678880,54,2,utRho09
ynjF,3683222,3683222,3682806,416,28,utRho09
ynjH,3684376,3684376,3684270,106,0,utRho09
ynjI,3690022,3690022,3689742,280,38,utRho09
yoaB,3786642,3786734,3786642,92,208,utRho09
yoaC,3787932,3788146,3787932,214,212,utRho09
yoaE,3803544,3803544,3803170,374,0,utRho09
yoaF,3755444,3755444,3755064,380,354,utRho09
yoaH,3789866,3789866,3789462,404,558,utRho09
yobB,3850418,3850880,3850418,462,328,utRho09
yobF,3815586,3815586,3815182,404,4,utRho09
yobH,3817800,3817850,3817800,50,0,utRho09
yodB,4084352,4084736,4084352,384,8,utRho09
yodC,4057008,4057008,4056740,268,2,utRho09
yohC,4451358,4451358,4451262,96,0,utRho09
yohD,4451526,4451602,4451526,76,2,utRho09
yohJ,4460986,4461248,4460986,262,0,utRho09
yohO,4431172,4431314,4431172,142,0,utRho09
yojI,4617282,4617282,4617230,52,0,utRho09
ypdI,4988988,4989396,4988988,408,6,utRho09
ypfG,5165786,5165786,5165554,232,2,utRho09
ypfM,5182140,5182140,5181732,408,332,utRho09
yphB,5349590,5349590,5349376,214,16,utRho09
ypjA,5565644,5565644,5565452,192,10,utRho09
ypjB,5569636,5569636,5568858,778,2,utRho09
ypjD,5495860,5495774,5495860,86,0,utRho09
yqaE,5594170,5594170,5594056,114,22,utRho09
yqcA,5846100,5846100,5845968,132,0,utRho09
yqcE,5800944,5801184,5800944,240,0,utRho09
yqeC,6030468,6030468,6030114,354,40,utRho09
yqeF,5971618,5971618,5971184,434,12,utRho09
yqeG,5971438,5971694,5971438,256,4,utRho09
yqeH,5975016,5975072,5975016,56,24,utRho09
yqeI,5976688,5977004,5976688,316,0,utRho09
yqeK,5981140,5981140,5980720,420,22,utRho09
yqfA,6086728,6086728,6086296,432,332,utRho09
yqgA,6219042,6219106,6219042,64,0,utRho09
yqgB,6172500,6172500,6172102,398,4156,utRho09
yqgE,6185768,6185874,6185768,106,360,utRho09
yqhA,6299150,6299150,6298942,208,2,utRho09
yqhC,6310768,6310768,6310436,332,48,utRho09
yqhD,6310604,6310710,6310604,106,48,utRho09
yqhH,6316842,6317254,6316842,412,226,utRho09
yqiC,6369662,6369680,6369662,18,2,utRho09
yqiJ,6384108,6384416,6384108,308,58,utRho09
yqjA,6495096,6495546,6495096,450,1008,utRho09
yqjF,6500932,6501124,6500932,192,34,utRho09
yqjG,6501948,6502048,6501948,100,0,utRho09
yqjH,6433078,6433078,6432982,96,0,utRho09
yqjI,6433506,6433558,6433506,52,0,utRho09
yraH,6574552,6574852,6574552,300,0,utRho09
yraP,6592144,6592818,6592144,674,316,utRho09
yraQ,6596414,6596414,6596276,138,0,utRho09
yraR,6598024,6598024,6597692,332,2,utRho09
yrbG,13360844,13361100,13360844,256,144,utRho09
yrbL,6696842,6696904,6696842,62,78,utRho09
yrbN,6616172,6616172,6615866,306,5100,utRho09
yrdB,6860176,6860176,6860046,130,6,utRho09
yrfF,7052548,7052938,7052548,390,336,utRho09
yrhB,7169440,7169518,7169440,78,0,utRho09
ysaB,7451804,7451804,7451424,380,0,utRho09
ysgA,8032686,8032686,8032338,348,20,utRho09
ytfB,8857638,8857638,8857434,204,62,utRho09
ytfE,8864018,8864018,8863966,52,0,utRho09
ytfF,8866296,8866296,8866130,166,6,utRho09
ytfH,8868164,8868226,8868164,62,0,utRho09
ytfI,8875234,8875414,8875234,180,0,utRho09
ytfJ,8878572,8878572,8878524,48,56,utRho09
ytfK,8879022,8879174,8879022,152,168,utRho09
ytfL,8882642,8882642,8882430,212,0,utRho09
ytfQ,8899634,8899924,8899634,290,188,utRho09
ytjB,9249598,9249598,9249578,20,2,utRho09
yzfA,8896588,8896588,8896490,98,2,utRho09
zapA,6111102,6111224,6111102,122,3258,utRho09
zapB,8236772,8237030,8236772,258,184,utRho09
zapC,2011700,2011904,2011700,204,10,utRho09
zinT,4082692,4082750,4082692,58,2,utRho09
zipA,5062814,5062814,5062466,348,0,utRho09
zitB,1569716,1569716,1569646,70,0,utRho09
zntA,7212844,7212902,7212844,58,0,utRho09
zntR,6878336,6878336,6878260,76,8,utRho09
znuA,3885322,3885322,3885166,156,0,utRho09
znuC,3885268,3885324,3885268,56,0,utRho09
zraP,8403424,8403424,8403376,48,0,utRho09
zraS,8403810,8403852,8403810,42,4,utRho09
zupT,6364866,6365100,6364866,234,182,utRho09
zur,8520282,8520282,8520006,276,224,utRho09
zwf,3872752,3872752,3872628,124,0,utRho09
C0343,2818676,2818728,2818676,52,0,utRho10
aaeB,6776526,6776526,6776376,150,0,utRho10
aaeR,6778762,6779040,6778762,278,458,utRho10
aaeX,6778860,6778860,6778674,186,588,utRho10
aat,1854920,1854920,1854864,56,0,utRho10
accA,416822,417242,416822,420,2658,utRho10
accB,6810280,6810872,6810280,592,7752,utRho10
accD,4868030,4868030,4867852,178,770,utRho10
aceB,8430804,8430956,8430804,152,502,utRho10
aceE,245938,246034,245938,96,62,utRho10
ackA,4826918,4826940,4826918,22,930,utRho10
acnA,2670848,2671662,2670848,814,1526,utRho10
acnB,263038,263230,263038,192,1226,utRho10
acpP,2303148,2303230,2303148,82,482,utRho10
acpS,5402324,5402324,5401996,328,714,utRho10
acrA,971396,971396,971238,158,130,utRho10
acrB,969370,969370,968806,564,1744,utRho10
acrD,5174950,5175190,5174950,240,46,utRho10
acrE,6827404,6827728,6827404,324,102,utRho10
acrR,971398,971522,971398,124,46,utRho10
acrZ,1589502,1589546,1589502,44,48,utRho10
acs,8575190,8575190,8574742,448,580,utRho10
actP,8569870,8569870,8569804,66,56,utRho10
ada,4620854,4620854,4620810,44,0,utRho10
add,3404404,3404466,3404404,62,20,utRho10
ade,7687802,7687928,7687802,126,252,utRho10
adhE,2596826,2596826,2596242,584,148,utRho10
adhP,3107988,3107988,3107676,312,618,utRho10
adiA,8681112,8681112,8681042,70,62,utRho10
adiC,8674404,8674404,8674062,342,220,utRho10
adiY,8676084,8676084,8675858,226,0,utRho10
adk,994278,994350,994278,72,1156,utRho10
adrA,807374,807406,807374,32,60,utRho10
aer,6438240,6438240,6438152,88,106,utRho10
aes,1000102,1000102,999946,156,1000,utRho10
agaR,6557406,6557406,6557330,76,0,utRho10
agaS,6563778,6563952,6563778,174,2,utRho10
agp,2131118,2131170,2131118,52,0,utRho10
agrA,7296126,7296126,7296126,0,0,utRho10
agrB,7296588,7296588,7296588,0,0,utRho10
ahpC,1277386,1277890,1277386,504,894,utRho10
ahpF,1278004,1279506,1278004,1502,48600,utRho10
ahr,8992698,8992698,8992418,280,122,utRho10
aidB,8828494,8828550,8828494,56,0,utRho10
ais,4731512,4731512,4731240,272,66,utRho10
alaA,4814816,4815122,4814816,306,116,utRho10
alaC,4996798,4996798,4996590,208,80,utRho10
alaE,5598140,5598328,5598140,188,62,utRho10
alaS,5644180,5644180,5644022,158,1554,utRho10
alaW,5036612,5036612,5036462,150,6,utRho10
aldA,2976380,2976464,2976380,84,214,utRho10
aldB,7513070,7513070,7513022,48,560,utRho10
alkA,4295118,4295118,4295080,38,82,utRho10
alkB,4618890,4618890,4618682,208,48,utRho10
allA,1064780,1064902,1064780,122,84,utRho10
allD,1092822,1092822,1092726,96,50,utRho10
allE,1088112,1088112,1088092,20,8,utRho10
allS,1064600,1064600,1064442,158,0,utRho10
alr,8531178,8531564,8531178,386,2370,utRho10
alsE,8617334,8617334,8616956,378,40,utRho10
alsK,8615990,8615990,8615598,392,390,utRho10
alx,6476740,6477160,6476740,420,0,utRho10
amiA,5104482,5104704,5104482,222,32,utRho10
amiC,5898378,5898378,5898020,358,1790,utRho10
amn,4110062,4110122,4110062,60,88,utRho10
ampC,8758006,8758006,8757888,118,48,utRho10
ampD,237362,237466,237362,104,176,utRho10
ampG,907372,907372,907090,282,408,utRho10
ampH,792726,792726,792574,152,176,utRho10
amyA,4012230,4012312,4012230,82,70,utRho10
anmK,3439346,3439346,3439204,142,0,utRho10
ansB,6201580,6201580,6201456,124,334,utRho10
ansP,3052040,3052040,3051960,80,198,utRho10
apaG,104068,104068,103212,856,5676,utRho10
apaH,102586,102586,102444,142,7614,utRho10
apbE,4623188,4623188,4623068,120,0,utRho10
appA,2081198,2081234,2081198,36,0,utRho10
appC,2075420,2075480,2075420,60,0,utRho10
appY,1167134,1167362,1167134,228,0,utRho10
apt,982620,982824,982620,204,370,utRho10
aqpZ,1832424,1832424,1832094,330,60,utRho10
araB,140150,140150,140096,54,106,utRho10
araC,140482,140774,140482,292,618,utRho10
araE,5964416,5964416,5964364,52,0,utRho10
araF,3972476,3972476,3972256,220,174,utRho10
araH,3967120,3967120,3967086,34,64,utRho10
araJ,825058,825058,824962,96,436,utRho10
arcA,9281602,9281602,9280612,990,3390,utRho10
arcB,6706098,6706098,6706050,48,156,utRho10
arcZ,6701154,6701154,6701154,0,0,utRho10
arfA,6877346,6877346,6877298,48,782,utRho10
argA,5898312,5898484,5898312,172,766,utRho10
argC,8309770,8310002,8309770,232,78,utRho10
argD,6980442,6980442,6980360,82,120,utRho10
argE,8310156,8310156,8309694,462,146,utRho10
argF,580680,580680,580610,70,0,utRho10
argG,6637124,6637274,6637124,150,458,utRho10
argI,8956688,8956688,8956622,66,142,utRho10
argO,6137672,6137672,6137616,56,720,utRho10
argP,6119460,6119506,6119460,46,670,utRho10
argR,6769204,6769406,6769204,202,314,utRho10
argS,3920002,3920124,3920002,122,0,utRho10
argT,4855698,4855698,4855582,116,336,utRho10
argU,1129406,1129446,1129406,40,0,utRho10
argW,4932616,4932618,4932616,2,60,utRho10
argX,7964728,7964750,7964728,22,12,utRho10
aroF,5482402,5482402,5482300,102,0,utRho10
aroG,1571182,1571266,1571182,84,574,utRho10
aroH,3576636,3576870,3576636,234,482,utRho10
aroK,7038760,7038760,7038128,632,1138,utRho10
aroL,812560,812810,812560,250,1100,utRho10
aroP,243342,243342,243102,240,24,utRho10
arpA,8445382,8445382,8444974,408,280,utRho10
arrS,7316108,7316108,7316108,0,0,utRho10
arsR,7297024,7297056,7297024,32,164,utRho10
artJ,1801252,1801252,1801150,102,32,utRho10
artP,1807686,1807686,1807468,218,2080,utRho10
ascF,5678858,5679048,5678858,190,0,utRho10
ascG,5678574,5678574,5678528,46,0,utRho10
aslB,7965562,7965916,7965562,354,47088,utRho10
asnA,7854258,7854310,7854258,52,466,utRho10
asnB,1398444,1398444,1398354,90,1356,utRho10
asnC,23562186,23562186,23562018,168,294,utRho10
asnS,1978088,1978088,1977970,118,6606,utRho10
asnT,4089082,4089098,4089082,16,154,utRho10
asnU,4119690,4119702,4119690,12,6,utRho10
asnV,4124504,4124520,4124504,16,234,utRho10
aspA,17473728,17473728,17473308,420,84,utRho10
aspC,1971486,1971486,1971418,68,1766,utRho10
aspS,3901402,3901402,3901044,358,230,utRho10
aspT,7893560,7893744,7893560,184,113846,utRho10
aspV,473826,473862,473826,36,4,utRho10
asr,3342654,3342752,3342654,98,76,utRho10
astC,3664088,3664088,3663964,124,48,utRho10
astE,3654138,3654138,3653846,292,68,utRho10
atoD,4646824,4646894,4646824,70,536,utRho10
atpB,7844540,7844540,7844102,438,450,utRho10
atpC,7832118,7832118,7831944,174,2368,utRho10
atpI,7845050,7845050,7844880,170,76,utRho10
avtA,7479348,7479410,7479348,62,640,utRho10
azoR,2965982,2965982,2965720,262,214,utRho10
azuC,3976002,3976002,3975918,84,16,utRho10
bacA,6408350,6408350,6408262,88,898,utRho10
bamA,394052,395856,394052,1804,974,utRho10
bamB,5277950,5277950,5277304,646,968,utRho10
bamC,5198028,5198028,5197730,298,848,utRho10
bamD,5471922,5472292,5471922,370,12672,utRho10
bamE,5506972,5507210,5506972,238,216,utRho10
basS,8666954,8666954,8666544,410,2020,utRho10
bax,7474468,7474468,7474354,114,28,utRho10
bcp,5200874,5200956,5200874,82,1406,utRho10
bcsB,7385346,7385346,7385214,132,70,utRho10
bcsE,7392644,7392916,7392644,272,0,utRho10
bdcA,8948128,8948128,8948106,22,2276,utRho10
bdcR,8948192,8948248,8948192,56,760,utRho10
bdm,3112680,3112680,3112560,120,12,utRho10
betA,654522,654522,654494,28,132,utRho10
betI,658722,658722,658668,54,154,utRho10
betT,658842,658926,658842,84,146,utRho10
bfr,6933498,6933498,6933450,48,16,utRho10
bglG,23440182,23440182,23439402,780,942,utRho10
bglX,4444240,4444240,4443978,262,76,utRho10
bhsA,2337962,2338146,2337962,184,160,utRho10
bioA,1618584,1618584,1618514,70,0,utRho10
bioB,1618604,1618688,1618604,84,0,utRho10
bioH,7089716,7089716,7089688,28,60,utRho10
bisC,7433026,7433026,7432788,238,554,utRho10
blc,8755490,8755490,8755444,46,0,utRho10
blr,3409024,3409102,3409024,78,108,utRho10
bluF,2431226,2431226,2430950,276,570,utRho10
bluR,2428226,2428226,2428118,108,0,utRho10
bolA,908698,908944,908698,246,90,utRho10
borD,1157842,1157842,1157786,56,0,utRho10
brnQ,838976,839182,838976,206,840,utRho10
bssR,1756492,1756496,1756492,4,0,utRho10
bssS,2242116,2242116,2241910,206,878,utRho10
btuB,8326798,8327278,8326798,480,3324,utRho10
cadB,8720212,8720212,8720062,150,162,utRho10
cadC,8723926,8723926,8723868,58,0,utRho10
caiE,70998,70998,70742,256,88,utRho10
caiF,68436,68600,68436,164,36,utRho10
caiT,84074,84074,83862,212,0,utRho10
can,285406,285406,285340,66,24,utRho10
carA,59102,59302,59102,200,40,utRho10
carB,61550,61634,61550,84,318,utRho10
cas2,5757830,5757830,5757706,124,470,utRho10
casA,5768638,5768638,5768276,362,0,utRho10
cbl,4121882,4121882,4121828,54,1852,utRho10
cbpA,2128074,2128074,2127550,524,480,utRho10
cbrA,7738628,7738754,7738628,126,0,utRho10
cbrB,7794958,7795012,7794958,54,342,utRho10
ccmH,4585242,4585242,4584820,422,0,utRho10
cdaR,364894,364926,364894,32,68,utRho10
cdd,4463638,4463688,4463638,50,0,utRho10
cdh,8219814,8219860,8219814,46,946,utRho10
cdsA,391110,391354,391110,244,2182,utRho10
cedA,3627484,3627484,3627326,158,146,utRho10
cfa,3482402,3482826,3482402,424,798,utRho10
chaC,2544844,2544972,2544844,128,210,utRho10
chbB,3643452,3643452,3643238,214,0,utRho10
chbG,3634624,3634624,3634270,354,0,utRho10
cheW,3946924,3946924,3946678,246,2008,utRho10
chiA,6939792,6939792,6939706,86,78,utRho10
chiP,1416472,1416668,1416472,196,104,utRho10
cho,3646984,3647030,3646984,46,66,utRho10
chpS,8896804,8896894,8896804,90,330,utRho10
cirA,4493884,4493884,4493538,346,240,utRho10
citC,1304078,1304078,1303712,366,110,utRho10
citT,1293264,1293264,1293160,104,4,utRho10
clcA,350104,350214,350104,110,2,utRho10
clpA,1846160,1846528,1846160,368,138,utRho10
clpB,5468410,5468410,5468346,64,234,utRho10
clpP,913154,913354,913154,200,388,utRho10
clpS,1845500,1845826,1845500,326,550,utRho10
clpX,914404,914852,914404,448,1022,utRho10
clsA,2617346,2617346,2617290,56,108,utRho10
clsC,2212584,2212710,2212584,126,548,utRho10
cmk,1922330,1922402,1922330,72,72,utRho10
cnu,3409522,3409898,3409522,376,2508,utRho10
coaA,8350214,8350214,8350052,162,1068,utRho10
cobC,1340092,1340092,1339814,278,524,utRho10
cobT,4129202,4129202,4128934,268,106,utRho10
cobU,4131944,4131944,4131528,416,766,utRho10
codB,709768,709844,709768,76,0,utRho10
comR,2337726,2337726,2337664,62,0,utRho10
copA,1022822,1022822,1022758,64,16,utRho10
corA,8002388,8002852,8002388,464,22366,utRho10
cpdB,8873258,8873258,8873130,128,446,utRho10
cptB,6082198,6082198,6082140,58,130,utRho10
cpxA,8210202,8210202,8209950,252,416,utRho10
cpxP,8211570,8211640,8211570,70,70,utRho10
cpxR,8211372,8211372,8211340,32,0,utRho10
cra,175894,176056,175894,162,2,utRho10
crcB,1316016,1316016,1315876,140,736,utRho10
creA,9270486,9271042,9270486,556,608,utRho10
creD,9276320,9276356,9276320,36,208,utRho10
crl,515620,515658,515620,38,1390,utRho10
crp,6971906,6972240,6971906,334,2716,utRho10
crr,5070960,5071668,5070960,708,2786,utRho10
csdA,5886414,5886674,5886414,260,484,utRho10
csgB,2207718,2207902,2207718,184,0,utRho10
csgD,2206688,2206688,2206392,296,484,utRho10
csgG,2203510,2203510,2203368,142,212,utRho10
csiD,5577854,5577970,5577854,116,30,utRho10
csiE,5330802,5330870,5330802,68,688,utRho10
csiR,5590942,5591348,5590942,406,118,utRho10
cspA,7439778,7440098,7439778,320,122430,utRho10
cspB,3283430,3283430,3283108,322,232,utRho10
cspC,3815018,3815018,3814870,148,650,utRho10
cspD,1845352,1845352,1845180,172,1584,utRho10
cspE,1314294,1314584,1314294,290,158,utRho10
cspF,3283380,3283710,3283380,330,278,utRho10
cspG,2102610,2102922,2102610,312,3956,utRho10
cspH,2102746,2102746,2102350,396,336,utRho10
cspI,3277624,3277624,3277334,290,112,utRho10
csrA,5638746,5638746,5638292,454,1240,utRho10
csrB,5849048,5849048,5849048,0,0,utRho10
csrC,8102072,8102072,8102072,0,0,utRho10
csrD,6806850,6806850,6806664,186,124,utRho10
cstA,1259710,1259788,1259710,78,0,utRho10
cueO,274090,274166,274090,76,0,utRho10
cueR,1027948,1027986,1027948,38,0,utRho10
curA,3037784,3038054,3037784,270,606,utRho10
cusC,1191146,1191200,1191146,54,38,utRho10
cusR,1190924,1190924,1190886,38,40,utRho10
cutA,8730784,8730784,8730712,72,764,utRho10
cutC,3918534,3918534,3917920,614,130,utRho10
cvpA,4861600,4861600,4861526,74,34,utRho10
cvrA,2484328,2484328,2484142,186,24,utRho10
cyaA,7981548,7982306,7981548,758,656,utRho10
cyaR,4334228,4334224,4334228,4,0,utRho10
cyaY,7988166,7988166,7988118,48,340,utRho10
cybB,2981522,2981804,2981522,282,384,utRho10
cycA,8859560,8859728,8859560,168,1102,utRho10
cydA,1542340,1542916,1542340,576,14,utRho10
cydC,1858800,1858800,1858390,410,116,utRho10
cydD,1862062,1862062,1861924,138,78,utRho10
cydX,1548300,1548392,1548300,92,118,utRho10
cynR,717418,717418,717380,38,84,utRho10
cynT,1435092,1435196,1435092,104,0,utRho10
cyoA,903306,903306,903220,86,4814,utRho10
cyoE,895540,895540,895410,130,1190,utRho10
cysB,2667576,2667710,2667576,134,408,utRho10
cysC,5748056,5748056,5747984,72,156,utRho10
cysD,5752736,5752736,5752658,78,2,utRho10
cysE,7565362,7565362,7565124,238,372,utRho10
cysG,6995508,6995656,6995508,148,252,utRho10
cysJ,5783928,5783928,5783796,132,2170,utRho10
cysK,5064688,5064818,5064688,130,0,utRho10
cysP,5087114,5087114,5087056,58,322,utRho10
cysS,1109154,1109222,1109154,68,138,utRho10
cysT,3984100,3984100,3983974,126,66,utRho10
cysZ,5062766,5062926,5062766,160,540,utRho10
cytR,8249018,8249018,8248912,106,26,utRho10
dacA,1328002,1328002,1327926,76,194,utRho10
dacB,6657714,6657926,6657714,212,114,utRho10
dacC,1761306,1761454,1761306,148,614,utRho10
dadA,2475018,2475142,2475018,124,122,utRho10
dam,7032504,7032504,7031826,678,1464,utRho10
damX,7035200,7035200,7034612,588,572,utRho10
dapA,5199568,5199568,5199520,48,94,utRho10
dapB,56576,56748,56576,172,148,utRho10
dapD,371954,371954,371894,60,162,utRho10
dapE,5183120,5183214,5183120,94,610,utRho10
dcp,3254844,3254844,3254760,84,86,utRho10
dcrB,7219534,7219910,7219534,376,320,utRho10
dctA,7366996,7366996,7366894,102,330,utRho10
dcuA,8733686,8733686,8733546,140,70,utRho10
dcuB,8698182,8698182,8697488,694,2378,utRho10
dcuC,1312166,1312166,1311936,230,724,utRho10
dcuD,6749166,6749738,6749166,572,126,utRho10
dcuR,8701130,8701130,8700068,1062,794,utRho10
dcuS,8703370,8703370,8703324,46,264,utRho10
dcyD,3999016,3999016,3998960,56,12,utRho10
ddpX,3126498,3126498,3126152,346,186,utRho10
deaD,6615818,6615818,6615720,98,7136,utRho10
dedA,4869880,4869880,4869482,398,11324,utRho10
dedD,4863750,4863750,4863368,382,112,utRho10
def,6867300,6867380,6867300,80,358,utRho10
degP,361690,361768,361690,78,62,utRho10
degQ,6761308,6761486,6761308,178,4928,utRho10
deoB,9239134,9239206,9239134,72,0,utRho10
deoC,9233358,9234646,9233358,1288,444,utRho10
dfp,7625406,7625462,7625406,56,0,utRho10
dgcZ,3247758,3247758,3247700,58,40,utRho10
dgkA,8512914,8513274,8512914,360,600,utRho10
dgt,358392,358474,358392,82,390,utRho10
dhaK,2501888,2501888,2501676,212,264,utRho10
dhaR,2502006,2502132,2502006,126,96,utRho10
dicB,3299194,3299218,3299194,24,0,utRho10
dicC,3295752,3295752,3295700,52,0,utRho10
dinB,501760,501796,501760,36,0,utRho10
dinD,7635398,7635520,7635398,122,482,utRho10
dinG,1666146,1666140,1666146,6,10,utRho10
dinI,2243018,2243018,2242974,44,1442,utRho10
dinJ,493230,493230,493004,226,64,utRho10
dinQ,7295964,7295964,7295576,388,1088,utRho10
djlA,114536,114728,114536,192,108,utRho10
dkgA,6313142,6313246,6313142,104,320,utRho10
dkgB,458196,458334,458196,138,320,utRho10
dksA,321502,321502,321208,294,928,utRho10
dld,4444164,4444370,4444164,206,38,utRho10
dmlA,3763424,3763824,3763424,400,708,utRho10
dmlR,3763710,3763710,3763618,92,266,utRho10
dmsA,1881646,1881918,1881646,272,60,utRho10
dnaA,7767922,7767922,7767458,464,1186,utRho10
dnaB,8528566,8528628,8528566,62,910,utRho10
dnaK,24096,24326,24096,230,3710,utRho10
dnaN,7765466,7765466,7764642,824,792,utRho10
dnaQ,471868,472134,471868,266,2372,utRho10
dnaT,18406460,18406460,18406068,392,4080,utRho10
dnaX,984112,984184,984112,72,974,utRho10
dosP,3131486,3131486,3131466,20,0,utRho10
dpiB,1303968,1304470,1303968,502,176,utRho10
dppA,7415740,7415740,7415410,330,2340,utRho10
dps,1697900,1697900,1697822,78,0,utRho10
dsbA,8086754,8086836,8086754,82,1334,utRho10
dsbB,2466294,2466294,2466060,234,0,utRho10
dsbC,6079266,6079266,6077644,1622,2002,utRho10
dsbG,1277600,1277600,1277146,454,354,utRho10
dsdA,4958242,4958404,4958242,162,140,utRho10
dsdC,4955492,4955492,4955258,234,172,utRho10
dsdX,4955642,4955694,4955642,52,152,utRho10
dsrA,4050626,4050626,4050626,0,0,utRho10
dsrB,4049686,4049686,4049646,40,1378,utRho10
dtpD,1485340,1485340,1485112,228,168,utRho10
dusA,8523200,8523338,8523200,138,4338,utRho10
dusB,6820492,6820560,6820492,68,42,utRho10
dusC,4460790,4460790,4460770,20,0,utRho10
dut,7627704,7627864,7627704,160,322,utRho10
dxr,386670,387042,386670,372,568,utRho10
ebgA,6445102,6445266,6445102,164,224,utRho10
ebgR,6442874,6442932,6442874,58,94,utRho10
ecnB,8753018,8753106,8753018,88,1606,utRho10
eco,4607594,4607810,4607594,216,14,utRho10
ecpA,621594,621594,621342,252,168,utRho10
ecpB,620238,620238,620052,186,130,utRho10
ecpR,622964,622964,622672,292,0,utRho10
eda,3866218,3866218,3865512,706,224,utRho10
edd,3869426,3869426,3869208,218,8,utRho10
efeO,2164308,2164486,2164308,178,48,utRho10
efeU_1,2162614,2162712,2162614,98,146,utRho10
efp,8751134,8751398,8751134,264,4890,utRho10
elaA,4763372,4763372,4763086,286,2,utRho10
elaD,4765308,4765426,4765308,118,136,utRho10
elfA,1995530,1995736,1995530,206,0,utRho10
elfD,1996642,1996980,1996642,338,0,utRho10
emrD,7707690,7707844,7707690,154,116,utRho10
emrK,4966896,4966896,4966678,218,12,utRho10
emrY,4964668,4964668,4964352,316,200,utRho10
emtA,2486250,2486360,2486250,110,134,utRho10
endA,12361100,12361388,12361100,288,200,utRho10
eno,5817692,5817692,5815882,1810,8452,utRho10
entC,1249662,1249770,1249662,108,0,utRho10
entD,1220508,1220508,1220158,350,0,utRho10
entH,1258584,1258600,1258584,16,0,utRho10
entS,1244506,1244600,1244506,94,0,utRho10
envR,6827266,6827266,6826930,336,0,utRho10
epd,12295292,12295292,12294764,528,136,utRho10
epmA,8765236,8765286,8765236,50,162,utRho10
epmB,8751406,8751406,8751314,92,2836,utRho10
eptB,7421162,7421162,7420950,212,126,utRho10
eptC,8300622,8300622,8300530,92,512,utRho10
erfK,4126708,4126708,4126646,62,1924,utRho10
erpA,353122,353220,353122,98,36,utRho10
esrE,8039956,8039956,8039956,0,0,utRho10
essD,1153746,1154796,1153746,1050,734,utRho10
etk,2088606,2088606,2088420,186,836,utRho10
evgA,4967262,4967510,4967262,248,38,utRho10
exbB,6304028,6304028,6303968,60,118,utRho10
exbD,6302780,6302780,6302486,294,104,utRho10
exuR,6493016,6493304,6493016,288,2,utRho10
exuT,6490004,6490208,6490004,204,24,utRho10
fabA,2032996,2032996,2032940,56,50,utRho10
fabB,4883282,4883282,4883210,72,74,utRho10
fabH,2297032,2297518,2297032,486,4638,utRho10
fabI,2702236,2702236,2702078,158,74,utRho10
fadB,8062026,8062026,8061942,84,52,utRho10
fadD,3779614,3779614,3779492,122,28,utRho10
fadE,486812,486812,486606,206,168,utRho10
fadH,6463248,6463330,6463248,82,236,utRho10
fadI,4921022,4921022,4920938,84,182,utRho10
fadL,4922410,4922600,4922410,190,176,utRho10
fadM,928720,928804,928720,84,32,utRho10
fadR,2469810,2469876,2469810,66,0,utRho10
fbaB,4357334,4357334,4357128,206,20,utRho10
fdhE,8162722,8162722,8162456,266,1294,utRho10
fdhF,8598814,8598814,8598732,82,306,utRho10
fdnG,3094744,3094802,3094744,58,26,utRho10
fdrA,1093012,1093360,1093012,348,230,utRho10
feaB,2894994,2895038,2894994,44,0,utRho10
feaR,2894734,2894734,2894566,168,0,utRho10
fecA,9033454,9033454,9033354,100,52,utRho10
fecE,9023288,9023288,9022914,374,5830,utRho10
fecI,9036564,9036564,9036470,94,412,utRho10
feoA,7080114,7080326,7080114,212,260,utRho10
fepA,1225334,1225334,1224988,346,0,utRho10
fepB,1249454,1249454,1249020,434,72,utRho10
fepD,1244468,1244468,1244378,90,0,utRho10
fes,1225374,1225630,1225374,256,136,utRho10
ffh,5495706,5495706,5495590,116,304,utRho10
ffs,952576,952848,952576,272,1520,utRho10
fhuA,334884,334968,334884,84,538,utRho10
fhuE,2323294,2323294,2323102,192,20,utRho10
fhuF,9211504,9211504,9211326,178,109270,utRho10
fic,6983296,6983296,6982926,370,1162,utRho10
fieF,8212864,8212938,8212864,74,10,utRho10
fimA,9085388,9086230,9085388,842,2180,utRho10
fimB,9081334,9081914,9081334,580,1938,utRho10
fimE,9083742,9084074,9083742,332,1858,utRho10
fimZ,1129214,1129214,1128960,254,2,utRho10
fiu,1683296,1683296,1683062,234,70,utRho10
fixA,84650,84806,84650,156,2,utRho10
fkpA,6955050,6955050,6954838,212,7314,utRho10
fldA,2846084,2846084,2845860,224,3980,utRho10
fldB,6079644,6079710,6079644,66,60,utRho10
flgA,2261770,2261770,2261726,44,1172,utRho10
flgB,2261986,2262036,2261986,50,160,utRho10
flgK,2276702,2276756,2276702,54,722,utRho10
flgM,2260330,2260330,2260256,74,490,utRho10
flgN,2259828,2259828,2259660,168,248,utRho10
flhB,3932432,3932432,3932382,50,2644,utRho10
flhC,3955864,3955864,3955688,176,372,utRho10
flhD,3957154,3957154,3956394,760,1620,utRho10
fliA,4003638,4003638,4003578,60,1352,utRho10
fliC,4007352,4007352,4007212,140,884,utRho10
fliD,4007634,4007744,4007634,110,400,utRho10
fliE,4026186,4026186,4026028,158,428,utRho10
fliF,4026292,4026458,4026292,166,360,utRho10
fliL,4039168,4039236,4039168,68,172,utRho10
flk,4875824,4875900,4875824,76,330,utRho10
flu,4142634,4143078,4142634,444,494,utRho10
flxA,3292776,3292810,3292776,34,170,utRho10
fnr,2799104,2799104,2799052,52,2,utRho10
fnrS,2818258,2818258,2818258,0,0,utRho10
focA,1909628,1909628,1908932,696,2672,utRho10
folA,99598,99646,99598,48,192,utRho10
folB,6409296,6409296,6409178,118,24,utRho10
folD,1115562,1115562,1115482,80,98,utRho10
folE,4487696,4487696,4487304,392,3504,utRho10
fpr,8228998,8228998,8228944,54,0,utRho10
frc,4986878,4986878,4986508,370,154,utRho10
frdA,8764824,8764824,8764636,188,142,utRho10
frdD,8758948,8758948,8758732,216,3332,utRho10
fre,8052886,8053054,8052886,168,980,utRho10
frlA,6999518,6999820,6999518,302,734,utRho10
frr,385624,385744,385624,120,1214,utRho10
frsA,513004,513054,513004,50,112,utRho10
fruB,4527194,4527194,4526990,204,0,utRho10
frvR,8179804,8179804,8179710,94,0,utRho10
fryA,5008986,5008986,5008970,16,88,utRho10
fsaA,1727060,1727284,1727060,224,426,utRho10
fsr,1009710,1009710,1009392,318,202,utRho10
ftnA,3977364,3977432,3977364,68,4,utRho10
ftnB,3973550,3973850,3973550,300,252,utRho10
ftsA,207122,207964,207122,842,502,utRho10
ftsB,5745802,5745802,5745640,162,150,utRho10
ftsH,6654204,6654204,6653870,334,936,utRho10
ftsK,1865858,1866448,1865858,590,982,utRho10
ftsL,181376,182064,181376,688,2020,utRho10
ftsP,6325732,6325732,6325338,394,284,utRho10
ftsQ,205484,206310,205484,826,258,utRho10
ftsX,7204512,7204512,7204172,340,370,utRho10
ftsZ,209272,210610,209272,1338,300,utRho10
fucA,5867708,5867708,5867376,332,2296,utRho10
fucP,5868238,5868470,5868238,232,208,utRho10
fumA,6753760,6753760,6753508,252,2128,utRho10
fumB,8694696,8694696,8694652,44,0,utRho10
fumC,3373418,3373418,3373176,242,4,utRho10
fur,2842892,2842892,2842584,308,7512,utRho10
fusA,6947370,6947370,6947028,342,35382,utRho10
fxsA,8737206,8737328,8737206,122,154,utRho10
gabD,5581824,5582546,5581824,722,1632,utRho10
gadA,7335214,7335214,7335160,54,0,utRho10
gadB,3144144,3144144,3144090,54,44,utRho10
gadC,3141168,3141168,3140978,190,278,utRho10
gadE,7315600,7316732,7315600,1132,524,utRho10
gadW,7329562,7329562,7329236,326,0,utRho10
gadX,14663356,14663356,14663240,116,964,utRho10
gadY,7329728,7329728,7329728,0,0,utRho10
galE,1584354,1584354,1584110,244,96,utRho10
galF,4228702,4228702,4228654,48,62,utRho10
galM,1577796,1577796,1577674,122,620,utRho10
galP,6176510,6176568,6176510,58,32,utRho10
galR,5953138,5953198,5953138,60,84,utRho10
galS,4483420,4483420,4483336,84,0,utRho10
galU,2582810,2582914,2582810,104,420,utRho10
gapA,3724480,3725542,3724480,1062,2336,utRho10
garP,6549868,6549868,6549814,54,132,utRho10
gatY,4354468,4354468,4354408,60,18,utRho10
gatZ,4352864,4352864,4352642,222,7652,utRho10
gcd,282558,282558,282450,108,70,utRho10
gcl,1067814,1067832,1067814,18,0,utRho10
gcvA,5885278,5885278,5885134,144,0,utRho10
gcvB,5885392,5885392,5885392,0,0,utRho10
gcvR,5199758,5199812,5199758,54,2,utRho10
gcvT,6101544,6101544,6101334,210,1418,utRho10
gdhA,3684616,3684742,3684616,126,0,utRho10
gfcA,2099668,2099668,2099488,180,1546,utRho10
gfcD,2096236,2096236,2095890,346,2938,utRho10
ghrA,2195648,2195772,2195648,124,58,utRho10
ghrB,7434378,7434620,7434378,242,1324,utRho10
glcA,6242728,6242728,6242558,170,196,utRho10
glcC,6256412,6256544,6256412,132,74,utRho10
glcD,6256152,6256152,6256042,110,164,utRho10
gldA,8278092,8278092,8278070,22,0,utRho10
glgA,7136784,7136784,7136066,718,3904,utRho10
glgB,7147314,7147314,7147004,310,198,utRho10
glgC,7139142,7139142,7138656,486,400,utRho10
glgP,7133546,7133546,7133162,384,1842,utRho10
glgS,6384024,6384024,6383878,146,40,utRho10
glgX,7142838,7142838,7142638,200,0,utRho10
glk,5018922,5018922,5018852,70,146,utRho10
glmS,7827622,7827622,7827336,286,4192,utRho10
glmU,7830652,7830652,7830400,252,1624,utRho10
glmY,10765360,10765360,10765360,0,0,utRho10
glmZ,7972864,7972864,7972864,0,0,utRho10
glnA,16232888,16232888,16232136,752,300,utRho10
glnB,5375052,5375052,5374816,236,668,utRho10
glnD,377310,377310,377300,10,20,utRho10
glnE,6399602,6399602,6399282,320,0,utRho10
glnH,1696396,1696396,1696008,388,440,utRho10
glnK,945112,945196,945112,84,2,utRho10
glnL,8112742,8112742,8112678,64,0,utRho10
glnQ,1693262,1693262,1692926,336,422,utRho10
glnS,1411998,1412186,1411998,188,598,utRho10
gloA,3455602,3455674,3455602,72,122,utRho10
gloB,469852,469852,469564,288,2704,utRho10
glpA,4705166,4705294,4705166,128,0,utRho10
glpD,7123942,7124026,7123942,84,4,utRho10
glpE,7123698,7123698,7123646,52,78,utRho10
glpF,8236322,8236322,8236180,142,492,utRho10
glpG,7122960,7122960,7122904,56,132,utRho10
glpR,7121782,7121782,7121210,572,742,utRho10
glpT,4704902,4704902,4704748,154,192,utRho10
glpX,8231212,8231212,8231158,54,9116,utRho10
glrK,5382246,5382246,5382196,50,2422,utRho10
gltA,1509534,1509534,1508936,598,5662,utRho10
gltB,6709018,6709264,6709018,246,534,utRho10
gltI,1375792,1375792,1375494,298,2860,utRho10
gltP,8588536,8588962,8588536,426,1438,utRho10
gltS,7657382,7657382,7657330,52,1114,utRho10
gltX,5041568,5041568,5041344,224,222,utRho10
gluQ,320286,320286,320224,62,26,utRho10
glyA,5371148,5371148,5371014,134,172,utRho10
glyQ,7450708,7450708,7450636,72,178,utRho10
glyS,7448990,7448990,7448794,196,3162,utRho10
glyU,5998128,5998128,5998114,14,18,utRho10
glyV,8784626,8784720,8784626,94,344,utRho10
glyW,3984360,3984360,3984234,126,46,utRho10
gmhB,445612,445666,445612,54,50,utRho10
gmk,7642776,7642856,7642776,80,80,utRho10
gmr,2693686,2693686,2693484,202,678,utRho10
gnd,4202648,4202648,4202536,112,908,utRho10
gnsB,3275692,3275692,3275564,128,2,utRho10
gntK,14310580,14310580,14310368,212,712,utRho10
gntP,9102668,9102668,9102592,76,134,utRho10
gntR,7157760,7157760,7157452,308,704,utRho10
gntT,7092810,7093118,7092810,308,1220,utRho10
gntU,7154170,7154170,7154122,48,118,utRho10
gntX,7089334,7089764,7089334,430,290,utRho10
gor,7292224,7292598,7292224,374,766,utRho10
gpmA,1575340,1575340,1575190,150,2,utRho10
gpmM,7570374,7570520,7570374,146,0,utRho10
gpsA,7567620,7567620,7567322,298,7118,utRho10
gpt,511828,511954,511828,126,1164,utRho10
grcA,5433046,5433046,5432898,148,2450,utRho10
greA,6657728,6657728,6657430,298,2036,utRho10
greB,7073488,7073624,7073488,136,242,utRho10
groL,8741566,8742050,8741566,484,584,utRho10
groS,8741232,8741376,8741232,144,560,utRho10
grpE,5501494,5501494,5501416,78,230,utRho10
grxA,1781552,1781552,1781506,46,92,utRho10
grxB,2248206,2248206,2248108,98,764,utRho10
grxC,7569152,7569152,7568884,268,5386,utRho10
grxD,3468324,3468324,3468202,122,6426,utRho10
gspA,6911268,6911268,6910796,472,386,utRho10
gspC,6910964,6911156,6910964,192,146,utRho10
gss,6277220,6277220,6277044,176,70,utRho10
gstA,3428654,3428754,3428654,100,0,utRho10
gstB,1761038,1761038,1760960,78,284,utRho10
guaB,5268214,5268214,5268140,74,130,utRho10
gudD,5839026,5839026,5838770,256,0,utRho10
gyrA,4678914,4678914,4678840,74,152,utRho10
gyrB,7760300,7760300,7760238,62,404,utRho10
hcaE,5337964,5338064,5337964,100,3134,utRho10
hcaR,5337928,5337928,5337792,136,4266,utRho10
hcaT,5336106,5336106,5335692,414,732,utRho10
hchA,4071260,4071670,4071260,410,0,utRho10
hcp,1828258,1828258,1827628,630,504,utRho10
hcr,1824400,1824400,1824300,100,0,utRho10
hdeA,7313582,7313582,7313480,102,2,utRho10
hdeD,7313920,7313990,7313920,70,376,utRho10
hdfR,7896320,7896320,7895934,386,1972,utRho10
hdhA,3396244,3396244,3396080,164,60,utRho10
helD,2048876,2048942,2048876,66,48,utRho10
hemA,2527166,2527428,2527166,262,322,utRho10
hemB,779722,779722,779454,268,936,utRho10
hemF,5106410,5106450,5106410,40,0,utRho10
hemH,996062,996110,996062,48,1204,utRho10
hemL,349882,349882,349764,118,10,utRho10
hemN,8103886,8104090,8103886,204,102,utRho10
hepA,127176,127176,126528,648,1474,utRho10
hflD,2385372,2385372,2385262,110,356,utRho10
hfq,8799602,8800576,8799602,974,6772,utRho10
hha,961006,961006,960616,390,260,utRho10
hicA,3018442,3018572,3018442,130,0,utRho10
higA,6468682,6468682,6468288,394,650,utRho10
higB,6468960,6468960,6468910,50,36,utRho10
hinT,2323642,2323770,2323642,128,0,utRho10
hipB,3184964,3184964,3184884,80,62,utRho10
hisB,4186720,4186936,4186720,216,602,utRho10
hisJ,4853674,4853674,4853576,98,124,utRho10
hisL,8359856,8359984,8359856,128,76,utRho10
hisS,5281284,5281284,5281150,134,358,utRho10
hlpA,400910,400964,400910,54,330,utRho10
hlyE,2460932,2460932,2460788,144,1452,utRho10
hmp,5371594,5371670,5371594,76,84,utRho10
hns,2585916,2585916,2585844,72,1202,utRho10
hofM,7045856,7045856,7045502,354,0,utRho10
hokA,7441620,7441620,7441200,420,13206,utRho10
hokC,33902,33902,33806,96,102,utRho10
hokE,1215462,1215672,1215462,210,0,utRho10
holC,8968546,8968546,8968560,14,562,utRho10
holD,9215562,9215606,9215562,44,0,utRho10
holE,3850040,3850216,3850040,176,5856,utRho10
hpt,282720,282862,282720,142,688,utRho10
hrpB,324150,324210,324150,60,88,utRho10
hscB,5319048,5319048,5318934,114,2574,utRho10
hscC,1367188,1367188,1366786,402,442,utRho10
hsdS,9163004,9163004,9162924,80,234,utRho10
hslJ,2883560,2883560,2883486,74,56,utRho10
hslO,7059344,7059548,7059344,204,5582,utRho10
hslR,7058220,7058696,7058220,476,1244,utRho10
hslV,8244708,8244708,8244574,134,410,utRho10
hsrA,7881412,7881412,7881224,188,86,utRho10
htgA,21286,21660,21286,374,14548,utRho10
htpG,989634,990240,989634,606,33122,utRho10
htpX,3825236,3825236,3825152,84,60,utRho10
htrE,311036,311036,310852,184,1260,utRho10
htrL,7587668,7587668,7587366,302,84,utRho10
hupA,8400352,8400562,8400352,210,122,utRho10
hupB,1845220,1845804,1845220,584,560,utRho10
hyaA,2063968,2064278,2063968,310,0,utRho10
hybO,6292726,6292726,6292522,204,5326,utRho10
hycA,5700922,5700922,5700870,52,104,utRho10
hycI,5686204,5686204,5686086,118,530,utRho10
hydN,5676264,5676264,5676210,54,50,utRho10
hyfA,5202342,5202402,5202342,60,42,utRho10
hypA,11402508,11402588,11402508,80,536,utRho10
hypB,11403356,11404004,11403356,648,256,utRho10
hypF,5676210,5676210,5674850,1360,3400,utRho10
hypT,9116634,9116634,9116578,56,0,utRho10
hyuA,6019660,6020056,6019660,396,2,utRho10
iaaA,1733074,1733136,1733074,62,0,utRho10
iadA,9119074,9119074,9119052,22,100,utRho10
iap,5753072,5753162,5753072,90,0,utRho10
ibaG,6673966,6673966,6673606,360,360,utRho10
ibpA,7735036,7735036,7734844,192,556,utRho10
ibpB,7733962,7733962,7733794,168,610,utRho10
icd,2389922,2390246,2389922,324,160,utRho10
iclR,8447304,8447304,8447256,48,0,utRho10
idi,6065876,6066130,6065876,254,398,utRho10
idnD,8988870,8988870,8988812,58,56,utRho10
idnK,8989194,8989246,8989194,52,84,utRho10
ihfA,3591442,3591442,3591104,338,352,utRho10
ihfB,1927498,1927656,1927498,158,712,utRho10
ileS,43666,44782,43666,1116,3520,utRho10
ileX,6431194,6431196,6431194,2,66,utRho10
ilvA,15820940,15821324,15820940,384,784,utRho10
ilvC,7915824,7915940,7915824,116,36,utRho10
ilvE,15809552,15809936,15809552,384,1284,utRho10
ilvI,170840,171260,170840,420,4,utRho10
ilvL,23701308,23701932,23701308,624,54,utRho10
ilvY,7915734,7915734,7915640,94,214,utRho10
inaA,4698998,4698998,4698944,54,424,utRho10
infA,1853370,1853370,1852886,484,2178,utRho10
infC,3602692,3602692,3601276,1416,3166,utRho10
insA-5,3958452,3958452,3958430,22,38,utRho10
insA-7,9036758,9037054,9036758,296,390,utRho10
insC-5,6372080,6372284,6372080,204,10278,utRho10
insEF-2,785238,785238,785820,582,1986,utRho10
insEF-4,2190310,2190310,2190892,582,1812,utRho10
insG,9007098,9007098,9006862,236,0,utRho10
insH-1,550596,550596,550234,362,1292,utRho10
insH-11,7306538,7306538,7306396,142,456,utRho10
insH-2,1151548,1151548,1151506,42,160,utRho10
insH-3,1378444,1378444,1378026,418,724,utRho10
insH-4,2791942,2792152,2791942,210,144,utRho10
insH-5,2857852,2857852,2857452,400,24,utRho10
insH-6,4135022,4135022,4134642,380,734,utRho10
insH-7,4206186,4206186,4205822,364,7296,utRho10
insH-9,6260050,6260356,6260050,306,280,utRho10
insI-3,9017372,9017372,9017234,138,114,utRho10
insJ,7441188,7441360,7441188,172,5694,utRho10
insK,7442130,7442308,7442130,178,128,utRho10
insL-1,30760,30890,30760,130,1172,utRho10
insL-2,1216112,1216130,1216112,18,340,utRho10
insL-3,5028644,5028662,5028644,18,376,utRho10
insN-1,540452,540484,540452,32,0,utRho10
intD,1132202,1132202,1131956,246,8910,utRho10
intR,2826520,2826520,2826470,50,44,utRho10
intS,4933026,4933090,4933026,64,4332,utRho10
intZ,5117386,5117542,5117386,156,2140,utRho10
iraD,9113152,9113986,9113152,834,232,utRho10
iraM,2424246,2424246,2424006,240,348,utRho10
iraP,802638,802772,802638,134,0,utRho10
iscA,5319924,5319924,5319772,152,1356,utRho10
iscR,5324398,5324398,5324262,136,13046,utRho10
iscX,5313834,5313834,5313472,362,3078,utRho10
ispF,5743968,5743968,5743560,408,2486,utRho10
ispG,5283908,5283908,5283608,300,752,utRho10
ispU,389568,389806,389568,238,0,utRho10
isrA,2811502,2811502,2811618,116,0,utRho10
istr-1,7706384,7706384,7706384,0,0,utRho10
istr-2,7706514,7706514,7706514,0,0,utRho10
ivbL,15412092,15412092,15411952,140,548,utRho10
ivy,480638,480686,480638,48,120,utRho10
katE,3627628,3627734,3627628,106,266,utRho10
katG,8267624,8267670,8267624,46,26,utRho10
kbaZ,6557732,6557828,6557732,96,0,utRho10
kbl,7585154,7585154,7585102,52,844,utRho10
kch,2621046,2621046,2620538,508,784,utRho10
kdgR,3820506,3820506,3820198,308,0,utRho10
kdpE,1443788,1443788,1443466,322,84,utRho10
kdpF,1457698,1457698,1457642,56,42,utRho10
kdsA,2535708,2536330,2535708,622,2896,utRho10
kdsC,6683438,6684546,6683438,1108,2040,utRho10
kduI,5968388,5968388,5968248,140,2912,utRho10
kefF,94160,94492,94160,332,1144,utRho10
kgtP,5451624,5451624,5451492,132,1248,utRho10
kup,7862206,7862632,7862206,426,354,utRho10
lacI,735076,735076,735020,56,0,utRho10
lacZ,1465508,1465508,1465220,288,404,utRho10
ldcA,2486394,2486394,2486160,234,184,utRho10
ldhA,2885830,2885830,2885686,144,2,utRho10
ldrA,2538954,2538954,2538550,404,4046,utRho10
ldrB,2540024,2540024,2539620,404,1536,utRho10
ldrC,2541092,2541092,2540690,402,1214,utRho10
ldrD,7400544,7400544,7400174,370,1110,utRho10
lepA,5414392,5414392,5414248,144,318,utRho10
lepB,5410928,5410928,5410618,310,942,utRho10
leuD,159188,159188,158906,282,40,utRho10
leuE,3761600,3761600,3761518,82,70,utRho10
leuL,168048,168048,167416,632,44,utRho10
leuO,168308,168736,168308,428,124,utRho10
leuQ,9212864,9212864,9212802,62,0,utRho10
leuU,6644556,6644556,6644316,240,2592,utRho10
leuV,9212546,9212546,9212330,216,2024,utRho10
leuX,8992772,8992810,8992772,38,40,utRho10
lexA,8514174,8514230,8514174,56,182,utRho10
lhr,3456706,3458174,3456706,1468,3640,utRho10
ligA,5060402,5060402,5060352,50,0,utRho10
ligB,7642576,7642576,7642340,236,236,utRho10
lipA,1320602,1320602,1320432,170,154,utRho10
lipB,1324802,1324802,1324556,246,3634,utRho10
lit,2397032,2397390,2397032,358,3794,utRho10
livJ,7199524,7199524,7199316,208,2914,utRho10
livK,7195510,7195510,7195120,390,410,utRho10
lldP,7554578,7554798,7554578,220,3070,utRho10
lnt,1381968,1381968,1381762,206,910,utRho10
loiP,6163784,6163826,6163784,42,388,utRho10
lolA,1874656,1874738,1874656,82,586,utRho10
lolB,2527112,2527112,2527000,112,166,utRho10
lolC,2350748,2350854,2350748,106,0,utRho10
lon,917630,917776,917630,146,314,utRho10
lpcA,486936,487086,486936,150,78,utRho10
lpd,255434,255824,255434,390,3144,utRho10
lplA,9248476,9248476,9248234,242,750,utRho10
lplT,5947878,5947878,5947724,154,48,utRho10
lpoA,6586422,6586800,6586422,378,264,utRho10
lpp,3514592,3514842,3514592,250,84,utRho10
lptA,6686598,6686760,6686598,162,418,utRho10
lptB,6686792,6687888,6686792,1096,1378,utRho10
lptD,114672,114672,114218,454,1726,utRho10
lptF,8972244,8972436,8972244,192,266,utRho10
lpxC,213016,213114,213016,98,6742,utRho10
lpxD,401920,401942,401920,22,110,utRho10
lpxL,2233418,2233418,2233164,254,0,utRho10
lpxM,3880456,3880456,3880386,70,262,utRho10
lpxP,4991156,4991290,4991156,134,164,utRho10
lrhA,4813312,4813312,4813282,30,80,utRho10
lrp,1864656,1865190,1864656,534,302,utRho10
lspA,50028,50414,50028,386,432,utRho10
lsrA,3202920,3202980,3202920,60,104,utRho10
lsrR,3202514,3202514,3202482,32,0,utRho10
ltaE,1818640,1818640,1818588,52,0,utRho10
luxS,5630130,5630130,5629466,664,32548,utRho10
lysA,5957902,5957902,5957798,104,20,utRho10
lysC,8467232,8467232,8466466,766,1066,utRho10
lysP,4497120,4497120,4497064,56,0,utRho10
lysR,5957900,5958042,5957900,142,64,utRho10
lysT,1561028,1561108,1561028,80,146,utRho10
lysU,8709610,8709610,8709434,176,94,utRho10
macB,1840188,1840694,1840188,506,474,utRho10
maeA,3111484,3111484,3111338,146,3438,utRho10
mak,820236,820288,820236,52,66,utRho10
malE,8492928,8492928,8492838,90,0,utRho10
malI,3398456,3398456,3398360,96,0,utRho10
malK,8493472,8493568,8493472,96,0,utRho10
malP,7105020,7105020,7104946,74,980,utRho10
malQ,7100798,7100798,7100140,658,22,utRho10
malS,14949880,14949988,14949880,108,88,utRho10
malT,7106048,7106170,7106048,122,96,utRho10
malX,3398626,3398710,3398626,84,0,utRho10
malZ,1689980,1690072,1689980,92,2980,utRho10
manA,3377102,3377152,3377102,50,8,utRho10
manX,3803866,3804096,3803866,230,138,utRho10
marC,3237882,3237882,3237816,66,484,utRho10
marR,3238186,3238240,3238186,54,404,utRho10
matP,2036918,2036970,2036918,52,264,utRho10
mazE,5822736,5822736,5822678,58,60,utRho10
mazG,5821720,5821720,5821370,350,3930,utRho10
mcbA,1684306,1684306,1684112,194,106,utRho10
mcbR,3040192,3040524,3040192,332,122,utRho10
mcrA,2420278,2420692,2420278,414,194,utRho10
mcrC,9156124,9156124,9155916,208,622,utRho10
mdaB,6344814,6345060,6344814,246,206,utRho10
mdfA,1767138,1767346,1767138,208,20,utRho10
mdh,6768940,6768940,6768536,404,164,utRho10
mdoB,9198988,9198988,9198882,106,5714,utRho10
mdoD,2993290,2993712,2993290,422,32,utRho10
mdoG,2218514,2218670,2218514,156,20,utRho10
mdtA,4307958,4308032,4307958,74,370,utRho10
mdtE,7318168,7318464,7318168,296,790,utRho10
mdtK,3486538,3486914,3486538,376,2158,utRho10
mdtP,8602472,8602472,8602060,412,264,utRho10
melA,8683774,8683822,8683774,48,0,utRho10
melR,8683300,8683300,8683256,44,188,utRho10
menA,8240812,8240812,8240698,114,32,utRho10
menB,4753774,4753774,4753638,136,204,utRho10
mepH,3468714,3468870,3468714,156,0,utRho10
mepM,3883666,3883666,3883270,396,480,utRho10
mepS,4539840,4539958,4539840,118,300,utRho10
metA,8428318,8428560,8428318,242,322,utRho10
metB,8257272,8257344,8257272,72,900,utRho10
metC,6304150,6304472,6304150,322,268,utRho10
metE,8025768,8026106,8025768,338,3114,utRho10
metF,8265092,8265232,8265092,140,168,utRho10
metG,4388538,4388600,4388538,62,10,utRho10
metH,8447010,8447656,8447010,646,1882,utRho10
metJ,8257116,8257116,8256790,326,242,utRho10
metK,6173154,6173412,6173154,258,84,utRho10
metN,445428,445428,445290,138,40,utRho10
metR,8025710,8025710,8025632,78,0,utRho10
metT,1394326,1394326,1394266,60,398,utRho10
metY,19910250,19910250,19909734,516,2124,utRho10
metZ,11789528,11789548,11789528,20,0,utRho10
mfd,2348056,2348056,2347928,128,24,utRho10
mglA,4478782,4478782,4478578,204,82,utRho10
mglB,4481132,4481132,4480696,436,6610,utRho10
mglC,4475918,4475918,4475506,412,106,utRho10
mgrB,3817584,3817584,3817532,52,98,utRho10
mgrR,3245828,3245828,3245828,0,0,utRho10
mgsA,2054082,2054082,2054030,52,82,utRho10
mgtL,8934560,8934862,8934560,302,68,utRho10
mhpA,737038,737222,737038,184,56,utRho10
mhpR,737072,737072,736840,232,0,utRho10
mhpT,750772,750918,750772,146,0,utRho10
miaA,8797964,8798504,8797964,540,4782,utRho10
micA,5629604,5629604,5629604,0,0,utRho10
micC,2874242,2874238,2874242,4,0,utRho10
micF,4626168,4626168,4626168,0,0,utRho10
micM,1014408,1014408,1014408,0,0,utRho10
minE,2449422,2449422,2449090,332,460,utRho10
mioC,7852950,7852950,7852910,40,0,utRho10
mipA,3733012,3733012,3732944,68,1622,utRho10
mlaA,4930270,4930270,4930014,256,0,utRho10
mlc,3337206,3337206,3337128,78,0,utRho10
mlrA,4429498,4429732,4429498,234,130,utRho10
mltA,5894546,5894546,5894356,190,200,utRho10
mltD,468050,468050,467910,140,78,utRho10
mltF,5391534,5391602,5391534,68,48,utRho10
mmuP,550238,550650,550238,412,1482,utRho10
mngA,1531622,1531968,1531622,346,1058,utRho10
mngR,1531852,1531852,1531750,102,670,utRho10
mnmG,7851348,7851348,7851266,82,5672,utRho10
mntH,5025470,5025470,5025412,58,160,utRho10
mntP,3810918,3811376,3810918,458,1730,utRho10
mntR,1706160,1706366,1706160,206,220,utRho10
mntS,1706128,1706128,1705994,134,346,utRho10
moaA,1633654,1634088,1633654,434,1238,utRho10
moaB,1635954,1636110,1635954,156,1694,utRho10
mobA,8084242,8084242,8083998,244,302,utRho10
mocA,6030112,6030320,6030112,208,12,utRho10
modA,1589990,1590178,1589990,188,112,utRho10
moeA,1732788,1732788,1732728,60,6,utRho10
mokB,2984610,2984610,2984258,352,418,utRho10
molR_1,4392888,4392948,4392888,60,128,utRho10
motA,3954604,3954604,3954278,326,272,utRho10
mpaA,2781278,2781278,2781196,82,344,utRho10
mpl,8911456,8911570,8911456,114,20,utRho10
mppA,2786108,2786454,2786108,346,170,utRho10
mprA,5621494,5621540,5621494,46,1758,utRho10
mqo,4613848,4613848,4613508,340,1260,utRho10
mqsA,6336742,6336742,6336492,250,492,utRho10
mqsR,6337306,6337306,6337088,218,740,utRho10
mraZ,179192,179268,179192,76,50,utRho10
mrcA,7045652,7045742,7045652,90,0,utRho10
mrcB,329442,329460,329442,18,0,utRho10
mreB,13605424,13605424,13604348,1076,2036,utRho10
mreD,6798166,6798166,6797750,416,414,utRho10
mrp,4388360,4388360,4388336,24,20,utRho10
mscK,972984,973072,972984,88,140,utRho10
mscL,6876002,6876048,6876002,46,1586,utRho10
mscS,6139742,6139742,6139614,128,202,utRho10
msrA,8884522,8884522,8884352,170,780,utRho10
msrB,3725168,3725168,3724858,310,0,utRho10
msyB,2228426,2228426,2228362,64,586,utRho10
mtfA,4087236,4087302,4087236,66,1366,utRho10
mtgA,6699662,6699662,6699618,44,2074,utRho10
mtlA,30177504,30178248,30177504,744,3696,utRho10
mtn,358366,358366,358306,60,956,utRho10
mtr,6611864,6611864,6611634,230,106,utRho10
mug,6430992,6430992,6430946,46,446,utRho10
murQ,5091466,5091546,5091466,80,0,utRho10
murR,5091586,5091586,5091218,368,122,utRho10
mutH,5939164,5939324,5939164,160,266,utRho10
mutL,8794092,8794824,8794092,732,17418,utRho10
mutM,7622554,7622554,7622304,250,2124,utRho10
mutS,5714038,5714186,5714038,148,844,utRho10
mutY,18617466,18618078,18617466,612,354,utRho10
nac,4123956,4123956,4123866,90,1176,utRho10
nadA,1564122,1564170,1564122,48,58,utRho10
nadB,5420714,5420840,5420714,126,28,utRho10
nadC,237326,237326,237290,36,106,utRho10
nadE,3644604,3644916,3644604,312,302,utRho10
nadK,5501526,5501662,5501526,136,274,utRho10
nagA,1406350,1406350,1405502,848,1666,utRho10
nagB,1407416,1407416,1407222,194,52,utRho10
nagC,1404016,1404016,1403188,828,162,utRho10
nagE,1407680,1407888,1407680,208,114,utRho10
nagK,2357080,2357186,2357080,106,86,utRho10
nanA,6747240,6747240,6747152,88,36,utRho10
nanC,9079856,9079856,9079002,854,122,utRho10
nanR,6749406,6749406,6748978,428,988,utRho10
nanS,9075406,9075406,9075188,218,0,utRho10
napF,4607390,4607390,4606994,396,586,utRho10
narG,2559614,2559728,2559614,114,316,utRho10
narK,2555642,2555914,2555642,272,0,utRho10
narP,4580844,4581000,4580844,156,122,utRho10
narQ,5171154,5171462,5171154,308,206,utRho10
narU,3088326,3088326,3088120,206,202,utRho10
narW,3077374,3077374,3074618,2756,372,utRho10
narX,2555554,2555554,2555236,318,0,utRho10
narZ,3085380,3085380,3085180,200,62,utRho10
ndh,2331984,2332170,2331984,186,168,utRho10
ndk,5289920,5289920,5289728,192,120,utRho10
nemR,6904084,6904092,6904084,8,596,utRho10
nepI,7683542,7683542,7683478,64,220,utRho10
nfo,4501612,4501680,4501612,68,340,utRho10
nfsB,1210906,1210906,1210848,58,94,utRho10
nfuA,7090916,7091248,7090916,332,512,utRho10
nhaA,34634,34978,34634,344,554,utRho10
nhaB,2469534,2469534,2469434,100,0,utRho10
nhoA,3067926,3068048,3067926,122,54,utRho10
nikA,7226878,7227334,7226878,456,10284,utRho10
nikR,7237074,7237176,7237074,102,204,utRho10
nirB,6987974,6988022,6987974,48,154,utRho10
nlpA,7680034,7680034,7679986,48,42,utRho10
nlpC,3585654,3585654,3585462,192,88,utRho10
nlpD,5737658,5737658,5737506,152,72,utRho10
nlpI,6618080,6618080,6617848,232,170,utRho10
nmpC,1153740,1153740,1153650,90,0,utRho10
nohA,3273206,3273206,3272734,472,1428,utRho10
norR,5664614,5664614,5664578,36,0,utRho10
norV,5664878,5664952,5664878,74,0,utRho10
nrdA,4689510,4689730,4689510,220,4628,utRho10
nrdD,8925676,8925676,8925320,356,3738,utRho10
nrdH,5601312,5601446,5601312,134,62,utRho10
nrdR,865954,866004,865954,50,12,utRho10
nrfA,8575342,8575528,8575342,186,146,utRho10
nsrR,8812088,8812380,8812088,292,15216,utRho10
nudB,3897348,3897348,3897264,84,0,utRho10
nudC,8393428,8393806,8393428,378,54,utRho10
nudE,7052658,7052658,7052298,360,1360,utRho10
nudG,3682876,3682980,3682876,104,108,utRho10
nudI,4729050,4729108,4729050,58,0,utRho10
nudJ,2388874,2388874,2388576,298,556,utRho10
nuoA,4810670,4810670,4810144,526,4656,utRho10
nuoN,4783434,4783434,4783010,424,1298,utRho10
nupC,5026018,5026084,5026018,66,0,utRho10
nupG,6211302,6211428,6211302,126,20,utRho10
ogrK,4335096,4335096,4335040,56,52,utRho10
ogt,2800568,2800568,2800472,96,90,utRho10
ohsC,5401036,5401040,5401036,4,74,utRho10
ompA,2040382,2040382,2040106,276,21240,utRho10
ompC,4625774,4625774,4625498,276,52,utRho10
ompF,1974184,1974184,1973964,220,288,utRho10
ompL,8128958,8128958,8128590,368,100,utRho10
ompN,2874158,2874158,2873786,372,120,utRho10
ompR,7073510,7073510,7073168,342,624,utRho10
ompT,1171330,1171330,1171266,64,80,utRho10
ompW,2627982,2628040,2627982,58,22,utRho10
ompX,1700418,1700900,1700418,482,1424,utRho10
omrA,5952378,5952378,5952378,0,0,utRho10
omrB,5952770,5952770,5952770,0,0,utRho10
oppA,2602170,2602364,2602170,194,10572,utRho10
orn,8783168,8783208,8783168,40,0,utRho10
osmB,2686952,2686952,2686656,296,2792,utRho10
osmC,3113192,3113250,3113192,58,40,utRho10
osmE,3644566,3644566,3644512,54,0,utRho10
osmF,4439046,4439046,4438962,84,1000,utRho10
osmY,9222306,9222792,9222306,486,1146,utRho10
otsA,3963302,3963302,3963224,78,96,utRho10
otsB,3964930,3964930,3964774,156,1246,utRho10
oxc,4984288,4984288,4983900,388,294,utRho10
oxyR,8316914,8316980,8316914,66,702,utRho10
oxyS,8316788,8316788,8316788,0,0,utRho10
paaA,2907730,2907854,2907730,124,0,utRho10
paaX,2927018,2927078,2927018,60,0,utRho10
paaZ,2907340,2907340,2907284,56,0,utRho10
pabA,6981702,6981702,6981658,44,112,utRho10
pabB,3789256,3789610,3789256,354,686,utRho10
pabC,2306186,2306600,2306186,414,720,utRho10
pagP,1313052,1313114,1313052,62,46,utRho10
panB,299260,299260,299202,58,3428,utRho10
panC,297840,297840,297590,250,348,utRho10
panD,293490,293490,293388,102,476,utRho10
panZ,7195656,7195968,7195656,312,64,utRho10
parC,6332060,6332060,6331946,114,360,utRho10
patA,6438916,6438988,6438916,72,68,utRho10
patD,3030830,3031156,3030830,326,42,utRho10
pbpC,5294986,5294986,5294650,336,0,utRho10
pbpG,4450132,4450132,4449740,392,184,utRho10
pck,7065358,7065636,7065358,278,4302,utRho10
pcnB,318782,318782,318252,530,876,utRho10
pdhR,244068,244184,244068,116,0,utRho10
pdxB,4875768,4875768,4875702,66,0,utRho10
pdxH,3436068,3436068,3436014,54,424,utRho10
pdxJ,5403626,5403626,5403458,168,544,utRho10
pdxK,5074638,5074638,5074474,164,134,utRho10
pepA,8972278,8972278,8971902,376,276,utRho10
pepD,511618,511618,511432,186,2636,utRho10
pepN,1981182,1981244,1981182,62,206,utRho10
pepQ,8062294,8062322,8062294,28,72,utRho10
pepT,2371646,2371688,2371646,42,66,utRho10
pfkA,8214948,8215104,8214948,156,164,utRho10
pfkB,3612646,3612740,3612646,94,46,utRho10
pflA,1902456,1902456,1902160,296,70,utRho10
pflB,1907850,1907850,1907108,742,950,utRho10
pflD,8287716,8287990,8287716,274,0,utRho10
pgaA,2185046,2185046,2184578,468,264,utRho10
pgi,8467444,8467516,8467444,72,62,utRho10
pgk,12291428,12291428,12290488,940,3508,utRho10
pgl,1597078,1597172,1597078,94,152,utRho10
pgpB,2678324,2678660,2678324,336,484,utRho10
pgpC,5397276,5397276,5397100,176,242,utRho10
pgrR,2783744,2783982,2783744,238,666,utRho10
pheL,5475158,5475198,5475158,40,112,utRho10
pheM,7197204,7197204,7197080,124,32,utRho10
pheP,1203858,1203918,1203858,60,10,utRho10
pheU,8725254,8725254,8725252,2,26,utRho10
pheV,6220730,6220732,6220730,2,8,utRho10
phnC,8650412,8650412,8650330,82,12,utRho10
phoA,803414,803494,803414,80,50,utRho10
phoB,834202,834284,834202,82,4,utRho10
phoE,520316,520316,520200,116,304,utRho10
phoH,2169730,2169984,2169730,254,152,utRho10
phoP,2381016,2381016,2380894,122,3084,utRho10
phoQ,2379880,2379880,2379552,328,1050,utRho10
phoU,7815330,7815330,7815156,174,272,utRho10
phr,1478842,1479014,1478842,172,0,utRho10
pinE,2419054,2419370,2419054,316,366,utRho10
pinQ,3267168,3267244,3267168,76,464,utRho10
pinR,2867424,2867424,2867348,76,774,utRho10
pitA,7275224,7275284,7275224,60,42,utRho10
pitB,6272806,6272806,6272742,64,104,utRho10
pka,5439862,5439906,5439862,44,354,utRho10
plaP,4174476,4174476,4174124,352,602,utRho10
pldA,8009628,8009724,8009628,96,594,utRho10
pldB,8018028,8018340,8018028,312,1996,utRho10
plsB,8513196,8513196,8512932,264,424,utRho10
pmbA,8915890,8915918,8915890,28,62,utRho10
pmrD,4747148,4747148,4747076,72,0,utRho10
pncB,1980828,1980828,1980712,116,52,utRho10
pncC,5648788,5648788,5648692,96,0,utRho10
pnp,6622652,6622652,6622336,316,64,utRho10
pntA,3355950,3355950,3355806,144,0,utRho10
pntB,3353096,3353096,3352720,376,80,utRho10
polA,8093880,8093932,8093880,52,262,utRho10
polB,131606,131606,131560,46,0,utRho10
potD,2365700,2365700,2365658,42,2,utRho10
potE,1436688,1436688,1436530,158,62,utRho10
potF,1787268,1787568,1787268,300,292,utRho10
poxB,1822152,1822152,1822098,54,364,utRho10
ppa,8899372,8899372,8899304,68,166,utRho10
ppc,8306380,8306380,8306196,184,106,utRho10
ppdA,5928440,5928440,5928354,86,4578,utRho10
ppdD,235410,235410,235098,312,480,utRho10
pphA,3846770,3846770,3845938,832,9536,utRho10
pphB,5719474,5719520,5719474,46,0,utRho10
ppiA,6984898,6984898,6984594,304,92,utRho10
ppiC,7919682,7919682,7919626,56,10,utRho10
ppiD,923638,923830,923638,192,644,utRho10
ppk,5245748,5246088,5245748,340,842,utRho10
pppA,6228958,6228958,6228704,254,0,utRho10
ppsA,3574322,3574322,3574224,98,0,utRho10
ppsR,3574678,3574890,3574678,212,200,utRho10
pptA,3065716,3066104,3065716,388,376,utRho10
pqiA,2023318,2024002,2023318,684,48,utRho10
prc,3830054,3830054,3829632,422,17310,utRho10
preT,4467978,4468066,4467978,88,1904,utRho10
prfC,9218688,9218828,9218688,140,1332,utRho10
prkB,6968622,6968980,6968622,358,1732,utRho10
prlC,7290476,7290476,7290364,112,314,utRho10
prlF,6553944,6554004,6553944,60,450,utRho10
proB,520432,520776,520432,344,662,utRho10
proC,811372,811372,811288,84,0,utRho10
proK,7417388,7417388,7417384,4,38,utRho10
proL,4572414,4572422,4572414,8,0,utRho10
proP,8660640,8661004,8660640,364,534,utRho10
proS,437674,437674,437550,124,936,utRho10
proV,5609126,5609630,5609126,504,272,utRho10
prpB,697292,697364,697292,72,68,utRho10
prpR,696942,696942,696886,56,80,utRho10
prs,2524354,2524354,2523750,604,33084,utRho10
psd,8781276,8781276,8780720,556,1538,utRho10
psiE,8480600,8480650,8480600,50,0,utRho10
pspA,2736076,2736158,2736076,82,0,utRho10
pspF,2736080,2736080,2735824,256,0,utRho10
pspG,8525632,8525680,8525632,48,42,utRho10
pssA,5445156,5445454,5445156,298,6228,utRho10
pstB,7817112,7817112,7816732,380,290,utRho10
pstC,7821084,7821084,7820796,288,24,utRho10
pstS,23469408,23469408,23469150,258,396,utRho10
psuG,4517114,4517114,4516734,380,1700,utRho10
psuT,4514992,4514992,4514670,322,0,utRho10
pth,2517084,2517084,2517026,58,98,utRho10
ptrA,5918022,5918022,5917768,254,0,utRho10
ptrB,3857730,3857730,3857678,52,4272,utRho10
ptsG,2315252,2315738,2315252,486,2976,utRho10
ptsH,5066996,5067528,5066996,532,2728,utRho10
purA,8809328,8809374,8809328,46,2,utRho10
purC,5195562,5195562,5195236,326,46,utRho10
purD,8411972,8411972,8411862,110,150,utRho10
purE,1106284,1106284,1106200,84,1284,utRho10
purH,8415254,8415254,8415064,190,128,utRho10
purL,5391178,5391178,5391086,92,136,utRho10
purM,5242306,5242394,5242306,88,62,utRho10
purR,3475378,3475688,3475378,310,188,utRho10
purT,3861438,3861762,3861438,324,732,utRho10
purU,2577512,2577512,2577248,264,84,utRho10
putA,2157850,2157850,2157764,86,0,utRho10
putP,2158336,2158610,2158336,274,180,utRho10
puuA,2721936,2721936,2721816,120,0,utRho10
puuC,2725456,2725486,2725456,30,0,utRho10
puuD,2722104,2722240,2722104,136,4,utRho10
puuP,2718746,2718746,2718374,372,346,utRho10
pykA,3874988,3875298,3874988,310,428,utRho10
pykF,3510934,3511396,3510934,462,622,utRho10
pyrC,2245286,2245286,2245214,72,68,utRho10
pyrD,2009464,2009536,2009464,72,284,utRho10
pyrE,7631970,7631970,7631536,434,232,utRho10
pyrF,2683740,2683842,2683740,102,548,utRho10
pyrG,5819594,5819594,5819332,262,2126,utRho10
pyrH,383624,383710,383624,86,2660,utRho10
pyrL,8945490,8945490,8945066,424,414,utRho10
qmcA,1031646,1031646,1031546,100,222,utRho10
qor,8528608,8528608,8528462,146,1784,utRho10
qseB,6339502,6339656,6339502,154,518,utRho10
queA,849970,850022,849970,52,1296,utRho10
queE,5811212,5811212,5810836,376,1636,utRho10
queF,5850642,5850696,5850642,54,20,utRho10
queG,8788184,8788184,8788134,50,196472,utRho10
racC,2835630,2835630,2835526,104,36,utRho10
racR,2840898,2840898,2840482,416,180,utRho10
raiA,5474208,5474308,5474208,100,2,utRho10
rarD,8008594,8008594,8008356,238,258,utRho10
ravA,7862256,7862256,7862186,70,96,utRho10
rayT,495088,495274,495088,186,48,utRho10
rbn,4763162,4763216,4763162,54,0,utRho10
rbsD,7866644,7866702,7866644,58,0,utRho10
rcnA,4371654,4371834,4371654,180,160,utRho10
rcnB,4373768,4373920,4373768,152,68,utRho10
rcnR,4371806,4371806,4371592,214,330,utRho10
rcsA,4047672,4047936,4047672,264,11374,utRho10
rcsB,4631390,4632354,4631390,964,536,utRho10
rcsC,4640162,4640162,4639656,506,202,utRho10
rcsD,4626904,4626976,4626904,72,232,utRho10
rdgB,6193240,6193362,6193240,122,666,utRho10
rdlA,2538646,2538646,2538646,0,0,utRho10
rdlB,2539712,2539716,2539712,4,72,utRho10
rdlC,2540782,2540786,2540782,4,2,utRho10
rdlD,7400272,7400272,7400272,0,0,utRho10
rdoA,8084782,8084830,8084782,48,20,utRho10
recA,11295276,11295276,11295076,200,232,utRho10
recC,5925014,5925014,5924856,158,96,utRho10
recF,7763722,7763722,7762442,1280,8638,utRho10
recN,5503518,5503590,5503518,72,0,utRho10
recQ,8011666,8011728,8011666,62,182,utRho10
relA,5828554,5828554,5827302,1252,532,utRho10
relB,3291806,3291806,3291744,62,68,utRho10
rem,3289950,3289950,3289804,146,170,utRho10
rep,7921294,7921354,7921294,60,98,utRho10
rfaD,7587730,7587974,7587730,244,750,utRho10
rfaE,6393852,6393852,6393506,346,0,utRho10
rfaH,8049930,8049930,8049642,288,2278,utRho10
rfbX,4219436,4219436,4219168,268,3226,utRho10
rfe,7935600,7935832,7935600,232,582,utRho10
rhaB,8194944,8194944,8194896,48,0,utRho10
rhaD,8188770,8188770,8188544,226,66,utRho10
rhaS,8195422,8195472,8195422,50,0,utRho10
rhaT,8201132,8201132,8201050,82,2,utRho10
rhlE,1661566,1661744,1661566,178,172,utRho10
rhoL,47593944,47594772,47593944,828,232368,utRho10
rhsB,7238006,7238384,7238006,378,722,utRho10
rhsC,1458758,1459166,1458758,408,0,utRho10
rhsD,1046132,1046522,1046132,390,56,utRho10
rhtA,1700608,1700608,1700194,414,310,utRho10
rhtC,8015478,8015514,8015478,36,1406,utRho10
ribA,2678468,2678468,2678320,148,402,utRho10
ribC,3486916,3486916,3486484,432,3576,utRho10
ribE,869008,869294,869008,286,5354,utRho10
ribF,42766,42814,42766,48,0,utRho10
ridA,8941892,8941892,8941826,66,100,utRho10
rihA,1369204,1369204,1368824,380,3662,utRho10
rihB,4510504,4510504,4510372,132,108,utRho10
rimJ,2251044,2251124,2251044,80,234,utRho10
rimK,1783752,1783934,1783752,182,554,utRho10
rimL,2997486,2997876,2997486,390,54,utRho10
rimO,1756140,1756140,1756070,70,78,utRho10
rimP,6636350,6636350,6636012,338,448,utRho10
rlmA,3814172,3814172,3814120,52,1744,utRho10
rlmD,5830086,5830086,5830000,86,34,utRho10
rlmE,6655520,6655520,6655328,192,1012,utRho10
rlmF,1684384,1684664,1684384,280,162,utRho10
rlmG,6471784,6471784,6471750,34,0,utRho10
rlmI,2060002,2060002,2059938,64,538,utRho10
rlmJ,7290700,7290770,7290700,70,12,utRho10
rlmL,2015344,2015688,2015344,344,1946,utRho10
rlpA,1330444,1330444,1330380,64,340,utRho10
rluA,120900,120900,120692,208,530,utRho10
rluF,8460324,8460708,8460324,384,232,utRho10
rmf,2031006,2031430,2031006,424,1434,utRho10
rna,1290068,1290068,1290006,62,24,utRho10
rnb,2698258,2698258,2697824,434,2966,utRho10
rnc,10816892,10816892,10816252,640,12820,utRho10
rnd,3776122,3776122,3775982,140,254,utRho10
rne,2289746,2289746,2288734,1012,7186,utRho10
rnhA,472082,472082,472004,78,878,utRho10
rnk,1288360,1288360,1287934,426,58,utRho10
rnlA,5531788,5531836,5531788,48,554,utRho10
rnlB,5533414,5533968,5533414,554,688,utRho10
rnpB,19623552,19623552,19623552,0,0,utRho10
rob,9270706,9270706,9270620,86,92,utRho10
rodZ,5285868,5285868,5285688,180,40,utRho10
rpe,7030306,7030306,7030118,188,230,utRho10
rph,15266320,15266320,15266196,124,32,utRho10
rpiA,6118706,6118706,6118650,56,1528,utRho10
rpiB,8626514,8626700,8626514,186,170,utRho10
rpiR,8626274,8626274,8625982,292,34,utRho10
rplJ,8359246,8359992,8359246,746,8574,utRho10
rplK,8356708,8356894,8356708,186,1100,utRho10
rplM,6757344,6757344,6757302,42,10532,utRho10
rplN,6896444,6896444,6896298,146,14292,utRho10
rplS,5489284,5489284,5489060,224,20888,utRho10
rplT,7199052,7199052,7198996,56,676,utRho10
rplU,6667036,6667036,6666902,134,118,utRho10
rplY,4564866,4565034,4564866,168,32,utRho10
rpmA,6666450,6666450,6666238,212,1220,utRho10
rpmB,15247980,15247980,15246696,1284,132108,utRho10
rpmE,8253816,8254026,8253816,210,784,utRho10
rpmF,2294676,2294734,2294676,58,59044,utRho10
rpmH,7768130,7768672,7768130,542,7318,utRho10
rpmI,3600854,3600854,3599998,856,11928,utRho10
rpoB,8362126,8362490,8362126,364,722,utRho10
rpoD,6424946,6426094,6424946,1148,28204,utRho10
rpoE,5420372,5420372,5420024,348,0,utRho10
rpoH,7202006,7202006,7201566,440,7158,utRho10
rpoN,6689324,6689434,6689324,110,48,utRho10
rpoS,5736236,5736236,5735102,1134,2778,utRho10
rpoZ,7644154,7644212,7644154,58,578,utRho10
rppH,5937986,5937986,5937954,32,38,utRho10
rprA,3540744,3540744,3540744,0,0,utRho10
rpsA,1923434,1923990,1923434,556,197894,utRho10
rpsF,8850050,8850236,8850050,186,43554,utRho10
rpsI,6756580,6756580,6756414,166,12098,utRho10
rpsJ,6906884,6906884,6906540,344,13954,utRho10
rpsL,6949242,6949242,6949104,138,720,utRho10
rpsM,6885130,6885130,6884942,188,2552,utRho10
rpsO,13247144,13247144,13246736,408,2892,utRho10
rpsP,5492508,5492508,5492370,138,74,utRho10
rpsT,42420,42420,42156,264,750,utRho10
rpsU,12842584,12843124,12842584,540,4228,utRho10
rraA,8238716,8238716,8238660,56,334,utRho10
rraB,8956768,8956946,8956768,178,142,utRho10
rrsA,8070478,8071062,8070478,584,6266,utRho10
rrsB,16665468,16666636,16665468,1168,13036,utRho10
rrsC,7883032,7883616,7883032,584,8156,utRho10
rrsD,6858094,6858094,6857524,570,784,utRho10
rrsE,8415726,8416294,8415726,568,870,utRho10
rrsG,5462896,5462896,5462314,582,5478,utRho10
rrsH,446970,447542,446970,572,946,utRho10
rsd,8393908,8393908,8393616,292,204,utRho10
rseA,5419264,5419264,5418808,456,44,utRho10
rseP,392940,393092,392940,152,14,utRho10
rseX,4067298,4067298,4067298,0,0,utRho10
rsfS,1338144,1338144,1338072,72,482,utRho10
rsgA,8783132,8783132,8783018,114,0,utRho10
rsmA,105176,105176,104860,316,3248,utRho10
rsmB,6869982,6870414,6869982,432,604,utRho10
rsmC,9215736,9215736,9215400,336,212,utRho10
rsmD,7208594,7208786,7208594,192,0,utRho10
rsmE,6182036,6182268,6182036,232,640,utRho10
rsmG,7847512,7847512,7847360,152,1622,utRho10
rsmH,180020,180188,180020,168,106,utRho10
rsmI,6587106,6587106,6586670,436,1060,utRho10
rssA,2578212,2578412,2578212,200,916,utRho10
rssB,2580440,2580484,2580440,44,192,utRho10
rstA,3364276,3364300,3364276,24,0,utRho10
rsuA,4561096,4561096,4560966,130,286,utRho10
rsxA,3411510,3411534,3411510,24,0,utRho10
rtcA,7114004,7114004,7113698,306,482,utRho10
rtcB,7116214,7116214,7116158,56,0,utRho10
rtn,4541356,4541452,4541356,96,80,utRho10
rutA,2148052,2148052,2148022,30,88,utRho10
rutG,2140090,2140090,2139678,412,34,utRho10
rutR,2148226,2148484,2148226,258,416,utRho10
ruvA,7784096,7784096,7783904,192,196,utRho10
ruvB,7782176,7782176,7781424,752,872,utRho10
ruvC,3894878,3894878,3894752,126,32,utRho10
rybB,1776114,1776114,1776114,0,0,utRho10
rydB,3529860,3529860,3529322,538,144,utRho10
rydC,2983012,2983012,2983012,0,0,utRho10
ryfA,5307398,5307710,5307398,312,218,utRho10
ryfD,5468590,5468590,5468590,0,0,utRho10
ryhB,7162032,7162032,7162032,0,0,utRho10
ryjA,8556132,8556132,8556132,0,0,utRho10
ryjB,9055954,9055954,9055954,0,0,utRho10
sad,3229598,3229598,3229406,192,0,utRho10
safA,3168056,3168056,3167918,138,138,utRho10
sanA,4465368,4465756,4465368,388,88,utRho10
sapF,2705314,2705314,2705268,46,54,utRho10
sbcB,4165456,4165512,4165456,56,0,utRho10
sbcC,831694,831694,831506,188,132,utRho10
sbcD,833954,833954,833904,50,46,utRho10
sbmA,793106,793278,793106,172,716,utRho10
sbmC,4162650,4162650,4162524,126,0,utRho10
sdaA,3793618,3793864,3793618,246,60,utRho10
sdaC,5856070,5856458,5856070,388,1446,utRho10
sdhC,1509916,1510354,1509916,438,31478,utRho10
sdhD,1510808,1511120,1510808,312,5722,utRho10
sdiA,3993834,3993834,3993664,170,420,utRho10
secE,8354354,8354716,8354354,362,454,utRho10
secG,6645180,6645180,6645010,170,770,utRho10
selA,7522594,7522594,7522498,96,1040,utRho10
selB,7519850,7519850,7519722,128,100,utRho10
selC,7672396,7672444,7672396,48,50,utRho10
selD,3696058,3696058,3696016,42,1958,utRho10
seqA,1425884,1425974,1425884,90,478,utRho10
serA,6117098,6117098,6116820,278,1512,utRho10
serB,9249712,9249790,9249712,78,248,utRho10
serC,3830380,3830612,3830380,232,0,utRho10
serS,1878730,1878856,1878730,126,2644,utRho10
serT,2063438,2063438,2063424,14,0,utRho10
serU,4087124,4087124,4087114,10,192,utRho10
serV,5637394,5637394,5637290,104,200,utRho10
serW,1852014,1852014,1851942,72,106,utRho10
serX,2195352,2195352,2195304,48,0,utRho10
setB,4527426,4527726,4527426,300,138,utRho10
setC,7673488,7673906,7673488,418,2650,utRho10
sfmA,1116124,1116424,1116124,300,120,utRho10
sfmC,1117606,1117948,1117606,342,0,utRho10
sfsA,323030,323030,322972,58,304,utRho10
sfsB,6669592,6669818,6669592,226,1552,utRho10
sgrR,154676,154676,154598,78,32,utRho10
sgrS,154734,154734,154734,0,0,utRho10
shiA,4107068,4107286,4107068,218,54,utRho10
sibA,4306622,4306622,4306622,0,0,utRho10
sibB,4307292,4307292,4307292,0,0,utRho10
sibC,6113702,6113702,6113702,0,0,utRho10
sibD,6389730,6389730,6389730,0,0,utRho10
sibE,6390480,6390480,6390480,0,0,utRho10
sixA,4913998,4913998,4913624,374,52,utRho10
slp,7307872,7307922,7307872,50,22,utRho10
slt,9261400,9261466,9261400,66,112,utRho10
slyA,3442028,3442028,3441648,380,82,utRho10
slyB,3439496,3439752,3439496,256,52,utRho10
slyD,6957398,6957398,6956994,404,360,utRho10
slyX,6954862,6955280,6954862,418,8378,utRho10
smf,6867372,6867372,6867120,252,424,utRho10
smpB,5509534,5509792,5509534,258,920,utRho10
smrA,2811872,2811958,2811872,86,196,utRho10
smrB,4896872,4897212,4896872,340,320,utRho10
smtA,1946808,1947074,1946808,266,84,utRho10
sodA,8201518,8201620,8201518,102,5670,utRho10
sodB,3470646,3470756,3470646,110,350,utRho10
sodC,3449358,3449358,3449310,48,124,utRho10
sohB,2658568,2658664,2658568,96,670,utRho10
sokB,2984232,2984238,2984232,6,44,utRho10
solA,2241218,2241218,2241172,46,2,utRho10
soxR,8554894,8554938,8554894,44,128,utRho10
soxS,8554846,8554846,8554766,80,122,utRho10
speA,6172096,6172096,6171822,274,408,utRho10
speB,6167892,6167892,6167594,298,264,utRho10
speC,6218350,6218350,6218310,40,50,utRho10
spf,8099798,8099798,8099798,0,0,utRho10
sppA,3697422,3697674,3697422,252,244,utRho10
spy,3651376,3651376,3651250,126,0,utRho10
sra,3112092,3112092,3111926,166,92,utRho10
sraB,2293178,2293178,2293178,0,0,utRho10
sraC,3846132,3846132,3846132,0,0,utRho10
srlA,5651582,5651664,5651582,82,66,utRho10
srlR,5657720,5658094,5657720,374,814,utRho10
srmB,5425752,5425792,5425752,40,98,utRho10
sroA,151216,151216,151216,0,0,utRho10
sroG,6369436,6369436,6369436,0,0,utRho10
sroH,8380974,8380974,8380974,0,0,utRho10
ssb,8548022,8548250,8548022,228,252,utRho10
sseA,5304782,5304988,5304782,206,4538,utRho10
sspA,6755138,6755138,6754840,298,586,utRho10
ssrA,5511014,5511186,5511014,172,174,utRho10
ssrS,12223036,12223932,12223036,896,1248,utRho10
sstT,6479726,6479888,6479726,162,104,utRho10
ssuB,1988282,1988282,1988088,194,242,utRho10
ssuE,1995126,1995126,1995024,102,0,utRho10
sthA,8321604,8321604,8321580,24,1672,utRho10
stpA,5597156,5597156,5596990,166,54,utRho10
sucA,3034344,3034824,3034344,480,4356,utRho10
sufA,3528836,3528836,3528772,64,212,utRho10
sufE,3518962,3518962,3518580,382,232,utRho10
sugE,8753588,8753750,8753588,162,2184,utRho10
sulA,2041894,2041894,2041838,56,4160,utRho10
syd,5850738,5850738,5850560,178,50,utRho10
symE,9159834,9159834,9159680,154,546,utRho10
symR,9159670,9159670,9159670,0,0,utRho10
tabA,8949566,8949724,8949566,158,62,utRho10
talA,5157140,5157332,5157140,192,0,utRho10
talB,16382,16476,16382,94,5940,utRho10
tam,3214442,3214692,3214442,250,34,utRho10
tamA,8884540,8884764,8884540,224,712,utRho10
tar,3945432,3945432,3945382,50,184,utRho10
tas,5943138,5943194,5943138,56,1262,utRho10
tatA,16087636,16087780,16087636,144,216,utRho10
tatE,1317742,1317894,1317742,152,120,utRho10
tauA,770410,770464,770410,54,96,utRho10
tdcA,6534186,6534186,6534130,56,0,utRho10
tdcG,6519652,6519652,6519298,354,350,utRho10
tdcR,6534380,6534760,6534380,380,44,utRho10
tdk,2586986,2587054,2586986,68,56,utRho10
tehA,3001072,3001146,3001072,74,0,utRho10
tesA,1039898,1039898,1039530,368,178,utRho10
tesB,950402,950402,950322,80,46,utRho10
tfaE,2418532,2418532,2418238,294,216,utRho10
tfaQ,3269912,3269912,3269770,142,532,utRho10
tff,379424,379256,379424,168,60,utRho10
tgt,852110,852274,852110,164,26,utRho10
thiD,4369346,4369346,4369032,314,130,utRho10
thiI,882936,883098,882936,162,436,utRho10
thiM,4370902,4370902,4370602,300,1102,utRho10
thiQ,146170,146170,145854,316,504,utRho10
thrL,592,760,592,168,152,utRho10
thrS,7210932,7210932,7210280,652,1028,utRho10
thrU,8350762,8350776,8350762,14,4,utRho10
thrV,6847414,6847414,6847310,104,187108,utRho10
thrW,525682,525742,525682,60,1754,utRho10
thyA,5930696,5930696,5930310,386,2180,utRho10
tig,909986,910266,909986,280,1110,utRho10
tisB,7706674,7707106,7706674,432,612,utRho10
tktA,6163414,6163414,6163270,144,278,utRho10
tktB,5158616,5159272,5158616,656,504,utRho10
tldD,6784368,6784368,6784056,312,34,utRho10
tmcA,5191876,5191876,5191718,158,112,utRho10
tnaC,15553644,15553740,15553644,96,1860,utRho10
tolB,1555074,1555480,1555074,406,346,utRho10
tolC,6356008,6356230,6356008,222,710,utRho10
tomB,961588,961588,961416,172,3422,utRho10
tonB,2622108,2622178,2622108,70,288,utRho10
topA,2661578,2662096,2661578,518,556,utRho10
torC,2116112,2116168,2116112,56,10,utRho10
torR,2115968,2115968,2115908,60,58,utRho10
torS,2112364,2112364,2112356,8,0,utRho10
torT,2112414,2112522,2112414,108,0,utRho10
tpiA,8223138,8223138,8223014,124,232,utRho10
tppB,3425342,3425538,3425342,196,6068,utRho10
tpr,2574376,2574376,2574376,0,0,utRho10
tpx,2777688,2777688,2777622,66,936,utRho10
tqsA,3347780,3347826,3347780,46,0,utRho10
treA,2494850,2494850,2494752,98,1370,utRho10
treB,8932420,8932420,8932360,60,84,utRho10
treF,7339102,7339184,7339102,82,284,utRho10
treR,8934694,8934694,8934492,202,0,utRho10
trg,2984878,2984940,2984878,62,264,utRho10
trkG,2847342,2847564,2847342,222,364,utRho10
trmA,8326590,8326590,8326540,50,222,utRho10
trpA,2634678,2634678,2634444,234,378,utRho10
trpC,2639888,2639888,2639570,318,0,utRho10
trpL,5292432,5292432,5292328,104,0,utRho10
trpR,9265408,9265520,9265408,112,322,utRho10
trpS,7027394,7027394,7027276,118,2366,utRho10
trpT,7893560,7893914,7893560,354,114558,utRho10
trxA,7931294,7931522,7931294,228,438,utRho10
trxB,1864156,1864156,1864100,56,64,utRho10
trxC,5437350,5437470,5437350,120,256,utRho10
tsaD,6421256,6421256,6421086,170,54,utRho10
tsgA,6985038,6985136,6985038,98,50,utRho10
tsr,9182824,9183314,9182824,490,268,utRho10
tsx,864490,864490,864026,464,270,utRho10
ttcA,2823970,2823970,2823896,74,2434,utRho10
ttdA,6412848,6412926,6412848,78,30,utRho10
ttdR,6412760,6412760,6412512,248,164,utRho10
tufA,6943448,6943448,6942658,790,183448,utRho10
tus,3368346,3368518,3368346,172,66,utRho10
tusA,7218040,7218040,7217992,48,80,utRho10
tusB,6950218,6950218,6949930,288,1370,utRho10
tynA,2902996,2902996,2902698,298,0,utRho10
typA,8116460,8116814,8116460,354,8084,utRho10
tyrB,8534164,8534228,8534164,64,3426,utRho10
tyrP,3979004,3979362,3979004,358,966,utRho10
tyrR,2773384,2773440,2773384,56,32,utRho10
tyrS,3434566,3434566,3434444,122,42,utRho10
tyrT,2575330,2575330,2575244,86,48,utRho10
uacT,6062378,6062734,6062378,356,382,utRho10
ubiC,8504886,8505012,8504886,126,152,utRho10
ubiD,8049618,8049976,8049618,358,2410,utRho10
ubiE,8037494,8037710,8037494,216,104,utRho10
ubiG,4679078,4679134,4679078,56,102,utRho10
ucpA,5089342,5089342,5089246,96,0,utRho10
udp,8032782,8032862,8032782,80,84,utRho10
ugd,4199470,4199470,4199226,244,0,utRho10
ugpB,7184852,7184852,7184650,202,2822,utRho10
ugpQ,7176600,7176600,7176226,374,76,utRho10
uhpT,7694396,7694396,7694334,62,100,utRho10
uidA,3392304,3392304,3392142,162,136,utRho10
uidC,3386012,3386012,3385702,310,0,utRho10
uidR,3394150,3394150,3394104,46,194,utRho10
ulaA,8839854,8839960,8839854,106,60,utRho10
ulaG,8839350,8839350,8839250,100,204,utRho10
ulaR,8837124,8837124,8836906,218,72,utRho10
umpG,5741372,5741372,5740548,824,188,utRho10
umpH,1400704,1400704,1400652,52,20,utRho10
umuD,2461476,2461534,2461476,58,0,utRho10
ung,5433476,5433508,5433476,32,72,utRho10
uof,2843316,2843316,2842900,416,8360,utRho10
upp,5241818,5241818,5241744,74,286,utRho10
usg,4873780,4873780,4873298,482,616,utRho10
ushA,1009772,1009828,1009772,56,74,utRho10
uspA,7279966,7280222,7279966,256,596,utRho10
uspB,7279696,7279696,7279440,256,370,utRho10
uspC,3959172,3959506,3959172,334,144,utRho10
uspE,2797318,2797318,2797244,74,280,utRho10
uspF,2871282,2871282,2871238,44,186,utRho10
uspG,1283806,1283806,1283734,72,2270,utRho10
uvrA,8547872,8547872,8547742,130,448,utRho10
uvrB,1626304,1627052,1626304,748,398,utRho10
uvrC,3989758,3989758,3989412,346,112,utRho10
uvrD,7995814,7995966,7995814,152,650,utRho10
uvrY,3990812,3990812,3990718,94,108,utRho10
uxaB,3221474,3221474,3221360,114,106,utRho10
uxaC,6489714,6489714,6489482,232,78,utRho10
uxuA,9103036,9103272,9103036,236,356,utRho10
uxuR,9108916,9109152,9108916,236,110,utRho10
valS,8967854,8967854,8967674,180,278,utRho10
valU,5041848,5041862,5041848,14,58,utRho10
valV,3492830,3492870,3492830,40,46,utRho10
ves,3649968,3649968,3649874,94,38,utRho10
waaA,7616512,7617080,7616512,568,648,utRho10
waaH,7580298,7580298,7580162,136,0,utRho10
waaQ,7616476,7616476,7616196,280,222,utRho10
waaU,7598996,7598996,7598624,372,392,utRho10
waaY,7602272,7602272,7601930,342,7216,utRho10
wbbH,4214888,4214888,4214452,436,5894,utRho10
wbbK,4209212,4209212,4209018,194,436,utRho10
wcaM,4231868,4231868,4231792,76,0,utRho10
wrbA,2135516,2135516,2135416,100,76,utRho10
wza,4275166,4275166,4274486,680,272,utRho10
wzxC,4240674,4240674,4240316,358,0,utRho10
wzzB,4196950,4196950,4196602,348,160,utRho10
xanP,7657642,7657890,7657642,248,220,utRho10
xanQ,6048520,6048702,6048520,182,100,utRho10
xapA,5049820,5049820,5049756,64,64,utRho10
xapR,10090252,10090252,10089908,344,60,utRho10
xdhA,6000514,6000690,6000514,176,694,utRho10
xerD,6079702,6079702,6079486,216,158,utRho10
xseA,5268394,5268464,5268394,70,132,utRho10
xseB,882746,882746,882686,60,432,utRho10
xthA,3664798,3664856,3664798,58,0,utRho10
xylA,7461614,7461614,7461530,84,5024,utRho10
xylE,8484540,8484540,8484508,32,0,utRho10
xylF,7462138,7462262,7462138,124,378,utRho10
xylR,7469812,7469958,7469812,146,40,utRho10
yaaA,13230,13230,12918,312,90,utRho10
yaaI,23876,23876,23572,304,1144,utRho10
yaaJ,16034,16034,15918,116,72,utRho10
yaaU,91184,91614,91184,430,298,utRho10
yaaW,23084,23084,22712,372,192,utRho10
yaaX,10060,10468,10060,408,282,utRho10
yabI,142542,142702,142542,160,244,utRho10
yacC,273880,273880,273834,46,894,utRho10
yacH,262932,262932,262520,412,574,utRho10
yacL,268678,268776,268678,98,630,utRho10
yadD,293796,293936,293796,140,124,utRho10
yadE,289930,290162,289930,232,752,utRho10
yadN,314110,314110,313766,344,396,utRho10
yadS,355572,355572,355248,324,3152,utRho10
yadV,312470,312470,312402,68,134,utRho10
yaeF,434270,434270,434006,264,44,utRho10
yaeP,428374,428374,428250,124,1210,utRho10
yaeQ,428176,428582,428176,406,1972,utRho10
yaeR,423716,423754,423716,38,0,utRho10
yafC,462166,462166,461762,404,288,utRho10
yafD,462128,462244,462128,116,276,utRho10
yafK,491986,491986,491610,376,1390,utRho10
yafL,493282,493424,493282,142,54,utRho10
yafN,503938,504010,503938,72,0,utRho10
yafS,469568,469632,469568,64,1186,utRho10
yafT,474470,474670,474470,200,100,utRho10
yafV,480432,480432,480378,54,336,utRho10
yafZ,536052,536052,536010,42,86,utRho10
yagE,564446,564556,564446,110,74,utRho10
yagG,570414,570790,570414,376,100,utRho10
yagI,578384,578384,578324,60,22,utRho10
yagK,586236,586236,585896,340,768,utRho10
yagL,588062,588062,587836,226,612,utRho10
yagN,591342,591342,591158,184,518,utRho10
yahA,663746,664742,663746,996,2968,utRho10
yahC,670136,670136,670044,92,2096,utRho10
yahE,671478,671850,671478,372,316,utRho10
yahM,690504,690808,690504,304,224,utRho10
yahN,692872,692872,692674,198,198,utRho10
yahO,692864,692968,692864,104,78,utRho10
yaiE,816296,816354,816296,58,258,utRho10
yaiI,811396,811528,811396,132,0,utRho10
yaiO,761946,761946,761684,262,38,utRho10
yaiP,767970,767970,767870,100,0,utRho10
yaiS,769660,769660,769232,428,140,utRho10
yaiV,788922,788922,788922,0,0,utRho10
yaiY,799094,799094,798666,428,316,utRho10
yaiZ,798888,799186,798888,298,1102,utRho10
yajC,854410,854574,854410,164,1592,utRho10
yajD,860938,861210,860938,272,496,utRho10
yajI,866068,866068,865702,366,142,utRho10
yajL,887496,887496,887282,214,946,utRho10
yajQ,889316,889366,889316,50,382,utRho10
yajR,893374,893374,893332,42,340,utRho10
ybaB,987418,988152,987418,734,4376,utRho10
ybaL,1006590,1006590,1006476,114,118,utRho10
ybaM,980648,980648,980542,106,944,utRho10
ybaN,981436,981764,981436,328,316,utRho10
ybaO,936704,936766,936704,62,0,utRho10
ybaP,1016568,1016568,1016160,408,968,utRho10
ybaQ,1016348,1016436,1016348,88,224,utRho10
ybaS,1023146,1023282,1023146,136,128,utRho10
ybaV,927504,927874,927504,370,54,utRho10
ybaY,950490,950758,950490,268,394,utRho10
ybbB,1062724,1062724,1062452,272,0,utRho10
ybbJ,1030154,1030154,1029718,436,916,utRho10
ybbL,1031784,1031838,1031784,54,0,utRho10
ybbN,1037136,1037136,1036558,578,1650,utRho10
ybbO,1038658,1038658,1038298,360,960,utRho10
ybbY,1080718,1081130,1080718,412,162,utRho10
ybcH,1176140,1176140,1175962,178,240,utRho10
ybcI,1113264,1113264,1113106,158,3910,utRho10
ybcJ,1114050,1114050,1113746,304,280,utRho10
ybcK,1137502,1137804,1137502,302,504,utRho10
ybcL,1141690,1141786,1141690,96,0,utRho10
ybcN,1144628,1144932,1144628,304,42,utRho10
ybcQ,1147548,1147912,1147548,364,448,utRho10
ybcW,1159610,1159760,1159610,150,36,utRho10
ybdD,1263982,1264364,1263982,382,308,utRho10
ybdF,1212106,1212106,1211772,334,112,utRho10
ybdH,1267048,1267048,1266954,94,214,utRho10
ybdJ,1212822,1212822,1212398,424,214,utRho10
ybdK,1215122,1215122,1214766,356,3306,utRho10
ybdL,1267114,1267172,1267114,58,14,utRho10
ybdM,1271110,1271110,1270752,358,1106,utRho10
ybdN,1273372,1273372,1273138,234,112,utRho10
ybdR,1283844,1284176,1283844,332,2430,utRho10
ybeD,1325412,1325412,1325284,128,194,utRho10
ybeF,1323090,1323090,1322756,334,1868,utRho10
ybeL,1349986,1350036,1349986,50,0,utRho10
ybeQ,1353412,1353412,1353094,318,124,utRho10
ybeR,1353120,1353422,1353120,302,124,utRho10
ybeT,1358832,1358832,1358812,20,0,utRho10
ybeU,1358924,1359016,1358924,92,0,utRho10
ybeZ,1386938,1386938,1386834,104,8424,utRho10
ybfA,1458074,1458268,1458074,194,92,utRho10
ybfE,1423878,1423878,1423796,82,414,utRho10
ybfF,1425692,1425692,1425604,88,478,utRho10
ybfH,1433282,1433282,1433194,88,56,utRho10
ybgA,1477840,1478002,1477840,162,92,utRho10
ybgC,1549288,1549504,1549288,216,94,utRho10
ybgD,1505916,1505916,1505590,326,15554,utRho10
ybgI,1485238,1485654,1485238,416,0,utRho10
ybgO,1498370,1498370,1497964,406,180,utRho10
ybgS,1570992,1570992,1570634,358,182,utRho10
ybhA,1597184,1597184,1596862,322,152,utRho10
ybhB,1616070,1616070,1615818,252,118,utRho10
ybhC,1614642,1614642,1614562,80,1186,utRho10
ybhD,1601418,1601418,1601276,142,38,utRho10
ybhH,1601104,1601518,1601104,414,100,utRho10
ybhK,1633384,1633384,1633294,90,172,utRho10
ybhM,1641556,1641586,1641556,30,0,utRho10
ybhN,1645296,1645296,1644996,300,134,utRho10
ybhQ,1649202,1649260,1649202,58,462,utRho10
ybiA,1665920,1665920,1665900,20,32,utRho10
ybiI,1676968,1676968,1676912,56,732,utRho10
ybiO,1691328,1691328,1690960,368,580,utRho10
ybiP,1705252,1705252,1705194,58,986,utRho10
ybiS,1711572,1711572,1711488,84,376,utRho10
ybiT,1711894,1711926,1711894,32,0,utRho10
ybiU,1718212,1718212,1718122,90,144,utRho10
ybiV,1720176,1720176,1720056,120,0,utRho10
ybiW,1725566,1725566,1725212,354,3570,utRho10
ybiX,1678548,1678548,1678414,134,234,utRho10
ybjC,1781784,1781826,1781784,42,16,utRho10
ybjE,1830154,1830154,1829714,440,400,utRho10
ybjG,1767016,1767016,1766776,240,1512,utRho10
ybjL,1779882,1779882,1779638,244,218,utRho10
ybjM,1779770,1780178,1779770,408,358,utRho10
ybjO,1795704,1795978,1795704,274,0,utRho10
ybjP,1809046,1809046,1808934,112,0,utRho10
ybjQ,1809034,1809186,1809034,152,0,utRho10
ybjS,1813796,1813796,1813506,290,88,utRho10
ybjX,1838206,1838206,1838168,38,0,utRho10
ycaD,1891438,1891742,1891438,304,0,utRho10
ycaI,1928210,1928640,1928210,430,160,utRho10
ycaK,1899094,1899336,1899094,242,334,utRho10
ycaL,1920264,1920528,1920264,264,92,utRho10
ycaM,1894240,1894458,1894240,218,78,utRho10
ycaR,1941284,1941346,1941284,62,4878,utRho10
ycbB,1961862,1962094,1961862,232,296,utRho10
ycbJ,1943344,1943504,1943344,160,0,utRho10
ycbK,1966046,1966150,1966046,104,232,utRho10
ycbZ,2036920,2036920,2036598,322,294,utRho10
yccA,2062886,2062886,2062836,50,192,utRho10
yccF,2048730,2048730,2048696,34,12,utRho10
yccS,2047988,2047988,2047766,222,56,utRho10
yccT,2055674,2055674,2055546,128,146,utRho10
yccX,2059960,2060128,2059960,168,2014,utRho10
ycdT,2185682,2185752,2185682,70,90,utRho10
ycdU,2191266,2191686,2191266,420,416,utRho10
ycdZ,2200504,2200592,2200504,88,0,utRho10
yceA,2233544,2233614,2233544,70,104,utRho10
yceD,2293298,2293588,2293298,290,7008,utRho10
yceF,2293522,2293522,2293190,332,4552,utRho10
yceH,2252154,2252314,2252154,160,676,utRho10
yceI,2237282,2237282,2236952,330,914,utRho10
yceJ,2238142,2238142,2238092,50,648,utRho10
yceM,2253208,2253612,2253208,404,702,utRho10
yceO,2239264,2239264,2238894,370,1598,utRho10
yceQ,2288760,2289004,2288760,244,5628,utRho10
ycfD,2376540,2376540,2376480,60,166,utRho10
ycfJ,2334814,2335198,2334814,384,200,utRho10
ycfS,2340834,2340834,2340748,86,0,utRho10
ycfT,2350658,2350658,2350330,328,76,utRho10
ycfZ,2362760,2362760,2362534,226,1618,utRho10
ycgB,2474570,2474570,2474482,88,114,utRho10
ycgG,2434614,2434656,2434614,42,338,utRho10
ycgJ,2452956,2453200,2452956,244,118,utRho10
ycgL,2455218,2455362,2455218,144,0,utRho10
ycgN,2457366,2457660,2457366,294,346,utRho10
ycgR,2489112,2489112,2489054,58,0,utRho10
ycgV,2512222,2512222,2511904,318,1790,utRho10
ycgX,2426568,2426568,2426214,354,30926,utRho10
ycgY,2490166,2490320,2490166,154,1058,utRho10
ycgZ,2431504,2431578,2431504,74,106,utRho10
ychE,2596904,2597196,2596904,292,70,utRho10
ychF,2515764,2515764,2515624,140,0,utRho10
ychH,2517476,2517582,2517476,106,1498,utRho10
ychJ,2578354,2578354,2578264,90,300,utRho10
ychN,2547310,2547310,2547198,112,288,utRho10
ychO,2547520,2547850,2547520,330,690,utRho10
ychQ,2533798,2533848,2533798,50,54,utRho10
yciA,2624828,2624828,2624492,336,344,utRho10
yciB,2626110,2626110,2625780,330,1822,utRho10
yciC,2627396,2627396,2627326,70,4,utRho10
yciE,2630794,2630794,2630448,346,138,utRho10
yciG,5264368,5264368,5264140,228,36,utRho10
yciI,2621784,2621784,2621730,54,50,utRho10
yciN,2661606,2661606,2661336,270,80,utRho10
yciS,2680270,2680486,2680270,216,68,utRho10
yciT,2689088,2689088,2688692,396,1214,utRho10
yciU,2614718,2614718,2614300,418,2922,utRho10
yciV,2646376,2646440,2646376,64,0,utRho10
yciW,2700472,2700472,2700214,258,3170,utRho10
yciZ,2689276,2689276,2689218,58,1272,utRho10
ycjD,2703792,2703792,2703520,272,96,utRho10
ycjG,2777748,2777860,2777748,112,332,utRho10
ycjM,2740006,2740432,2740006,426,110,utRho10
ycjW,2767982,2767982,2767922,60,12,utRho10
ycjX,2768138,2768234,2768138,96,4,utRho10
ycjY,5568288,5568288,5567460,828,1492,utRho10
ydaE,2836438,2836438,2836016,422,896,utRho10
ydaN,2816048,2816100,2816048,52,228,utRho10
ydaS,2840340,2840730,2840340,390,114,utRho10
ydbC,2948376,2948442,2948376,66,74,utRho10
ydbD,2950132,2950288,2950132,156,0,utRho10
ydbH,2885800,2886102,2885800,302,162,utRho10
ydbJ,2881712,2882116,2881712,404,410,utRho10
ydbK,2881692,2881692,2881568,124,48,utRho10
ydcA,2983294,2983354,2983294,60,152,utRho10
ydcF,2974404,2974470,2974404,66,0,utRho10
ydcI,2990268,2990268,2990142,126,0,utRho10
ydcJ,2990266,2990576,2990266,310,62,utRho10
ydcK,3001280,3001280,3000898,382,4,utRho10
ydcL,3004646,3004914,3004646,268,12,utRho10
ydcN,3012308,3012344,3012308,36,390,utRho10
ydcP,3013508,3013562,3013508,54,184,utRho10
ydcR,3019956,3020006,3019956,50,0,utRho10
ydcS,3022906,3023308,3022906,402,122,utRho10
ydcX,3034442,3034778,3034442,336,498,utRho10
ydcY,3035220,3035296,3035220,76,0,utRho10
ydcZ,3036750,3036750,3036662,88,1270,utRho10
yddB,3155332,3155332,3155238,94,0,utRho10
yddE,3071738,3071738,3071716,22,0,utRho10
yddG,3094410,3094410,3094338,72,0,utRho10
yddJ,3089732,3089732,3089438,294,222,utRho10
yddW,3137704,3137704,3137646,58,48,utRho10
ydeA,3233910,3234056,3233910,146,232,utRho10
ydeE,3242528,3242664,3242528,136,86,utRho10
ydeI,3249118,3249118,3248994,124,66,utRho10
ydeJ,3249376,3249546,3249376,170,0,utRho10
ydeN,3165458,3165458,3165048,410,74,utRho10
ydeP,3173328,3173328,3172972,356,172,utRho10
ydeR,3176596,3176596,3176592,4,0,utRho10
ydfA,3296872,3297016,3296872,144,46,utRho10
ydfG,3254982,3255034,3254982,52,174,utRho10
ydfH,3256652,3256704,3256652,52,80,utRho10
ydfK,3265446,3266144,3265446,698,18650,utRho10
ydgA,3379588,3379704,3379588,116,14,utRho10
ydgC,3364124,3364124,3364060,64,150,utRho10
ydgD,3343906,3343920,3343906,14,226,utRho10
ydgH,3356754,3356854,3356754,100,0,utRho10
ydgJ,3408798,3408798,3408616,182,368,utRho10
ydgK,3410414,3410500,3410414,86,272,utRho10
ydhB,3479618,3479618,3479596,22,0,utRho10
ydhC,3479698,3479822,3479698,124,22,utRho10
ydhF,3451310,3451310,3451264,46,0,utRho10
ydhI,3441996,3442050,3441996,54,20,utRho10
ydhL,3451864,3451864,3451840,24,264,utRho10
ydhQ,3492404,3492404,3492254,150,36,utRho10
ydhS,3494136,3494262,3494136,126,2780,utRho10
ydhT,3499138,3499138,3499118,20,190,utRho10
ydhY,3509284,3509284,3508954,330,142,utRho10
ydhZ,3510418,3510418,3510282,136,198,utRho10
ydiE,3579206,3579226,3579206,20,0,utRho10
ydiH,3530582,3530582,3530406,176,0,utRho10
ydiM,3541852,3542142,3541852,290,90,utRho10
ydiN,3544818,3545024,3544818,206,0,utRho10
ydiP,3558656,3558656,3558602,54,24,utRho10
ydiU,3582508,3582508,3582488,20,178,utRho10
ydiV,3584174,3584174,3584040,134,24,utRho10
ydiY,3612500,3612500,3612166,334,74,utRho10
ydjA,3697400,3697400,3697352,48,112,utRho10
ydjE,3708082,3708082,3707958,124,86,utRho10
ydjF,3709848,3709848,3709708,140,62,utRho10
ydjM,3620340,3620422,3620340,82,0,utRho10
ydjO,3626696,3626696,3626288,408,216,utRho10
ydjX,3666434,3666802,3666434,368,2062,utRho10
yeaE,3731448,3731448,3731272,176,78,utRho10
yeaG,3733530,3733816,3733530,286,40,utRho10
yeaI,3740486,3740770,3740486,284,72,utRho10
yeaJ,3743874,3744082,3743874,208,156,utRho10
yeaL,3748646,3748704,3748646,58,180,utRho10
yeaM,3751296,3751296,3751152,144,0,utRho10
yeaN,3750926,3751346,3750926,420,74,utRho10
yeaO,3753554,3753818,3753554,264,38,utRho10
yeaP,3755314,3755430,3755314,116,730,utRho10
yeaQ,3758780,3758780,3758510,270,578,utRho10
yeaR,3759988,3759988,3759896,92,74,utRho10
yeaY,3781122,3781122,3781064,58,50,utRho10
yebB,3892220,3892502,3892220,282,896,utRho10
yebC,3896370,3896370,3896302,68,54,utRho10
yebE,3859464,3859464,3859414,50,430,utRho10
yebG,3861530,3861530,3861494,36,184,utRho10
yebK,3873180,3873304,3873180,124,66,utRho10
yebQ,3820314,3820552,3820314,238,0,utRho10
yebS,3832238,3832516,3832238,278,16,utRho10
yebV,3843430,3843560,3843430,130,0,utRho10
yebW,3843914,3844242,3843914,328,1964,utRho10
yecC,3995646,3995646,3995628,18,2,utRho10
yecD,3901272,3901664,3901272,392,80,utRho10
yecF,3991434,3991636,3991434,202,328,utRho10
yecH,3979304,3979304,3978980,324,1166,utRho10
yecJ,3975604,3975604,3975516,88,0,utRho10
yecM,3919968,3919968,3919692,276,164,utRho10
yecR,3976400,3976444,3976400,44,100,utRho10
yecT,3923862,3923944,3923862,82,86,utRho10
yedD,4016522,4016522,4016180,342,368,utRho10
yedE,4016310,4016554,4016310,244,360,utRho10
yedI,4058922,4058922,4058732,190,104,utRho10
yedJ,4066446,4066446,4066158,288,56,utRho10
yedV,4076404,4076404,4076304,100,242,utRho10
yedX,4077680,4077912,4077680,232,0,utRho10
yedY,4078572,4078956,4078572,384,854,utRho10
yeeA,4161322,4161322,4161182,140,0,utRho10
yeeE,4171104,4171104,4171050,54,154,utRho10
yeeJ,4089526,4089822,4089526,296,5084,utRho10
yeeN,4113508,4113716,4113508,208,2014,utRho10
yeeO,4119444,4119444,4119692,248,0,utRho10
yeeX,4158834,4158834,4158722,112,428,utRho10
yeeZ,4178422,4178422,4178256,166,0,utRho10
yefM,4179466,4179466,4179426,40,0,utRho10
yegD,4295288,4295348,4295288,60,174,utRho10
yegH,4275726,4275804,4275726,78,364,utRho10
yegI,4302154,4302154,4301970,184,56,utRho10
yegJ,4302032,4302370,4302032,338,164,utRho10
yegQ,4331182,4331336,4331182,154,562,utRho10
yegR,4336698,4336698,4336612,86,308,utRho10
yegS,4337086,4337424,4337086,338,418,utRho10
yegT,4357562,4357642,4357562,80,390,utRho10
yegX,4367640,4367640,4367302,338,248,utRho10
yehA,4376944,4376944,4376828,116,44,utRho10
yehE,4385818,4385818,4385592,226,24,utRho10
yehK,4407568,4407944,4407568,376,0,utRho10
yehL,4408804,4409192,4408804,388,120,utRho10
yeiB,4486146,4486146,4485934,212,42,utRho10
yeiE,4499422,4499422,4499236,186,0,utRho10
yeiG,4487776,4487820,4487776,44,110,utRho10
yeiH,4499332,4499434,4499332,102,0,utRho10
yeiI,4503306,4503400,4503306,94,278,utRho10
yeiL,4510580,4510710,4510580,130,0,utRho10
yeiP,4530834,4530900,4530834,66,584,utRho10
yeiQ,4532328,4532490,4532328,162,650,utRho10
yeiR,4535484,4535658,4535484,174,178,utRho10
yeiW,4530840,4530840,4530590,250,718,utRho10
yejA,4544624,4544728,4544624,104,30,utRho10
yejG,4556892,4556892,4556474,418,6796,utRho10
yejH,4561244,4561264,4561244,20,0,utRho10
yejK,4568218,4568218,4567894,324,36,utRho10
yejO,4578352,4578352,4577800,552,560,utRho10
yfaD,4713380,4713808,4713380,428,576,utRho10
yfaE,4696676,4697028,4696676,352,1104,utRho10
yfaL,4688568,4688568,4688338,230,44,utRho10
yfaP,4656398,4656398,4656286,112,0,utRho10
yfaU,4717892,4717892,4717690,202,0,utRho10
yfaY,4727310,4727310,4727266,44,42,utRho10
yfaZ,4728744,4728744,4728550,194,2,utRho10
yfbK,4771810,4771810,4771444,366,612,utRho10
yfbL,4771500,4771720,4771500,220,388,utRho10
yfbN,4777174,4777174,4776852,322,128,utRho10
yfbO,4776916,4777162,4776916,246,104,utRho10
yfbP,4777990,4778232,4777990,242,15724,utRho10
yfbR,4817662,4817724,4817662,62,74,utRho10
yfcI,4847424,4847424,4847078,346,1358,utRho10
yfcJ,4880482,4880482,4880240,242,874,utRho10
yfcL,4888502,4888502,4888338,164,88,utRho10
yfcV,4911642,4911642,4911292,350,180,utRho10
yfcZ,4921958,4921958,4921868,90,0,utRho10
yfdF,4925604,4926024,4925604,420,17600,utRho10
yfdG,4935474,4935710,4935474,236,0,utRho10
yfdP,4946844,4947040,4946844,196,26,utRho10
yfdX,4988866,4988866,4988804,62,28,utRho10
yfdY,4990672,4990672,4990584,88,0,utRho10
yfeA,5035784,5035784,5035664,120,38214,utRho10
yfeC,5036668,5036934,5036668,266,196,utRho10
yfeH,5053818,5053892,5053818,74,138,utRho10
yfeK,5074630,5074684,5074630,54,0,utRho10
yfeO,5018906,5019260,5018906,354,300,utRho10
yfeR,5054078,5054078,5053712,366,140,utRho10
yfeX,5101356,5101356,5101090,266,16,utRho10
yfeY,5102486,5102486,5102432,54,0,utRho10
yfeZ,5103842,5103842,5103452,390,0,utRho10
yffO,5123804,5124222,5123804,418,220,utRho10
yffQ,5126778,5127154,5126778,376,348,utRho10
yffS,5128800,5128986,5128800,186,290,utRho10
yfgC,5232052,5232188,5232052,136,114,utRho10
yfgF,5258062,5258062,5257876,186,1026,utRho10
yfgG,5258170,5258580,5258170,410,1184,utRho10
yfgH,5259344,5259584,5259344,240,136,utRho10
yfgM,5278866,5278866,5278566,300,530,utRho10
yfhH,5397414,5397518,5397414,104,182,utRho10
yfhM,5304648,5304648,5304574,74,48,utRho10
yfhR,5328408,5328726,5328408,318,11578,utRho10
yfiC,5425610,5425610,5425528,82,72,utRho10
yfiE,5430688,5430688,5430640,48,1394,utRho10
yfiL,5482630,5482720,5482630,90,0,utRho10
yfiM,5448066,5448358,5448066,292,21592,utRho10
yfiR,5483354,5483750,5483354,396,310,utRho10
yfjH,5517326,5517326,5517200,126,64,utRho10
yfjI,5517710,5517970,5517710,260,30,utRho10
yfjJ,5521014,5521094,5521014,80,36,utRho10
yfjM,5531970,5531970,5531552,418,3848,utRho10
yfjP,5535080,5535420,5535080,340,1682,utRho10
yfjW,5546570,5546636,5546570,66,0,utRho10
yfjX,5551776,5551838,5551776,62,0,utRho10
ygaC,5601180,5601180,5599988,1192,686,utRho10
ygaM,5600242,5600292,5600242,50,120,utRho10
ygaU,5593628,5593628,5593572,56,134,utRho10
ygaZ,5619190,5619234,5619190,44,350,utRho10
ygbA,5713656,5713656,5713612,44,88,utRho10
ygbE,5746784,5746784,5746674,110,72,utRho10
ygbI,5722882,5722882,5722528,354,442,utRho10
ygbK,5724394,5724670,5724394,276,392,utRho10
ygbL,5727074,5727186,5727074,112,78,utRho10
ygbN,5729814,5730202,5729814,388,986,utRho10
ygcG,5811210,5811422,5811210,212,94,utRho10
ygcN,5785144,5785314,5785144,170,206,utRho10
ygcU,5799214,5799214,5798836,378,22,utRho10
ygcW,5800942,5800942,5800546,396,0,utRho10
ygdD,5883442,5883442,5883262,180,34,utRho10
ygdG,5861746,5861930,5861746,184,634,utRho10
ygdI,5886526,5886526,5886290,236,508,utRho10
ygdQ,5940784,5940840,5940784,56,68,utRho10
ygdR,5942494,5942542,5942494,48,106,utRho10
ygeA,5961606,5961606,5961270,336,78,utRho10
ygeH,5983758,5984188,5983758,430,504,utRho10
ygeI,5987162,5987276,5987162,114,5286,utRho10
ygeR,6000078,6000078,5999782,296,406,utRho10
ygeV,6011694,6011694,6011572,122,0,utRho10
ygeW,6012234,6012524,6012234,290,600,utRho10
ygfB,6110946,6110946,6110888,58,0,utRho10
ygfK,6031984,6032120,6031984,136,0,utRho10
ygfS,6058328,6058328,6058024,304,0,utRho10
ygfZ,6082564,6082626,6082564,62,522,utRho10
yggC,6149512,6149512,6149378,134,162,utRho10
yggE,6136370,6136370,6136160,210,80,utRho10
yggI,6179176,6179510,6179176,334,768,utRho10
yggL,6204508,6204508,6204266,242,192,utRho10
yggM,6199514,6199514,6199130,384,354,utRho10
yggN,6203596,6203596,6203246,350,384,utRho10
yggX,18623958,18624558,18623958,600,672,utRho10
yghA,6298966,6299324,6298966,358,48,utRho10
yghB,6307058,6307126,6307058,68,136,utRho10
yghD,6222614,6222614,6222252,362,1396,utRho10
yghF,6225798,6225798,6225840,42,312,utRho10
yghJ,6238640,6238640,6238224,416,2,utRho10
yghQ,6265186,6265186,6264816,370,366,utRho10
yghT,6267830,6268262,6267830,432,396,utRho10
yghU,6277400,6277454,6277400,54,82,utRho10
yghW,6293506,6293506,6293474,32,46,utRho10
yghZ,6295562,6295794,6295562,232,440,utRho10
ygiD,6365122,6365122,6364868,254,7874,utRho10
ygiH,6409066,6409388,6409066,322,176,utRho10
ygiL,6370622,6370828,6370622,206,276,utRho10
ygiM,6402084,6402414,6402084,330,228,utRho10
ygiN,6346156,6346284,6346156,128,858,utRho10
ygiQ,6322620,6322620,6322292,328,1426,utRho10
ygiS,6335462,6335462,6335436,26,0,utRho10
ygiV,6338582,6338582,6338462,120,134,utRho10
ygiW,6339774,6339774,6339352,422,1372,utRho10
ygiZ,6344506,6344506,6344422,84,0,utRho10
ygjH,6442528,6442528,6442494,34,22,utRho10
ygjI,6452140,6452468,6452140,328,42,utRho10
ygjQ,6472730,6473080,6472730,350,866,utRho10
ygjR,6474564,6474586,6474564,22,0,utRho10
ygjV,6483638,6483638,6483488,150,6,utRho10
yhaB,6535632,6535708,6535632,76,0,utRho10
yhaH,6504498,6504608,6504498,110,244,utRho10
yhaI,6505400,6505822,6505400,422,360,utRho10
yhaJ,6508560,6508560,6508428,132,36,utRho10
yhaK,6508538,6508638,6508538,100,54,utRho10
yhbQ,6599878,6599932,6599878,54,320,utRho10
yhbT,6602736,6602736,6602552,184,212,utRho10
yhbU,6602558,6602970,6602558,412,224,utRho10
yhbX,6643302,6643302,6643226,76,0,utRho10
yhbY,6655518,6655580,6655518,62,490,utRho10
yhcA,6723956,6724224,6723956,268,112,utRho10
yhcB,6760364,6760382,6760364,18,0,utRho10
yhcC,6708470,6708470,6708100,370,622,utRho10
yhcF,6733440,6733852,6733440,412,518,utRho10
yhcH,6739124,6739124,6738956,168,540,utRho10
yhcM,6760312,6760312,6759994,318,198,utRho10
yhcN,6770812,6771076,6770812,264,244,utRho10
yhcO,6772606,6772606,6772258,348,0,utRho10
yhdH,6806560,6806968,6806560,408,296,utRho10
yhdJ,6823234,6823306,6823234,72,0,utRho10
yhdN,6879092,6879092,6879018,74,2930,utRho10
yhdT,6814702,6814750,6814702,48,570,utRho10
yhdU,6824994,6825242,6824994,248,974,utRho10
yhdV,6836392,6836780,6836392,388,808,utRho10
yhdW,6837944,6838298,6837944,354,0,utRho10
yheO,6953082,6953082,6952880,202,384,utRho10
yheV,6957970,6957970,6957584,386,82,utRho10
yhfA,6971902,6971902,6971636,266,834,utRho10
yhfG,6983294,6983294,6983240,54,806,utRho10
yhfL,6998622,6998896,6998622,274,456,utRho10
yhfY,7023244,7023244,7022844,400,150,utRho10
yhgA,7086294,7086334,7086294,40,30,utRho10
yhgE,7065176,7065176,7064878,298,216,utRho10
yhgF,7074352,7074770,7074352,418,4910,utRho10
yhhA,7173458,7173886,7173458,428,302,utRho10
yhhI,7248346,7248756,7248346,410,80,utRho10
yhhJ,7253696,7253696,7253606,90,38,utRho10
yhhM,7211588,7211588,7211220,368,792,utRho10
yhhN,7211150,7211502,7211150,352,540,utRho10
yhhQ,7218238,7218434,7218238,196,544,utRho10
yhhT,7223682,7223730,7223682,48,114,utRho10
yhhX,7162032,7162032,7161610,422,94,utRho10
yhhY,7162222,7162276,7162222,54,68,utRho10
yhhZ,7163516,7163726,7163516,210,276,utRho10
yhiD,7312220,7312220,7311804,416,3914,utRho10
yhiJ,7265190,7265190,7265180,10,84,utRho10
yhiM,7269270,7269682,7269270,412,1970,utRho10
yhiN,7275000,7275000,7274820,180,102,utRho10
yhjA,7338522,7338522,7338376,146,62,utRho10
yhjB,7344090,7344090,7343788,302,1068,utRho10
yhjC,7344272,7344684,7344272,412,240,utRho10
yhjD,7346660,7346724,7346660,64,170,utRho10
yhjE,7349274,7349572,7349274,298,1012,utRho10
yhjG,7356824,7356824,7356730,94,62,utRho10
yhjH,7358458,7358458,7358374,84,1182,utRho10
yhjJ,7364032,7364032,7363880,152,158,utRho10
yhjK,7371296,7371296,7371158,138,118,utRho10
yhjR,7392750,7392750,7392370,380,0,utRho10
yhjV,7400796,7401126,7400796,330,2316,utRho10
yhjX,7424194,7424194,7424014,180,216,utRho10
yhjY,7425966,7425966,7425868,98,128,utRho10
yiaB,7455654,7455654,7455496,158,52,utRho10
yiaD,7432712,7433094,7432712,382,978,utRho10
yiaF,7438194,7438194,7438088,106,484,utRho10
yiaG,7438862,7438956,7438862,94,452,utRho10
yiaJ,7485236,7485236,7485064,172,930,utRho10
yiaK,7485348,7485466,7485348,118,48,utRho10
yiaT,7503924,7503924,7503736,188,6,utRho10
yiaU,7503792,7503984,7503792,192,6,utRho10
yiaY,7515856,7515856,7515654,202,306,utRho10
yibF,7523950,7523950,7523910,40,12,utRho10
yibG,7536128,7536354,7536128,226,22,utRho10
yibL,7553194,7553330,7553194,136,366,utRho10
yibN,7570112,7570112,7570030,82,440,utRho10
yibT,7552848,7552848,7552760,88,1072,utRho10
yicC,7633290,7633352,7633290,62,0,utRho10
yicH,7660862,7660914,7660862,52,136,utRho10
yicJ,7673328,7673328,7671858,1470,9728,utRho10
yicN,7685018,7685018,7684804,214,140,utRho10
yicO,7687914,7687914,7687578,336,252,utRho10
yicR,15250308,15250308,15250236,72,0,utRho10
yidB,7755230,7755230,7754930,300,124,utRho10
yidE,7732780,7732780,7732546,234,52,utRho10
yidF,7711580,7711580,7711222,358,272,utRho10
yidQ,7735088,7735456,7735088,368,1018,utRho10
yidR,7738824,7738824,7738618,206,40,utRho10
yieE,7787658,7787738,7787658,80,166,utRho10
yieH,7793314,7793548,7793314,234,290,utRho10
yieK,7798928,7798928,7798786,142,0,utRho10
yifB,7900350,7900350,7899998,352,332,utRho10
yifL,7988984,7989044,7988984,60,3398,utRho10
yigF,8005750,8005750,8005598,152,19128,utRho10
yigI,8009448,8009448,8009394,54,282,utRho10
yigM,8022100,8022152,8022100,52,96,utRho10
yihA,8101970,8101970,8101458,512,86,utRho10
yihD,8084098,8084138,8084098,40,104,utRho10
yihF,8088110,8088398,8088110,288,302,utRho10
yihG,8093304,8093304,8093204,100,42,utRho10
yihI,8102616,8102694,8102616,78,0,utRho10
yihL,8120506,8120894,8120506,388,86,utRho10
yihN,8124332,8124494,8124332,162,82,utRho10
yihO,8131942,8131942,8131532,410,0,utRho10
yihQ,8138892,8138892,8138552,340,116,utRho10
yihV,8147064,8147478,8147064,414,102,utRho10
yihX,8151096,8151106,8151096,10,32,utRho10
yiiE,8158192,8158582,8158192,390,608,utRho10
yiiF,8159124,8159502,8159124,378,906,utRho10
yiiG,8173762,8174004,8173762,242,0,utRho10
yiiM,8205506,8205644,8205506,138,1402,utRho10
yiiQ,8224624,8224624,8224428,196,0,utRho10
yiiS,8225738,8225934,8225738,196,304,utRho10
yijE,8272178,8272216,8272178,38,44,utRho10
yijF,8275728,8275728,8275314,414,494,utRho10
yijO,8296858,8296858,8296634,224,330,utRho10
yjaA,8426240,8426468,8426240,228,109644,utRho10
yjaB,8428312,8428312,8428246,66,390,utRho10
yjaG,8398746,8399008,8398746,262,1400,utRho10
yjaH,8401022,8401132,8401022,110,74,utRho10
yjaZ,8379506,8379572,8379506,66,0,utRho10
yjbB,8455204,8455462,8455204,258,48,utRho10
yjbE,16943432,16943624,16943432,192,100,utRho10
yjbL,8520318,8520642,8520318,324,278,utRho10
yjbQ,8540428,8540476,8540428,48,104,utRho10
yjcB,8550328,8550328,8550082,246,294,utRho10
yjcC,8550836,8550942,8550836,106,266,utRho10
yjcD,8556628,8556958,8556628,330,332,utRho10
yjcE,8559658,8559960,8559658,302,0,utRho10
yjcF,8566212,8566212,8566150,62,0,utRho10
yjcO,8594660,8594660,8594250,410,34,utRho10
yjdA,8654128,8654270,8654128,142,30,utRho10
yjdC,8726660,8726660,8726616,44,2,utRho10
yjdK,8704780,8705168,8704780,388,548,utRho10
yjdL,8713034,8713034,8712822,212,80,utRho10
yjdM,8653672,8653672,8653468,204,296,utRho10
yjeF,8787354,8788132,8787354,778,326438,utRho10
yjeI,8745522,8745618,8745522,96,0,utRho10
yjeJ,8748806,8748806,8748468,338,1382,utRho10
yjeV,8785472,8785784,8785472,312,8286,utRho10
yjfP,8833512,8833904,8833512,392,178,utRho10
yjfY,8849656,8849656,8849582,74,0,utRho10
yjfZ,8855052,8855052,8854844,208,546,utRho10
yjgA,8916162,8916162,8915730,432,564,utRho10
yjgL,8950802,8950874,8950802,72,0,utRho10
yjgM,8959342,8959342,8959074,268,240,utRho10
yjgN,8959132,8959460,8959132,328,192,utRho10
yjgR,8980170,8980170,8980126,44,392,utRho10
yjgZ,9002116,9002520,9002116,404,10870,utRho10
yjhB,9007764,9008116,9007764,352,362,utRho10
yjhG,9048452,9048452,9048188,264,1944,utRho10
yjhU,9041080,9041080,9040648,432,362,utRho10
yjiA,9178096,9178096,9177730,366,286,utRho10
yjiJ,9125364,9125364,9125350,14,0,utRho10
yjiK,9127270,9127270,9127422,152,196,utRho10
yjiL,9129604,9129604,9129378,226,18,utRho10
yjiS,9143410,9143502,9143410,92,228,utRho10
yjiY,9182734,9182734,9182558,176,490,utRho10
yjjA,9200674,9200674,9200378,296,1674,utRho10
yjjB,18408708,18408708,18407800,908,1236,utRho10
yjjJ,9243314,9243538,9243314,224,0,utRho10
yjjK,9261132,9261132,9261044,88,402,utRho10
yjjL,9189764,9189764,9189444,320,52,utRho10
yjjM,9191894,9191894,9191702,192,490,utRho10
yjjP,9206068,9206068,9205716,352,25040,utRho10
yjjQ,9206638,9206954,9206638,316,19526,utRho10
yjjX,9267798,9267798,9267490,308,1356,utRho10
yjjY,9280716,9280804,9280716,88,300,utRho10
yjjZ,9211554,9211608,9211554,54,78786,utRho10
yjtD,9281676,9281884,9281676,208,46,utRho10
ykfB,532454,532454,532174,280,8862,utRho10
ykfI,527636,527636,527338,298,1664,utRho10
ykgB,637050,637050,636638,412,126,utRho10
ykgC,640430,640430,640002,428,30,utRho10
ykgD,640232,640454,640232,222,30,utRho10
ykgE,642962,643216,642962,254,550,utRho10
ykgJ,608524,608524,608364,160,130,utRho10
ykgL,623878,624224,623878,346,66,utRho10
ykgM,625610,625610,625554,56,0,utRho10
ykgR,626570,626570,626484,86,38,utRho10
ylaC,958576,958576,958502,74,3448,utRho10
yliE,1745938,1745958,1745938,20,0,utRho10
ymcE,2103660,2103694,2103660,34,78,utRho10
ymdA,2210450,2210828,2210450,378,126,utRho10
ymdB,2211428,2211640,2211428,212,116,utRho10
ymfD,2395322,2395322,2395064,258,1368,utRho10
ymfI,2402880,2402994,2402880,114,50,utRho10
ymfJ,2404518,2404518,2404168,350,132,utRho10
ymfK,2406176,2406176,2405866,310,168,utRho10
ymfT,2405766,2406048,2405766,282,178,utRho10
ymgE,2489110,2489456,2489110,346,1180,utRho10
ymgF,2437628,2437966,2437628,338,370,utRho10
ymiA,2670112,2670320,2670112,208,172,utRho10
ymjA,2715620,2715620,2715336,284,564,utRho10
ynaI,2791946,2791946,2791844,102,50,utRho10
ynaK,2850438,2850754,2850438,316,40,utRho10
ynbA,2954924,2955242,2954924,318,0,utRho10
yncD,3046552,3046552,3046130,422,60,utRho10
yncE,3046454,3046614,3046454,160,34,utRho10
yncG,3052456,3052494,3052456,38,128,utRho10
yncL,3034492,3034492,3034388,104,220,utRho10
yneE,3218364,3218364,3218044,320,116,utRho10
yneF,3223748,3223748,3223708,40,2,utRho10
yneJ,3229560,3229608,3229560,48,0,utRho10
yneK,3231100,3231526,3231100,426,730,utRho10
yneM,3245176,3245292,3245176,116,1422,utRho10
ynfA,3311398,3311398,3311346,52,0,utRho10
ynfB,3311418,3311616,3311418,198,162,utRho10
ynfC,3315094,3315094,3314914,180,0,utRho10
ynfD,3314828,3315130,3314828,302,16,utRho10
ynfE,3316006,3316138,3316006,132,118,utRho10
ynfK,3334670,3334670,3334438,232,70,utRho10
ynfL,3339304,3339304,3339184,120,0,utRho10
ynfM,3339260,3339398,3339260,138,18,utRho10
ynfN,3276598,3276598,3276218,380,76,utRho10
ynfO,3273454,3273512,3273454,58,330,utRho10
ynhG,3517890,3517890,3517450,440,94,utRho10
yniA,3615158,3615592,3615158,434,182,utRho10
yniB,3618526,3618526,3618466,60,92,utRho10
yniC,3618652,3618760,3618652,108,42,utRho10
yniD,3610202,3610330,3610202,128,102,utRho10
ynjE,3678880,3678934,3678880,54,44,utRho10
ynjF,3683222,3683222,3682806,416,524,utRho10
ynjH,3684376,3684376,3684270,106,144,utRho10
ynjI,3690022,3690022,3689742,280,410,utRho10
yoaB,3786642,3786734,3786642,92,218,utRho10
yoaC,3787932,3788146,3787932,214,256,utRho10
yoaE,3803544,3803544,3803170,374,630,utRho10
yoaF,3755444,3755444,3755064,380,938,utRho10
yoaH,3789866,3789866,3789462,404,1070,utRho10
yobB,3850418,3850880,3850418,462,906,utRho10
yobF,3815586,3815586,3815182,404,820,utRho10
yobH,3817800,3817850,3817800,50,534,utRho10
yodB,4084352,4084736,4084352,384,2242,utRho10
yodC,4057008,4057008,4056740,268,324,utRho10
yohC,4451358,4451358,4451262,96,98,utRho10
yohD,4451526,4451602,4451526,76,42,utRho10
yohJ,4460986,4461248,4460986,262,156,utRho10
yohO,4431172,4431314,4431172,142,182,utRho10
yojI,4617282,4617282,4617230,52,0,utRho10
ypdI,4988988,4989396,4988988,408,278,utRho10
ypfG,5165786,5165786,5165554,232,120,utRho10
ypfM,5182140,5182140,5181732,408,504,utRho10
yphB,5349590,5349590,5349376,214,20,utRho10
ypjA,5565644,5565644,5565452,192,114,utRho10
ypjB,5569636,5569636,5568858,778,134,utRho10
ypjD,5495860,5495774,5495860,86,0,utRho10
yqaE,5594170,5594170,5594056,114,44,utRho10
yqcA,5846100,5846100,5845968,132,126,utRho10
yqcE,5800944,5801184,5800944,240,0,utRho10
yqeC,6030468,6030468,6030114,354,24,utRho10
yqeF,5971618,5971618,5971184,434,228,utRho10
yqeG,5971438,5971694,5971438,256,132,utRho10
yqeH,5975016,5975072,5975016,56,296,utRho10
yqeI,5976688,5977004,5976688,316,156,utRho10
yqeK,5981140,5981140,5980720,420,1992,utRho10
yqfA,6086728,6086728,6086296,432,734,utRho10
yqgA,6219042,6219106,6219042,64,0,utRho10
yqgB,6172500,6172500,6172102,398,4332,utRho10
yqgE,6185768,6185874,6185768,106,508,utRho10
yqhA,6299150,6299150,6298942,208,48,utRho10
yqhC,6310768,6310768,6310436,332,424,utRho10
yqhD,6310604,6310710,6310604,106,218,utRho10
yqhH,6316842,6317254,6316842,412,968,utRho10
yqiC,6369662,6369680,6369662,18,66,utRho10
yqiJ,6384108,6384416,6384108,308,312,utRho10
yqjA,6495096,6495546,6495096,450,3912,utRho10
yqjF,6500932,6501124,6500932,192,712,utRho10
yqjG,6501948,6502048,6501948,100,18,utRho10
yqjH,6433078,6433078,6432982,96,52,utRho10
yqjI,6433506,6433558,6433506,52,0,utRho10
yraH,6574552,6574852,6574552,300,96,utRho10
yraP,6592144,6592818,6592144,674,1004,utRho10
yraQ,6596414,6596414,6596276,138,0,utRho10
yraR,6598024,6598024,6597692,332,266,utRho10
yrbG,13360844,13361100,13360844,256,4,utRho10
yrbL,6696842,6696904,6696842,62,1606,utRho10
yrbN,6616172,6616172,6615866,306,18264,utRho10
yrdB,6860176,6860176,6860046,130,132,utRho10
yrfF,7052548,7052938,7052548,390,782,utRho10
yrhB,7169440,7169518,7169440,78,36,utRho10
ysaB,7451804,7451804,7451424,380,12,utRho10
ysgA,8032686,8032686,8032338,348,310,utRho10
ytfB,8857638,8857638,8857434,204,1610,utRho10
ytfE,8864018,8864018,8863966,52,126,utRho10
ytfF,8866296,8866296,8866130,166,350,utRho10
ytfH,8868164,8868226,8868164,62,220,utRho10
ytfI,8875234,8875414,8875234,180,236,utRho10
ytfJ,8878572,8878572,8878524,48,176,utRho10
ytfK,8879022,8879174,8879022,152,460,utRho10
ytfL,8882642,8882642,8882430,212,178,utRho10
ytfQ,8899634,8899924,8899634,290,226,utRho10
ytjB,9249598,9249598,9249578,20,74,utRho10
yzfA,8896588,8896588,8896490,98,62,utRho10
zapA,6111102,6111224,6111102,122,1604,utRho10
zapB,8236772,8237030,8236772,258,282,utRho10
zapC,2011700,2011904,2011700,204,112,utRho10
zinT,4082692,4082750,4082692,58,482,utRho10
zipA,5062814,5062814,5062466,348,234,utRho10
zitB,1569716,1569716,1569646,70,146,utRho10
zntA,7212844,7212902,7212844,58,90,utRho10
zntR,6878336,6878336,6878260,76,114,utRho10
znuA,3885322,3885322,3885166,156,48,utRho10
znuC,3885268,3885324,3885268,56,14,utRho10
zraP,8403424,8403424,8403376,48,10,utRho10
zraS,8403810,8403852,8403810,42,0,utRho10
zupT,6364866,6365100,6364866,234,7626,utRho10
zur,8520282,8520282,8520006,276,690,utRho10
zwf,3872752,3872752,3872628,124,62,utRho10
C0343,2818676,2818728,2818676,52,0,utRho11
aaeB,6776526,6776526,6776376,150,0,utRho11
aaeR,6778762,6779040,6778762,278,272,utRho11
aaeX,6778860,6778860,6778674,186,384,utRho11
aat,1854920,1854920,1854864,56,0,utRho11
accA,416822,417242,416822,420,2354,utRho11
accB,6810280,6810872,6810280,592,9532,utRho11
accD,4868030,4868030,4867852,178,302,utRho11
aceB,8430804,8430956,8430804,152,4,utRho11
aceE,245938,246034,245938,96,422,utRho11
ackA,4826918,4826940,4826918,22,2480,utRho11
acnA,2670848,2671662,2670848,814,1204,utRho11
acnB,263038,263230,263038,192,1252,utRho11
acpP,2303148,2303230,2303148,82,634,utRho11
acpS,5402324,5402324,5401996,328,1082,utRho11
acrA,971396,971396,971238,158,112,utRho11
acrB,969370,969370,968806,564,3332,utRho11
acrD,5174950,5175190,5174950,240,80,utRho11
acrE,6827404,6827728,6827404,324,252,utRho11
acrR,971398,971522,971398,124,278,utRho11
acrZ,1589502,1589546,1589502,44,4,utRho11
acs,8575190,8575190,8574742,448,344,utRho11
actP,8569870,8569870,8569804,66,0,utRho11
ada,4620854,4620854,4620810,44,0,utRho11
add,3404404,3404466,3404404,62,72,utRho11
ade,7687802,7687928,7687802,126,0,utRho11
adhE,2596826,2596826,2596242,584,0,utRho11
adhP,3107988,3107988,3107676,312,1242,utRho11
adiA,8681112,8681112,8681042,70,26,utRho11
adiC,8674404,8674404,8674062,342,190,utRho11
adiY,8676084,8676084,8675858,226,0,utRho11
adk,994278,994350,994278,72,778,utRho11
adrA,807374,807406,807374,32,0,utRho11
aer,6438240,6438240,6438152,88,256,utRho11
aes,1000102,1000102,999946,156,470,utRho11
agaR,6557406,6557406,6557330,76,78,utRho11
agaS,6563778,6563952,6563778,174,0,utRho11
agp,2131118,2131170,2131118,52,0,utRho11
agrA,7296126,7296126,7296126,0,0,utRho11
agrB,7296588,7296588,7296588,0,0,utRho11
ahpC,1277386,1277890,1277386,504,538,utRho11
ahpF,1278004,1279506,1278004,1502,60174,utRho11
ahr,8992698,8992698,8992418,280,40,utRho11
aidB,8828494,8828550,8828494,56,64,utRho11
ais,4731512,4731512,4731240,272,0,utRho11
alaA,4814816,4815122,4814816,306,84,utRho11
alaC,4996798,4996798,4996590,208,0,utRho11
alaE,5598140,5598328,5598140,188,164,utRho11
alaS,5644180,5644180,5644022,158,2550,utRho11
alaW,5036612,5036612,5036462,150,4,utRho11
aldA,2976380,2976464,2976380,84,216,utRho11
aldB,7513070,7513070,7513022,48,196,utRho11
alkA,4295118,4295118,4295080,38,132,utRho11
alkB,4618890,4618890,4618682,208,0,utRho11
allA,1064780,1064902,1064780,122,0,utRho11
allD,1092822,1092822,1092726,96,0,utRho11
allE,1088112,1088112,1088092,20,56,utRho11
allS,1064600,1064600,1064442,158,0,utRho11
alr,8531178,8531564,8531178,386,4070,utRho11
alsE,8617334,8617334,8616956,378,270,utRho11
alsK,8615990,8615990,8615598,392,56,utRho11
alx,6476740,6477160,6476740,420,0,utRho11
amiA,5104482,5104704,5104482,222,0,utRho11
amiC,5898378,5898378,5898020,358,980,utRho11
amn,4110062,4110122,4110062,60,114,utRho11
ampC,8758006,8758006,8757888,118,0,utRho11
ampD,237362,237466,237362,104,60,utRho11
ampG,907372,907372,907090,282,866,utRho11
ampH,792726,792726,792574,152,68,utRho11
amyA,4012230,4012312,4012230,82,74,utRho11
anmK,3439346,3439346,3439204,142,0,utRho11
ansB,6201580,6201580,6201456,124,328,utRho11
ansP,3052040,3052040,3051960,80,100,utRho11
apaG,104068,104068,103212,856,5912,utRho11
apaH,102586,102586,102444,142,9998,utRho11
apbE,4623188,4623188,4623068,120,0,utRho11
appA,2081198,2081234,2081198,36,0,utRho11
appC,2075420,2075480,2075420,60,0,utRho11
appY,1167134,1167362,1167134,228,0,utRho11
apt,982620,982824,982620,204,338,utRho11
aqpZ,1832424,1832424,1832094,330,0,utRho11
araB,140150,140150,140096,54,0,utRho11
araC,140482,140774,140482,292,146,utRho11
araE,5964416,5964416,5964364,52,0,utRho11
araF,3972476,3972476,3972256,220,120,utRho11
araH,3967120,3967120,3967086,34,0,utRho11
araJ,825058,825058,824962,96,102,utRho11
arcA,9281602,9281602,9280612,990,2806,utRho11
arcB,6706098,6706098,6706050,48,0,utRho11
arcZ,6701154,6701154,6701154,0,0,utRho11
arfA,6877346,6877346,6877298,48,714,utRho11
argA,5898312,5898484,5898312,172,430,utRho11
argC,8309770,8310002,8309770,232,0,utRho11
argD,6980442,6980442,6980360,82,0,utRho11
argE,8310156,8310156,8309694,462,40,utRho11
argF,580680,580680,580610,70,0,utRho11
argG,6637124,6637274,6637124,150,286,utRho11
argI,8956688,8956688,8956622,66,0,utRho11
argO,6137672,6137672,6137616,56,586,utRho11
argP,6119460,6119506,6119460,46,110,utRho11
argR,6769204,6769406,6769204,202,148,utRho11
argS,3920002,3920124,3920002,122,0,utRho11
argT,4855698,4855698,4855582,116,64,utRho11
argU,1129406,1129446,1129406,40,0,utRho11
argW,4932616,4932618,4932616,2,0,utRho11
argX,7964728,7964750,7964728,22,4,utRho11
aroF,5482402,5482402,5482300,102,62,utRho11
aroG,1571182,1571266,1571182,84,150,utRho11
aroH,3576636,3576870,3576636,234,770,utRho11
aroK,7038760,7038760,7038128,632,1172,utRho11
aroL,812560,812810,812560,250,1154,utRho11
aroP,243342,243342,243102,240,0,utRho11
arpA,8445382,8445382,8444974,408,118,utRho11
arrS,7316108,7316108,7316108,0,0,utRho11
arsR,7297024,7297056,7297024,32,178,utRho11
artJ,1801252,1801252,1801150,102,0,utRho11
artP,1807686,1807686,1807468,218,516,utRho11
ascF,5678858,5679048,5678858,190,10,utRho11
ascG,5678574,5678574,5678528,46,46,utRho11
aslB,7965562,7965916,7965562,354,43942,utRho11
asnA,7854258,7854310,7854258,52,210,utRho11
asnB,1398444,1398444,1398354,90,1712,utRho11
asnC,23562186,23562186,23562018,168,258,utRho11
asnS,1978088,1978088,1977970,118,7936,utRho11
asnT,4089082,4089098,4089082,16,272,utRho11
asnU,4119690,4119702,4119690,12,2,utRho11
asnV,4124504,4124520,4124504,16,156,utRho11
aspA,17473728,17473728,17473308,420,0,utRho11
aspC,1971486,1971486,1971418,68,2158,utRho11
aspS,3901402,3901402,3901044,358,68,utRho11
aspT,7893560,7893744,7893560,184,121312,utRho11
aspV,473826,473862,473826,36,10,utRho11
asr,3342654,3342752,3342654,98,0,utRho11
astC,3664088,3664088,3663964,124,0,utRho11
astE,3654138,3654138,3653846,292,0,utRho11
atoD,4646824,4646894,4646824,70,364,utRho11
atpB,7844540,7844540,7844102,438,300,utRho11
atpC,7832118,7832118,7831944,174,2800,utRho11
atpI,7845050,7845050,7844880,170,52,utRho11
avtA,7479348,7479410,7479348,62,648,utRho11
azoR,2965982,2965982,2965720,262,118,utRho11
azuC,3976002,3976002,3975918,84,0,utRho11
bacA,6408350,6408350,6408262,88,234,utRho11
bamA,394052,395856,394052,1804,630,utRho11
bamB,5277950,5277950,5277304,646,1452,utRho11
bamC,5198028,5198028,5197730,298,622,utRho11
bamD,5471922,5472292,5471922,370,14118,utRho11
bamE,5506972,5507210,5506972,238,524,utRho11
basS,8666954,8666954,8666544,410,1844,utRho11
bax,7474468,7474468,7474354,114,0,utRho11
bcp,5200874,5200956,5200874,82,1682,utRho11
bcsB,7385346,7385346,7385214,132,56,utRho11
bcsE,7392644,7392916,7392644,272,0,utRho11
bdcA,8948128,8948128,8948106,22,728,utRho11
bdcR,8948192,8948248,8948192,56,184,utRho11
bdm,3112680,3112680,3112560,120,24,utRho11
betA,654522,654522,654494,28,210,utRho11
betI,658722,658722,658668,54,32,utRho11
betT,658842,658926,658842,84,44,utRho11
bfr,6933498,6933498,6933450,48,0,utRho11
bglG,23440182,23440182,23439402,780,0,utRho11
bglX,4444240,4444240,4443978,262,0,utRho11
bhsA,2337962,2338146,2337962,184,0,utRho11
bioA,1618584,1618584,1618514,70,52,utRho11
bioB,1618604,1618688,1618604,84,0,utRho11
bioH,7089716,7089716,7089688,28,80,utRho11
bisC,7433026,7433026,7432788,238,60,utRho11
blc,8755490,8755490,8755444,46,0,utRho11
blr,3409024,3409102,3409024,78,328,utRho11
bluF,2431226,2431226,2430950,276,814,utRho11
bluR,2428226,2428226,2428118,108,12,utRho11
bolA,908698,908944,908698,246,28,utRho11
borD,1157842,1157842,1157786,56,6,utRho11
brnQ,838976,839182,838976,206,732,utRho11
bssR,1756492,1756496,1756492,4,0,utRho11
bssS,2242116,2242116,2241910,206,304,utRho11
btuB,8326798,8327278,8326798,480,5698,utRho11
cadB,8720212,8720212,8720062,150,16,utRho11
cadC,8723926,8723926,8723868,58,8,utRho11
caiE,70998,70998,70742,256,0,utRho11
caiF,68436,68600,68436,164,2,utRho11
caiT,84074,84074,83862,212,50,utRho11
can,285406,285406,285340,66,98,utRho11
carA,59102,59302,59102,200,20,utRho11
carB,61550,61634,61550,84,50,utRho11
cas2,5757830,5757830,5757706,124,230,utRho11
casA,5768638,5768638,5768276,362,0,utRho11
cbl,4121882,4121882,4121828,54,1524,utRho11
cbpA,2128074,2128074,2127550,524,480,utRho11
cbrA,7738628,7738754,7738628,126,64,utRho11
cbrB,7794958,7795012,7794958,54,44,utRho11
ccmH,4585242,4585242,4584820,422,42,utRho11
cdaR,364894,364926,364894,32,0,utRho11
cdd,4463638,4463688,4463638,50,0,utRho11
cdh,8219814,8219860,8219814,46,224,utRho11
cdsA,391110,391354,391110,244,1492,utRho11
cedA,3627484,3627484,3627326,158,86,utRho11
cfa,3482402,3482826,3482402,424,136,utRho11
chaC,2544844,2544972,2544844,128,2,utRho11
chbB,3643452,3643452,3643238,214,0,utRho11
chbG,3634624,3634624,3634270,354,0,utRho11
cheW,3946924,3946924,3946678,246,2314,utRho11
chiA,6939792,6939792,6939706,86,0,utRho11
chiP,1416472,1416668,1416472,196,0,utRho11
cho,3646984,3647030,3646984,46,60,utRho11
chpS,8896804,8896894,8896804,90,224,utRho11
cirA,4493884,4493884,4493538,346,40,utRho11
citC,1304078,1304078,1303712,366,0,utRho11
citT,1293264,1293264,1293160,104,2,utRho11
clcA,350104,350214,350104,110,0,utRho11
clpA,1846160,1846528,1846160,368,28,utRho11
clpB,5468410,5468410,5468346,64,238,utRho11
clpP,913154,913354,913154,200,518,utRho11
clpS,1845500,1845826,1845500,326,0,utRho11
clpX,914404,914852,914404,448,1270,utRho11
clsA,2617346,2617346,2617290,56,150,utRho11
clsC,2212584,2212710,2212584,126,226,utRho11
cmk,1922330,1922402,1922330,72,34,utRho11
cnu,3409522,3409898,3409522,376,1344,utRho11
coaA,8350214,8350214,8350052,162,970,utRho11
cobC,1340092,1340092,1339814,278,516,utRho11
cobT,4129202,4129202,4128934,268,196,utRho11
cobU,4131944,4131944,4131528,416,428,utRho11
codB,709768,709844,709768,76,0,utRho11
comR,2337726,2337726,2337664,62,0,utRho11
copA,1022822,1022822,1022758,64,4,utRho11
corA,8002388,8002852,8002388,464,18584,utRho11
cpdB,8873258,8873258,8873130,128,196,utRho11
cptB,6082198,6082198,6082140,58,144,utRho11
cpxA,8210202,8210202,8209950,252,266,utRho11
cpxP,8211570,8211640,8211570,70,144,utRho11
cpxR,8211372,8211372,8211340,32,0,utRho11
cra,175894,176056,175894,162,72,utRho11
crcB,1316016,1316016,1315876,140,1438,utRho11
creA,9270486,9271042,9270486,556,366,utRho11
creD,9276320,9276356,9276320,36,198,utRho11
crl,515620,515658,515620,38,2248,utRho11
crp,6971906,6972240,6971906,334,2932,utRho11
crr,5070960,5071668,5070960,708,2632,utRho11
csdA,5886414,5886674,5886414,260,254,utRho11
csgB,2207718,2207902,2207718,184,0,utRho11
csgD,2206688,2206688,2206392,296,84,utRho11
csgG,2203510,2203510,2203368,142,98,utRho11
csiD,5577854,5577970,5577854,116,38,utRho11
csiE,5330802,5330870,5330802,68,252,utRho11
csiR,5590942,5591348,5590942,406,0,utRho11
cspA,7439778,7440098,7439778,320,125654,utRho11
cspB,3283430,3283430,3283108,322,104,utRho11
cspC,3815018,3815018,3814870,148,862,utRho11
cspD,1845352,1845352,1845180,172,994,utRho11
cspE,1314294,1314584,1314294,290,90,utRho11
cspF,3283380,3283710,3283380,330,56,utRho11
cspG,2102610,2102922,2102610,312,3550,utRho11
cspH,2102746,2102746,2102350,396,432,utRho11
cspI,3277624,3277624,3277334,290,0,utRho11
csrA,5638746,5638746,5638292,454,1790,utRho11
csrB,5849048,5849048,5849048,0,0,utRho11
csrC,8102072,8102072,8102072,0,0,utRho11
csrD,6806850,6806850,6806664,186,0,utRho11
cstA,1259710,1259788,1259710,78,0,utRho11
cueO,274090,274166,274090,76,92,utRho11
cueR,1027948,1027986,1027948,38,30,utRho11
curA,3037784,3038054,3037784,270,504,utRho11
cusC,1191146,1191200,1191146,54,0,utRho11
cusR,1190924,1190924,1190886,38,2,utRho11
cutA,8730784,8730784,8730712,72,456,utRho11
cutC,3918534,3918534,3917920,614,188,utRho11
cvpA,4861600,4861600,4861526,74,0,utRho11
cvrA,2484328,2484328,2484142,186,66,utRho11
cyaA,7981548,7982306,7981548,758,500,utRho11
cyaR,4334228,4334224,4334228,4,0,utRho11
cyaY,7988166,7988166,7988118,48,312,utRho11
cybB,2981522,2981804,2981522,282,334,utRho11
cycA,8859560,8859728,8859560,168,608,utRho11
cydA,1542340,1542916,1542340,576,266,utRho11
cydC,1858800,1858800,1858390,410,106,utRho11
cydD,1862062,1862062,1861924,138,38,utRho11
cydX,1548300,1548392,1548300,92,408,utRho11
cynR,717418,717418,717380,38,12,utRho11
cynT,1435092,1435196,1435092,104,0,utRho11
cyoA,903306,903306,903220,86,4308,utRho11
cyoE,895540,895540,895410,130,666,utRho11
cysB,2667576,2667710,2667576,134,244,utRho11
cysC,5748056,5748056,5747984,72,0,utRho11
cysD,5752736,5752736,5752658,78,60,utRho11
cysE,7565362,7565362,7565124,238,804,utRho11
cysG,6995508,6995656,6995508,148,540,utRho11
cysJ,5783928,5783928,5783796,132,2930,utRho11
cysK,5064688,5064818,5064688,130,0,utRho11
cysP,5087114,5087114,5087056,58,546,utRho11
cysS,1109154,1109222,1109154,68,80,utRho11
cysT,3984100,3984100,3983974,126,42,utRho11
cysZ,5062766,5062926,5062766,160,400,utRho11
cytR,8249018,8249018,8248912,106,128,utRho11
dacA,1328002,1328002,1327926,76,314,utRho11
dacB,6657714,6657926,6657714,212,152,utRho11
dacC,1761306,1761454,1761306,148,400,utRho11
dadA,2475018,2475142,2475018,124,0,utRho11
dam,7032504,7032504,7031826,678,1602,utRho11
damX,7035200,7035200,7034612,588,504,utRho11
dapA,5199568,5199568,5199520,48,0,utRho11
dapB,56576,56748,56576,172,292,utRho11
dapD,371954,371954,371894,60,250,utRho11
dapE,5183120,5183214,5183120,94,970,utRho11
dcp,3254844,3254844,3254760,84,22,utRho11
dcrB,7219534,7219910,7219534,376,626,utRho11
dctA,7366996,7366996,7366894,102,480,utRho11
dcuA,8733686,8733686,8733546,140,4,utRho11
dcuB,8698182,8698182,8697488,694,2304,utRho11
dcuC,1312166,1312166,1311936,230,242,utRho11
dcuD,6749166,6749738,6749166,572,208,utRho11
dcuR,8701130,8701130,8700068,1062,1104,utRho11
dcuS,8703370,8703370,8703324,46,126,utRho11
dcyD,3999016,3999016,3998960,56,0,utRho11
ddpX,3126498,3126498,3126152,346,60,utRho11
deaD,6615818,6615818,6615720,98,4686,utRho11
dedA,4869880,4869880,4869482,398,11972,utRho11
dedD,4863750,4863750,4863368,382,414,utRho11
def,6867300,6867380,6867300,80,74,utRho11
degP,361690,361768,361690,78,0,utRho11
degQ,6761308,6761486,6761308,178,5802,utRho11
deoB,9239134,9239206,9239134,72,0,utRho11
deoC,9233358,9234646,9233358,1288,160,utRho11
dfp,7625406,7625462,7625406,56,0,utRho11
dgcZ,3247758,3247758,3247700,58,0,utRho11
dgkA,8512914,8513274,8512914,360,604,utRho11
dgt,358392,358474,358392,82,104,utRho11
dhaK,2501888,2501888,2501676,212,482,utRho11
dhaR,2502006,2502132,2502006,126,252,utRho11
dicB,3299194,3299218,3299194,24,0,utRho11
dicC,3295752,3295752,3295700,52,66,utRho11
dinB,501760,501796,501760,36,0,utRho11
dinD,7635398,7635520,7635398,122,536,utRho11
dinG,1666146,1666140,1666146,6,4,utRho11
dinI,2243018,2243018,2242974,44,172,utRho11
dinJ,493230,493230,493004,226,70,utRho11
dinQ,7295964,7295964,7295576,388,1490,utRho11
djlA,114536,114728,114536,192,0,utRho11
dkgA,6313142,6313246,6313142,104,158,utRho11
dkgB,458196,458334,458196,138,336,utRho11
dksA,321502,321502,321208,294,446,utRho11
dld,4444164,4444370,4444164,206,46,utRho11
dmlA,3763424,3763824,3763424,400,192,utRho11
dmlR,3763710,3763710,3763618,92,46,utRho11
dmsA,1881646,1881918,1881646,272,52,utRho11
dnaA,7767922,7767922,7767458,464,1564,utRho11
dnaB,8528566,8528628,8528566,62,728,utRho11
dnaK,24096,24326,24096,230,832,utRho11
dnaN,7765466,7765466,7764642,824,882,utRho11
dnaQ,471868,472134,471868,266,1476,utRho11
dnaT,18406460,18406460,18406068,392,1632,utRho11
dnaX,984112,984184,984112,72,1234,utRho11
dosP,3131486,3131486,3131466,20,0,utRho11
dpiB,1303968,1304470,1303968,502,52,utRho11
dppA,7415740,7415740,7415410,330,2540,utRho11
dps,1697900,1697900,1697822,78,0,utRho11
dsbA,8086754,8086836,8086754,82,1470,utRho11
dsbB,2466294,2466294,2466060,234,0,utRho11
dsbC,6079266,6079266,6077644,1622,1540,utRho11
dsbG,1277600,1277600,1277146,454,352,utRho11
dsdA,4958242,4958404,4958242,162,100,utRho11
dsdC,4955492,4955492,4955258,234,230,utRho11
dsdX,4955642,4955694,4955642,52,166,utRho11
dsrA,4050626,4050626,4050626,0,0,utRho11
dsrB,4049686,4049686,4049646,40,780,utRho11
dtpD,1485340,1485340,1485112,228,50,utRho11
dusA,8523200,8523338,8523200,138,2272,utRho11
dusB,6820492,6820560,6820492,68,106,utRho11
dusC,4460790,4460790,4460770,20,0,utRho11
dut,7627704,7627864,7627704,160,1278,utRho11
dxr,386670,387042,386670,372,686,utRho11
ebgA,6445102,6445266,6445102,164,58,utRho11
ebgR,6442874,6442932,6442874,58,80,utRho11
ecnB,8753018,8753106,8753018,88,1284,utRho11
eco,4607594,4607810,4607594,216,0,utRho11
ecpA,621594,621594,621342,252,302,utRho11
ecpB,620238,620238,620052,186,118,utRho11
ecpR,622964,622964,622672,292,24,utRho11
eda,3866218,3866218,3865512,706,124,utRho11
edd,3869426,3869426,3869208,218,60,utRho11
efeO,2164308,2164486,2164308,178,416,utRho11
efeU_1,2162614,2162712,2162614,98,22,utRho11
efp,8751134,8751398,8751134,264,6140,utRho11
elaA,4763372,4763372,4763086,286,4,utRho11
elaD,4765308,4765426,4765308,118,316,utRho11
elfA,1995530,1995736,1995530,206,62,utRho11
elfD,1996642,1996980,1996642,338,0,utRho11
emrD,7707690,7707844,7707690,154,78,utRho11
emrK,4966896,4966896,4966678,218,138,utRho11
emrY,4964668,4964668,4964352,316,0,utRho11
emtA,2486250,2486360,2486250,110,0,utRho11
endA,12361100,12361388,12361100,288,4,utRho11
eno,5817692,5817692,5815882,1810,7638,utRho11
entC,1249662,1249770,1249662,108,0,utRho11
entD,1220508,1220508,1220158,350,144,utRho11
entH,1258584,1258600,1258584,16,0,utRho11
entS,1244506,1244600,1244506,94,0,utRho11
envR,6827266,6827266,6826930,336,0,utRho11
epd,12295292,12295292,12294764,528,76,utRho11
epmA,8765236,8765286,8765236,50,0,utRho11
epmB,8751406,8751406,8751314,92,3212,utRho11
eptB,7421162,7421162,7420950,212,38,utRho11
eptC,8300622,8300622,8300530,92,718,utRho11
erfK,4126708,4126708,4126646,62,1788,utRho11
erpA,353122,353220,353122,98,0,utRho11
esrE,8039956,8039956,8039956,0,0,utRho11
essD,1153746,1154796,1153746,1050,546,utRho11
etk,2088606,2088606,2088420,186,300,utRho11
evgA,4967262,4967510,4967262,248,0,utRho11
exbB,6304028,6304028,6303968,60,0,utRho11
exbD,6302780,6302780,6302486,294,96,utRho11
exuR,6493016,6493304,6493016,288,150,utRho11
exuT,6490004,6490208,6490004,204,0,utRho11
fabA,2032996,2032996,2032940,56,66,utRho11
fabB,4883282,4883282,4883210,72,68,utRho11
fabH,2297032,2297518,2297032,486,4146,utRho11
fabI,2702236,2702236,2702078,158,460,utRho11
fadB,8062026,8062026,8061942,84,0,utRho11
fadD,3779614,3779614,3779492,122,6,utRho11
fadE,486812,486812,486606,206,0,utRho11
fadH,6463248,6463330,6463248,82,14,utRho11
fadI,4921022,4921022,4920938,84,298,utRho11
fadL,4922410,4922600,4922410,190,0,utRho11
fadM,928720,928804,928720,84,2,utRho11
fadR,2469810,2469876,2469810,66,70,utRho11
fbaB,4357334,4357334,4357128,206,32,utRho11
fdhE,8162722,8162722,8162456,266,1768,utRho11
fdhF,8598814,8598814,8598732,82,0,utRho11
fdnG,3094744,3094802,3094744,58,0,utRho11
fdrA,1093012,1093360,1093012,348,0,utRho11
feaB,2894994,2895038,2894994,44,0,utRho11
feaR,2894734,2894734,2894566,168,98,utRho11
fecA,9033454,9033454,9033354,100,40,utRho11
fecE,9023288,9023288,9022914,374,8320,utRho11
fecI,9036564,9036564,9036470,94,290,utRho11
feoA,7080114,7080326,7080114,212,88,utRho11
fepA,1225334,1225334,1224988,346,40,utRho11
fepB,1249454,1249454,1249020,434,0,utRho11
fepD,1244468,1244468,1244378,90,0,utRho11
fes,1225374,1225630,1225374,256,350,utRho11
ffh,5495706,5495706,5495590,116,968,utRho11
ffs,952576,952848,952576,272,234,utRho11
fhuA,334884,334968,334884,84,320,utRho11
fhuE,2323294,2323294,2323102,192,204,utRho11
fhuF,9211504,9211504,9211326,178,133922,utRho11
fic,6983296,6983296,6982926,370,1298,utRho11
fieF,8212864,8212938,8212864,74,110,utRho11
fimA,9085388,9086230,9085388,842,1222,utRho11
fimB,9081334,9081914,9081334,580,1648,utRho11
fimE,9083742,9084074,9083742,332,1538,utRho11
fimZ,1129214,1129214,1128960,254,4,utRho11
fiu,1683296,1683296,1683062,234,24,utRho11
fixA,84650,84806,84650,156,0,utRho11
fkpA,6955050,6955050,6954838,212,7882,utRho11
fldA,2846084,2846084,2845860,224,4824,utRho11
fldB,6079644,6079710,6079644,66,208,utRho11
flgA,2261770,2261770,2261726,44,974,utRho11
flgB,2261986,2262036,2261986,50,146,utRho11
flgK,2276702,2276756,2276702,54,1562,utRho11
flgM,2260330,2260330,2260256,74,266,utRho11
flgN,2259828,2259828,2259660,168,212,utRho11
flhB,3932432,3932432,3932382,50,2842,utRho11
flhC,3955864,3955864,3955688,176,218,utRho11
flhD,3957154,3957154,3956394,760,1182,utRho11
fliA,4003638,4003638,4003578,60,2248,utRho11
fliC,4007352,4007352,4007212,140,1288,utRho11
fliD,4007634,4007744,4007634,110,760,utRho11
fliE,4026186,4026186,4026028,158,236,utRho11
fliF,4026292,4026458,4026292,166,398,utRho11
fliL,4039168,4039236,4039168,68,168,utRho11
flk,4875824,4875900,4875824,76,170,utRho11
flu,4142634,4143078,4142634,444,90,utRho11
flxA,3292776,3292810,3292776,34,82,utRho11
fnr,2799104,2799104,2799052,52,50,utRho11
fnrS,2818258,2818258,2818258,0,0,utRho11
focA,1909628,1909628,1908932,696,1010,utRho11
folA,99598,99646,99598,48,76,utRho11
folB,6409296,6409296,6409178,118,0,utRho11
folD,1115562,1115562,1115482,80,136,utRho11
folE,4487696,4487696,4487304,392,3154,utRho11
fpr,8228998,8228998,8228944,54,30,utRho11
frc,4986878,4986878,4986508,370,54,utRho11
frdA,8764824,8764824,8764636,188,58,utRho11
frdD,8758948,8758948,8758732,216,1486,utRho11
fre,8052886,8053054,8052886,168,1804,utRho11
frlA,6999518,6999820,6999518,302,720,utRho11
frr,385624,385744,385624,120,1440,utRho11
frsA,513004,513054,513004,50,362,utRho11
fruB,4527194,4527194,4526990,204,0,utRho11
frvR,8179804,8179804,8179710,94,0,utRho11
fryA,5008986,5008986,5008970,16,180,utRho11
fsaA,1727060,1727284,1727060,224,334,utRho11
fsr,1009710,1009710,1009392,318,76,utRho11
ftnA,3977364,3977432,3977364,68,0,utRho11
ftnB,3973550,3973850,3973550,300,0,utRho11
ftsA,207122,207964,207122,842,720,utRho11
ftsB,5745802,5745802,5745640,162,72,utRho11
ftsH,6654204,6654204,6653870,334,1040,utRho11
ftsK,1865858,1866448,1865858,590,1030,utRho11
ftsL,181376,182064,181376,688,2138,utRho11
ftsP,6325732,6325732,6325338,394,366,utRho11
ftsQ,205484,206310,205484,826,356,utRho11
ftsX,7204512,7204512,7204172,340,956,utRho11
ftsZ,209272,210610,209272,1338,140,utRho11
fucA,5867708,5867708,5867376,332,932,utRho11
fucP,5868238,5868470,5868238,232,24,utRho11
fumA,6753760,6753760,6753508,252,3352,utRho11
fumB,8694696,8694696,8694652,44,0,utRho11
fumC,3373418,3373418,3373176,242,56,utRho11
fur,2842892,2842892,2842584,308,6976,utRho11
fusA,6947370,6947370,6947028,342,31738,utRho11
fxsA,8737206,8737328,8737206,122,164,utRho11
gabD,5581824,5582546,5581824,722,1278,utRho11
gadA,7335214,7335214,7335160,54,0,utRho11
gadB,3144144,3144144,3144090,54,0,utRho11
gadC,3141168,3141168,3140978,190,336,utRho11
gadE,7315600,7316732,7315600,1132,272,utRho11
gadW,7329562,7329562,7329236,326,0,utRho11
gadX,14663356,14663356,14663240,116,484,utRho11
gadY,7329728,7329728,7329728,0,0,utRho11
galE,1584354,1584354,1584110,244,68,utRho11
galF,4228702,4228702,4228654,48,14,utRho11
galM,1577796,1577796,1577674,122,888,utRho11
galP,6176510,6176568,6176510,58,2,utRho11
galR,5953138,5953198,5953138,60,178,utRho11
galS,4483420,4483420,4483336,84,56,utRho11
galU,2582810,2582914,2582810,104,366,utRho11
gapA,3724480,3725542,3724480,1062,3910,utRho11
garP,6549868,6549868,6549814,54,62,utRho11
gatY,4354468,4354468,4354408,60,0,utRho11
gatZ,4352864,4352864,4352642,222,12672,utRho11
gcd,282558,282558,282450,108,14,utRho11
gcl,1067814,1067832,1067814,18,0,utRho11
gcvA,5885278,5885278,5885134,144,0,utRho11
gcvB,5885392,5885392,5885392,0,0,utRho11
gcvR,5199758,5199812,5199758,54,0,utRho11
gcvT,6101544,6101544,6101334,210,1396,utRho11
gdhA,3684616,3684742,3684616,126,0,utRho11
gfcA,2099668,2099668,2099488,180,1506,utRho11
gfcD,2096236,2096236,2095890,346,1112,utRho11
ghrA,2195648,2195772,2195648,124,4,utRho11
ghrB,7434378,7434620,7434378,242,1958,utRho11
glcA,6242728,6242728,6242558,170,178,utRho11
glcC,6256412,6256544,6256412,132,68,utRho11
glcD,6256152,6256152,6256042,110,130,utRho11
gldA,8278092,8278092,8278070,22,0,utRho11
glgA,7136784,7136784,7136066,718,1218,utRho11
glgB,7147314,7147314,7147004,310,296,utRho11
glgC,7139142,7139142,7138656,486,164,utRho11
glgP,7133546,7133546,7133162,384,848,utRho11
glgS,6384024,6384024,6383878,146,20,utRho11
glgX,7142838,7142838,7142638,200,0,utRho11
glk,5018922,5018922,5018852,70,162,utRho11
glmS,7827622,7827622,7827336,286,5840,utRho11
glmU,7830652,7830652,7830400,252,1428,utRho11
glmY,10765360,10765360,10765360,0,0,utRho11
glmZ,7972864,7972864,7972864,0,0,utRho11
glnA,16232888,16232888,16232136,752,428,utRho11
glnB,5375052,5375052,5374816,236,300,utRho11
glnD,377310,377310,377300,10,0,utRho11
glnE,6399602,6399602,6399282,320,0,utRho11
glnH,1696396,1696396,1696008,388,274,utRho11
glnK,945112,945196,945112,84,4,utRho11
glnL,8112742,8112742,8112678,64,0,utRho11
glnQ,1693262,1693262,1692926,336,350,utRho11
glnS,1411998,1412186,1411998,188,1552,utRho11
gloA,3455602,3455674,3455602,72,0,utRho11
gloB,469852,469852,469564,288,2864,utRho11
glpA,4705166,4705294,4705166,128,0,utRho11
glpD,7123942,7124026,7123942,84,14,utRho11
glpE,7123698,7123698,7123646,52,0,utRho11
glpF,8236322,8236322,8236180,142,508,utRho11
glpG,7122960,7122960,7122904,56,368,utRho11
glpR,7121782,7121782,7121210,572,660,utRho11
glpT,4704902,4704902,4704748,154,86,utRho11
glpX,8231212,8231212,8231158,54,11310,utRho11
glrK,5382246,5382246,5382196,50,1136,utRho11
gltA,1509534,1509534,1508936,598,8566,utRho11
gltB,6709018,6709264,6709018,246,700,utRho11
gltI,1375792,1375792,1375494,298,4600,utRho11
gltP,8588536,8588962,8588536,426,1756,utRho11
gltS,7657382,7657382,7657330,52,318,utRho11
gltX,5041568,5041568,5041344,224,226,utRho11
gluQ,320286,320286,320224,62,102,utRho11
glyA,5371148,5371148,5371014,134,160,utRho11
glyQ,7450708,7450708,7450636,72,328,utRho11
glyS,7448990,7448990,7448794,196,4254,utRho11
glyU,5998128,5998128,5998114,14,110,utRho11
glyV,8784626,8784720,8784626,94,316,utRho11
glyW,3984360,3984360,3984234,126,2,utRho11
gmhB,445612,445666,445612,54,0,utRho11
gmk,7642776,7642856,7642776,80,130,utRho11
gmr,2693686,2693686,2693484,202,694,utRho11
gnd,4202648,4202648,4202536,112,200,utRho11
gnsB,3275692,3275692,3275564,128,0,utRho11
gntK,14310580,14310580,14310368,212,780,utRho11
gntP,9102668,9102668,9102592,76,66,utRho11
gntR,7157760,7157760,7157452,308,464,utRho11
gntT,7092810,7093118,7092810,308,1456,utRho11
gntU,7154170,7154170,7154122,48,238,utRho11
gntX,7089334,7089764,7089334,430,80,utRho11
gor,7292224,7292598,7292224,374,1244,utRho11
gpmA,1575340,1575340,1575190,150,4,utRho11
gpmM,7570374,7570520,7570374,146,4,utRho11
gpsA,7567620,7567620,7567322,298,10234,utRho11
gpt,511828,511954,511828,126,1126,utRho11
grcA,5433046,5433046,5432898,148,838,utRho11
greA,6657728,6657728,6657430,298,2400,utRho11
greB,7073488,7073624,7073488,136,0,utRho11
groL,8741566,8742050,8741566,484,1588,utRho11
groS,8741232,8741376,8741232,144,578,utRho11
grpE,5501494,5501494,5501416,78,514,utRho11
grxA,1781552,1781552,1781506,46,68,utRho11
grxB,2248206,2248206,2248108,98,678,utRho11
grxC,7569152,7569152,7568884,268,4924,utRho11
grxD,3468324,3468324,3468202,122,9672,utRho11
gspA,6911268,6911268,6910796,472,82,utRho11
gspC,6910964,6911156,6910964,192,0,utRho11
gss,6277220,6277220,6277044,176,234,utRho11
gstA,3428654,3428754,3428654,100,14,utRho11
gstB,1761038,1761038,1760960,78,0,utRho11
guaB,5268214,5268214,5268140,74,84,utRho11
gudD,5839026,5839026,5838770,256,96,utRho11
gyrA,4678914,4678914,4678840,74,18,utRho11
gyrB,7760300,7760300,7760238,62,196,utRho11
hcaE,5337964,5338064,5337964,100,382,utRho11
hcaR,5337928,5337928,5337792,136,418,utRho11
hcaT,5336106,5336106,5335692,414,76,utRho11
hchA,4071260,4071670,4071260,410,84,utRho11
hcp,1828258,1828258,1827628,630,200,utRho11
hcr,1824400,1824400,1824300,100,44,utRho11
hdeA,7313582,7313582,7313480,102,0,utRho11
hdeD,7313920,7313990,7313920,70,174,utRho11
hdfR,7896320,7896320,7895934,386,1380,utRho11
hdhA,3396244,3396244,3396080,164,100,utRho11
helD,2048876,2048942,2048876,66,62,utRho11
hemA,2527166,2527428,2527166,262,2,utRho11
hemB,779722,779722,779454,268,418,utRho11
hemF,5106410,5106450,5106410,40,28,utRho11
hemH,996062,996110,996062,48,1256,utRho11
hemL,349882,349882,349764,118,16,utRho11
hemN,8103886,8104090,8103886,204,54,utRho11
hepA,127176,127176,126528,648,1600,utRho11
hflD,2385372,2385372,2385262,110,630,utRho11
hfq,8799602,8800576,8799602,974,3758,utRho11
hha,961006,961006,960616,390,190,utRho11
hicA,3018442,3018572,3018442,130,0,utRho11
higA,6468682,6468682,6468288,394,420,utRho11
higB,6468960,6468960,6468910,50,74,utRho11
hinT,2323642,2323770,2323642,128,0,utRho11
hipB,3184964,3184964,3184884,80,0,utRho11
hisB,4186720,4186936,4186720,216,894,utRho11
hisJ,4853674,4853674,4853576,98,30,utRho11
hisL,8359856,8359984,8359856,128,372,utRho11
hisS,5281284,5281284,5281150,134,238,utRho11
hlpA,400910,400964,400910,54,24,utRho11
hlyE,2460932,2460932,2460788,144,314,utRho11
hmp,5371594,5371670,5371594,76,70,utRho11
hns,2585916,2585916,2585844,72,1302,utRho11
hofM,7045856,7045856,7045502,354,0,utRho11
hokA,7441620,7441620,7441200,420,9470,utRho11
hokC,33902,33902,33806,96,292,utRho11
hokE,1215462,1215672,1215462,210,0,utRho11
holC,8968546,8968546,8968560,14,900,utRho11
holD,9215562,9215606,9215562,44,0,utRho11
holE,3850040,3850216,3850040,176,6314,utRho11
hpt,282720,282862,282720,142,576,utRho11
hrpB,324150,324210,324150,60,0,utRho11
hscB,5319048,5319048,5318934,114,2418,utRho11
hscC,1367188,1367188,1366786,402,940,utRho11
hsdS,9163004,9163004,9162924,80,266,utRho11
hslJ,2883560,2883560,2883486,74,216,utRho11
hslO,7059344,7059548,7059344,204,7318,utRho11
hslR,7058220,7058696,7058220,476,1376,utRho11
hslV,8244708,8244708,8244574,134,126,utRho11
hsrA,7881412,7881412,7881224,188,24,utRho11
htgA,21286,21660,21286,374,7936,utRho11
htpG,989634,990240,989634,606,32108,utRho11
htpX,3825236,3825236,3825152,84,0,utRho11
htrE,311036,311036,310852,184,830,utRho11
htrL,7587668,7587668,7587366,302,24,utRho11
hupA,8400352,8400562,8400352,210,0,utRho11
hupB,1845220,1845804,1845220,584,8,utRho11
hyaA,2063968,2064278,2063968,310,0,utRho11
hybO,6292726,6292726,6292522,204,5888,utRho11
hycA,5700922,5700922,5700870,52,18,utRho11
hycI,5686204,5686204,5686086,118,318,utRho11
hydN,5676264,5676264,5676210,54,0,utRho11
hyfA,5202342,5202402,5202342,60,104,utRho11
hypA,11402508,11402588,11402508,80,224,utRho11
hypB,11403356,11404004,11403356,648,0,utRho11
hypF,5676210,5676210,5674850,1360,2654,utRho11
hypT,9116634,9116634,9116578,56,0,utRho11
hyuA,6019660,6020056,6019660,396,0,utRho11
iaaA,1733074,1733136,1733074,62,0,utRho11
iadA,9119074,9119074,9119052,22,248,utRho11
iap,5753072,5753162,5753072,90,32,utRho11
ibaG,6673966,6673966,6673606,360,328,utRho11
ibpA,7735036,7735036,7734844,192,630,utRho11
ibpB,7733962,7733962,7733794,168,242,utRho11
icd,2389922,2390246,2389922,324,338,utRho11
iclR,8447304,8447304,8447256,48,164,utRho11
idi,6065876,6066130,6065876,254,100,utRho11
idnD,8988870,8988870,8988812,58,2,utRho11
idnK,8989194,8989246,8989194,52,84,utRho11
ihfA,3591442,3591442,3591104,338,930,utRho11
ihfB,1927498,1927656,1927498,158,862,utRho11
ileS,43666,44782,43666,1116,3090,utRho11
ileX,6431194,6431196,6431194,2,0,utRho11
ilvA,15820940,15821324,15820940,384,228,utRho11
ilvC,7915824,7915940,7915824,116,44,utRho11
ilvE,15809552,15809936,15809552,384,2364,utRho11
ilvI,170840,171260,170840,420,172,utRho11
ilvL,23701308,23701932,23701308,624,6,utRho11
ilvY,7915734,7915734,7915640,94,44,utRho11
inaA,4698998,4698998,4698944,54,354,utRho11
infA,1853370,1853370,1852886,484,2320,utRho11
infC,3602692,3602692,3601276,1416,5374,utRho11
insA-5,3958452,3958452,3958430,22,2,utRho11
insA-7,9036758,9037054,9036758,296,648,utRho11
insC-5,6372080,6372284,6372080,204,7926,utRho11
insEF-2,785238,785238,785820,582,926,utRho11
insEF-4,2190310,2190310,2190892,582,890,utRho11
insG,9007098,9007098,9006862,236,146,utRho11
insH-1,550596,550596,550234,362,556,utRho11
insH-11,7306538,7306538,7306396,142,116,utRho11
insH-2,1151548,1151548,1151506,42,48,utRho11
insH-3,1378444,1378444,1378026,418,852,utRho11
insH-4,2791942,2792152,2791942,210,174,utRho11
insH-5,2857852,2857852,2857452,400,0,utRho11
insH-6,4135022,4135022,4134642,380,772,utRho11
insH-7,4206186,4206186,4205822,364,5264,utRho11
insH-9,6260050,6260356,6260050,306,218,utRho11
insI-3,9017372,9017372,9017234,138,218,utRho11
insJ,7441188,7441360,7441188,172,4222,utRho11
insK,7442130,7442308,7442130,178,0,utRho11
insL-1,30760,30890,30760,130,720,utRho11
insL-2,1216112,1216130,1216112,18,90,utRho11
insL-3,5028644,5028662,5028644,18,304,utRho11
insN-1,540452,540484,540452,32,0,utRho11
intD,1132202,1132202,1131956,246,4204,utRho11
intR,2826520,2826520,2826470,50,0,utRho11
intS,4933026,4933090,4933026,64,5742,utRho11
intZ,5117386,5117542,5117386,156,2676,utRho11
iraD,9113152,9113986,9113152,834,120,utRho11
iraM,2424246,2424246,2424006,240,0,utRho11
iraP,802638,802772,802638,134,0,utRho11
iscA,5319924,5319924,5319772,152,1800,utRho11
iscR,5324398,5324398,5324262,136,15898,utRho11
iscX,5313834,5313834,5313472,362,5272,utRho11
ispF,5743968,5743968,5743560,408,3384,utRho11
ispG,5283908,5283908,5283608,300,622,utRho11
ispU,389568,389806,389568,238,224,utRho11
isrA,2811502,2811502,2811618,116,0,utRho11
istr-1,7706384,7706384,7706384,0,0,utRho11
istr-2,7706514,7706514,7706514,0,0,utRho11
ivbL,15412092,15412092,15411952,140,1200,utRho11
ivy,480638,480686,480638,48,82,utRho11
katE,3627628,3627734,3627628,106,90,utRho11
katG,8267624,8267670,8267624,46,190,utRho11
kbaZ,6557732,6557828,6557732,96,2,utRho11
kbl,7585154,7585154,7585102,52,912,utRho11
kch,2621046,2621046,2620538,508,580,utRho11
kdgR,3820506,3820506,3820198,308,126,utRho11
kdpE,1443788,1443788,1443466,322,0,utRho11
kdpF,1457698,1457698,1457642,56,0,utRho11
kdsA,2535708,2536330,2535708,622,2592,utRho11
kdsC,6683438,6684546,6683438,1108,4200,utRho11
kduI,5968388,5968388,5968248,140,4978,utRho11
kefF,94160,94492,94160,332,194,utRho11
kgtP,5451624,5451624,5451492,132,1878,utRho11
kup,7862206,7862632,7862206,426,112,utRho11
lacI,735076,735076,735020,56,0,utRho11
lacZ,1465508,1465508,1465220,288,292,utRho11
ldcA,2486394,2486394,2486160,234,0,utRho11
ldhA,2885830,2885830,2885686,144,0,utRho11
ldrA,2538954,2538954,2538550,404,4016,utRho11
ldrB,2540024,2540024,2539620,404,1292,utRho11
ldrC,2541092,2541092,2540690,402,1128,utRho11
ldrD,7400544,7400544,7400174,370,1484,utRho11
lepA,5414392,5414392,5414248,144,226,utRho11
lepB,5410928,5410928,5410618,310,904,utRho11
leuD,159188,159188,158906,282,246,utRho11
leuE,3761600,3761600,3761518,82,0,utRho11
leuL,168048,168048,167416,632,76,utRho11
leuO,168308,168736,168308,428,0,utRho11
leuQ,9212864,9212864,9212802,62,0,utRho11
leuU,6644556,6644556,6644316,240,2436,utRho11
leuV,9212546,9212546,9212330,216,3038,utRho11
leuX,8992772,8992810,8992772,38,0,utRho11
lexA,8514174,8514230,8514174,56,154,utRho11
lhr,3456706,3458174,3456706,1468,4496,utRho11
ligA,5060402,5060402,5060352,50,0,utRho11
ligB,7642576,7642576,7642340,236,336,utRho11
lipA,1320602,1320602,1320432,170,436,utRho11
lipB,1324802,1324802,1324556,246,4390,utRho11
lit,2397032,2397390,2397032,358,1488,utRho11
livJ,7199524,7199524,7199316,208,1982,utRho11
livK,7195510,7195510,7195120,390,418,utRho11
lldP,7554578,7554798,7554578,220,4446,utRho11
lnt,1381968,1381968,1381762,206,578,utRho11
loiP,6163784,6163826,6163784,42,228,utRho11
lolA,1874656,1874738,1874656,82,304,utRho11
lolB,2527112,2527112,2527000,112,26,utRho11
lolC,2350748,2350854,2350748,106,0,utRho11
lon,917630,917776,917630,146,1778,utRho11
lpcA,486936,487086,486936,150,2,utRho11
lpd,255434,255824,255434,390,3046,utRho11
lplA,9248476,9248476,9248234,242,732,utRho11
lplT,5947878,5947878,5947724,154,146,utRho11
lpoA,6586422,6586800,6586422,378,242,utRho11
lpp,3514592,3514842,3514592,250,226,utRho11
lptA,6686598,6686760,6686598,162,998,utRho11
lptB,6686792,6687888,6686792,1096,2680,utRho11
lptD,114672,114672,114218,454,2106,utRho11
lptF,8972244,8972436,8972244,192,76,utRho11
lpxC,213016,213114,213016,98,8306,utRho11
lpxD,401920,401942,401920,22,280,utRho11
lpxL,2233418,2233418,2233164,254,6,utRho11
lpxM,3880456,3880456,3880386,70,140,utRho11
lpxP,4991156,4991290,4991156,134,2,utRho11
lrhA,4813312,4813312,4813282,30,0,utRho11
lrp,1864656,1865190,1864656,534,906,utRho11
lspA,50028,50414,50028,386,1016,utRho11
lsrA,3202920,3202980,3202920,60,22,utRho11
lsrR,3202514,3202514,3202482,32,2,utRho11
ltaE,1818640,1818640,1818588,52,0,utRho11
luxS,5630130,5630130,5629466,664,18624,utRho11
lysA,5957902,5957902,5957798,104,44,utRho11
lysC,8467232,8467232,8466466,766,916,utRho11
lysP,4497120,4497120,4497064,56,0,utRho11
lysR,5957900,5958042,5957900,142,134,utRho11
lysT,1561028,1561108,1561028,80,282,utRho11
lysU,8709610,8709610,8709434,176,4,utRho11
macB,1840188,1840694,1840188,506,270,utRho11
maeA,3111484,3111484,3111338,146,3522,utRho11
mak,820236,820288,820236,52,0,utRho11
malE,8492928,8492928,8492838,90,76,utRho11
malI,3398456,3398456,3398360,96,0,utRho11
malK,8493472,8493568,8493472,96,132,utRho11
malP,7105020,7105020,7104946,74,316,utRho11
malQ,7100798,7100798,7100140,658,36,utRho11
malS,14949880,14949988,14949880,108,4,utRho11
malT,7106048,7106170,7106048,122,102,utRho11
malX,3398626,3398710,3398626,84,0,utRho11
malZ,1689980,1690072,1689980,92,4448,utRho11
manA,3377102,3377152,3377102,50,0,utRho11
manX,3803866,3804096,3803866,230,96,utRho11
marC,3237882,3237882,3237816,66,134,utRho11
marR,3238186,3238240,3238186,54,118,utRho11
matP,2036918,2036970,2036918,52,196,utRho11
mazE,5822736,5822736,5822678,58,56,utRho11
mazG,5821720,5821720,5821370,350,4930,utRho11
mcbA,1684306,1684306,1684112,194,0,utRho11
mcbR,3040192,3040524,3040192,332,52,utRho11
mcrA,2420278,2420692,2420278,414,0,utRho11
mcrC,9156124,9156124,9155916,208,250,utRho11
mdaB,6344814,6345060,6344814,246,92,utRho11
mdfA,1767138,1767346,1767138,208,0,utRho11
mdh,6768940,6768940,6768536,404,94,utRho11
mdoB,9198988,9198988,9198882,106,2870,utRho11
mdoD,2993290,2993712,2993290,422,0,utRho11
mdoG,2218514,2218670,2218514,156,100,utRho11
mdtA,4307958,4308032,4307958,74,490,utRho11
mdtE,7318168,7318464,7318168,296,546,utRho11
mdtK,3486538,3486914,3486538,376,1166,utRho11
mdtP,8602472,8602472,8602060,412,112,utRho11
melA,8683774,8683822,8683774,48,0,utRho11
melR,8683300,8683300,8683256,44,6,utRho11
menA,8240812,8240812,8240698,114,22,utRho11
menB,4753774,4753774,4753638,136,314,utRho11
mepH,3468714,3468870,3468714,156,0,utRho11
mepM,3883666,3883666,3883270,396,786,utRho11
mepS,4539840,4539958,4539840,118,384,utRho11
metA,8428318,8428560,8428318,242,326,utRho11
metB,8257272,8257344,8257272,72,800,utRho11
metC,6304150,6304472,6304150,322,100,utRho11
metE,8025768,8026106,8025768,338,1148,utRho11
metF,8265092,8265232,8265092,140,274,utRho11
metG,4388538,4388600,4388538,62,56,utRho11
metH,8447010,8447656,8447010,646,2426,utRho11
metJ,8257116,8257116,8256790,326,24,utRho11
metK,6173154,6173412,6173154,258,48,utRho11
metN,445428,445428,445290,138,8,utRho11
metR,8025710,8025710,8025632,78,0,utRho11
metT,1394326,1394326,1394266,60,216,utRho11
metY,19910250,19910250,19909734,516,636,utRho11
metZ,11789528,11789548,11789528,20,36,utRho11
mfd,2348056,2348056,2347928,128,110,utRho11
mglA,4478782,4478782,4478578,204,122,utRho11
mglB,4481132,4481132,4480696,436,7902,utRho11
mglC,4475918,4475918,4475506,412,286,utRho11
mgrB,3817584,3817584,3817532,52,46,utRho11
mgrR,3245828,3245828,3245828,0,0,utRho11
mgsA,2054082,2054082,2054030,52,18,utRho11
mgtL,8934560,8934862,8934560,302,0,utRho11
mhpA,737038,737222,737038,184,204,utRho11
mhpR,737072,737072,736840,232,102,utRho11
mhpT,750772,750918,750772,146,16,utRho11
miaA,8797964,8798504,8797964,540,1834,utRho11
micA,5629604,5629604,5629604,0,0,utRho11
micC,2874242,2874238,2874242,4,0,utRho11
micF,4626168,4626168,4626168,0,0,utRho11
micM,1014408,1014408,1014408,0,0,utRho11
minE,2449422,2449422,2449090,332,1578,utRho11
mioC,7852950,7852950,7852910,40,26,utRho11
mipA,3733012,3733012,3732944,68,2004,utRho11
mlaA,4930270,4930270,4930014,256,36,utRho11
mlc,3337206,3337206,3337128,78,206,utRho11
mlrA,4429498,4429732,4429498,234,8,utRho11
mltA,5894546,5894546,5894356,190,0,utRho11
mltD,468050,468050,467910,140,0,utRho11
mltF,5391534,5391602,5391534,68,0,utRho11
mmuP,550238,550650,550238,412,608,utRho11
mngA,1531622,1531968,1531622,346,430,utRho11
mngR,1531852,1531852,1531750,102,418,utRho11
mnmG,7851348,7851348,7851266,82,5928,utRho11
mntH,5025470,5025470,5025412,58,32,utRho11
mntP,3810918,3811376,3810918,458,1836,utRho11
mntR,1706160,1706366,1706160,206,22,utRho11
mntS,1706128,1706128,1705994,134,44,utRho11
moaA,1633654,1634088,1633654,434,846,utRho11
moaB,1635954,1636110,1635954,156,1846,utRho11
mobA,8084242,8084242,8083998,244,542,utRho11
mocA,6030112,6030320,6030112,208,18,utRho11
modA,1589990,1590178,1589990,188,30,utRho11
moeA,1732788,1732788,1732728,60,42,utRho11
mokB,2984610,2984610,2984258,352,530,utRho11
molR_1,4392888,4392948,4392888,60,246,utRho11
motA,3954604,3954604,3954278,326,116,utRho11
mpaA,2781278,2781278,2781196,82,252,utRho11
mpl,8911456,8911570,8911456,114,30,utRho11
mppA,2786108,2786454,2786108,346,28,utRho11
mprA,5621494,5621540,5621494,46,1414,utRho11
mqo,4613848,4613848,4613508,340,676,utRho11
mqsA,6336742,6336742,6336492,250,270,utRho11
mqsR,6337306,6337306,6337088,218,454,utRho11
mraZ,179192,179268,179192,76,4,utRho11
mrcA,7045652,7045742,7045652,90,0,utRho11
mrcB,329442,329460,329442,18,0,utRho11
mreB,13605424,13605424,13604348,1076,2944,utRho11
mreD,6798166,6798166,6797750,416,574,utRho11
mrp,4388360,4388360,4388336,24,112,utRho11
mscK,972984,973072,972984,88,120,utRho11
mscL,6876002,6876048,6876002,46,1326,utRho11
mscS,6139742,6139742,6139614,128,48,utRho11
msrA,8884522,8884522,8884352,170,464,utRho11
msrB,3725168,3725168,3724858,310,2,utRho11
msyB,2228426,2228426,2228362,64,280,utRho11
mtfA,4087236,4087302,4087236,66,924,utRho11
mtgA,6699662,6699662,6699618,44,930,utRho11
mtlA,30177504,30178248,30177504,744,1440,utRho11
mtn,358366,358366,358306,60,418,utRho11
mtr,6611864,6611864,6611634,230,140,utRho11
mug,6430992,6430992,6430946,46,610,utRho11
murQ,5091466,5091546,5091466,80,16,utRho11
murR,5091586,5091586,5091218,368,142,utRho11
mutH,5939164,5939324,5939164,160,328,utRho11
mutL,8794092,8794824,8794092,732,5836,utRho11
mutM,7622554,7622554,7622304,250,1896,utRho11
mutS,5714038,5714186,5714038,148,614,utRho11
mutY,18617466,18618078,18617466,612,6,utRho11
nac,4123956,4123956,4123866,90,818,utRho11
nadA,1564122,1564170,1564122,48,240,utRho11
nadB,5420714,5420840,5420714,126,0,utRho11
nadC,237326,237326,237290,36,134,utRho11
nadE,3644604,3644916,3644604,312,100,utRho11
nadK,5501526,5501662,5501526,136,378,utRho11
nagA,1406350,1406350,1405502,848,2320,utRho11
nagB,1407416,1407416,1407222,194,48,utRho11
nagC,1404016,1404016,1403188,828,0,utRho11
nagE,1407680,1407888,1407680,208,84,utRho11
nagK,2357080,2357186,2357080,106,0,utRho11
nanA,6747240,6747240,6747152,88,58,utRho11
nanC,9079856,9079856,9079002,854,44,utRho11
nanR,6749406,6749406,6748978,428,880,utRho11
nanS,9075406,9075406,9075188,218,0,utRho11
napF,4607390,4607390,4606994,396,80,utRho11
narG,2559614,2559728,2559614,114,66,utRho11
narK,2555642,2555914,2555642,272,4,utRho11
narP,4580844,4581000,4580844,156,0,utRho11
narQ,5171154,5171462,5171154,308,138,utRho11
narU,3088326,3088326,3088120,206,0,utRho11
narW,3077374,3077374,3074618,2756,292,utRho11
narX,2555554,2555554,2555236,318,0,utRho11
narZ,3085380,3085380,3085180,200,0,utRho11
ndh,2331984,2332170,2331984,186,228,utRho11
ndk,5289920,5289920,5289728,192,248,utRho11
nemR,6904084,6904092,6904084,8,256,utRho11
nepI,7683542,7683542,7683478,64,152,utRho11
nfo,4501612,4501680,4501612,68,136,utRho11
nfsB,1210906,1210906,1210848,58,2,utRho11
nfuA,7090916,7091248,7090916,332,1092,utRho11
nhaA,34634,34978,34634,344,444,utRho11
nhaB,2469534,2469534,2469434,100,32,utRho11
nhoA,3067926,3068048,3067926,122,0,utRho11
nikA,7226878,7227334,7226878,456,7610,utRho11
nikR,7237074,7237176,7237074,102,232,utRho11
nirB,6987974,6988022,6987974,48,156,utRho11
nlpA,7680034,7680034,7679986,48,0,utRho11
nlpC,3585654,3585654,3585462,192,0,utRho11
nlpD,5737658,5737658,5737506,152,130,utRho11
nlpI,6618080,6618080,6617848,232,4,utRho11
nmpC,1153740,1153740,1153650,90,0,utRho11
nohA,3273206,3273206,3272734,472,252,utRho11
norR,5664614,5664614,5664578,36,0,utRho11
norV,5664878,5664952,5664878,74,0,utRho11
nrdA,4689510,4689730,4689510,220,8334,utRho11
nrdD,8925676,8925676,8925320,356,5822,utRho11
nrdH,5601312,5601446,5601312,134,62,utRho11
nrdR,865954,866004,865954,50,12,utRho11
nrfA,8575342,8575528,8575342,186,0,utRho11
nsrR,8812088,8812380,8812088,292,15248,utRho11
nudB,3897348,3897348,3897264,84,0,utRho11
nudC,8393428,8393806,8393428,378,40,utRho11
nudE,7052658,7052658,7052298,360,848,utRho11
nudG,3682876,3682980,3682876,104,0,utRho11
nudI,4729050,4729108,4729050,58,0,utRho11
nudJ,2388874,2388874,2388576,298,1102,utRho11
nuoA,4810670,4810670,4810144,526,6262,utRho11
nuoN,4783434,4783434,4783010,424,1258,utRho11
nupC,5026018,5026084,5026018,66,52,utRho11
nupG,6211302,6211428,6211302,126,146,utRho11
ogrK,4335096,4335096,4335040,56,0,utRho11
ogt,2800568,2800568,2800472,96,48,utRho11
ohsC,5401036,5401040,5401036,4,68,utRho11
ompA,2040382,2040382,2040106,276,23650,utRho11
ompC,4625774,4625774,4625498,276,298,utRho11
ompF,1974184,1974184,1973964,220,162,utRho11
ompL,8128958,8128958,8128590,368,262,utRho11
ompN,2874158,2874158,2873786,372,0,utRho11
ompR,7073510,7073510,7073168,342,168,utRho11
ompT,1171330,1171330,1171266,64,182,utRho11
ompW,2627982,2628040,2627982,58,0,utRho11
ompX,1700418,1700900,1700418,482,1044,utRho11
omrA,5952378,5952378,5952378,0,0,utRho11
omrB,5952770,5952770,5952770,0,0,utRho11
oppA,2602170,2602364,2602170,194,10876,utRho11
orn,8783168,8783208,8783168,40,50,utRho11
osmB,2686952,2686952,2686656,296,3958,utRho11
osmC,3113192,3113250,3113192,58,176,utRho11
osmE,3644566,3644566,3644512,54,128,utRho11
osmF,4439046,4439046,4438962,84,1258,utRho11
osmY,9222306,9222792,9222306,486,998,utRho11
otsA,3963302,3963302,3963224,78,76,utRho11
otsB,3964930,3964930,3964774,156,566,utRho11
oxc,4984288,4984288,4983900,388,2,utRho11
oxyR,8316914,8316980,8316914,66,432,utRho11
oxyS,8316788,8316788,8316788,0,0,utRho11
paaA,2907730,2907854,2907730,124,0,utRho11
paaX,2927018,2927078,2927018,60,0,utRho11
paaZ,2907340,2907340,2907284,56,0,utRho11
pabA,6981702,6981702,6981658,44,0,utRho11
pabB,3789256,3789610,3789256,354,334,utRho11
pabC,2306186,2306600,2306186,414,572,utRho11
pagP,1313052,1313114,1313052,62,0,utRho11
panB,299260,299260,299202,58,1570,utRho11
panC,297840,297840,297590,250,462,utRho11
panD,293490,293490,293388,102,264,utRho11
panZ,7195656,7195968,7195656,312,104,utRho11
parC,6332060,6332060,6331946,114,538,utRho11
patA,6438916,6438988,6438916,72,0,utRho11
patD,3030830,3031156,3030830,326,0,utRho11
pbpC,5294986,5294986,5294650,336,0,utRho11
pbpG,4450132,4450132,4449740,392,204,utRho11
pck,7065358,7065636,7065358,278,4910,utRho11
pcnB,318782,318782,318252,530,1190,utRho11
pdhR,244068,244184,244068,116,42,utRho11
pdxB,4875768,4875768,4875702,66,146,utRho11
pdxH,3436068,3436068,3436014,54,246,utRho11
pdxJ,5403626,5403626,5403458,168,204,utRho11
pdxK,5074638,5074638,5074474,164,80,utRho11
pepA,8972278,8972278,8971902,376,82,utRho11
pepD,511618,511618,511432,186,3816,utRho11
pepN,1981182,1981244,1981182,62,276,utRho11
pepQ,8062294,8062322,8062294,28,0,utRho11
pepT,2371646,2371688,2371646,42,76,utRho11
pfkA,8214948,8215104,8214948,156,74,utRho11
pfkB,3612646,3612740,3612646,94,0,utRho11
pflA,1902456,1902456,1902160,296,38,utRho11
pflB,1907850,1907850,1907108,742,1228,utRho11
pflD,8287716,8287990,8287716,274,0,utRho11
pgaA,2185046,2185046,2184578,468,14,utRho11
pgi,8467444,8467516,8467444,72,0,utRho11
pgk,12291428,12291428,12290488,940,4656,utRho11
pgl,1597078,1597172,1597078,94,102,utRho11
pgpB,2678324,2678660,2678324,336,484,utRho11
pgpC,5397276,5397276,5397100,176,0,utRho11
pgrR,2783744,2783982,2783744,238,366,utRho11
pheL,5475158,5475198,5475158,40,0,utRho11
pheM,7197204,7197204,7197080,124,248,utRho11
pheP,1203858,1203918,1203858,60,90,utRho11
pheU,8725254,8725254,8725252,2,0,utRho11
pheV,6220730,6220732,6220730,2,0,utRho11
phnC,8650412,8650412,8650330,82,82,utRho11
phoA,803414,803494,803414,80,0,utRho11
phoB,834202,834284,834202,82,0,utRho11
phoE,520316,520316,520200,116,198,utRho11
phoH,2169730,2169984,2169730,254,218,utRho11
phoP,2381016,2381016,2380894,122,2808,utRho11
phoQ,2379880,2379880,2379552,328,822,utRho11
phoU,7815330,7815330,7815156,174,414,utRho11
phr,1478842,1479014,1478842,172,208,utRho11
pinE,2419054,2419370,2419054,316,214,utRho11
pinQ,3267168,3267244,3267168,76,274,utRho11
pinR,2867424,2867424,2867348,76,402,utRho11
pitA,7275224,7275284,7275224,60,0,utRho11
pitB,6272806,6272806,6272742,64,30,utRho11
pka,5439862,5439906,5439862,44,96,utRho11
plaP,4174476,4174476,4174124,352,826,utRho11
pldA,8009628,8009724,8009628,96,270,utRho11
pldB,8018028,8018340,8018028,312,1306,utRho11
plsB,8513196,8513196,8512932,264,304,utRho11
pmbA,8915890,8915918,8915890,28,156,utRho11
pmrD,4747148,4747148,4747076,72,0,utRho11
pncB,1980828,1980828,1980712,116,4,utRho11
pncC,5648788,5648788,5648692,96,0,utRho11
pnp,6622652,6622652,6622336,316,180,utRho11
pntA,3355950,3355950,3355806,144,0,utRho11
pntB,3353096,3353096,3352720,376,16,utRho11
polA,8093880,8093932,8093880,52,136,utRho11
polB,131606,131606,131560,46,0,utRho11
potD,2365700,2365700,2365658,42,8,utRho11
potE,1436688,1436688,1436530,158,0,utRho11
potF,1787268,1787568,1787268,300,396,utRho11
poxB,1822152,1822152,1822098,54,90,utRho11
ppa,8899372,8899372,8899304,68,266,utRho11
ppc,8306380,8306380,8306196,184,128,utRho11
ppdA,5928440,5928440,5928354,86,3666,utRho11
ppdD,235410,235410,235098,312,562,utRho11
pphA,3846770,3846770,3845938,832,6220,utRho11
pphB,5719474,5719520,5719474,46,204,utRho11
ppiA,6984898,6984898,6984594,304,42,utRho11
ppiC,7919682,7919682,7919626,56,6,utRho11
ppiD,923638,923830,923638,192,446,utRho11
ppk,5245748,5246088,5245748,340,650,utRho11
pppA,6228958,6228958,6228704,254,2,utRho11
ppsA,3574322,3574322,3574224,98,0,utRho11
ppsR,3574678,3574890,3574678,212,242,utRho11
pptA,3065716,3066104,3065716,388,280,utRho11
pqiA,2023318,2024002,2023318,684,152,utRho11
prc,3830054,3830054,3829632,422,20804,utRho11
preT,4467978,4468066,4467978,88,1562,utRho11
prfC,9218688,9218828,9218688,140,2096,utRho11
prkB,6968622,6968980,6968622,358,1942,utRho11
prlC,7290476,7290476,7290364,112,320,utRho11
prlF,6553944,6554004,6553944,60,1008,utRho11
proB,520432,520776,520432,344,308,utRho11
proC,811372,811372,811288,84,24,utRho11
proK,7417388,7417388,7417384,4,86,utRho11
proL,4572414,4572422,4572414,8,0,utRho11
proP,8660640,8661004,8660640,364,536,utRho11
proS,437674,437674,437550,124,560,utRho11
proV,5609126,5609630,5609126,504,106,utRho11
prpB,697292,697364,697292,72,32,utRho11
prpR,696942,696942,696886,56,0,utRho11
prs,2524354,2524354,2523750,604,53142,utRho11
psd,8781276,8781276,8780720,556,836,utRho11
psiE,8480600,8480650,8480600,50,0,utRho11
pspA,2736076,2736158,2736076,82,0,utRho11
pspF,2736080,2736080,2735824,256,0,utRho11
pspG,8525632,8525680,8525632,48,64,utRho11
pssA,5445156,5445454,5445156,298,3604,utRho11
pstB,7817112,7817112,7816732,380,28,utRho11
pstC,7821084,7821084,7820796,288,140,utRho11
pstS,23469408,23469408,23469150,258,768,utRho11
psuG,4517114,4517114,4516734,380,972,utRho11
psuT,4514992,4514992,4514670,322,124,utRho11
pth,2517084,2517084,2517026,58,88,utRho11
ptrA,5918022,5918022,5917768,254,0,utRho11
ptrB,3857730,3857730,3857678,52,5446,utRho11
ptsG,2315252,2315738,2315252,486,3394,utRho11
ptsH,5066996,5067528,5066996,532,4148,utRho11
purA,8809328,8809374,8809328,46,0,utRho11
purC,5195562,5195562,5195236,326,0,utRho11
purD,8411972,8411972,8411862,110,0,utRho11
purE,1106284,1106284,1106200,84,2732,utRho11
purH,8415254,8415254,8415064,190,72,utRho11
purL,5391178,5391178,5391086,92,590,utRho11
purM,5242306,5242394,5242306,88,0,utRho11
purR,3475378,3475688,3475378,310,372,utRho11
purT,3861438,3861762,3861438,324,280,utRho11
purU,2577512,2577512,2577248,264,552,utRho11
putA,2157850,2157850,2157764,86,0,utRho11
putP,2158336,2158610,2158336,274,610,utRho11
puuA,2721936,2721936,2721816,120,0,utRho11
puuC,2725456,2725486,2725456,30,0,utRho11
puuD,2722104,2722240,2722104,136,0,utRho11
puuP,2718746,2718746,2718374,372,582,utRho11
pykA,3874988,3875298,3874988,310,338,utRho11
pykF,3510934,3511396,3510934,462,1362,utRho11
pyrC,2245286,2245286,2245214,72,142,utRho11
pyrD,2009464,2009536,2009464,72,330,utRho11
pyrE,7631970,7631970,7631536,434,388,utRho11
pyrF,2683740,2683842,2683740,102,254,utRho11
pyrG,5819594,5819594,5819332,262,1890,utRho11
pyrH,383624,383710,383624,86,2636,utRho11
pyrL,8945490,8945490,8945066,424,14,utRho11
qmcA,1031646,1031646,1031546,100,190,utRho11
qor,8528608,8528608,8528462,146,1028,utRho11
qseB,6339502,6339656,6339502,154,190,utRho11
queA,849970,850022,849970,52,726,utRho11
queE,5811212,5811212,5810836,376,416,utRho11
queF,5850642,5850696,5850642,54,78,utRho11
queG,8788184,8788184,8788134,50,82880,utRho11
racC,2835630,2835630,2835526,104,0,utRho11
racR,2840898,2840898,2840482,416,0,utRho11
raiA,5474208,5474308,5474208,100,8,utRho11
rarD,8008594,8008594,8008356,238,606,utRho11
ravA,7862256,7862256,7862186,70,40,utRho11
rayT,495088,495274,495088,186,44,utRho11
rbn,4763162,4763216,4763162,54,2,utRho11
rbsD,7866644,7866702,7866644,58,0,utRho11
rcnA,4371654,4371834,4371654,180,10,utRho11
rcnB,4373768,4373920,4373768,152,22,utRho11
rcnR,4371806,4371806,4371592,214,20,utRho11
rcsA,4047672,4047936,4047672,264,6012,utRho11
rcsB,4631390,4632354,4631390,964,852,utRho11
rcsC,4640162,4640162,4639656,506,266,utRho11
rcsD,4626904,4626976,4626904,72,348,utRho11
rdgB,6193240,6193362,6193240,122,1010,utRho11
rdlA,2538646,2538646,2538646,0,0,utRho11
rdlB,2539712,2539716,2539712,4,158,utRho11
rdlC,2540782,2540786,2540782,4,0,utRho11
rdlD,7400272,7400272,7400272,0,0,utRho11
rdoA,8084782,8084830,8084782,48,40,utRho11
recA,11295276,11295276,11295076,200,280,utRho11
recC,5925014,5925014,5924856,158,0,utRho11
recF,7763722,7763722,7762442,1280,13066,utRho11
recN,5503518,5503590,5503518,72,48,utRho11
recQ,8011666,8011728,8011666,62,0,utRho11
relA,5828554,5828554,5827302,1252,384,utRho11
relB,3291806,3291806,3291744,62,208,utRho11
rem,3289950,3289950,3289804,146,0,utRho11
rep,7921294,7921354,7921294,60,194,utRho11
rfaD,7587730,7587974,7587730,244,172,utRho11
rfaE,6393852,6393852,6393506,346,152,utRho11
rfaH,8049930,8049930,8049642,288,2128,utRho11
rfbX,4219436,4219436,4219168,268,3540,utRho11
rfe,7935600,7935832,7935600,232,356,utRho11
rhaB,8194944,8194944,8194896,48,0,utRho11
rhaD,8188770,8188770,8188544,226,2,utRho11
rhaS,8195422,8195472,8195422,50,0,utRho11
rhaT,8201132,8201132,8201050,82,0,utRho11
rhlE,1661566,1661744,1661566,178,94,utRho11
rhoL,47593944,47594772,47593944,828,301704,utRho11
rhsB,7238006,7238384,7238006,378,382,utRho11
rhsC,1458758,1459166,1458758,408,0,utRho11
rhsD,1046132,1046522,1046132,390,0,utRho11
rhtA,1700608,1700608,1700194,414,0,utRho11
rhtC,8015478,8015514,8015478,36,1032,utRho11
ribA,2678468,2678468,2678320,148,138,utRho11
ribC,3486916,3486916,3486484,432,2116,utRho11
ribE,869008,869294,869008,286,6416,utRho11
ribF,42766,42814,42766,48,42,utRho11
ridA,8941892,8941892,8941826,66,130,utRho11
rihA,1369204,1369204,1368824,380,3144,utRho11
rihB,4510504,4510504,4510372,132,46,utRho11
rimJ,2251044,2251124,2251044,80,42,utRho11
rimK,1783752,1783934,1783752,182,316,utRho11
rimL,2997486,2997876,2997486,390,182,utRho11
rimO,1756140,1756140,1756070,70,0,utRho11
rimP,6636350,6636350,6636012,338,650,utRho11
rlmA,3814172,3814172,3814120,52,1008,utRho11
rlmD,5830086,5830086,5830000,86,26,utRho11
rlmE,6655520,6655520,6655328,192,1608,utRho11
rlmF,1684384,1684664,1684384,280,120,utRho11
rlmG,6471784,6471784,6471750,34,2,utRho11
rlmI,2060002,2060002,2059938,64,378,utRho11
rlmJ,7290700,7290770,7290700,70,88,utRho11
rlmL,2015344,2015688,2015344,344,2370,utRho11
rlpA,1330444,1330444,1330380,64,212,utRho11
rluA,120900,120900,120692,208,606,utRho11
rluF,8460324,8460708,8460324,384,112,utRho11
rmf,2031006,2031430,2031006,424,2666,utRho11
rna,1290068,1290068,1290006,62,0,utRho11
rnb,2698258,2698258,2697824,434,3874,utRho11
rnc,10816892,10816892,10816252,640,12372,utRho11
rnd,3776122,3776122,3775982,140,302,utRho11
rne,2289746,2289746,2288734,1012,9846,utRho11
rnhA,472082,472082,472004,78,396,utRho11
rnk,1288360,1288360,1287934,426,240,utRho11
rnlA,5531788,5531836,5531788,48,438,utRho11
rnlB,5533414,5533968,5533414,554,978,utRho11
rnpB,19623552,19623552,19623552,0,0,utRho11
rob,9270706,9270706,9270620,86,90,utRho11
rodZ,5285868,5285868,5285688,180,76,utRho11
rpe,7030306,7030306,7030118,188,176,utRho11
rph,15266320,15266320,15266196,124,56,utRho11
rpiA,6118706,6118706,6118650,56,458,utRho11
rpiB,8626514,8626700,8626514,186,48,utRho11
rpiR,8626274,8626274,8625982,292,0,utRho11
rplJ,8359246,8359992,8359246,746,12764,utRho11
rplK,8356708,8356894,8356708,186,918,utRho11
rplM,6757344,6757344,6757302,42,10732,utRho11
rplN,6896444,6896444,6896298,146,11052,utRho11
rplS,5489284,5489284,5489060,224,21662,utRho11
rplT,7199052,7199052,7198996,56,1876,utRho11
rplU,6667036,6667036,6666902,134,0,utRho11
rplY,4564866,4565034,4564866,168,356,utRho11
rpmA,6666450,6666450,6666238,212,1060,utRho11
rpmB,15247980,15247980,15246696,1284,166776,utRho11
rpmE,8253816,8254026,8253816,210,1164,utRho11
rpmF,2294676,2294734,2294676,58,58362,utRho11
rpmH,7768130,7768672,7768130,542,7644,utRho11
rpmI,3600854,3600854,3599998,856,15442,utRho11
rpoB,8362126,8362490,8362126,364,1188,utRho11
rpoD,6424946,6426094,6424946,1148,32998,utRho11
rpoE,5420372,5420372,5420024,348,68,utRho11
rpoH,7202006,7202006,7201566,440,8784,utRho11
rpoN,6689324,6689434,6689324,110,50,utRho11
rpoS,5736236,5736236,5735102,1134,2512,utRho11
rpoZ,7644154,7644212,7644154,58,972,utRho11
rppH,5937986,5937986,5937954,32,0,utRho11
rprA,3540744,3540744,3540744,0,0,utRho11
rpsA,1923434,1923990,1923434,556,222476,utRho11
rpsF,8850050,8850236,8850050,186,49844,utRho11
rpsI,6756580,6756580,6756414,166,12896,utRho11
rpsJ,6906884,6906884,6906540,344,15436,utRho11
rpsL,6949242,6949242,6949104,138,82,utRho11
rpsM,6885130,6885130,6884942,188,2390,utRho11
rpsO,13247144,13247144,13246736,408,3688,utRho11
rpsP,5492508,5492508,5492370,138,104,utRho11
rpsT,42420,42420,42156,264,1580,utRho11
rpsU,12842584,12843124,12842584,540,3168,utRho11
rraA,8238716,8238716,8238660,56,350,utRho11
rraB,8956768,8956946,8956768,178,16,utRho11
rrsA,8070478,8071062,8070478,584,7536,utRho11
rrsB,16665468,16666636,16665468,1168,15708,utRho11
rrsC,7883032,7883616,7883032,584,7748,utRho11
rrsD,6858094,6858094,6857524,570,490,utRho11
rrsE,8415726,8416294,8415726,568,1246,utRho11
rrsG,5462896,5462896,5462314,582,6438,utRho11
rrsH,446970,447542,446970,572,2036,utRho11
rsd,8393908,8393908,8393616,292,136,utRho11
rseA,5419264,5419264,5418808,456,0,utRho11
rseP,392940,393092,392940,152,4,utRho11
rseX,4067298,4067298,4067298,0,0,utRho11
rsfS,1338144,1338144,1338072,72,244,utRho11
rsgA,8783132,8783132,8783018,114,40,utRho11
rsmA,105176,105176,104860,316,4080,utRho11
rsmB,6869982,6870414,6869982,432,668,utRho11
rsmC,9215736,9215736,9215400,336,408,utRho11
rsmD,7208594,7208786,7208594,192,0,utRho11
rsmE,6182036,6182268,6182036,232,318,utRho11
rsmG,7847512,7847512,7847360,152,2906,utRho11
rsmH,180020,180188,180020,168,138,utRho11
rsmI,6587106,6587106,6586670,436,1098,utRho11
rssA,2578212,2578412,2578212,200,598,utRho11
rssB,2580440,2580484,2580440,44,122,utRho11
rstA,3364276,3364300,3364276,24,0,utRho11
rsuA,4561096,4561096,4560966,130,216,utRho11
rsxA,3411510,3411534,3411510,24,2,utRho11
rtcA,7114004,7114004,7113698,306,486,utRho11
rtcB,7116214,7116214,7116158,56,84,utRho11
rtn,4541356,4541452,4541356,96,6,utRho11
rutA,2148052,2148052,2148022,30,0,utRho11
rutG,2140090,2140090,2139678,412,56,utRho11
rutR,2148226,2148484,2148226,258,366,utRho11
ruvA,7784096,7784096,7783904,192,24,utRho11
ruvB,7782176,7782176,7781424,752,720,utRho11
ruvC,3894878,3894878,3894752,126,0,utRho11
rybB,1776114,1776114,1776114,0,0,utRho11
rydB,3529860,3529860,3529322,538,216,utRho11
rydC,2983012,2983012,2983012,0,0,utRho11
ryfA,5307398,5307710,5307398,312,240,utRho11
ryfD,5468590,5468590,5468590,0,0,utRho11
ryhB,7162032,7162032,7162032,0,0,utRho11
ryjA,8556132,8556132,8556132,0,0,utRho11
ryjB,9055954,9055954,9055954,0,0,utRho11
sad,3229598,3229598,3229406,192,144,utRho11
safA,3168056,3168056,3167918,138,46,utRho11
sanA,4465368,4465756,4465368,388,128,utRho11
sapF,2705314,2705314,2705268,46,160,utRho11
sbcB,4165456,4165512,4165456,56,0,utRho11
sbcC,831694,831694,831506,188,240,utRho11
sbcD,833954,833954,833904,50,0,utRho11
sbmA,793106,793278,793106,172,540,utRho11
sbmC,4162650,4162650,4162524,126,2,utRho11
sdaA,3793618,3793864,3793618,246,130,utRho11
sdaC,5856070,5856458,5856070,388,1518,utRho11
sdhC,1509916,1510354,1509916,438,43864,utRho11
sdhD,1510808,1511120,1510808,312,9736,utRho11
sdiA,3993834,3993834,3993664,170,150,utRho11
secE,8354354,8354716,8354354,362,240,utRho11
secG,6645180,6645180,6645010,170,998,utRho11
selA,7522594,7522594,7522498,96,836,utRho11
selB,7519850,7519850,7519722,128,324,utRho11
selC,7672396,7672444,7672396,48,120,utRho11
selD,3696058,3696058,3696016,42,2274,utRho11
seqA,1425884,1425974,1425884,90,300,utRho11
serA,6117098,6117098,6116820,278,566,utRho11
serB,9249712,9249790,9249712,78,284,utRho11
serC,3830380,3830612,3830380,232,0,utRho11
serS,1878730,1878856,1878730,126,2568,utRho11
serT,2063438,2063438,2063424,14,0,utRho11
serU,4087124,4087124,4087114,10,2,utRho11
serV,5637394,5637394,5637290,104,130,utRho11
serW,1852014,1852014,1851942,72,164,utRho11
serX,2195352,2195352,2195304,48,22,utRho11
setB,4527426,4527726,4527426,300,68,utRho11
setC,7673488,7673906,7673488,418,1730,utRho11
sfmA,1116124,1116424,1116124,300,0,utRho11
sfmC,1117606,1117948,1117606,342,0,utRho11
sfsA,323030,323030,322972,58,560,utRho11
sfsB,6669592,6669818,6669592,226,604,utRho11
sgrR,154676,154676,154598,78,0,utRho11
sgrS,154734,154734,154734,0,0,utRho11
shiA,4107068,4107286,4107068,218,4,utRho11
sibA,4306622,4306622,4306622,0,0,utRho11
sibB,4307292,4307292,4307292,0,0,utRho11
sibC,6113702,6113702,6113702,0,0,utRho11
sibD,6389730,6389730,6389730,0,0,utRho11
sibE,6390480,6390480,6390480,0,0,utRho11
sixA,4913998,4913998,4913624,374,0,utRho11
slp,7307872,7307922,7307872,50,0,utRho11
slt,9261400,9261466,9261400,66,0,utRho11
slyA,3442028,3442028,3441648,380,64,utRho11
slyB,3439496,3439752,3439496,256,60,utRho11
slyD,6957398,6957398,6956994,404,622,utRho11
slyX,6954862,6955280,6954862,418,8598,utRho11
smf,6867372,6867372,6867120,252,106,utRho11
smpB,5509534,5509792,5509534,258,950,utRho11
smrA,2811872,2811958,2811872,86,426,utRho11
smrB,4896872,4897212,4896872,340,248,utRho11
smtA,1946808,1947074,1946808,266,36,utRho11
sodA,8201518,8201620,8201518,102,10232,utRho11
sodB,3470646,3470756,3470646,110,464,utRho11
sodC,3449358,3449358,3449310,48,2,utRho11
sohB,2658568,2658664,2658568,96,598,utRho11
sokB,2984232,2984238,2984232,6,26,utRho11
solA,2241218,2241218,2241172,46,0,utRho11
soxR,8554894,8554938,8554894,44,0,utRho11
soxS,8554846,8554846,8554766,80,0,utRho11
speA,6172096,6172096,6171822,274,612,utRho11
speB,6167892,6167892,6167594,298,348,utRho11
speC,6218350,6218350,6218310,40,188,utRho11
spf,8099798,8099798,8099798,0,0,utRho11
sppA,3697422,3697674,3697422,252,74,utRho11
spy,3651376,3651376,3651250,126,102,utRho11
sra,3112092,3112092,3111926,166,0,utRho11
sraB,2293178,2293178,2293178,0,0,utRho11
sraC,3846132,3846132,3846132,0,0,utRho11
srlA,5651582,5651664,5651582,82,96,utRho11
srlR,5657720,5658094,5657720,374,748,utRho11
srmB,5425752,5425792,5425752,40,208,utRho11
sroA,151216,151216,151216,0,0,utRho11
sroG,6369436,6369436,6369436,0,0,utRho11
sroH,8380974,8380974,8380974,0,0,utRho11
ssb,8548022,8548250,8548022,228,170,utRho11
sseA,5304782,5304988,5304782,206,7616,utRho11
sspA,6755138,6755138,6754840,298,580,utRho11
ssrA,5511014,5511186,5511014,172,158,utRho11
ssrS,12223036,12223932,12223036,896,2232,utRho11
sstT,6479726,6479888,6479726,162,44,utRho11
ssuB,1988282,1988282,1988088,194,168,utRho11
ssuE,1995126,1995126,1995024,102,0,utRho11
sthA,8321604,8321604,8321580,24,888,utRho11
stpA,5597156,5597156,5596990,166,132,utRho11
sucA,3034344,3034824,3034344,480,3140,utRho11
sufA,3528836,3528836,3528772,64,234,utRho11
sufE,3518962,3518962,3518580,382,430,utRho11
sugE,8753588,8753750,8753588,162,2516,utRho11
sulA,2041894,2041894,2041838,56,4658,utRho11
syd,5850738,5850738,5850560,178,218,utRho11
symE,9159834,9159834,9159680,154,626,utRho11
symR,9159670,9159670,9159670,0,0,utRho11
tabA,8949566,8949724,8949566,158,0,utRho11
talA,5157140,5157332,5157140,192,0,utRho11
talB,16382,16476,16382,94,8148,utRho11
tam,3214442,3214692,3214442,250,48,utRho11
tamA,8884540,8884764,8884540,224,386,utRho11
tar,3945432,3945432,3945382,50,150,utRho11
tas,5943138,5943194,5943138,56,1600,utRho11
tatA,16087636,16087780,16087636,144,304,utRho11
tatE,1317742,1317894,1317742,152,144,utRho11
tauA,770410,770464,770410,54,56,utRho11
tdcA,6534186,6534186,6534130,56,0,utRho11
tdcG,6519652,6519652,6519298,354,268,utRho11
tdcR,6534380,6534760,6534380,380,62,utRho11
tdk,2586986,2587054,2586986,68,0,utRho11
tehA,3001072,3001146,3001072,74,0,utRho11
tesA,1039898,1039898,1039530,368,326,utRho11
tesB,950402,950402,950322,80,22,utRho11
tfaE,2418532,2418532,2418238,294,232,utRho11
tfaQ,3269912,3269912,3269770,142,346,utRho11
tff,379424,379256,379424,168,0,utRho11
tgt,852110,852274,852110,164,30,utRho11
thiD,4369346,4369346,4369032,314,4,utRho11
thiI,882936,883098,882936,162,320,utRho11
thiM,4370902,4370902,4370602,300,720,utRho11
thiQ,146170,146170,145854,316,514,utRho11
thrL,592,760,592,168,352,utRho11
thrS,7210932,7210932,7210280,652,1120,utRho11
thrU,8350762,8350776,8350762,14,8,utRho11
thrV,6847414,6847414,6847310,104,213490,utRho11
thrW,525682,525742,525682,60,2098,utRho11
thyA,5930696,5930696,5930310,386,3664,utRho11
tig,909986,910266,909986,280,1066,utRho11
tisB,7706674,7707106,7706674,432,682,utRho11
tktA,6163414,6163414,6163270,144,156,utRho11
tktB,5158616,5159272,5158616,656,802,utRho11
tldD,6784368,6784368,6784056,312,68,utRho11
tmcA,5191876,5191876,5191718,158,80,utRho11
tnaC,15553644,15553740,15553644,96,1740,utRho11
tolB,1555074,1555480,1555074,406,420,utRho11
tolC,6356008,6356230,6356008,222,438,utRho11
tomB,961588,961588,961416,172,2028,utRho11
tonB,2622108,2622178,2622108,70,0,utRho11
topA,2661578,2662096,2661578,518,82,utRho11
torC,2116112,2116168,2116112,56,38,utRho11
torR,2115968,2115968,2115908,60,70,utRho11
torS,2112364,2112364,2112356,8,0,utRho11
torT,2112414,2112522,2112414,108,0,utRho11
tpiA,8223138,8223138,8223014,124,240,utRho11
tppB,3425342,3425538,3425342,196,7350,utRho11
tpr,2574376,2574376,2574376,0,0,utRho11
tpx,2777688,2777688,2777622,66,848,utRho11
tqsA,3347780,3347826,3347780,46,194,utRho11
treA,2494850,2494850,2494752,98,1764,utRho11
treB,8932420,8932420,8932360,60,226,utRho11
treF,7339102,7339184,7339102,82,48,utRho11
treR,8934694,8934694,8934492,202,0,utRho11
trg,2984878,2984940,2984878,62,114,utRho11
trkG,2847342,2847564,2847342,222,144,utRho11
trmA,8326590,8326590,8326540,50,124,utRho11
trpA,2634678,2634678,2634444,234,1042,utRho11
trpC,2639888,2639888,2639570,318,0,utRho11
trpL,5292432,5292432,5292328,104,0,utRho11
trpR,9265408,9265520,9265408,112,208,utRho11
trpS,7027394,7027394,7027276,118,2654,utRho11
trpT,7893560,7893914,7893560,354,122216,utRho11
trxA,7931294,7931522,7931294,228,550,utRho11
trxB,1864156,1864156,1864100,56,0,utRho11
trxC,5437350,5437470,5437350,120,86,utRho11
tsaD,6421256,6421256,6421086,170,0,utRho11
tsgA,6985038,6985136,6985038,98,14,utRho11
tsr,9182824,9183314,9182824,490,356,utRho11
tsx,864490,864490,864026,464,298,utRho11
ttcA,2823970,2823970,2823896,74,3240,utRho11
ttdA,6412848,6412926,6412848,78,0,utRho11
ttdR,6412760,6412760,6412512,248,250,utRho11
tufA,6943448,6943448,6942658,790,206746,utRho11
tus,3368346,3368518,3368346,172,32,utRho11
tusA,7218040,7218040,7217992,48,168,utRho11
tusB,6950218,6950218,6949930,288,2090,utRho11
tynA,2902996,2902996,2902698,298,0,utRho11
typA,8116460,8116814,8116460,354,11388,utRho11
tyrB,8534164,8534228,8534164,64,3810,utRho11
tyrP,3979004,3979362,3979004,358,1646,utRho11
tyrR,2773384,2773440,2773384,56,64,utRho11
tyrS,3434566,3434566,3434444,122,32,utRho11
tyrT,2575330,2575330,2575244,86,10,utRho11
uacT,6062378,6062734,6062378,356,84,utRho11
ubiC,8504886,8505012,8504886,126,58,utRho11
ubiD,8049618,8049976,8049618,358,2228,utRho11
ubiE,8037494,8037710,8037494,216,88,utRho11
ubiG,4679078,4679134,4679078,56,0,utRho11
ucpA,5089342,5089342,5089246,96,0,utRho11
udp,8032782,8032862,8032782,80,40,utRho11
ugd,4199470,4199470,4199226,244,4,utRho11
ugpB,7184852,7184852,7184650,202,2154,utRho11
ugpQ,7176600,7176600,7176226,374,44,utRho11
uhpT,7694396,7694396,7694334,62,106,utRho11
uidA,3392304,3392304,3392142,162,0,utRho11
uidC,3386012,3386012,3385702,310,0,utRho11
uidR,3394150,3394150,3394104,46,0,utRho11
ulaA,8839854,8839960,8839854,106,136,utRho11
ulaG,8839350,8839350,8839250,100,88,utRho11
ulaR,8837124,8837124,8836906,218,0,utRho11
umpG,5741372,5741372,5740548,824,42,utRho11
umpH,1400704,1400704,1400652,52,0,utRho11
umuD,2461476,2461534,2461476,58,0,utRho11
ung,5433476,5433508,5433476,32,130,utRho11
uof,2843316,2843316,2842900,416,7824,utRho11
upp,5241818,5241818,5241744,74,460,utRho11
usg,4873780,4873780,4873298,482,222,utRho11
ushA,1009772,1009828,1009772,56,34,utRho11
uspA,7279966,7280222,7279966,256,672,utRho11
uspB,7279696,7279696,7279440,256,292,utRho11
uspC,3959172,3959506,3959172,334,0,utRho11
uspE,2797318,2797318,2797244,74,62,utRho11
uspF,2871282,2871282,2871238,44,0,utRho11
uspG,1283806,1283806,1283734,72,2272,utRho11
uvrA,8547872,8547872,8547742,130,42,utRho11
uvrB,1626304,1627052,1626304,748,980,utRho11
uvrC,3989758,3989758,3989412,346,296,utRho11
uvrD,7995814,7995966,7995814,152,226,utRho11
uvrY,3990812,3990812,3990718,94,166,utRho11
uxaB,3221474,3221474,3221360,114,178,utRho11
uxaC,6489714,6489714,6489482,232,0,utRho11
uxuA,9103036,9103272,9103036,236,462,utRho11
uxuR,9108916,9109152,9108916,236,0,utRho11
valS,8967854,8967854,8967674,180,970,utRho11
valU,5041848,5041862,5041848,14,4,utRho11
valV,3492830,3492870,3492830,40,40,utRho11
ves,3649968,3649968,3649874,94,90,utRho11
waaA,7616512,7617080,7616512,568,292,utRho11
waaH,7580298,7580298,7580162,136,108,utRho11
waaQ,7616476,7616476,7616196,280,208,utRho11
waaU,7598996,7598996,7598624,372,150,utRho11
waaY,7602272,7602272,7601930,342,7392,utRho11
wbbH,4214888,4214888,4214452,436,4134,utRho11
wbbK,4209212,4209212,4209018,194,96,utRho11
wcaM,4231868,4231868,4231792,76,0,utRho11
wrbA,2135516,2135516,2135416,100,16,utRho11
wza,4275166,4275166,4274486,680,0,utRho11
wzxC,4240674,4240674,4240316,358,0,utRho11
wzzB,4196950,4196950,4196602,348,196,utRho11
xanP,7657642,7657890,7657642,248,0,utRho11
xanQ,6048520,6048702,6048520,182,20,utRho11
xapA,5049820,5049820,5049756,64,2,utRho11
xapR,10090252,10090252,10089908,344,0,utRho11
xdhA,6000514,6000690,6000514,176,242,utRho11
xerD,6079702,6079702,6079486,216,254,utRho11
xseA,5268394,5268464,5268394,70,208,utRho11
xseB,882746,882746,882686,60,212,utRho11
xthA,3664798,3664856,3664798,58,0,utRho11
xylA,7461614,7461614,7461530,84,1766,utRho11
xylE,8484540,8484540,8484508,32,0,utRho11
xylF,7462138,7462262,7462138,124,202,utRho11
xylR,7469812,7469958,7469812,146,38,utRho11
yaaA,13230,13230,12918,312,328,utRho11
yaaI,23876,23876,23572,304,856,utRho11
yaaJ,16034,16034,15918,116,0,utRho11
yaaU,91184,91614,91184,430,0,utRho11
yaaW,23084,23084,22712,372,146,utRho11
yaaX,10060,10468,10060,408,16,utRho11
yabI,142542,142702,142542,160,166,utRho11
yacC,273880,273880,273834,46,1040,utRho11
yacH,262932,262932,262520,412,36,utRho11
yacL,268678,268776,268678,98,594,utRho11
yadD,293796,293936,293796,140,62,utRho11
yadE,289930,290162,289930,232,1292,utRho11
yadN,314110,314110,313766,344,502,utRho11
yadS,355572,355572,355248,324,2000,utRho11
yadV,312470,312470,312402,68,86,utRho11
yaeF,434270,434270,434006,264,0,utRho11
yaeP,428374,428374,428250,124,602,utRho11
yaeQ,428176,428582,428176,406,982,utRho11
yaeR,423716,423754,423716,38,34,utRho11
yafC,462166,462166,461762,404,38,utRho11
yafD,462128,462244,462128,116,102,utRho11
yafK,491986,491986,491610,376,2538,utRho11
yafL,493282,493424,493282,142,0,utRho11
yafN,503938,504010,503938,72,26,utRho11
yafS,469568,469632,469568,64,1234,utRho11
yafT,474470,474670,474470,200,0,utRho11
yafV,480432,480432,480378,54,26,utRho11
yafZ,536052,536052,536010,42,114,utRho11
yagE,564446,564556,564446,110,0,utRho11
yagG,570414,570790,570414,376,74,utRho11
yagI,578384,578384,578324,60,44,utRho11
yagK,586236,586236,585896,340,354,utRho11
yagL,588062,588062,587836,226,488,utRho11
yagN,591342,591342,591158,184,276,utRho11
yahA,663746,664742,663746,996,2480,utRho11
yahC,670136,670136,670044,92,766,utRho11
yahE,671478,671850,671478,372,170,utRho11
yahM,690504,690808,690504,304,394,utRho11
yahN,692872,692872,692674,198,218,utRho11
yahO,692864,692968,692864,104,72,utRho11
yaiE,816296,816354,816296,58,76,utRho11
yaiI,811396,811528,811396,132,54,utRho11
yaiO,761946,761946,761684,262,68,utRho11
yaiP,767970,767970,767870,100,0,utRho11
yaiS,769660,769660,769232,428,0,utRho11
yaiV,788922,788922,788922,0,0,utRho11
yaiY,799094,799094,798666,428,374,utRho11
yaiZ,798888,799186,798888,298,1734,utRho11
yajC,854410,854574,854410,164,706,utRho11
yajD,860938,861210,860938,272,760,utRho11
yajI,866068,866068,865702,366,252,utRho11
yajL,887496,887496,887282,214,308,utRho11
yajQ,889316,889366,889316,50,136,utRho11
yajR,893374,893374,893332,42,662,utRho11
ybaB,987418,988152,987418,734,4496,utRho11
ybaL,1006590,1006590,1006476,114,56,utRho11
ybaM,980648,980648,980542,106,1536,utRho11
ybaN,981436,981764,981436,328,164,utRho11
ybaO,936704,936766,936704,62,0,utRho11
ybaP,1016568,1016568,1016160,408,1178,utRho11
ybaQ,1016348,1016436,1016348,88,174,utRho11
ybaS,1023146,1023282,1023146,136,90,utRho11
ybaV,927504,927874,927504,370,94,utRho11
ybaY,950490,950758,950490,268,68,utRho11
ybbB,1062724,1062724,1062452,272,2,utRho11
ybbJ,1030154,1030154,1029718,436,940,utRho11
ybbL,1031784,1031838,1031784,54,0,utRho11
ybbN,1037136,1037136,1036558,578,1878,utRho11
ybbO,1038658,1038658,1038298,360,1634,utRho11
ybbY,1080718,1081130,1080718,412,352,utRho11
ybcH,1176140,1176140,1175962,178,66,utRho11
ybcI,1113264,1113264,1113106,158,3466,utRho11
ybcJ,1114050,1114050,1113746,304,150,utRho11
ybcK,1137502,1137804,1137502,302,34,utRho11
ybcL,1141690,1141786,1141690,96,0,utRho11
ybcN,1144628,1144932,1144628,304,36,utRho11
ybcQ,1147548,1147912,1147548,364,524,utRho11
ybcW,1159610,1159760,1159610,150,0,utRho11
ybdD,1263982,1264364,1263982,382,594,utRho11
ybdF,1212106,1212106,1211772,334,100,utRho11
ybdH,1267048,1267048,1266954,94,2,utRho11
ybdJ,1212822,1212822,1212398,424,0,utRho11
ybdK,1215122,1215122,1214766,356,2610,utRho11
ybdL,1267114,1267172,1267114,58,2,utRho11
ybdM,1271110,1271110,1270752,358,726,utRho11
ybdN,1273372,1273372,1273138,234,0,utRho11
ybdR,1283844,1284176,1283844,332,2808,utRho11
ybeD,1325412,1325412,1325284,128,102,utRho11
ybeF,1323090,1323090,1322756,334,1292,utRho11
ybeL,1349986,1350036,1349986,50,2,utRho11
ybeQ,1353412,1353412,1353094,318,76,utRho11
ybeR,1353120,1353422,1353120,302,76,utRho11
ybeT,1358832,1358832,1358812,20,0,utRho11
ybeU,1358924,1359016,1358924,92,0,utRho11
ybeZ,1386938,1386938,1386834,104,11416,utRho11
ybfA,1458074,1458268,1458074,194,6,utRho11
ybfE,1423878,1423878,1423796,82,520,utRho11
ybfF,1425692,1425692,1425604,88,508,utRho11
ybfH,1433282,1433282,1433194,88,0,utRho11
ybgA,1477840,1478002,1477840,162,0,utRho11
ybgC,1549288,1549504,1549288,216,104,utRho11
ybgD,1505916,1505916,1505590,326,8470,utRho11
ybgI,1485238,1485654,1485238,416,0,utRho11
ybgO,1498370,1498370,1497964,406,98,utRho11
ybgS,1570992,1570992,1570634,358,80,utRho11
ybhA,1597184,1597184,1596862,322,102,utRho11
ybhB,1616070,1616070,1615818,252,142,utRho11
ybhC,1614642,1614642,1614562,80,1322,utRho11
ybhD,1601418,1601418,1601276,142,32,utRho11
ybhH,1601104,1601518,1601104,414,64,utRho11
ybhK,1633384,1633384,1633294,90,0,utRho11
ybhM,1641556,1641586,1641556,30,0,utRho11
ybhN,1645296,1645296,1644996,300,72,utRho11
ybhQ,1649202,1649260,1649202,58,324,utRho11
ybiA,1665920,1665920,1665900,20,34,utRho11
ybiI,1676968,1676968,1676912,56,354,utRho11
ybiO,1691328,1691328,1690960,368,686,utRho11
ybiP,1705252,1705252,1705194,58,1184,utRho11
ybiS,1711572,1711572,1711488,84,600,utRho11
ybiT,1711894,1711926,1711894,32,22,utRho11
ybiU,1718212,1718212,1718122,90,36,utRho11
ybiV,1720176,1720176,1720056,120,0,utRho11
ybiW,1725566,1725566,1725212,354,2222,utRho11
ybiX,1678548,1678548,1678414,134,184,utRho11
ybjC,1781784,1781826,1781784,42,8,utRho11
ybjE,1830154,1830154,1829714,440,0,utRho11
ybjG,1767016,1767016,1766776,240,2406,utRho11
ybjL,1779882,1779882,1779638,244,124,utRho11
ybjM,1779770,1780178,1779770,408,494,utRho11
ybjO,1795704,1795978,1795704,274,0,utRho11
ybjP,1809046,1809046,1808934,112,0,utRho11
ybjQ,1809034,1809186,1809034,152,0,utRho11
ybjS,1813796,1813796,1813506,290,188,utRho11
ybjX,1838206,1838206,1838168,38,0,utRho11
ycaD,1891438,1891742,1891438,304,0,utRho11
ycaI,1928210,1928640,1928210,430,350,utRho11
ycaK,1899094,1899336,1899094,242,66,utRho11
ycaL,1920264,1920528,1920264,264,56,utRho11
ycaM,1894240,1894458,1894240,218,110,utRho11
ycaR,1941284,1941346,1941284,62,4258,utRho11
ycbB,1961862,1962094,1961862,232,48,utRho11
ycbJ,1943344,1943504,1943344,160,130,utRho11
ycbK,1966046,1966150,1966046,104,332,utRho11
ycbZ,2036920,2036920,2036598,322,160,utRho11
yccA,2062886,2062886,2062836,50,140,utRho11
yccF,2048730,2048730,2048696,34,0,utRho11
yccS,2047988,2047988,2047766,222,68,utRho11
yccT,2055674,2055674,2055546,128,128,utRho11
yccX,2059960,2060128,2059960,168,1222,utRho11
ycdT,2185682,2185752,2185682,70,2,utRho11
ycdU,2191266,2191686,2191266,420,144,utRho11
ycdZ,2200504,2200592,2200504,88,138,utRho11
yceA,2233544,2233614,2233544,70,74,utRho11
yceD,2293298,2293588,2293298,290,7574,utRho11
yceF,2293522,2293522,2293190,332,4510,utRho11
yceH,2252154,2252314,2252154,160,1134,utRho11
yceI,2237282,2237282,2236952,330,512,utRho11
yceJ,2238142,2238142,2238092,50,402,utRho11
yceM,2253208,2253612,2253208,404,260,utRho11
yceO,2239264,2239264,2238894,370,420,utRho11
yceQ,2288760,2289004,2288760,244,8308,utRho11
ycfD,2376540,2376540,2376480,60,164,utRho11
ycfJ,2334814,2335198,2334814,384,202,utRho11
ycfS,2340834,2340834,2340748,86,0,utRho11
ycfT,2350658,2350658,2350330,328,0,utRho11
ycfZ,2362760,2362760,2362534,226,1348,utRho11
ycgB,2474570,2474570,2474482,88,150,utRho11
ycgG,2434614,2434656,2434614,42,410,utRho11
ycgJ,2452956,2453200,2452956,244,150,utRho11
ycgL,2455218,2455362,2455218,144,0,utRho11
ycgN,2457366,2457660,2457366,294,294,utRho11
ycgR,2489112,2489112,2489054,58,52,utRho11
ycgV,2512222,2512222,2511904,318,1464,utRho11
ycgX,2426568,2426568,2426214,354,31158,utRho11
ycgY,2490166,2490320,2490166,154,864,utRho11
ycgZ,2431504,2431578,2431504,74,156,utRho11
ychE,2596904,2597196,2596904,292,36,utRho11
ychF,2515764,2515764,2515624,140,0,utRho11
ychH,2517476,2517582,2517476,106,1576,utRho11
ychJ,2578354,2578354,2578264,90,0,utRho11
ychN,2547310,2547310,2547198,112,34,utRho11
ychO,2547520,2547850,2547520,330,94,utRho11
ychQ,2533798,2533848,2533798,50,50,utRho11
yciA,2624828,2624828,2624492,336,106,utRho11
yciB,2626110,2626110,2625780,330,2996,utRho11
yciC,2627396,2627396,2627326,70,94,utRho11
yciE,2630794,2630794,2630448,346,126,utRho11
yciG,5264368,5264368,5264140,228,0,utRho11
yciI,2621784,2621784,2621730,54,46,utRho11
yciN,2661606,2661606,2661336,270,54,utRho11
yciS,2680270,2680486,2680270,216,96,utRho11
yciT,2689088,2689088,2688692,396,1224,utRho11
yciU,2614718,2614718,2614300,418,3032,utRho11
yciV,2646376,2646440,2646376,64,0,utRho11
yciW,2700472,2700472,2700214,258,3116,utRho11
yciZ,2689276,2689276,2689218,58,922,utRho11
ycjD,2703792,2703792,2703520,272,130,utRho11
ycjG,2777748,2777860,2777748,112,200,utRho11
ycjM,2740006,2740432,2740006,426,612,utRho11
ycjW,2767982,2767982,2767922,60,62,utRho11
ycjX,2768138,2768234,2768138,96,0,utRho11
ycjY,5568288,5568288,5567460,828,1108,utRho11
ydaE,2836438,2836438,2836016,422,462,utRho11
ydaN,2816048,2816100,2816048,52,92,utRho11
ydaS,2840340,2840730,2840340,390,18,utRho11
ydbC,2948376,2948442,2948376,66,0,utRho11
ydbD,2950132,2950288,2950132,156,0,utRho11
ydbH,2885800,2886102,2885800,302,2,utRho11
ydbJ,2881712,2882116,2881712,404,80,utRho11
ydbK,2881692,2881692,2881568,124,40,utRho11
ydcA,2983294,2983354,2983294,60,96,utRho11
ydcF,2974404,2974470,2974404,66,48,utRho11
ydcI,2990268,2990268,2990142,126,32,utRho11
ydcJ,2990266,2990576,2990266,310,92,utRho11
ydcK,3001280,3001280,3000898,382,18,utRho11
ydcL,3004646,3004914,3004646,268,0,utRho11
ydcN,3012308,3012344,3012308,36,362,utRho11
ydcP,3013508,3013562,3013508,54,24,utRho11
ydcR,3019956,3020006,3019956,50,0,utRho11
ydcS,3022906,3023308,3022906,402,126,utRho11
ydcX,3034442,3034778,3034442,336,658,utRho11
ydcY,3035220,3035296,3035220,76,60,utRho11
ydcZ,3036750,3036750,3036662,88,920,utRho11
yddB,3155332,3155332,3155238,94,0,utRho11
yddE,3071738,3071738,3071716,22,0,utRho11
yddG,3094410,3094410,3094338,72,32,utRho11
yddJ,3089732,3089732,3089438,294,0,utRho11
yddW,3137704,3137704,3137646,58,26,utRho11
ydeA,3233910,3234056,3233910,146,314,utRho11
ydeE,3242528,3242664,3242528,136,0,utRho11
ydeI,3249118,3249118,3248994,124,60,utRho11
ydeJ,3249376,3249546,3249376,170,0,utRho11
ydeN,3165458,3165458,3165048,410,0,utRho11
ydeP,3173328,3173328,3172972,356,0,utRho11
ydeR,3176596,3176596,3176592,4,2,utRho11
ydfA,3296872,3297016,3296872,144,2,utRho11
ydfG,3254982,3255034,3254982,52,0,utRho11
ydfH,3256652,3256704,3256652,52,150,utRho11
ydfK,3265446,3266144,3265446,698,17872,utRho11
ydgA,3379588,3379704,3379588,116,30,utRho11
ydgC,3364124,3364124,3364060,64,0,utRho11
ydgD,3343906,3343920,3343906,14,120,utRho11
ydgH,3356754,3356854,3356754,100,4,utRho11
ydgJ,3408798,3408798,3408616,182,170,utRho11
ydgK,3410414,3410500,3410414,86,840,utRho11
ydhB,3479618,3479618,3479596,22,66,utRho11
ydhC,3479698,3479822,3479698,124,0,utRho11
ydhF,3451310,3451310,3451264,46,0,utRho11
ydhI,3441996,3442050,3441996,54,0,utRho11
ydhL,3451864,3451864,3451840,24,44,utRho11
ydhQ,3492404,3492404,3492254,150,58,utRho11
ydhS,3494136,3494262,3494136,126,2264,utRho11
ydhT,3499138,3499138,3499118,20,28,utRho11
ydhY,3509284,3509284,3508954,330,46,utRho11
ydhZ,3510418,3510418,3510282,136,20,utRho11
ydiE,3579206,3579226,3579206,20,0,utRho11
ydiH,3530582,3530582,3530406,176,0,utRho11
ydiM,3541852,3542142,3541852,290,0,utRho11
ydiN,3544818,3545024,3544818,206,0,utRho11
ydiP,3558656,3558656,3558602,54,104,utRho11
ydiU,3582508,3582508,3582488,20,178,utRho11
ydiV,3584174,3584174,3584040,134,522,utRho11
ydiY,3612500,3612500,3612166,334,38,utRho11
ydjA,3697400,3697400,3697352,48,72,utRho11
ydjE,3708082,3708082,3707958,124,0,utRho11
ydjF,3709848,3709848,3709708,140,64,utRho11
ydjM,3620340,3620422,3620340,82,0,utRho11
ydjO,3626696,3626696,3626288,408,32,utRho11
ydjX,3666434,3666802,3666434,368,2980,utRho11
yeaE,3731448,3731448,3731272,176,24,utRho11
yeaG,3733530,3733816,3733530,286,0,utRho11
yeaI,3740486,3740770,3740486,284,0,utRho11
yeaJ,3743874,3744082,3743874,208,52,utRho11
yeaL,3748646,3748704,3748646,58,364,utRho11
yeaM,3751296,3751296,3751152,144,0,utRho11
yeaN,3750926,3751346,3750926,420,0,utRho11
yeaO,3753554,3753818,3753554,264,72,utRho11
yeaP,3755314,3755430,3755314,116,604,utRho11
yeaQ,3758780,3758780,3758510,270,818,utRho11
yeaR,3759988,3759988,3759896,92,192,utRho11
yeaY,3781122,3781122,3781064,58,0,utRho11
yebB,3892220,3892502,3892220,282,1052,utRho11
yebC,3896370,3896370,3896302,68,6,utRho11
yebE,3859464,3859464,3859414,50,276,utRho11
yebG,3861530,3861530,3861494,36,76,utRho11
yebK,3873180,3873304,3873180,124,28,utRho11
yebQ,3820314,3820552,3820314,238,126,utRho11
yebS,3832238,3832516,3832238,278,34,utRho11
yebV,3843430,3843560,3843430,130,0,utRho11
yebW,3843914,3844242,3843914,328,1748,utRho11
yecC,3995646,3995646,3995628,18,0,utRho11
yecD,3901272,3901664,3901272,392,48,utRho11
yecF,3991434,3991636,3991434,202,144,utRho11
yecH,3979304,3979304,3978980,324,2134,utRho11
yecJ,3975604,3975604,3975516,88,0,utRho11
yecM,3919968,3919968,3919692,276,176,utRho11
yecR,3976400,3976444,3976400,44,60,utRho11
yecT,3923862,3923944,3923862,82,36,utRho11
yedD,4016522,4016522,4016180,342,352,utRho11
yedE,4016310,4016554,4016310,244,118,utRho11
yedI,4058922,4058922,4058732,190,100,utRho11
yedJ,4066446,4066446,4066158,288,84,utRho11
yedV,4076404,4076404,4076304,100,140,utRho11
yedX,4077680,4077912,4077680,232,0,utRho11
yedY,4078572,4078956,4078572,384,60,utRho11
yeeA,4161322,4161322,4161182,140,2,utRho11
yeeE,4171104,4171104,4171050,54,30,utRho11
yeeJ,4089526,4089822,4089526,296,4964,utRho11
yeeN,4113508,4113716,4113508,208,1204,utRho11
yeeO,4119444,4119444,4119692,248,2,utRho11
yeeX,4158834,4158834,4158722,112,260,utRho11
yeeZ,4178422,4178422,4178256,166,16,utRho11
yefM,4179466,4179466,4179426,40,0,utRho11
yegD,4295288,4295348,4295288,60,0,utRho11
yegH,4275726,4275804,4275726,78,200,utRho11
yegI,4302154,4302154,4301970,184,0,utRho11
yegJ,4302032,4302370,4302032,338,48,utRho11
yegQ,4331182,4331336,4331182,154,132,utRho11
yegR,4336698,4336698,4336612,86,422,utRho11
yegS,4337086,4337424,4337086,338,146,utRho11
yegT,4357562,4357642,4357562,80,132,utRho11
yegX,4367640,4367640,4367302,338,146,utRho11
yehA,4376944,4376944,4376828,116,0,utRho11
yehE,4385818,4385818,4385592,226,34,utRho11
yehK,4407568,4407944,4407568,376,2,utRho11
yehL,4408804,4409192,4408804,388,48,utRho11
yeiB,4486146,4486146,4485934,212,120,utRho11
yeiE,4499422,4499422,4499236,186,2,utRho11
yeiG,4487776,4487820,4487776,44,478,utRho11
yeiH,4499332,4499434,4499332,102,62,utRho11
yeiI,4503306,4503400,4503306,94,110,utRho11
yeiL,4510580,4510710,4510580,130,0,utRho11
yeiP,4530834,4530900,4530834,66,690,utRho11
yeiQ,4532328,4532490,4532328,162,856,utRho11
yeiR,4535484,4535658,4535484,174,162,utRho11
yeiW,4530840,4530840,4530590,250,814,utRho11
yejA,4544624,4544728,4544624,104,0,utRho11
yejG,4556892,4556892,4556474,418,7178,utRho11
yejH,4561244,4561264,4561244,20,0,utRho11
yejK,4568218,4568218,4567894,324,44,utRho11
yejO,4578352,4578352,4577800,552,190,utRho11
yfaD,4713380,4713808,4713380,428,1618,utRho11
yfaE,4696676,4697028,4696676,352,1008,utRho11
yfaL,4688568,4688568,4688338,230,0,utRho11
yfaP,4656398,4656398,4656286,112,14,utRho11
yfaU,4717892,4717892,4717690,202,0,utRho11
yfaY,4727310,4727310,4727266,44,62,utRho11
yfaZ,4728744,4728744,4728550,194,154,utRho11
yfbK,4771810,4771810,4771444,366,462,utRho11
yfbL,4771500,4771720,4771500,220,434,utRho11
yfbN,4777174,4777174,4776852,322,54,utRho11
yfbO,4776916,4777162,4776916,246,54,utRho11
yfbP,4777990,4778232,4777990,242,8774,utRho11
yfbR,4817662,4817724,4817662,62,98,utRho11
yfcI,4847424,4847424,4847078,346,1222,utRho11
yfcJ,4880482,4880482,4880240,242,864,utRho11
yfcL,4888502,4888502,4888338,164,120,utRho11
yfcV,4911642,4911642,4911292,350,2,utRho11
yfcZ,4921958,4921958,4921868,90,70,utRho11
yfdF,4925604,4926024,4925604,420,17692,utRho11
yfdG,4935474,4935710,4935474,236,52,utRho11
yfdP,4946844,4947040,4946844,196,50,utRho11
yfdX,4988866,4988866,4988804,62,0,utRho11
yfdY,4990672,4990672,4990584,88,60,utRho11
yfeA,5035784,5035784,5035664,120,36982,utRho11
yfeC,5036668,5036934,5036668,266,184,utRho11
yfeH,5053818,5053892,5053818,74,202,utRho11
yfeK,5074630,5074684,5074630,54,40,utRho11
yfeO,5018906,5019260,5018906,354,352,utRho11
yfeR,5054078,5054078,5053712,366,240,utRho11
yfeX,5101356,5101356,5101090,266,0,utRho11
yfeY,5102486,5102486,5102432,54,64,utRho11
yfeZ,5103842,5103842,5103452,390,0,utRho11
yffO,5123804,5124222,5123804,418,12,utRho11
yffQ,5126778,5127154,5126778,376,244,utRho11
yffS,5128800,5128986,5128800,186,86,utRho11
yfgC,5232052,5232188,5232052,136,0,utRho11
yfgF,5258062,5258062,5257876,186,544,utRho11
yfgG,5258170,5258580,5258170,410,1038,utRho11
yfgH,5259344,5259584,5259344,240,74,utRho11
yfgM,5278866,5278866,5278566,300,622,utRho11
yfhH,5397414,5397518,5397414,104,0,utRho11
yfhM,5304648,5304648,5304574,74,0,utRho11
yfhR,5328408,5328726,5328408,318,13192,utRho11
yfiC,5425610,5425610,5425528,82,2,utRho11
yfiE,5430688,5430688,5430640,48,938,utRho11
yfiL,5482630,5482720,5482630,90,0,utRho11
yfiM,5448066,5448358,5448066,292,23582,utRho11
yfiR,5483354,5483750,5483354,396,326,utRho11
yfjH,5517326,5517326,5517200,126,0,utRho11
yfjI,5517710,5517970,5517710,260,64,utRho11
yfjJ,5521014,5521094,5521014,80,0,utRho11
yfjM,5531970,5531970,5531552,418,3872,utRho11
yfjP,5535080,5535420,5535080,340,1272,utRho11
yfjW,5546570,5546636,5546570,66,0,utRho11
yfjX,5551776,5551838,5551776,62,0,utRho11
ygaC,5601180,5601180,5599988,1192,642,utRho11
ygaM,5600242,5600292,5600242,50,144,utRho11
ygaU,5593628,5593628,5593572,56,66,utRho11
ygaZ,5619190,5619234,5619190,44,274,utRho11
ygbA,5713656,5713656,5713612,44,46,utRho11
ygbE,5746784,5746784,5746674,110,94,utRho11
ygbI,5722882,5722882,5722528,354,12,utRho11
ygbK,5724394,5724670,5724394,276,324,utRho11
ygbL,5727074,5727186,5727074,112,70,utRho11
ygbN,5729814,5730202,5729814,388,188,utRho11
ygcG,5811210,5811422,5811210,212,40,utRho11
ygcN,5785144,5785314,5785144,170,188,utRho11
ygcU,5799214,5799214,5798836,378,98,utRho11
ygcW,5800942,5800942,5800546,396,2,utRho11
ygdD,5883442,5883442,5883262,180,160,utRho11
ygdG,5861746,5861930,5861746,184,254,utRho11
ygdI,5886526,5886526,5886290,236,448,utRho11
ygdQ,5940784,5940840,5940784,56,0,utRho11
ygdR,5942494,5942542,5942494,48,2,utRho11
ygeA,5961606,5961606,5961270,336,78,utRho11
ygeH,5983758,5984188,5983758,430,104,utRho11
ygeI,5987162,5987276,5987162,114,532,utRho11
ygeR,6000078,6000078,5999782,296,732,utRho11
ygeV,6011694,6011694,6011572,122,116,utRho11
ygeW,6012234,6012524,6012234,290,276,utRho11
ygfB,6110946,6110946,6110888,58,98,utRho11
ygfK,6031984,6032120,6031984,136,26,utRho11
ygfS,6058328,6058328,6058024,304,2,utRho11
ygfZ,6082564,6082626,6082564,62,422,utRho11
yggC,6149512,6149512,6149378,134,190,utRho11
yggE,6136370,6136370,6136160,210,192,utRho11
yggI,6179176,6179510,6179176,334,478,utRho11
yggL,6204508,6204508,6204266,242,228,utRho11
yggM,6199514,6199514,6199130,384,392,utRho11
yggN,6203596,6203596,6203246,350,100,utRho11
yggX,18623958,18624558,18623958,600,0,utRho11
yghA,6298966,6299324,6298966,358,42,utRho11
yghB,6307058,6307126,6307058,68,2,utRho11
yghD,6222614,6222614,6222252,362,1012,utRho11
yghF,6225798,6225798,6225840,42,248,utRho11
yghJ,6238640,6238640,6238224,416,0,utRho11
yghQ,6265186,6265186,6264816,370,98,utRho11
yghT,6267830,6268262,6267830,432,300,utRho11
yghU,6277400,6277454,6277400,54,78,utRho11
yghW,6293506,6293506,6293474,32,68,utRho11
yghZ,6295562,6295794,6295562,232,176,utRho11
ygiD,6365122,6365122,6364868,254,6260,utRho11
ygiH,6409066,6409388,6409066,322,0,utRho11
ygiL,6370622,6370828,6370622,206,82,utRho11
ygiM,6402084,6402414,6402084,330,108,utRho11
ygiN,6346156,6346284,6346156,128,694,utRho11
ygiQ,6322620,6322620,6322292,328,1308,utRho11
ygiS,6335462,6335462,6335436,26,70,utRho11
ygiV,6338582,6338582,6338462,120,14,utRho11
ygiW,6339774,6339774,6339352,422,528,utRho11
ygiZ,6344506,6344506,6344422,84,66,utRho11
ygjH,6442528,6442528,6442494,34,0,utRho11
ygjI,6452140,6452468,6452140,328,10,utRho11
ygjQ,6472730,6473080,6472730,350,304,utRho11
ygjR,6474564,6474586,6474564,22,0,utRho11
ygjV,6483638,6483638,6483488,150,0,utRho11
yhaB,6535632,6535708,6535632,76,18,utRho11
yhaH,6504498,6504608,6504498,110,252,utRho11
yhaI,6505400,6505822,6505400,422,250,utRho11
yhaJ,6508560,6508560,6508428,132,204,utRho11
yhaK,6508538,6508638,6508538,100,204,utRho11
yhbQ,6599878,6599932,6599878,54,520,utRho11
yhbT,6602736,6602736,6602552,184,126,utRho11
yhbU,6602558,6602970,6602558,412,126,utRho11
yhbX,6643302,6643302,6643226,76,0,utRho11
yhbY,6655518,6655580,6655518,62,1328,utRho11
yhcA,6723956,6724224,6723956,268,2,utRho11
yhcB,6760364,6760382,6760364,18,0,utRho11
yhcC,6708470,6708470,6708100,370,778,utRho11
yhcF,6733440,6733852,6733440,412,718,utRho11
yhcH,6739124,6739124,6738956,168,296,utRho11
yhcM,6760312,6760312,6759994,318,180,utRho11
yhcN,6770812,6771076,6770812,264,800,utRho11
yhcO,6772606,6772606,6772258,348,0,utRho11
yhdH,6806560,6806968,6806560,408,0,utRho11
yhdJ,6823234,6823306,6823234,72,0,utRho11
yhdN,6879092,6879092,6879018,74,3694,utRho11
yhdT,6814702,6814750,6814702,48,626,utRho11
yhdU,6824994,6825242,6824994,248,370,utRho11
yhdV,6836392,6836780,6836392,388,352,utRho11
yhdW,6837944,6838298,6837944,354,0,utRho11
yheO,6953082,6953082,6952880,202,748,utRho11
yheV,6957970,6957970,6957584,386,130,utRho11
yhfA,6971902,6971902,6971636,266,1042,utRho11
yhfG,6983294,6983294,6983240,54,786,utRho11
yhfL,6998622,6998896,6998622,274,210,utRho11
yhfY,7023244,7023244,7022844,400,56,utRho11
yhgA,7086294,7086334,7086294,40,0,utRho11
yhgE,7065176,7065176,7064878,298,176,utRho11
yhgF,7074352,7074770,7074352,418,5138,utRho11
yhhA,7173458,7173886,7173458,428,166,utRho11
yhhI,7248346,7248756,7248346,410,36,utRho11
yhhJ,7253696,7253696,7253606,90,190,utRho11
yhhM,7211588,7211588,7211220,368,304,utRho11
yhhN,7211150,7211502,7211150,352,340,utRho11
yhhQ,7218238,7218434,7218238,196,972,utRho11
yhhT,7223682,7223730,7223682,48,12,utRho11
yhhX,7162032,7162032,7161610,422,0,utRho11
yhhY,7162222,7162276,7162222,54,0,utRho11
yhhZ,7163516,7163726,7163516,210,158,utRho11
yhiD,7312220,7312220,7311804,416,3440,utRho11
yhiJ,7265190,7265190,7265180,10,2,utRho11
yhiM,7269270,7269682,7269270,412,1138,utRho11
yhiN,7275000,7275000,7274820,180,130,utRho11
yhjA,7338522,7338522,7338376,146,0,utRho11
yhjB,7344090,7344090,7343788,302,320,utRho11
yhjC,7344272,7344684,7344272,412,36,utRho11
yhjD,7346660,7346724,7346660,64,0,utRho11
yhjE,7349274,7349572,7349274,298,744,utRho11
yhjG,7356824,7356824,7356730,94,120,utRho11
yhjH,7358458,7358458,7358374,84,302,utRho11
yhjJ,7364032,7364032,7363880,152,406,utRho11
yhjK,7371296,7371296,7371158,138,36,utRho11
yhjR,7392750,7392750,7392370,380,0,utRho11
yhjV,7400796,7401126,7400796,330,2206,utRho11
yhjX,7424194,7424194,7424014,180,28,utRho11
yhjY,7425966,7425966,7425868,98,0,utRho11
yiaB,7455654,7455654,7455496,158,88,utRho11
yiaD,7432712,7433094,7432712,382,220,utRho11
yiaF,7438194,7438194,7438088,106,124,utRho11
yiaG,7438862,7438956,7438862,94,82,utRho11
yiaJ,7485236,7485236,7485064,172,208,utRho11
yiaK,7485348,7485466,7485348,118,92,utRho11
yiaT,7503924,7503924,7503736,188,0,utRho11
yiaU,7503792,7503984,7503792,192,0,utRho11
yiaY,7515856,7515856,7515654,202,4,utRho11
yibF,7523950,7523950,7523910,40,92,utRho11
yibG,7536128,7536354,7536128,226,2,utRho11
yibL,7553194,7553330,7553194,136,70,utRho11
yibN,7570112,7570112,7570030,82,174,utRho11
yibT,7552848,7552848,7552760,88,896,utRho11
yicC,7633290,7633352,7633290,62,116,utRho11
yicH,7660862,7660914,7660862,52,0,utRho11
yicJ,7673328,7673328,7671858,1470,12554,utRho11
yicN,7685018,7685018,7684804,214,0,utRho11
yicO,7687914,7687914,7687578,336,0,utRho11
yicR,15250308,15250308,15250236,72,0,utRho11
yidB,7755230,7755230,7754930,300,88,utRho11
yidE,7732780,7732780,7732546,234,84,utRho11
yidF,7711580,7711580,7711222,358,152,utRho11
yidQ,7735088,7735456,7735088,368,920,utRho11
yidR,7738824,7738824,7738618,206,150,utRho11
yieE,7787658,7787738,7787658,80,8,utRho11
yieH,7793314,7793548,7793314,234,168,utRho11
yieK,7798928,7798928,7798786,142,4,utRho11
yifB,7900350,7900350,7899998,352,436,utRho11
yifL,7988984,7989044,7988984,60,3790,utRho11
yigF,8005750,8005750,8005598,152,8146,utRho11
yigI,8009448,8009448,8009394,54,4,utRho11
yigM,8022100,8022152,8022100,52,258,utRho11
yihA,8101970,8101970,8101458,512,62,utRho11
yihD,8084098,8084138,8084098,40,0,utRho11
yihF,8088110,8088398,8088110,288,134,utRho11
yihG,8093304,8093304,8093204,100,64,utRho11
yihI,8102616,8102694,8102616,78,0,utRho11
yihL,8120506,8120894,8120506,388,244,utRho11
yihN,8124332,8124494,8124332,162,2,utRho11
yihO,8131942,8131942,8131532,410,44,utRho11
yihQ,8138892,8138892,8138552,340,0,utRho11
yihV,8147064,8147478,8147064,414,126,utRho11
yihX,8151096,8151106,8151096,10,54,utRho11
yiiE,8158192,8158582,8158192,390,248,utRho11
yiiF,8159124,8159502,8159124,378,838,utRho11
yiiG,8173762,8174004,8173762,242,0,utRho11
yiiM,8205506,8205644,8205506,138,1152,utRho11
yiiQ,8224624,8224624,8224428,196,124,utRho11
yiiS,8225738,8225934,8225738,196,238,utRho11
yijE,8272178,8272216,8272178,38,76,utRho11
yijF,8275728,8275728,8275314,414,814,utRho11
yijO,8296858,8296858,8296634,224,136,utRho11
yjaA,8426240,8426468,8426240,228,120246,utRho11
yjaB,8428312,8428312,8428246,66,410,utRho11
yjaG,8398746,8399008,8398746,262,1590,utRho11
yjaH,8401022,8401132,8401022,110,360,utRho11
yjaZ,8379506,8379572,8379506,66,0,utRho11
yjbB,8455204,8455462,8455204,258,0,utRho11
yjbE,16943432,16943624,16943432,192,664,utRho11
yjbL,8520318,8520642,8520318,324,70,utRho11
yjbQ,8540428,8540476,8540428,48,190,utRho11
yjcB,8550328,8550328,8550082,246,234,utRho11
yjcC,8550836,8550942,8550836,106,132,utRho11
yjcD,8556628,8556958,8556628,330,96,utRho11
yjcE,8559658,8559960,8559658,302,0,utRho11
yjcF,8566212,8566212,8566150,62,0,utRho11
yjcO,8594660,8594660,8594250,410,14,utRho11
yjdA,8654128,8654270,8654128,142,0,utRho11
yjdC,8726660,8726660,8726616,44,10,utRho11
yjdK,8704780,8705168,8704780,388,378,utRho11
yjdL,8713034,8713034,8712822,212,0,utRho11
yjdM,8653672,8653672,8653468,204,220,utRho11
yjeF,8787354,8788132,8787354,778,138078,utRho11
yjeI,8745522,8745618,8745522,96,82,utRho11
yjeJ,8748806,8748806,8748468,338,764,utRho11
yjeV,8785472,8785784,8785472,312,5100,utRho11
yjfP,8833512,8833904,8833512,392,46,utRho11
yjfY,8849656,8849656,8849582,74,22,utRho11
yjfZ,8855052,8855052,8854844,208,512,utRho11
yjgA,8916162,8916162,8915730,432,386,utRho11
yjgL,8950802,8950874,8950802,72,0,utRho11
yjgM,8959342,8959342,8959074,268,460,utRho11
yjgN,8959132,8959460,8959132,328,176,utRho11
yjgR,8980170,8980170,8980126,44,78,utRho11
yjgZ,9002116,9002520,9002116,404,4704,utRho11
yjhB,9007764,9008116,9007764,352,332,utRho11
yjhG,9048452,9048452,9048188,264,1518,utRho11
yjhU,9041080,9041080,9040648,432,534,utRho11
yjiA,9178096,9178096,9177730,366,46,utRho11
yjiJ,9125364,9125364,9125350,14,0,utRho11
yjiK,9127270,9127270,9127422,152,294,utRho11
yjiL,9129604,9129604,9129378,226,0,utRho11
yjiS,9143410,9143502,9143410,92,108,utRho11
yjiY,9182734,9182734,9182558,176,212,utRho11
yjjA,9200674,9200674,9200378,296,262,utRho11
yjjB,18408708,18408708,18407800,908,608,utRho11
yjjJ,9243314,9243538,9243314,224,0,utRho11
yjjK,9261132,9261132,9261044,88,164,utRho11
yjjL,9189764,9189764,9189444,320,208,utRho11
yjjM,9191894,9191894,9191702,192,156,utRho11
yjjP,9206068,9206068,9205716,352,5348,utRho11
yjjQ,9206638,9206954,9206638,316,7128,utRho11
yjjX,9267798,9267798,9267490,308,2080,utRho11
yjjY,9280716,9280804,9280716,88,282,utRho11
yjjZ,9211554,9211608,9211554,54,100674,utRho11
yjtD,9281676,9281884,9281676,208,168,utRho11
ykfB,532454,532454,532174,280,4950,utRho11
ykfI,527636,527636,527338,298,1078,utRho11
ykgB,637050,637050,636638,412,4,utRho11
ykgC,640430,640430,640002,428,64,utRho11
ykgD,640232,640454,640232,222,68,utRho11
ykgE,642962,643216,642962,254,296,utRho11
ykgJ,608524,608524,608364,160,66,utRho11
ykgL,623878,624224,623878,346,228,utRho11
ykgM,625610,625610,625554,56,0,utRho11
ykgR,626570,626570,626484,86,0,utRho11
ylaC,958576,958576,958502,74,3374,utRho11
yliE,1745938,1745958,1745938,20,0,utRho11
ymcE,2103660,2103694,2103660,34,2,utRho11
ymdA,2210450,2210828,2210450,378,184,utRho11
ymdB,2211428,2211640,2211428,212,56,utRho11
ymfD,2395322,2395322,2395064,258,1476,utRho11
ymfI,2402880,2402994,2402880,114,0,utRho11
ymfJ,2404518,2404518,2404168,350,82,utRho11
ymfK,2406176,2406176,2405866,310,120,utRho11
ymfT,2405766,2406048,2405766,282,148,utRho11
ymgE,2489110,2489456,2489110,346,1122,utRho11
ymgF,2437628,2437966,2437628,338,8,utRho11
ymiA,2670112,2670320,2670112,208,130,utRho11
ymjA,2715620,2715620,2715336,284,456,utRho11
ynaI,2791946,2791946,2791844,102,60,utRho11
ynaK,2850438,2850754,2850438,316,0,utRho11
ynbA,2954924,2955242,2954924,318,0,utRho11
yncD,3046552,3046552,3046130,422,106,utRho11
yncE,3046454,3046614,3046454,160,0,utRho11
yncG,3052456,3052494,3052456,38,10,utRho11
yncL,3034492,3034492,3034388,104,184,utRho11
yneE,3218364,3218364,3218044,320,0,utRho11
yneF,3223748,3223748,3223708,40,4,utRho11
yneJ,3229560,3229608,3229560,48,108,utRho11
yneK,3231100,3231526,3231100,426,0,utRho11
yneM,3245176,3245292,3245176,116,1014,utRho11
ynfA,3311398,3311398,3311346,52,0,utRho11
ynfB,3311418,3311616,3311418,198,696,utRho11
ynfC,3315094,3315094,3314914,180,40,utRho11
ynfD,3314828,3315130,3314828,302,40,utRho11
ynfE,3316006,3316138,3316006,132,170,utRho11
ynfK,3334670,3334670,3334438,232,34,utRho11
ynfL,3339304,3339304,3339184,120,0,utRho11
ynfM,3339260,3339398,3339260,138,0,utRho11
ynfN,3276598,3276598,3276218,380,120,utRho11
ynfO,3273454,3273512,3273454,58,76,utRho11
ynhG,3517890,3517890,3517450,440,168,utRho11
yniA,3615158,3615592,3615158,434,348,utRho11
yniB,3618526,3618526,3618466,60,100,utRho11
yniC,3618652,3618760,3618652,108,0,utRho11
yniD,3610202,3610330,3610202,128,502,utRho11
ynjE,3678880,3678934,3678880,54,24,utRho11
ynjF,3683222,3683222,3682806,416,78,utRho11
ynjH,3684376,3684376,3684270,106,74,utRho11
ynjI,3690022,3690022,3689742,280,96,utRho11
yoaB,3786642,3786734,3786642,92,110,utRho11
yoaC,3787932,3788146,3787932,214,676,utRho11
yoaE,3803544,3803544,3803170,374,196,utRho11
yoaF,3755444,3755444,3755064,380,850,utRho11
yoaH,3789866,3789866,3789462,404,722,utRho11
yobB,3850418,3850880,3850418,462,888,utRho11
yobF,3815586,3815586,3815182,404,578,utRho11
yobH,3817800,3817850,3817800,50,1200,utRho11
yodB,4084352,4084736,4084352,384,1582,utRho11
yodC,4057008,4057008,4056740,268,196,utRho11
yohC,4451358,4451358,4451262,96,20,utRho11
yohD,4451526,4451602,4451526,76,0,utRho11
yohJ,4460986,4461248,4460986,262,160,utRho11
yohO,4431172,4431314,4431172,142,0,utRho11
yojI,4617282,4617282,4617230,52,2,utRho11
ypdI,4988988,4989396,4988988,408,0,utRho11
ypfG,5165786,5165786,5165554,232,16,utRho11
ypfM,5182140,5182140,5181732,408,276,utRho11
yphB,5349590,5349590,5349376,214,34,utRho11
ypjA,5565644,5565644,5565452,192,36,utRho11
ypjB,5569636,5569636,5568858,778,4,utRho11
ypjD,5495860,5495774,5495860,86,0,utRho11
yqaE,5594170,5594170,5594056,114,14,utRho11
yqcA,5846100,5846100,5845968,132,140,utRho11
yqcE,5800944,5801184,5800944,240,0,utRho11
yqeC,6030468,6030468,6030114,354,78,utRho11
yqeF,5971618,5971618,5971184,434,10,utRho11
yqeG,5971438,5971694,5971438,256,140,utRho11
yqeH,5975016,5975072,5975016,56,164,utRho11
yqeI,5976688,5977004,5976688,316,36,utRho11
yqeK,5981140,5981140,5980720,420,992,utRho11
yqfA,6086728,6086728,6086296,432,770,utRho11
yqgA,6219042,6219106,6219042,64,2,utRho11
yqgB,6172500,6172500,6172102,398,5296,utRho11
yqgE,6185768,6185874,6185768,106,964,utRho11
yqhA,6299150,6299150,6298942,208,6,utRho11
yqhC,6310768,6310768,6310436,332,20,utRho11
yqhD,6310604,6310710,6310604,106,18,utRho11
yqhH,6316842,6317254,6316842,412,1624,utRho11
yqiC,6369662,6369680,6369662,18,2,utRho11
yqiJ,6384108,6384416,6384108,308,700,utRho11
yqjA,6495096,6495546,6495096,450,5216,utRho11
yqjF,6500932,6501124,6500932,192,662,utRho11
yqjG,6501948,6502048,6501948,100,0,utRho11
yqjH,6433078,6433078,6432982,96,0,utRho11
yqjI,6433506,6433558,6433506,52,0,utRho11
yraH,6574552,6574852,6574552,300,66,utRho11
yraP,6592144,6592818,6592144,674,1104,utRho11
yraQ,6596414,6596414,6596276,138,2,utRho11
yraR,6598024,6598024,6597692,332,160,utRho11
yrbG,13360844,13361100,13360844,256,0,utRho11
yrbL,6696842,6696904,6696842,62,1054,utRho11
yrbN,6616172,6616172,6615866,306,14604,utRho11
yrdB,6860176,6860176,6860046,130,168,utRho11
yrfF,7052548,7052938,7052548,390,614,utRho11
yrhB,7169440,7169518,7169440,78,0,utRho11
ysaB,7451804,7451804,7451424,380,0,utRho11
ysgA,8032686,8032686,8032338,348,80,utRho11
ytfB,8857638,8857638,8857434,204,542,utRho11
ytfE,8864018,8864018,8863966,52,6,utRho11
ytfF,8866296,8866296,8866130,166,96,utRho11
ytfH,8868164,8868226,8868164,62,274,utRho11
ytfI,8875234,8875414,8875234,180,166,utRho11
ytfJ,8878572,8878572,8878524,48,120,utRho11
ytfK,8879022,8879174,8879022,152,454,utRho11
ytfL,8882642,8882642,8882430,212,352,utRho11
ytfQ,8899634,8899924,8899634,290,408,utRho11
ytjB,9249598,9249598,9249578,20,150,utRho11
yzfA,8896588,8896588,8896490,98,18,utRho11
zapA,6111102,6111224,6111102,122,2648,utRho11
zapB,8236772,8237030,8236772,258,582,utRho11
zapC,2011700,2011904,2011700,204,18,utRho11
zinT,4082692,4082750,4082692,58,346,utRho11
zipA,5062814,5062814,5062466,348,164,utRho11
zitB,1569716,1569716,1569646,70,106,utRho11
zntA,7212844,7212902,7212844,58,84,utRho11
zntR,6878336,6878336,6878260,76,142,utRho11
znuA,3885322,3885322,3885166,156,0,utRho11
znuC,3885268,3885324,3885268,56,0,utRho11
zraP,8403424,8403424,8403376,48,90,utRho11
zraS,8403810,8403852,8403810,42,0,utRho11
zupT,6364866,6365100,6364866,234,6234,utRho11
zur,8520282,8520282,8520006,276,300,utRho11
zwf,3872752,3872752,3872628,124,20,utRho11
C0343,2818676,2818728,2818676,52,4,utRho12
aaeB,6776526,6776526,6776376,150,0,utRho12
aaeR,6778762,6779040,6778762,278,326,utRho12
aaeX,6778860,6778860,6778674,186,464,utRho12
aat,1854920,1854920,1854864,56,0,utRho12
accA,416822,417242,416822,420,2394,utRho12
accB,6810280,6810872,6810280,592,8722,utRho12
accD,4868030,4868030,4867852,178,594,utRho12
aceB,8430804,8430956,8430804,152,186,utRho12
aceE,245938,246034,245938,96,190,utRho12
ackA,4826918,4826940,4826918,22,960,utRho12
acnA,2670848,2671662,2670848,814,862,utRho12
acnB,263038,263230,263038,192,868,utRho12
acpP,2303148,2303230,2303148,82,414,utRho12
acpS,5402324,5402324,5401996,328,422,utRho12
acrA,971396,971396,971238,158,134,utRho12
acrB,969370,969370,968806,564,1682,utRho12
acrD,5174950,5175190,5174950,240,50,utRho12
acrE,6827404,6827728,6827404,324,362,utRho12
acrR,971398,971522,971398,124,48,utRho12
acrZ,1589502,1589546,1589502,44,22,utRho12
acs,8575190,8575190,8574742,448,242,utRho12
actP,8569870,8569870,8569804,66,0,utRho12
ada,4620854,4620854,4620810,44,80,utRho12
add,3404404,3404466,3404404,62,28,utRho12
ade,7687802,7687928,7687802,126,126,utRho12
adhE,2596826,2596826,2596242,584,2,utRho12
adhP,3107988,3107988,3107676,312,852,utRho12
adiA,8681112,8681112,8681042,70,20,utRho12
adiC,8674404,8674404,8674062,342,0,utRho12
adiY,8676084,8676084,8675858,226,0,utRho12
adk,994278,994350,994278,72,724,utRho12
adrA,807374,807406,807374,32,0,utRho12
aer,6438240,6438240,6438152,88,204,utRho12
aes,1000102,1000102,999946,156,330,utRho12
agaR,6557406,6557406,6557330,76,0,utRho12
agaS,6563778,6563952,6563778,174,0,utRho12
agp,2131118,2131170,2131118,52,0,utRho12
agrA,7296126,7296126,7296126,0,0,utRho12
agrB,7296588,7296588,7296588,0,0,utRho12
ahpC,1277386,1277890,1277386,504,650,utRho12
ahpF,1278004,1279506,1278004,1502,45570,utRho12
ahr,8992698,8992698,8992418,280,28,utRho12
aidB,8828494,8828550,8828494,56,0,utRho12
ais,4731512,4731512,4731240,272,0,utRho12
alaA,4814816,4815122,4814816,306,52,utRho12
alaC,4996798,4996798,4996590,208,28,utRho12
alaE,5598140,5598328,5598140,188,146,utRho12
alaS,5644180,5644180,5644022,158,2106,utRho12
alaW,5036612,5036612,5036462,150,12,utRho12
aldA,2976380,2976464,2976380,84,228,utRho12
aldB,7513070,7513070,7513022,48,192,utRho12
alkA,4295118,4295118,4295080,38,0,utRho12
alkB,4618890,4618890,4618682,208,0,utRho12
allA,1064780,1064902,1064780,122,0,utRho12
allD,1092822,1092822,1092726,96,0,utRho12
allE,1088112,1088112,1088092,20,26,utRho12
allS,1064600,1064600,1064442,158,14,utRho12
alr,8531178,8531564,8531178,386,1798,utRho12
alsE,8617334,8617334,8616956,378,0,utRho12
alsK,8615990,8615990,8615598,392,152,utRho12
alx,6476740,6477160,6476740,420,0,utRho12
amiA,5104482,5104704,5104482,222,0,utRho12
amiC,5898378,5898378,5898020,358,444,utRho12
amn,4110062,4110122,4110062,60,0,utRho12
ampC,8758006,8758006,8757888,118,0,utRho12
ampD,237362,237466,237362,104,210,utRho12
ampG,907372,907372,907090,282,282,utRho12
ampH,792726,792726,792574,152,0,utRho12
amyA,4012230,4012312,4012230,82,64,utRho12
anmK,3439346,3439346,3439204,142,44,utRho12
ansB,6201580,6201580,6201456,124,4,utRho12
ansP,3052040,3052040,3051960,80,152,utRho12
apaG,104068,104068,103212,856,4672,utRho12
apaH,102586,102586,102444,142,6470,utRho12
apbE,4623188,4623188,4623068,120,0,utRho12
appA,2081198,2081234,2081198,36,0,utRho12
appC,2075420,2075480,2075420,60,0,utRho12
appY,1167134,1167362,1167134,228,0,utRho12
apt,982620,982824,982620,204,84,utRho12
aqpZ,1832424,1832424,1832094,330,130,utRho12
araB,140150,140150,140096,54,0,utRho12
araC,140482,140774,140482,292,240,utRho12
araE,5964416,5964416,5964364,52,0,utRho12
araF,3972476,3972476,3972256,220,140,utRho12
araH,3967120,3967120,3967086,34,28,utRho12
araJ,825058,825058,824962,96,94,utRho12
arcA,9281602,9281602,9280612,990,3270,utRho12
arcB,6706098,6706098,6706050,48,132,utRho12
arcZ,6701154,6701154,6701154,0,0,utRho12
arfA,6877346,6877346,6877298,48,784,utRho12
argA,5898312,5898484,5898312,172,212,utRho12
argC,8309770,8310002,8309770,232,0,utRho12
argD,6980442,6980442,6980360,82,0,utRho12
argE,8310156,8310156,8309694,462,0,utRho12
argF,580680,580680,580610,70,0,utRho12
argG,6637124,6637274,6637124,150,336,utRho12
argI,8956688,8956688,8956622,66,0,utRho12
argO,6137672,6137672,6137616,56,498,utRho12
argP,6119460,6119506,6119460,46,38,utRho12
argR,6769204,6769406,6769204,202,86,utRho12
argS,3920002,3920124,3920002,122,0,utRho12
argT,4855698,4855698,4855582,116,326,utRho12
argU,1129406,1129446,1129406,40,0,utRho12
argW,4932616,4932618,4932616,2,0,utRho12
argX,7964728,7964750,7964728,22,26,utRho12
aroF,5482402,5482402,5482300,102,86,utRho12
aroG,1571182,1571266,1571182,84,454,utRho12
aroH,3576636,3576870,3576636,234,346,utRho12
aroK,7038760,7038760,7038128,632,1684,utRho12
aroL,812560,812810,812560,250,328,utRho12
aroP,243342,243342,243102,240,48,utRho12
arpA,8445382,8445382,8444974,408,154,utRho12
arrS,7316108,7316108,7316108,0,0,utRho12
arsR,7297024,7297056,7297024,32,216,utRho12
artJ,1801252,1801252,1801150,102,0,utRho12
artP,1807686,1807686,1807468,218,214,utRho12
ascF,5678858,5679048,5678858,190,0,utRho12
ascG,5678574,5678574,5678528,46,0,utRho12
aslB,7965562,7965916,7965562,354,25358,utRho12
asnA,7854258,7854310,7854258,52,294,utRho12
asnB,1398444,1398444,1398354,90,510,utRho12
asnC,23562186,23562186,23562018,168,312,utRho12
asnS,1978088,1978088,1977970,118,6032,utRho12
asnT,4089082,4089098,4089082,16,304,utRho12
asnU,4119690,4119702,4119690,12,0,utRho12
asnV,4124504,4124520,4124504,16,72,utRho12
aspA,17473728,17473728,17473308,420,232,utRho12
aspC,1971486,1971486,1971418,68,1410,utRho12
aspS,3901402,3901402,3901044,358,236,utRho12
aspT,7893560,7893744,7893560,184,121404,utRho12
aspV,473826,473862,473826,36,66,utRho12
asr,3342654,3342752,3342654,98,56,utRho12
astC,3664088,3664088,3663964,124,0,utRho12
astE,3654138,3654138,3653846,292,0,utRho12
atoD,4646824,4646894,4646824,70,72,utRho12
atpB,7844540,7844540,7844102,438,496,utRho12
atpC,7832118,7832118,7831944,174,1730,utRho12
atpI,7845050,7845050,7844880,170,0,utRho12
avtA,7479348,7479410,7479348,62,386,utRho12
azoR,2965982,2965982,2965720,262,142,utRho12
azuC,3976002,3976002,3975918,84,44,utRho12
bacA,6408350,6408350,6408262,88,214,utRho12
bamA,394052,395856,394052,1804,594,utRho12
bamB,5277950,5277950,5277304,646,914,utRho12
bamC,5198028,5198028,5197730,298,634,utRho12
bamD,5471922,5472292,5471922,370,8702,utRho12
bamE,5506972,5507210,5506972,238,150,utRho12
basS,8666954,8666954,8666544,410,768,utRho12
bax,7474468,7474468,7474354,114,48,utRho12
bcp,5200874,5200956,5200874,82,1206,utRho12
bcsB,7385346,7385346,7385214,132,0,utRho12
bcsE,7392644,7392916,7392644,272,70,utRho12
bdcA,8948128,8948128,8948106,22,140,utRho12
bdcR,8948192,8948248,8948192,56,0,utRho12
bdm,3112680,3112680,3112560,120,0,utRho12
betA,654522,654522,654494,28,574,utRho12
betI,658722,658722,658668,54,0,utRho12
betT,658842,658926,658842,84,50,utRho12
bfr,6933498,6933498,6933450,48,0,utRho12
bglG,23440182,23440182,23439402,780,492,utRho12
bglX,4444240,4444240,4443978,262,0,utRho12
bhsA,2337962,2338146,2337962,184,50,utRho12
bioA,1618584,1618584,1618514,70,0,utRho12
bioB,1618604,1618688,1618604,84,0,utRho12
bioH,7089716,7089716,7089688,28,0,utRho12
bisC,7433026,7433026,7432788,238,200,utRho12
blc,8755490,8755490,8755444,46,64,utRho12
blr,3409024,3409102,3409024,78,126,utRho12
bluF,2431226,2431226,2430950,276,358,utRho12
bluR,2428226,2428226,2428118,108,2,utRho12
bolA,908698,908944,908698,246,0,utRho12
borD,1157842,1157842,1157786,56,0,utRho12
brnQ,838976,839182,838976,206,788,utRho12
bssR,1756492,1756496,1756492,4,0,utRho12
bssS,2242116,2242116,2241910,206,218,utRho12
btuB,8326798,8327278,8326798,480,3096,utRho12
cadB,8720212,8720212,8720062,150,90,utRho12
cadC,8723926,8723926,8723868,58,22,utRho12
caiE,70998,70998,70742,256,0,utRho12
caiF,68436,68600,68436,164,46,utRho12
caiT,84074,84074,83862,212,0,utRho12
can,285406,285406,285340,66,148,utRho12
carA,59102,59302,59102,200,0,utRho12
carB,61550,61634,61550,84,208,utRho12
cas2,5757830,5757830,5757706,124,134,utRho12
casA,5768638,5768638,5768276,362,16,utRho12
cbl,4121882,4121882,4121828,54,1688,utRho12
cbpA,2128074,2128074,2127550,524,150,utRho12
cbrA,7738628,7738754,7738628,126,38,utRho12
cbrB,7794958,7795012,7794958,54,48,utRho12
ccmH,4585242,4585242,4584820,422,50,utRho12
cdaR,364894,364926,364894,32,0,utRho12
cdd,4463638,4463688,4463638,50,114,utRho12
cdh,8219814,8219860,8219814,46,266,utRho12
cdsA,391110,391354,391110,244,1856,utRho12
cedA,3627484,3627484,3627326,158,76,utRho12
cfa,3482402,3482826,3482402,424,344,utRho12
chaC,2544844,2544972,2544844,128,118,utRho12
chbB,3643452,3643452,3643238,214,0,utRho12
chbG,3634624,3634624,3634270,354,0,utRho12
cheW,3946924,3946924,3946678,246,1974,utRho12
chiA,6939792,6939792,6939706,86,0,utRho12
chiP,1416472,1416668,1416472,196,0,utRho12
cho,3646984,3647030,3646984,46,0,utRho12
chpS,8896804,8896894,8896804,90,254,utRho12
cirA,4493884,4493884,4493538,346,74,utRho12
citC,1304078,1304078,1303712,366,36,utRho12
citT,1293264,1293264,1293160,104,0,utRho12
clcA,350104,350214,350104,110,0,utRho12
clpA,1846160,1846528,1846160,368,108,utRho12
clpB,5468410,5468410,5468346,64,0,utRho12
clpP,913154,913354,913154,200,1014,utRho12
clpS,1845500,1845826,1845500,326,152,utRho12
clpX,914404,914852,914404,448,782,utRho12
clsA,2617346,2617346,2617290,56,260,utRho12
clsC,2212584,2212710,2212584,126,454,utRho12
cmk,1922330,1922402,1922330,72,0,utRho12
cnu,3409522,3409898,3409522,376,1302,utRho12
coaA,8350214,8350214,8350052,162,850,utRho12
cobC,1340092,1340092,1339814,278,90,utRho12
cobT,4129202,4129202,4128934,268,44,utRho12
cobU,4131944,4131944,4131528,416,174,utRho12
codB,709768,709844,709768,76,16,utRho12
comR,2337726,2337726,2337664,62,0,utRho12
copA,1022822,1022822,1022758,64,32,utRho12
corA,8002388,8002852,8002388,464,13142,utRho12
cpdB,8873258,8873258,8873130,128,388,utRho12
cptB,6082198,6082198,6082140,58,56,utRho12
cpxA,8210202,8210202,8209950,252,322,utRho12
cpxP,8211570,8211640,8211570,70,134,utRho12
cpxR,8211372,8211372,8211340,32,88,utRho12
cra,175894,176056,175894,162,0,utRho12
crcB,1316016,1316016,1315876,140,486,utRho12
creA,9270486,9271042,9270486,556,174,utRho12
creD,9276320,9276356,9276320,36,172,utRho12
crl,515620,515658,515620,38,1558,utRho12
crp,6971906,6972240,6971906,334,3414,utRho12
crr,5070960,5071668,5070960,708,2912,utRho12
csdA,5886414,5886674,5886414,260,260,utRho12
csgB,2207718,2207902,2207718,184,0,utRho12
csgD,2206688,2206688,2206392,296,152,utRho12
csgG,2203510,2203510,2203368,142,264,utRho12
csiD,5577854,5577970,5577854,116,28,utRho12
csiE,5330802,5330870,5330802,68,124,utRho12
csiR,5590942,5591348,5590942,406,0,utRho12
cspA,7439778,7440098,7439778,320,93494,utRho12
cspB,3283430,3283430,3283108,322,196,utRho12
cspC,3815018,3815018,3814870,148,506,utRho12
cspD,1845352,1845352,1845180,172,1182,utRho12
cspE,1314294,1314584,1314294,290,128,utRho12
cspF,3283380,3283710,3283380,330,60,utRho12
cspG,2102610,2102922,2102610,312,3880,utRho12
cspH,2102746,2102746,2102350,396,242,utRho12
cspI,3277624,3277624,3277334,290,56,utRho12
csrA,5638746,5638746,5638292,454,1148,utRho12
csrB,5849048,5849048,5849048,0,0,utRho12
csrC,8102072,8102072,8102072,0,0,utRho12
csrD,6806850,6806850,6806664,186,88,utRho12
cstA,1259710,1259788,1259710,78,0,utRho12
cueO,274090,274166,274090,76,0,utRho12
cueR,1027948,1027986,1027948,38,98,utRho12
curA,3037784,3038054,3037784,270,220,utRho12
cusC,1191146,1191200,1191146,54,56,utRho12
cusR,1190924,1190924,1190886,38,0,utRho12
cutA,8730784,8730784,8730712,72,356,utRho12
cutC,3918534,3918534,3917920,614,78,utRho12
cvpA,4861600,4861600,4861526,74,24,utRho12
cvrA,2484328,2484328,2484142,186,84,utRho12
cyaA,7981548,7982306,7981548,758,786,utRho12
cyaR,4334228,4334224,4334228,4,0,utRho12
cyaY,7988166,7988166,7988118,48,244,utRho12
cybB,2981522,2981804,2981522,282,386,utRho12
cycA,8859560,8859728,8859560,168,848,utRho12
cydA,1542340,1542916,1542340,576,98,utRho12
cydC,1858800,1858800,1858390,410,4,utRho12
cydD,1862062,1862062,1861924,138,0,utRho12
cydX,1548300,1548392,1548300,92,284,utRho12
cynR,717418,717418,717380,38,0,utRho12
cynT,1435092,1435196,1435092,104,112,utRho12
cyoA,903306,903306,903220,86,3440,utRho12
cyoE,895540,895540,895410,130,958,utRho12
cysB,2667576,2667710,2667576,134,104,utRho12
cysC,5748056,5748056,5747984,72,20,utRho12
cysD,5752736,5752736,5752658,78,0,utRho12
cysE,7565362,7565362,7565124,238,466,utRho12
cysG,6995508,6995656,6995508,148,198,utRho12
cysJ,5783928,5783928,5783796,132,1492,utRho12
cysK,5064688,5064818,5064688,130,12,utRho12
cysP,5087114,5087114,5087056,58,312,utRho12
cysS,1109154,1109222,1109154,68,58,utRho12
cysT,3984100,3984100,3983974,126,212,utRho12
cysZ,5062766,5062926,5062766,160,140,utRho12
cytR,8249018,8249018,8248912,106,26,utRho12
dacA,1328002,1328002,1327926,76,302,utRho12
dacB,6657714,6657926,6657714,212,70,utRho12
dacC,1761306,1761454,1761306,148,202,utRho12
dadA,2475018,2475142,2475018,124,0,utRho12
dam,7032504,7032504,7031826,678,1434,utRho12
damX,7035200,7035200,7034612,588,392,utRho12
dapA,5199568,5199568,5199520,48,0,utRho12
dapB,56576,56748,56576,172,128,utRho12
dapD,371954,371954,371894,60,160,utRho12
dapE,5183120,5183214,5183120,94,780,utRho12
dcp,3254844,3254844,3254760,84,2,utRho12
dcrB,7219534,7219910,7219534,376,52,utRho12
dctA,7366996,7366996,7366894,102,346,utRho12
dcuA,8733686,8733686,8733546,140,0,utRho12
dcuB,8698182,8698182,8697488,694,2078,utRho12
dcuC,1312166,1312166,1311936,230,256,utRho12
dcuD,6749166,6749738,6749166,572,76,utRho12
dcuR,8701130,8701130,8700068,1062,758,utRho12
dcuS,8703370,8703370,8703324,46,106,utRho12
dcyD,3999016,3999016,3998960,56,0,utRho12
ddpX,3126498,3126498,3126152,346,10,utRho12
deaD,6615818,6615818,6615720,98,5348,utRho12
dedA,4869880,4869880,4869482,398,9496,utRho12
dedD,4863750,4863750,4863368,382,100,utRho12
def,6867300,6867380,6867300,80,58,utRho12
degP,361690,361768,361690,78,0,utRho12
degQ,6761308,6761486,6761308,178,4528,utRho12
deoB,9239134,9239206,9239134,72,54,utRho12
deoC,9233358,9234646,9233358,1288,220,utRho12
dfp,7625406,7625462,7625406,56,4,utRho12
dgcZ,3247758,3247758,3247700,58,0,utRho12
dgkA,8512914,8513274,8512914,360,416,utRho12
dgt,358392,358474,358392,82,104,utRho12
dhaK,2501888,2501888,2501676,212,158,utRho12
dhaR,2502006,2502132,2502006,126,38,utRho12
dicB,3299194,3299218,3299194,24,0,utRho12
dicC,3295752,3295752,3295700,52,0,utRho12
dinB,501760,501796,501760,36,0,utRho12
dinD,7635398,7635520,7635398,122,206,utRho12
dinG,1666146,1666140,1666146,6,0,utRho12
dinI,2243018,2243018,2242974,44,202,utRho12
dinJ,493230,493230,493004,226,76,utRho12
dinQ,7295964,7295964,7295576,388,1448,utRho12
djlA,114536,114728,114536,192,0,utRho12
dkgA,6313142,6313246,6313142,104,38,utRho12
dkgB,458196,458334,458196,138,234,utRho12
dksA,321502,321502,321208,294,542,utRho12
dld,4444164,4444370,4444164,206,0,utRho12
dmlA,3763424,3763824,3763424,400,114,utRho12
dmlR,3763710,3763710,3763618,92,14,utRho12
dmsA,1881646,1881918,1881646,272,0,utRho12
dnaA,7767922,7767922,7767458,464,1160,utRho12
dnaB,8528566,8528628,8528566,62,316,utRho12
dnaK,24096,24326,24096,230,1258,utRho12
dnaN,7765466,7765466,7764642,824,1284,utRho12
dnaQ,471868,472134,471868,266,1118,utRho12
dnaT,18406460,18406460,18406068,392,836,utRho12
dnaX,984112,984184,984112,72,716,utRho12
dosP,3131486,3131486,3131466,20,8,utRho12
dpiB,1303968,1304470,1303968,502,156,utRho12
dppA,7415740,7415740,7415410,330,3150,utRho12
dps,1697900,1697900,1697822,78,0,utRho12
dsbA,8086754,8086836,8086754,82,1938,utRho12
dsbB,2466294,2466294,2466060,234,0,utRho12
dsbC,6079266,6079266,6077644,1622,1782,utRho12
dsbG,1277600,1277600,1277146,454,136,utRho12
dsdA,4958242,4958404,4958242,162,120,utRho12
dsdC,4955492,4955492,4955258,234,2,utRho12
dsdX,4955642,4955694,4955642,52,2,utRho12
dsrA,4050626,4050626,4050626,0,0,utRho12
dsrB,4049686,4049686,4049646,40,484,utRho12
dtpD,1485340,1485340,1485112,228,166,utRho12
dusA,8523200,8523338,8523200,138,2696,utRho12
dusB,6820492,6820560,6820492,68,216,utRho12
dusC,4460790,4460790,4460770,20,0,utRho12
dut,7627704,7627864,7627704,160,1418,utRho12
dxr,386670,387042,386670,372,942,utRho12
ebgA,6445102,6445266,6445102,164,54,utRho12
ebgR,6442874,6442932,6442874,58,52,utRho12
ecnB,8753018,8753106,8753018,88,694,utRho12
eco,4607594,4607810,4607594,216,50,utRho12
ecpA,621594,621594,621342,252,244,utRho12
ecpB,620238,620238,620052,186,22,utRho12
ecpR,622964,622964,622672,292,54,utRho12
eda,3866218,3866218,3865512,706,0,utRho12
edd,3869426,3869426,3869208,218,116,utRho12
efeO,2164308,2164486,2164308,178,62,utRho12
efeU_1,2162614,2162712,2162614,98,24,utRho12
efp,8751134,8751398,8751134,264,4268,utRho12
elaA,4763372,4763372,4763086,286,142,utRho12
elaD,4765308,4765426,4765308,118,122,utRho12
elfA,1995530,1995736,1995530,206,64,utRho12
elfD,1996642,1996980,1996642,338,110,utRho12
emrD,7707690,7707844,7707690,154,100,utRho12
emrK,4966896,4966896,4966678,218,0,utRho12
emrY,4964668,4964668,4964352,316,120,utRho12
emtA,2486250,2486360,2486250,110,0,utRho12
endA,12361100,12361388,12361100,288,0,utRho12
eno,5817692,5817692,5815882,1810,6350,utRho12
entC,1249662,1249770,1249662,108,0,utRho12
entD,1220508,1220508,1220158,350,0,utRho12
entH,1258584,1258600,1258584,16,0,utRho12
entS,1244506,1244600,1244506,94,146,utRho12
envR,6827266,6827266,6826930,336,20,utRho12
epd,12295292,12295292,12294764,528,152,utRho12
epmA,8765236,8765286,8765236,50,62,utRho12
epmB,8751406,8751406,8751314,92,2344,utRho12
eptB,7421162,7421162,7420950,212,0,utRho12
eptC,8300622,8300622,8300530,92,296,utRho12
erfK,4126708,4126708,4126646,62,784,utRho12
erpA,353122,353220,353122,98,46,utRho12
esrE,8039956,8039956,8039956,0,0,utRho12
essD,1153746,1154796,1153746,1050,898,utRho12
etk,2088606,2088606,2088420,186,452,utRho12
evgA,4967262,4967510,4967262,248,28,utRho12
exbB,6304028,6304028,6303968,60,36,utRho12
exbD,6302780,6302780,6302486,294,230,utRho12
exuR,6493016,6493304,6493016,288,34,utRho12
exuT,6490004,6490208,6490004,204,0,utRho12
fabA,2032996,2032996,2032940,56,70,utRho12
fabB,4883282,4883282,4883210,72,0,utRho12
fabH,2297032,2297518,2297032,486,4022,utRho12
fabI,2702236,2702236,2702078,158,124,utRho12
fadB,8062026,8062026,8061942,84,16,utRho12
fadD,3779614,3779614,3779492,122,118,utRho12
fadE,486812,486812,486606,206,74,utRho12
fadH,6463248,6463330,6463248,82,0,utRho12
fadI,4921022,4921022,4920938,84,126,utRho12
fadL,4922410,4922600,4922410,190,0,utRho12
fadM,928720,928804,928720,84,112,utRho12
fadR,2469810,2469876,2469810,66,34,utRho12
fbaB,4357334,4357334,4357128,206,0,utRho12
fdhE,8162722,8162722,8162456,266,1540,utRho12
fdhF,8598814,8598814,8598732,82,30,utRho12
fdnG,3094744,3094802,3094744,58,0,utRho12
fdrA,1093012,1093360,1093012,348,0,utRho12
feaB,2894994,2895038,2894994,44,52,utRho12
feaR,2894734,2894734,2894566,168,0,utRho12
fecA,9033454,9033454,9033354,100,4,utRho12
fecE,9023288,9023288,9022914,374,4602,utRho12
fecI,9036564,9036564,9036470,94,214,utRho12
feoA,7080114,7080326,7080114,212,158,utRho12
fepA,1225334,1225334,1224988,346,0,utRho12
fepB,1249454,1249454,1249020,434,16,utRho12
fepD,1244468,1244468,1244378,90,86,utRho12
fes,1225374,1225630,1225374,256,50,utRho12
ffh,5495706,5495706,5495590,116,628,utRho12
ffs,952576,952848,952576,272,340,utRho12
fhuA,334884,334968,334884,84,486,utRho12
fhuE,2323294,2323294,2323102,192,20,utRho12
fhuF,9211504,9211504,9211326,178,82302,utRho12
fic,6983296,6983296,6982926,370,876,utRho12
fieF,8212864,8212938,8212864,74,0,utRho12
fimA,9085388,9086230,9085388,842,1476,utRho12
fimB,9081334,9081914,9081334,580,1638,utRho12
fimE,9083742,9084074,9083742,332,1666,utRho12
fimZ,1129214,1129214,1128960,254,18,utRho12
fiu,1683296,1683296,1683062,234,20,utRho12
fixA,84650,84806,84650,156,40,utRho12
fkpA,6955050,6955050,6954838,212,7342,utRho12
fldA,2846084,2846084,2845860,224,4196,utRho12
fldB,6079644,6079710,6079644,66,140,utRho12
flgA,2261770,2261770,2261726,44,110,utRho12
flgB,2261986,2262036,2261986,50,46,utRho12
flgK,2276702,2276756,2276702,54,894,utRho12
flgM,2260330,2260330,2260256,74,288,utRho12
flgN,2259828,2259828,2259660,168,184,utRho12
flhB,3932432,3932432,3932382,50,1416,utRho12
flhC,3955864,3955864,3955688,176,174,utRho12
flhD,3957154,3957154,3956394,760,574,utRho12
fliA,4003638,4003638,4003578,60,1064,utRho12
fliC,4007352,4007352,4007212,140,836,utRho12
fliD,4007634,4007744,4007634,110,214,utRho12
fliE,4026186,4026186,4026028,158,308,utRho12
fliF,4026292,4026458,4026292,166,142,utRho12
fliL,4039168,4039236,4039168,68,134,utRho12
flk,4875824,4875900,4875824,76,14,utRho12
flu,4142634,4143078,4142634,444,232,utRho12
flxA,3292776,3292810,3292776,34,242,utRho12
fnr,2799104,2799104,2799052,52,72,utRho12
fnrS,2818258,2818258,2818258,0,0,utRho12
focA,1909628,1909628,1908932,696,2030,utRho12
folA,99598,99646,99598,48,52,utRho12
folB,6409296,6409296,6409178,118,104,utRho12
folD,1115562,1115562,1115482,80,132,utRho12
folE,4487696,4487696,4487304,392,2648,utRho12
fpr,8228998,8228998,8228944,54,76,utRho12
frc,4986878,4986878,4986508,370,0,utRho12
frdA,8764824,8764824,8764636,188,98,utRho12
frdD,8758948,8758948,8758732,216,916,utRho12
fre,8052886,8053054,8052886,168,1868,utRho12
frlA,6999518,6999820,6999518,302,228,utRho12
frr,385624,385744,385624,120,1346,utRho12
frsA,513004,513054,513004,50,254,utRho12
fruB,4527194,4527194,4526990,204,2,utRho12
frvR,8179804,8179804,8179710,94,0,utRho12
fryA,5008986,5008986,5008970,16,88,utRho12
fsaA,1727060,1727284,1727060,224,418,utRho12
fsr,1009710,1009710,1009392,318,102,utRho12
ftnA,3977364,3977432,3977364,68,32,utRho12
ftnB,3973550,3973850,3973550,300,22,utRho12
ftsA,207122,207964,207122,842,398,utRho12
ftsB,5745802,5745802,5745640,162,34,utRho12
ftsH,6654204,6654204,6653870,334,592,utRho12
ftsK,1865858,1866448,1865858,590,1424,utRho12
ftsL,181376,182064,181376,688,1514,utRho12
ftsP,6325732,6325732,6325338,394,114,utRho12
ftsQ,205484,206310,205484,826,168,utRho12
ftsX,7204512,7204512,7204172,340,400,utRho12
ftsZ,209272,210610,209272,1338,192,utRho12
fucA,5867708,5867708,5867376,332,466,utRho12
fucP,5868238,5868470,5868238,232,10,utRho12
fumA,6753760,6753760,6753508,252,3228,utRho12
fumB,8694696,8694696,8694652,44,36,utRho12
fumC,3373418,3373418,3373176,242,0,utRho12
fur,2842892,2842892,2842584,308,7264,utRho12
fusA,6947370,6947370,6947028,342,30242,utRho12
fxsA,8737206,8737328,8737206,122,136,utRho12
gabD,5581824,5582546,5581824,722,1064,utRho12
gadA,7335214,7335214,7335160,54,0,utRho12
gadB,3144144,3144144,3144090,54,0,utRho12
gadC,3141168,3141168,3140978,190,62,utRho12
gadE,7315600,7316732,7315600,1132,292,utRho12
gadW,7329562,7329562,7329236,326,0,utRho12
gadX,14663356,14663356,14663240,116,492,utRho12
gadY,7329728,7329728,7329728,0,0,utRho12
galE,1584354,1584354,1584110,244,48,utRho12
galF,4228702,4228702,4228654,48,52,utRho12
galM,1577796,1577796,1577674,122,312,utRho12
galP,6176510,6176568,6176510,58,44,utRho12
galR,5953138,5953198,5953138,60,28,utRho12
galS,4483420,4483420,4483336,84,84,utRho12
galU,2582810,2582914,2582810,104,478,utRho12
gapA,3724480,3725542,3724480,1062,3958,utRho12
garP,6549868,6549868,6549814,54,78,utRho12
gatY,4354468,4354468,4354408,60,8,utRho12
gatZ,4352864,4352864,4352642,222,8136,utRho12
gcd,282558,282558,282450,108,98,utRho12
gcl,1067814,1067832,1067814,18,0,utRho12
gcvA,5885278,5885278,5885134,144,0,utRho12
gcvB,5885392,5885392,5885392,0,0,utRho12
gcvR,5199758,5199812,5199758,54,20,utRho12
gcvT,6101544,6101544,6101334,210,1198,utRho12
gdhA,3684616,3684742,3684616,126,0,utRho12
gfcA,2099668,2099668,2099488,180,818,utRho12
gfcD,2096236,2096236,2095890,346,1392,utRho12
ghrA,2195648,2195772,2195648,124,4,utRho12
ghrB,7434378,7434620,7434378,242,1056,utRho12
glcA,6242728,6242728,6242558,170,164,utRho12
glcC,6256412,6256544,6256412,132,0,utRho12
glcD,6256152,6256152,6256042,110,24,utRho12
gldA,8278092,8278092,8278070,22,0,utRho12
glgA,7136784,7136784,7136066,718,848,utRho12
glgB,7147314,7147314,7147004,310,76,utRho12
glgC,7139142,7139142,7138656,486,474,utRho12
glgP,7133546,7133546,7133162,384,312,utRho12
glgS,6384024,6384024,6383878,146,0,utRho12
glgX,7142838,7142838,7142638,200,0,utRho12
glk,5018922,5018922,5018852,70,92,utRho12
glmS,7827622,7827622,7827336,286,5004,utRho12
glmU,7830652,7830652,7830400,252,698,utRho12
glmY,10765360,10765360,10765360,0,0,utRho12
glmZ,7972864,7972864,7972864,0,0,utRho12
glnA,16232888,16232888,16232136,752,244,utRho12
glnB,5375052,5375052,5374816,236,566,utRho12
glnD,377310,377310,377300,10,88,utRho12
glnE,6399602,6399602,6399282,320,4,utRho12
glnH,1696396,1696396,1696008,388,0,utRho12
glnK,945112,945196,945112,84,30,utRho12
glnL,8112742,8112742,8112678,64,38,utRho12
glnQ,1693262,1693262,1692926,336,24,utRho12
glnS,1411998,1412186,1411998,188,876,utRho12
gloA,3455602,3455674,3455602,72,184,utRho12
gloB,469852,469852,469564,288,1760,utRho12
glpA,4705166,4705294,4705166,128,0,utRho12
glpD,7123942,7124026,7123942,84,70,utRho12
glpE,7123698,7123698,7123646,52,0,utRho12
glpF,8236322,8236322,8236180,142,234,utRho12
glpG,7122960,7122960,7122904,56,198,utRho12
glpR,7121782,7121782,7121210,572,172,utRho12
glpT,4704902,4704902,4704748,154,110,utRho12
glpX,8231212,8231212,8231158,54,9046,utRho12
glrK,5382246,5382246,5382196,50,1758,utRho12
gltA,1509534,1509534,1508936,598,4628,utRho12
gltB,6709018,6709264,6709018,246,414,utRho12
gltI,1375792,1375792,1375494,298,3092,utRho12
gltP,8588536,8588962,8588536,426,570,utRho12
gltS,7657382,7657382,7657330,52,502,utRho12
gltX,5041568,5041568,5041344,224,20,utRho12
gluQ,320286,320286,320224,62,66,utRho12
glyA,5371148,5371148,5371014,134,0,utRho12
glyQ,7450708,7450708,7450636,72,110,utRho12
glyS,7448990,7448990,7448794,196,2844,utRho12
glyU,5998128,5998128,5998114,14,0,utRho12
glyV,8784626,8784720,8784626,94,232,utRho12
glyW,3984360,3984360,3984234,126,0,utRho12
gmhB,445612,445666,445612,54,0,utRho12
gmk,7642776,7642856,7642776,80,22,utRho12
gmr,2693686,2693686,2693484,202,336,utRho12
gnd,4202648,4202648,4202536,112,940,utRho12
gnsB,3275692,3275692,3275564,128,38,utRho12
gntK,14310580,14310580,14310368,212,652,utRho12
gntP,9102668,9102668,9102592,76,68,utRho12
gntR,7157760,7157760,7157452,308,524,utRho12
gntT,7092810,7093118,7092810,308,860,utRho12
gntU,7154170,7154170,7154122,48,0,utRho12
gntX,7089334,7089764,7089334,430,20,utRho12
gor,7292224,7292598,7292224,374,296,utRho12
gpmA,1575340,1575340,1575190,150,20,utRho12
gpmM,7570374,7570520,7570374,146,0,utRho12
gpsA,7567620,7567620,7567322,298,7856,utRho12
gpt,511828,511954,511828,126,888,utRho12
grcA,5433046,5433046,5432898,148,1304,utRho12
greA,6657728,6657728,6657430,298,1494,utRho12
greB,7073488,7073624,7073488,136,86,utRho12
groL,8741566,8742050,8741566,484,380,utRho12
groS,8741232,8741376,8741232,144,578,utRho12
grpE,5501494,5501494,5501416,78,216,utRho12
grxA,1781552,1781552,1781506,46,0,utRho12
grxB,2248206,2248206,2248108,98,122,utRho12
grxC,7569152,7569152,7568884,268,6004,utRho12
grxD,3468324,3468324,3468202,122,8134,utRho12
gspA,6911268,6911268,6910796,472,86,utRho12
gspC,6910964,6911156,6910964,192,8,utRho12
gss,6277220,6277220,6277044,176,0,utRho12
gstA,3428654,3428754,3428654,100,0,utRho12
gstB,1761038,1761038,1760960,78,58,utRho12
guaB,5268214,5268214,5268140,74,190,utRho12
gudD,5839026,5839026,5838770,256,34,utRho12
gyrA,4678914,4678914,4678840,74,56,utRho12
gyrB,7760300,7760300,7760238,62,228,utRho12
hcaE,5337964,5338064,5337964,100,190,utRho12
hcaR,5337928,5337928,5337792,136,204,utRho12
hcaT,5336106,5336106,5335692,414,96,utRho12
hchA,4071260,4071670,4071260,410,10,utRho12
hcp,1828258,1828258,1827628,630,754,utRho12
hcr,1824400,1824400,1824300,100,74,utRho12
hdeA,7313582,7313582,7313480,102,0,utRho12
hdeD,7313920,7313990,7313920,70,0,utRho12
hdfR,7896320,7896320,7895934,386,860,utRho12
hdhA,3396244,3396244,3396080,164,104,utRho12
helD,2048876,2048942,2048876,66,0,utRho12
hemA,2527166,2527428,2527166,262,110,utRho12
hemB,779722,779722,779454,268,94,utRho12
hemF,5106410,5106450,5106410,40,0,utRho12
hemH,996062,996110,996062,48,656,utRho12
hemL,349882,349882,349764,118,0,utRho12
hemN,8103886,8104090,8103886,204,122,utRho12
hepA,127176,127176,126528,648,1342,utRho12
hflD,2385372,2385372,2385262,110,112,utRho12
hfq,8799602,8800576,8799602,974,3126,utRho12
hha,961006,961006,960616,390,178,utRho12
hicA,3018442,3018572,3018442,130,154,utRho12
higA,6468682,6468682,6468288,394,364,utRho12
higB,6468960,6468960,6468910,50,0,utRho12
hinT,2323642,2323770,2323642,128,0,utRho12
hipB,3184964,3184964,3184884,80,18,utRho12
hisB,4186720,4186936,4186720,216,806,utRho12
hisJ,4853674,4853674,4853576,98,42,utRho12
hisL,8359856,8359984,8359856,128,76,utRho12
hisS,5281284,5281284,5281150,134,286,utRho12
hlpA,400910,400964,400910,54,178,utRho12
hlyE,2460932,2460932,2460788,144,296,utRho12
hmp,5371594,5371670,5371594,76,0,utRho12
hns,2585916,2585916,2585844,72,1022,utRho12
hofM,7045856,7045856,7045502,354,0,utRho12
hokA,7441620,7441620,7441200,420,6966,utRho12
hokC,33902,33902,33806,96,166,utRho12
hokE,1215462,1215672,1215462,210,22,utRho12
holC,8968546,8968546,8968560,14,490,utRho12
holD,9215562,9215606,9215562,44,0,utRho12
holE,3850040,3850216,3850040,176,4680,utRho12
hpt,282720,282862,282720,142,204,utRho12
hrpB,324150,324210,324150,60,94,utRho12
hscB,5319048,5319048,5318934,114,1188,utRho12
hscC,1367188,1367188,1366786,402,374,utRho12
hsdS,9163004,9163004,9162924,80,58,utRho12
hslJ,2883560,2883560,2883486,74,82,utRho12
hslO,7059344,7059548,7059344,204,4566,utRho12
hslR,7058220,7058696,7058220,476,940,utRho12
hslV,8244708,8244708,8244574,134,250,utRho12
hsrA,7881412,7881412,7881224,188,144,utRho12
htgA,21286,21660,21286,374,5402,utRho12
htpG,989634,990240,989634,606,26374,utRho12
htpX,3825236,3825236,3825152,84,0,utRho12
htrE,311036,311036,310852,184,490,utRho12
htrL,7587668,7587668,7587366,302,102,utRho12
hupA,8400352,8400562,8400352,210,94,utRho12
hupB,1845220,1845804,1845220,584,244,utRho12
hyaA,2063968,2064278,2063968,310,96,utRho12
hybO,6292726,6292726,6292522,204,3592,utRho12
hycA,5700922,5700922,5700870,52,0,utRho12
hycI,5686204,5686204,5686086,118,268,utRho12
hydN,5676264,5676264,5676210,54,0,utRho12
hyfA,5202342,5202402,5202342,60,36,utRho12
hypA,11402508,11402588,11402508,80,116,utRho12
hypB,11403356,11404004,11403356,648,240,utRho12
hypF,5676210,5676210,5674850,1360,1566,utRho12
hypT,9116634,9116634,9116578,56,0,utRho12
hyuA,6019660,6020056,6019660,396,0,utRho12
iaaA,1733074,1733136,1733074,62,0,utRho12
iadA,9119074,9119074,9119052,22,36,utRho12
iap,5753072,5753162,5753072,90,0,utRho12
ibaG,6673966,6673966,6673606,360,196,utRho12
ibpA,7735036,7735036,7734844,192,244,utRho12
ibpB,7733962,7733962,7733794,168,50,utRho12
icd,2389922,2390246,2389922,324,280,utRho12
iclR,8447304,8447304,8447256,48,56,utRho12
idi,6065876,6066130,6065876,254,0,utRho12
idnD,8988870,8988870,8988812,58,0,utRho12
idnK,8989194,8989246,8989194,52,4,utRho12
ihfA,3591442,3591442,3591104,338,692,utRho12
ihfB,1927498,1927656,1927498,158,608,utRho12
ileS,43666,44782,43666,1116,3834,utRho12
ileX,6431194,6431196,6431194,2,0,utRho12
ilvA,15820940,15821324,15820940,384,96,utRho12
ilvC,7915824,7915940,7915824,116,26,utRho12
ilvE,15809552,15809936,15809552,384,660,utRho12
ilvI,170840,171260,170840,420,196,utRho12
ilvL,23701308,23701932,23701308,624,66,utRho12
ilvY,7915734,7915734,7915640,94,32,utRho12
inaA,4698998,4698998,4698944,54,150,utRho12
infA,1853370,1853370,1852886,484,1798,utRho12
infC,3602692,3602692,3601276,1416,3468,utRho12
insA-5,3958452,3958452,3958430,22,26,utRho12
insA-7,9036758,9037054,9036758,296,494,utRho12
insC-5,6372080,6372284,6372080,204,6468,utRho12
insEF-2,785238,785238,785820,582,714,utRho12
insEF-4,2190310,2190310,2190892,582,682,utRho12
insG,9007098,9007098,9006862,236,42,utRho12
insH-1,550596,550596,550234,362,360,utRho12
insH-11,7306538,7306538,7306396,142,52,utRho12
insH-2,1151548,1151548,1151506,42,98,utRho12
insH-3,1378444,1378444,1378026,418,456,utRho12
insH-4,2791942,2792152,2791942,210,76,utRho12
insH-5,2857852,2857852,2857452,400,40,utRho12
insH-6,4135022,4135022,4134642,380,568,utRho12
insH-7,4206186,4206186,4205822,364,6010,utRho12
insH-9,6260050,6260356,6260050,306,138,utRho12
insI-3,9017372,9017372,9017234,138,80,utRho12
insJ,7441188,7441360,7441188,172,3366,utRho12
insK,7442130,7442308,7442130,178,0,utRho12
insL-1,30760,30890,30760,130,678,utRho12
insL-2,1216112,1216130,1216112,18,74,utRho12
insL-3,5028644,5028662,5028644,18,68,utRho12
insN-1,540452,540484,540452,32,0,utRho12
intD,1132202,1132202,1131956,246,2990,utRho12
intR,2826520,2826520,2826470,50,0,utRho12
intS,4933026,4933090,4933026,64,4744,utRho12
intZ,5117386,5117542,5117386,156,856,utRho12
iraD,9113152,9113986,9113152,834,192,utRho12
iraM,2424246,2424246,2424006,240,78,utRho12
iraP,802638,802772,802638,134,0,utRho12
iscA,5319924,5319924,5319772,152,1048,utRho12
iscR,5324398,5324398,5324262,136,12624,utRho12
iscX,5313834,5313834,5313472,362,3524,utRho12
ispF,5743968,5743968,5743560,408,1828,utRho12
ispG,5283908,5283908,5283608,300,714,utRho12
ispU,389568,389806,389568,238,16,utRho12
isrA,2811502,2811502,2811618,116,0,utRho12
istr-1,7706384,7706384,7706384,0,0,utRho12
istr-2,7706514,7706514,7706514,0,0,utRho12
ivbL,15412092,15412092,15411952,140,532,utRho12
ivy,480638,480686,480638,48,2,utRho12
katE,3627628,3627734,3627628,106,76,utRho12
katG,8267624,8267670,8267624,46,54,utRho12
kbaZ,6557732,6557828,6557732,96,0,utRho12
kbl,7585154,7585154,7585102,52,668,utRho12
kch,2621046,2621046,2620538,508,402,utRho12
kdgR,3820506,3820506,3820198,308,8,utRho12
kdpE,1443788,1443788,1443466,322,2,utRho12
kdpF,1457698,1457698,1457642,56,0,utRho12
kdsA,2535708,2536330,2535708,622,2054,utRho12
kdsC,6683438,6684546,6683438,1108,1724,utRho12
kduI,5968388,5968388,5968248,140,3116,utRho12
kefF,94160,94492,94160,332,188,utRho12
kgtP,5451624,5451624,5451492,132,1626,utRho12
kup,7862206,7862632,7862206,426,4,utRho12
lacI,735076,735076,735020,56,0,utRho12
lacZ,1465508,1465508,1465220,288,24,utRho12
ldcA,2486394,2486394,2486160,234,44,utRho12
ldhA,2885830,2885830,2885686,144,0,utRho12
ldrA,2538954,2538954,2538550,404,3274,utRho12
ldrB,2540024,2540024,2539620,404,1044,utRho12
ldrC,2541092,2541092,2540690,402,648,utRho12
ldrD,7400544,7400544,7400174,370,1462,utRho12
lepA,5414392,5414392,5414248,144,300,utRho12
lepB,5410928,5410928,5410618,310,572,utRho12
leuD,159188,159188,158906,282,60,utRho12
leuE,3761600,3761600,3761518,82,0,utRho12
leuL,168048,168048,167416,632,0,utRho12
leuO,168308,168736,168308,428,192,utRho12
leuQ,9212864,9212864,9212802,62,0,utRho12
leuU,6644556,6644556,6644316,240,2588,utRho12
leuV,9212546,9212546,9212330,216,3474,utRho12
leuX,8992772,8992810,8992772,38,0,utRho12
lexA,8514174,8514230,8514174,56,102,utRho12
lhr,3456706,3458174,3456706,1468,1778,utRho12
ligA,5060402,5060402,5060352,50,36,utRho12
ligB,7642576,7642576,7642340,236,344,utRho12
lipA,1320602,1320602,1320432,170,88,utRho12
lipB,1324802,1324802,1324556,246,3226,utRho12
lit,2397032,2397390,2397032,358,1174,utRho12
livJ,7199524,7199524,7199316,208,1842,utRho12
livK,7195510,7195510,7195120,390,70,utRho12
lldP,7554578,7554798,7554578,220,2990,utRho12
lnt,1381968,1381968,1381762,206,244,utRho12
loiP,6163784,6163826,6163784,42,212,utRho12
lolA,1874656,1874738,1874656,82,390,utRho12
lolB,2527112,2527112,2527000,112,110,utRho12
lolC,2350748,2350854,2350748,106,0,utRho12
lon,917630,917776,917630,146,1078,utRho12
lpcA,486936,487086,486936,150,0,utRho12
lpd,255434,255824,255434,390,3594,utRho12
lplA,9248476,9248476,9248234,242,1092,utRho12
lplT,5947878,5947878,5947724,154,0,utRho12
lpoA,6586422,6586800,6586422,378,162,utRho12
lpp,3514592,3514842,3514592,250,410,utRho12
lptA,6686598,6686760,6686598,162,198,utRho12
lptB,6686792,6687888,6686792,1096,1670,utRho12
lptD,114672,114672,114218,454,2178,utRho12
lptF,8972244,8972436,8972244,192,72,utRho12
lpxC,213016,213114,213016,98,6500,utRho12
lpxD,401920,401942,401920,22,178,utRho12
lpxL,2233418,2233418,2233164,254,112,utRho12
lpxM,3880456,3880456,3880386,70,44,utRho12
lpxP,4991156,4991290,4991156,134,244,utRho12
lrhA,4813312,4813312,4813282,30,50,utRho12
lrp,1864656,1865190,1864656,534,398,utRho12
lspA,50028,50414,50028,386,536,utRho12
lsrA,3202920,3202980,3202920,60,24,utRho12
lsrR,3202514,3202514,3202482,32,0,utRho12
ltaE,1818640,1818640,1818588,52,0,utRho12
luxS,5630130,5630130,5629466,664,16656,utRho12
lysA,5957902,5957902,5957798,104,62,utRho12
lysC,8467232,8467232,8466466,766,254,utRho12
lysP,4497120,4497120,4497064,56,0,utRho12
lysR,5957900,5958042,5957900,142,60,utRho12
lysT,1561028,1561108,1561028,80,142,utRho12
lysU,8709610,8709610,8709434,176,126,utRho12
macB,1840188,1840694,1840188,506,268,utRho12
maeA,3111484,3111484,3111338,146,2804,utRho12
mak,820236,820288,820236,52,44,utRho12
malE,8492928,8492928,8492838,90,0,utRho12
malI,3398456,3398456,3398360,96,0,utRho12
malK,8493472,8493568,8493472,96,0,utRho12
malP,7105020,7105020,7104946,74,488,utRho12
malQ,7100798,7100798,7100140,658,100,utRho12
malS,14949880,14949988,14949880,108,0,utRho12
malT,7106048,7106170,7106048,122,172,utRho12
malX,3398626,3398710,3398626,84,0,utRho12
malZ,1689980,1690072,1689980,92,2420,utRho12
manA,3377102,3377152,3377102,50,0,utRho12
manX,3803866,3804096,3803866,230,14,utRho12
marC,3237882,3237882,3237816,66,0,utRho12
marR,3238186,3238240,3238186,54,244,utRho12
matP,2036918,2036970,2036918,52,106,utRho12
mazE,5822736,5822736,5822678,58,0,utRho12
mazG,5821720,5821720,5821370,350,3438,utRho12
mcbA,1684306,1684306,1684112,194,2,utRho12
mcbR,3040192,3040524,3040192,332,72,utRho12
mcrA,2420278,2420692,2420278,414,0,utRho12
mcrC,9156124,9156124,9155916,208,234,utRho12
mdaB,6344814,6345060,6344814,246,36,utRho12
mdfA,1767138,1767346,1767138,208,0,utRho12
mdh,6768940,6768940,6768536,404,78,utRho12
mdoB,9198988,9198988,9198882,106,1444,utRho12
mdoD,2993290,2993712,2993290,422,0,utRho12
mdoG,2218514,2218670,2218514,156,344,utRho12
mdtA,4307958,4308032,4307958,74,212,utRho12
mdtE,7318168,7318464,7318168,296,580,utRho12
mdtK,3486538,3486914,3486538,376,872,utRho12
mdtP,8602472,8602472,8602060,412,192,utRho12
melA,8683774,8683822,8683774,48,0,utRho12
melR,8683300,8683300,8683256,44,32,utRho12
menA,8240812,8240812,8240698,114,50,utRho12
menB,4753774,4753774,4753638,136,158,utRho12
mepH,3468714,3468870,3468714,156,34,utRho12
mepM,3883666,3883666,3883270,396,660,utRho12
mepS,4539840,4539958,4539840,118,288,utRho12
metA,8428318,8428560,8428318,242,406,utRho12
metB,8257272,8257344,8257272,72,520,utRho12
metC,6304150,6304472,6304150,322,86,utRho12
metE,8025768,8026106,8025768,338,962,utRho12
metF,8265092,8265232,8265092,140,60,utRho12
metG,4388538,4388600,4388538,62,6,utRho12
metH,8447010,8447656,8447010,646,1528,utRho12
metJ,8257116,8257116,8256790,326,92,utRho12
metK,6173154,6173412,6173154,258,182,utRho12
metN,445428,445428,445290,138,0,utRho12
metR,8025710,8025710,8025632,78,12,utRho12
metT,1394326,1394326,1394266,60,290,utRho12
metY,19910250,19910250,19909734,516,408,utRho12
metZ,11789528,11789548,11789528,20,80,utRho12
mfd,2348056,2348056,2347928,128,20,utRho12
mglA,4478782,4478782,4478578,204,202,utRho12
mglB,4481132,4481132,4480696,436,7684,utRho12
mglC,4475918,4475918,4475506,412,36,utRho12
mgrB,3817584,3817584,3817532,52,18,utRho12
mgrR,3245828,3245828,3245828,0,0,utRho12
mgsA,2054082,2054082,2054030,52,170,utRho12
mgtL,8934560,8934862,8934560,302,216,utRho12
mhpA,737038,737222,737038,184,0,utRho12
mhpR,737072,737072,736840,232,0,utRho12
mhpT,750772,750918,750772,146,0,utRho12
miaA,8797964,8798504,8797964,540,1496,utRho12
micA,5629604,5629604,5629604,0,0,utRho12
micC,2874242,2874238,2874242,4,0,utRho12
micF,4626168,4626168,4626168,0,0,utRho12
micM,1014408,1014408,1014408,0,0,utRho12
minE,2449422,2449422,2449090,332,946,utRho12
mioC,7852950,7852950,7852910,40,18,utRho12
mipA,3733012,3733012,3732944,68,2512,utRho12
mlaA,4930270,4930270,4930014,256,0,utRho12
mlc,3337206,3337206,3337128,78,4,utRho12
mlrA,4429498,4429732,4429498,234,124,utRho12
mltA,5894546,5894546,5894356,190,0,utRho12
mltD,468050,468050,467910,140,0,utRho12
mltF,5391534,5391602,5391534,68,0,utRho12
mmuP,550238,550650,550238,412,550,utRho12
mngA,1531622,1531968,1531622,346,510,utRho12
mngR,1531852,1531852,1531750,102,434,utRho12
mnmG,7851348,7851348,7851266,82,5704,utRho12
mntH,5025470,5025470,5025412,58,78,utRho12
mntP,3810918,3811376,3810918,458,1256,utRho12
mntR,1706160,1706366,1706160,206,170,utRho12
mntS,1706128,1706128,1705994,134,70,utRho12
moaA,1633654,1634088,1633654,434,576,utRho12
moaB,1635954,1636110,1635954,156,1946,utRho12
mobA,8084242,8084242,8083998,244,68,utRho12
mocA,6030112,6030320,6030112,208,48,utRho12
modA,1589990,1590178,1589990,188,388,utRho12
moeA,1732788,1732788,1732728,60,70,utRho12
mokB,2984610,2984610,2984258,352,740,utRho12
molR_1,4392888,4392948,4392888,60,150,utRho12
motA,3954604,3954604,3954278,326,106,utRho12
mpaA,2781278,2781278,2781196,82,362,utRho12
mpl,8911456,8911570,8911456,114,24,utRho12
mppA,2786108,2786454,2786108,346,26,utRho12
mprA,5621494,5621540,5621494,46,1116,utRho12
mqo,4613848,4613848,4613508,340,694,utRho12
mqsA,6336742,6336742,6336492,250,192,utRho12
mqsR,6337306,6337306,6337088,218,982,utRho12
mraZ,179192,179268,179192,76,114,utRho12
mrcA,7045652,7045742,7045652,90,0,utRho12
mrcB,329442,329460,329442,18,0,utRho12
mreB,13605424,13605424,13604348,1076,2552,utRho12
mreD,6798166,6798166,6797750,416,120,utRho12
mrp,4388360,4388360,4388336,24,0,utRho12
mscK,972984,973072,972984,88,74,utRho12
mscL,6876002,6876048,6876002,46,1018,utRho12
mscS,6139742,6139742,6139614,128,0,utRho12
msrA,8884522,8884522,8884352,170,286,utRho12
msrB,3725168,3725168,3724858,310,0,utRho12
msyB,2228426,2228426,2228362,64,454,utRho12
mtfA,4087236,4087302,4087236,66,1252,utRho12
mtgA,6699662,6699662,6699618,44,514,utRho12
mtlA,30177504,30178248,30177504,744,584,utRho12
mtn,358366,358366,358306,60,392,utRho12
mtr,6611864,6611864,6611634,230,170,utRho12
mug,6430992,6430992,6430946,46,158,utRho12
murQ,5091466,5091546,5091466,80,0,utRho12
murR,5091586,5091586,5091218,368,0,utRho12
mutH,5939164,5939324,5939164,160,326,utRho12
mutL,8794092,8794824,8794092,732,5624,utRho12
mutM,7622554,7622554,7622304,250,1980,utRho12
mutS,5714038,5714186,5714038,148,734,utRho12
mutY,18617466,18618078,18617466,612,216,utRho12
nac,4123956,4123956,4123866,90,390,utRho12
nadA,1564122,1564170,1564122,48,52,utRho12
nadB,5420714,5420840,5420714,126,4,utRho12
nadC,237326,237326,237290,36,62,utRho12
nadE,3644604,3644916,3644604,312,164,utRho12
nadK,5501526,5501662,5501526,136,114,utRho12
nagA,1406350,1406350,1405502,848,1456,utRho12
nagB,1407416,1407416,1407222,194,0,utRho12
nagC,1404016,1404016,1403188,828,2,utRho12
nagE,1407680,1407888,1407680,208,54,utRho12
nagK,2357080,2357186,2357080,106,72,utRho12
nanA,6747240,6747240,6747152,88,22,utRho12
nanC,9079856,9079856,9079002,854,92,utRho12
nanR,6749406,6749406,6748978,428,364,utRho12
nanS,9075406,9075406,9075188,218,0,utRho12
napF,4607390,4607390,4606994,396,172,utRho12
narG,2559614,2559728,2559614,114,0,utRho12
narK,2555642,2555914,2555642,272,2,utRho12
narP,4580844,4581000,4580844,156,28,utRho12
narQ,5171154,5171462,5171154,308,256,utRho12
narU,3088326,3088326,3088120,206,32,utRho12
narW,3077374,3077374,3074618,2756,60,utRho12
narX,2555554,2555554,2555236,318,56,utRho12
narZ,3085380,3085380,3085180,200,0,utRho12
ndh,2331984,2332170,2331984,186,108,utRho12
ndk,5289920,5289920,5289728,192,36,utRho12
nemR,6904084,6904092,6904084,8,84,utRho12
nepI,7683542,7683542,7683478,64,104,utRho12
nfo,4501612,4501680,4501612,68,54,utRho12
nfsB,1210906,1210906,1210848,58,0,utRho12
nfuA,7090916,7091248,7090916,332,392,utRho12
nhaA,34634,34978,34634,344,138,utRho12
nhaB,2469534,2469534,2469434,100,0,utRho12
nhoA,3067926,3068048,3067926,122,0,utRho12
nikA,7226878,7227334,7226878,456,6328,utRho12
nikR,7237074,7237176,7237074,102,254,utRho12
nirB,6987974,6988022,6987974,48,24,utRho12
nlpA,7680034,7680034,7679986,48,72,utRho12
nlpC,3585654,3585654,3585462,192,0,utRho12
nlpD,5737658,5737658,5737506,152,10,utRho12
nlpI,6618080,6618080,6617848,232,62,utRho12
nmpC,1153740,1153740,1153650,90,0,utRho12
nohA,3273206,3273206,3272734,472,304,utRho12
norR,5664614,5664614,5664578,36,0,utRho12
norV,5664878,5664952,5664878,74,0,utRho12
nrdA,4689510,4689730,4689510,220,6412,utRho12
nrdD,8925676,8925676,8925320,356,2904,utRho12
nrdH,5601312,5601446,5601312,134,42,utRho12
nrdR,865954,866004,865954,50,140,utRho12
nrfA,8575342,8575528,8575342,186,88,utRho12
nsrR,8812088,8812380,8812088,292,15148,utRho12
nudB,3897348,3897348,3897264,84,92,utRho12
nudC,8393428,8393806,8393428,378,0,utRho12
nudE,7052658,7052658,7052298,360,952,utRho12
nudG,3682876,3682980,3682876,104,0,utRho12
nudI,4729050,4729108,4729050,58,0,utRho12
nudJ,2388874,2388874,2388576,298,984,utRho12
nuoA,4810670,4810670,4810144,526,5246,utRho12
nuoN,4783434,4783434,4783010,424,630,utRho12
nupC,5026018,5026084,5026018,66,0,utRho12
nupG,6211302,6211428,6211302,126,142,utRho12
ogrK,4335096,4335096,4335040,56,0,utRho12
ogt,2800568,2800568,2800472,96,42,utRho12
ohsC,5401036,5401040,5401036,4,50,utRho12
ompA,2040382,2040382,2040106,276,19188,utRho12
ompC,4625774,4625774,4625498,276,134,utRho12
ompF,1974184,1974184,1973964,220,132,utRho12
ompL,8128958,8128958,8128590,368,0,utRho12
ompN,2874158,2874158,2873786,372,22,utRho12
ompR,7073510,7073510,7073168,342,116,utRho12
ompT,1171330,1171330,1171266,64,146,utRho12
ompW,2627982,2628040,2627982,58,0,utRho12
ompX,1700418,1700900,1700418,482,1758,utRho12
omrA,5952378,5952378,5952378,0,0,utRho12
omrB,5952770,5952770,5952770,0,0,utRho12
oppA,2602170,2602364,2602170,194,9448,utRho12
orn,8783168,8783208,8783168,40,0,utRho12
osmB,2686952,2686952,2686656,296,1976,utRho12
osmC,3113192,3113250,3113192,58,0,utRho12
osmE,3644566,3644566,3644512,54,52,utRho12
osmF,4439046,4439046,4438962,84,850,utRho12
osmY,9222306,9222792,9222306,486,988,utRho12
otsA,3963302,3963302,3963224,78,68,utRho12
otsB,3964930,3964930,3964774,156,392,utRho12
oxc,4984288,4984288,4983900,388,312,utRho12
oxyR,8316914,8316980,8316914,66,334,utRho12
oxyS,8316788,8316788,8316788,0,0,utRho12
paaA,2907730,2907854,2907730,124,44,utRho12
paaX,2927018,2927078,2927018,60,0,utRho12
paaZ,2907340,2907340,2907284,56,0,utRho12
pabA,6981702,6981702,6981658,44,34,utRho12
pabB,3789256,3789610,3789256,354,206,utRho12
pabC,2306186,2306600,2306186,414,916,utRho12
pagP,1313052,1313114,1313052,62,0,utRho12
panB,299260,299260,299202,58,862,utRho12
panC,297840,297840,297590,250,152,utRho12
panD,293490,293490,293388,102,102,utRho12
panZ,7195656,7195968,7195656,312,430,utRho12
parC,6332060,6332060,6331946,114,82,utRho12
patA,6438916,6438988,6438916,72,0,utRho12
patD,3030830,3031156,3030830,326,0,utRho12
pbpC,5294986,5294986,5294650,336,0,utRho12
pbpG,4450132,4450132,4449740,392,120,utRho12
pck,7065358,7065636,7065358,278,4192,utRho12
pcnB,318782,318782,318252,530,300,utRho12
pdhR,244068,244184,244068,116,0,utRho12
pdxB,4875768,4875768,4875702,66,126,utRho12
pdxH,3436068,3436068,3436014,54,188,utRho12
pdxJ,5403626,5403626,5403458,168,230,utRho12
pdxK,5074638,5074638,5074474,164,262,utRho12
pepA,8972278,8972278,8971902,376,346,utRho12
pepD,511618,511618,511432,186,3228,utRho12
pepN,1981182,1981244,1981182,62,234,utRho12
pepQ,8062294,8062322,8062294,28,0,utRho12
pepT,2371646,2371688,2371646,42,98,utRho12
pfkA,8214948,8215104,8214948,156,78,utRho12
pfkB,3612646,3612740,3612646,94,0,utRho12
pflA,1902456,1902456,1902160,296,0,utRho12
pflB,1907850,1907850,1907108,742,760,utRho12
pflD,8287716,8287990,8287716,274,24,utRho12
pgaA,2185046,2185046,2184578,468,82,utRho12
pgi,8467444,8467516,8467444,72,0,utRho12
pgk,12291428,12291428,12290488,940,968,utRho12
pgl,1597078,1597172,1597078,94,82,utRho12
pgpB,2678324,2678660,2678324,336,124,utRho12
pgpC,5397276,5397276,5397100,176,4,utRho12
pgrR,2783744,2783982,2783744,238,104,utRho12
pheL,5475158,5475198,5475158,40,0,utRho12
pheM,7197204,7197204,7197080,124,80,utRho12
pheP,1203858,1203918,1203858,60,66,utRho12
pheU,8725254,8725254,8725252,2,0,utRho12
pheV,6220730,6220732,6220730,2,0,utRho12
phnC,8650412,8650412,8650330,82,40,utRho12
phoA,803414,803494,803414,80,124,utRho12
phoB,834202,834284,834202,82,0,utRho12
phoE,520316,520316,520200,116,84,utRho12
phoH,2169730,2169984,2169730,254,0,utRho12
phoP,2381016,2381016,2380894,122,1794,utRho12
phoQ,2379880,2379880,2379552,328,644,utRho12
phoU,7815330,7815330,7815156,174,500,utRho12
phr,1478842,1479014,1478842,172,0,utRho12
pinE,2419054,2419370,2419054,316,140,utRho12
pinQ,3267168,3267244,3267168,76,570,utRho12
pinR,2867424,2867424,2867348,76,472,utRho12
pitA,7275224,7275284,7275224,60,0,utRho12
pitB,6272806,6272806,6272742,64,0,utRho12
pka,5439862,5439906,5439862,44,56,utRho12
plaP,4174476,4174476,4174124,352,1326,utRho12
pldA,8009628,8009724,8009628,96,144,utRho12
pldB,8018028,8018340,8018028,312,504,utRho12
plsB,8513196,8513196,8512932,264,252,utRho12
pmbA,8915890,8915918,8915890,28,32,utRho12
pmrD,4747148,4747148,4747076,72,0,utRho12
pncB,1980828,1980828,1980712,116,4,utRho12
pncC,5648788,5648788,5648692,96,0,utRho12
pnp,6622652,6622652,6622336,316,248,utRho12
pntA,3355950,3355950,3355806,144,0,utRho12
pntB,3353096,3353096,3352720,376,0,utRho12
polA,8093880,8093932,8093880,52,68,utRho12
polB,131606,131606,131560,46,0,utRho12
potD,2365700,2365700,2365658,42,0,utRho12
potE,1436688,1436688,1436530,158,0,utRho12
potF,1787268,1787568,1787268,300,106,utRho12
poxB,1822152,1822152,1822098,54,116,utRho12
ppa,8899372,8899372,8899304,68,266,utRho12
ppc,8306380,8306380,8306196,184,10,utRho12
ppdA,5928440,5928440,5928354,86,3128,utRho12
ppdD,235410,235410,235098,312,218,utRho12
pphA,3846770,3846770,3845938,832,7398,utRho12
pphB,5719474,5719520,5719474,46,318,utRho12
ppiA,6984898,6984898,6984594,304,4,utRho12
ppiC,7919682,7919682,7919626,56,224,utRho12
ppiD,923638,923830,923638,192,414,utRho12
ppk,5245748,5246088,5245748,340,286,utRho12
pppA,6228958,6228958,6228704,254,48,utRho12
ppsA,3574322,3574322,3574224,98,88,utRho12
ppsR,3574678,3574890,3574678,212,18,utRho12
pptA,3065716,3066104,3065716,388,96,utRho12
pqiA,2023318,2024002,2023318,684,124,utRho12
prc,3830054,3830054,3829632,422,19798,utRho12
preT,4467978,4468066,4467978,88,1012,utRho12
prfC,9218688,9218828,9218688,140,1544,utRho12
prkB,6968622,6968980,6968622,358,836,utRho12
prlC,7290476,7290476,7290364,112,234,utRho12
prlF,6553944,6554004,6553944,60,156,utRho12
proB,520432,520776,520432,344,122,utRho12
proC,811372,811372,811288,84,0,utRho12
proK,7417388,7417388,7417384,4,0,utRho12
proL,4572414,4572422,4572414,8,32,utRho12
proP,8660640,8661004,8660640,364,438,utRho12
proS,437674,437674,437550,124,1024,utRho12
proV,5609126,5609630,5609126,504,0,utRho12
prpB,697292,697364,697292,72,0,utRho12
prpR,696942,696942,696886,56,0,utRho12
prs,2524354,2524354,2523750,604,32958,utRho12
psd,8781276,8781276,8780720,556,1510,utRho12
psiE,8480600,8480650,8480600,50,0,utRho12
pspA,2736076,2736158,2736076,82,0,utRho12
pspF,2736080,2736080,2735824,256,0,utRho12
pspG,8525632,8525680,8525632,48,0,utRho12
pssA,5445156,5445454,5445156,298,2226,utRho12
pstB,7817112,7817112,7816732,380,174,utRho12
pstC,7821084,7821084,7820796,288,192,utRho12
pstS,23469408,23469408,23469150,258,324,utRho12
psuG,4517114,4517114,4516734,380,922,utRho12
psuT,4514992,4514992,4514670,322,0,utRho12
pth,2517084,2517084,2517026,58,0,utRho12
ptrA,5918022,5918022,5917768,254,22,utRho12
ptrB,3857730,3857730,3857678,52,3246,utRho12
ptsG,2315252,2315738,2315252,486,2500,utRho12
ptsH,5066996,5067528,5066996,532,2950,utRho12
purA,8809328,8809374,8809328,46,38,utRho12
purC,5195562,5195562,5195236,326,0,utRho12
purD,8411972,8411972,8411862,110,36,utRho12
purE,1106284,1106284,1106200,84,1424,utRho12
purH,8415254,8415254,8415064,190,0,utRho12
purL,5391178,5391178,5391086,92,522,utRho12
purM,5242306,5242394,5242306,88,0,utRho12
purR,3475378,3475688,3475378,310,334,utRho12
purT,3861438,3861762,3861438,324,200,utRho12
purU,2577512,2577512,2577248,264,752,utRho12
putA,2157850,2157850,2157764,86,0,utRho12
putP,2158336,2158610,2158336,274,322,utRho12
puuA,2721936,2721936,2721816,120,0,utRho12
puuC,2725456,2725486,2725456,30,0,utRho12
puuD,2722104,2722240,2722104,136,4,utRho12
puuP,2718746,2718746,2718374,372,164,utRho12
pykA,3874988,3875298,3874988,310,280,utRho12
pykF,3510934,3511396,3510934,462,616,utRho12
pyrC,2245286,2245286,2245214,72,242,utRho12
pyrD,2009464,2009536,2009464,72,100,utRho12
pyrE,7631970,7631970,7631536,434,22,utRho12
pyrF,2683740,2683842,2683740,102,424,utRho12
pyrG,5819594,5819594,5819332,262,1616,utRho12
pyrH,383624,383710,383624,86,1862,utRho12
pyrL,8945490,8945490,8945066,424,146,utRho12
qmcA,1031646,1031646,1031546,100,68,utRho12
qor,8528608,8528608,8528462,146,656,utRho12
qseB,6339502,6339656,6339502,154,70,utRho12
queA,849970,850022,849970,52,574,utRho12
queE,5811212,5811212,5810836,376,818,utRho12
queF,5850642,5850696,5850642,54,0,utRho12
queG,8788184,8788184,8788134,50,75356,utRho12
racC,2835630,2835630,2835526,104,0,utRho12
racR,2840898,2840898,2840482,416,0,utRho12
raiA,5474208,5474308,5474208,100,42,utRho12
rarD,8008594,8008594,8008356,238,128,utRho12
ravA,7862256,7862256,7862186,70,0,utRho12
rayT,495088,495274,495088,186,148,utRho12
rbn,4763162,4763216,4763162,54,30,utRho12
rbsD,7866644,7866702,7866644,58,0,utRho12
rcnA,4371654,4371834,4371654,180,136,utRho12
rcnB,4373768,4373920,4373768,152,76,utRho12
rcnR,4371806,4371806,4371592,214,204,utRho12
rcsA,4047672,4047936,4047672,264,4080,utRho12
rcsB,4631390,4632354,4631390,964,216,utRho12
rcsC,4640162,4640162,4639656,506,114,utRho12
rcsD,4626904,4626976,4626904,72,418,utRho12
rdgB,6193240,6193362,6193240,122,390,utRho12
rdlA,2538646,2538646,2538646,0,0,utRho12
rdlB,2539712,2539716,2539712,4,58,utRho12
rdlC,2540782,2540786,2540782,4,0,utRho12
rdlD,7400272,7400272,7400272,0,0,utRho12
rdoA,8084782,8084830,8084782,48,12,utRho12
recA,11295276,11295276,11295076,200,396,utRho12
recC,5925014,5925014,5924856,158,56,utRho12
recF,7763722,7763722,7762442,1280,7480,utRho12
recN,5503518,5503590,5503518,72,132,utRho12
recQ,8011666,8011728,8011666,62,40,utRho12
relA,5828554,5828554,5827302,1252,292,utRho12
relB,3291806,3291806,3291744,62,52,utRho12
rem,3289950,3289950,3289804,146,12,utRho12
rep,7921294,7921354,7921294,60,136,utRho12
rfaD,7587730,7587974,7587730,244,230,utRho12
rfaE,6393852,6393852,6393506,346,0,utRho12
rfaH,8049930,8049930,8049642,288,1308,utRho12
rfbX,4219436,4219436,4219168,268,2600,utRho12
rfe,7935600,7935832,7935600,232,228,utRho12
rhaB,8194944,8194944,8194896,48,0,utRho12
rhaD,8188770,8188770,8188544,226,0,utRho12
rhaS,8195422,8195472,8195422,50,0,utRho12
rhaT,8201132,8201132,8201050,82,80,utRho12
rhlE,1661566,1661744,1661566,178,118,utRho12
rhoL,47593944,47594772,47593944,828,205392,utRho12
rhsB,7238006,7238384,7238006,378,430,utRho12
rhsC,1458758,1459166,1458758,408,70,utRho12
rhsD,1046132,1046522,1046132,390,0,utRho12
rhtA,1700608,1700608,1700194,414,92,utRho12
rhtC,8015478,8015514,8015478,36,962,utRho12
ribA,2678468,2678468,2678320,148,86,utRho12
ribC,3486916,3486916,3486484,432,1352,utRho12
ribE,869008,869294,869008,286,6314,utRho12
ribF,42766,42814,42766,48,90,utRho12
ridA,8941892,8941892,8941826,66,98,utRho12
rihA,1369204,1369204,1368824,380,2026,utRho12
rihB,4510504,4510504,4510372,132,20,utRho12
rimJ,2251044,2251124,2251044,80,2,utRho12
rimK,1783752,1783934,1783752,182,418,utRho12
rimL,2997486,2997876,2997486,390,424,utRho12
rimO,1756140,1756140,1756070,70,12,utRho12
rimP,6636350,6636350,6636012,338,722,utRho12
rlmA,3814172,3814172,3814120,52,1028,utRho12
rlmD,5830086,5830086,5830000,86,52,utRho12
rlmE,6655520,6655520,6655328,192,1106,utRho12
rlmF,1684384,1684664,1684384,280,110,utRho12
rlmG,6471784,6471784,6471750,34,0,utRho12
rlmI,2060002,2060002,2059938,64,280,utRho12
rlmJ,7290700,7290770,7290700,70,194,utRho12
rlmL,2015344,2015688,2015344,344,2018,utRho12
rlpA,1330444,1330444,1330380,64,314,utRho12
rluA,120900,120900,120692,208,304,utRho12
rluF,8460324,8460708,8460324,384,92,utRho12
rmf,2031006,2031430,2031006,424,2452,utRho12
rna,1290068,1290068,1290006,62,10,utRho12
rnb,2698258,2698258,2697824,434,1730,utRho12
rnc,10816892,10816892,10816252,640,7860,utRho12
rnd,3776122,3776122,3775982,140,138,utRho12
rne,2289746,2289746,2288734,1012,5768,utRho12
rnhA,472082,472082,472004,78,542,utRho12
rnk,1288360,1288360,1287934,426,32,utRho12
rnlA,5531788,5531836,5531788,48,410,utRho12
rnlB,5533414,5533968,5533414,554,634,utRho12
rnpB,19623552,19623552,19623552,0,0,utRho12
rob,9270706,9270706,9270620,86,12,utRho12
rodZ,5285868,5285868,5285688,180,16,utRho12
rpe,7030306,7030306,7030118,188,140,utRho12
rph,15266320,15266320,15266196,124,0,utRho12
rpiA,6118706,6118706,6118650,56,224,utRho12
rpiB,8626514,8626700,8626514,186,70,utRho12
rpiR,8626274,8626274,8625982,292,22,utRho12
rplJ,8359246,8359992,8359246,746,9828,utRho12
rplK,8356708,8356894,8356708,186,778,utRho12
rplM,6757344,6757344,6757302,42,11062,utRho12
rplN,6896444,6896444,6896298,146,12688,utRho12
rplS,5489284,5489284,5489060,224,22818,utRho12
rplT,7199052,7199052,7198996,56,2020,utRho12
rplU,6667036,6667036,6666902,134,142,utRho12
rplY,4564866,4565034,4564866,168,108,utRho12
rpmA,6666450,6666450,6666238,212,832,utRho12
rpmB,15247980,15247980,15246696,1284,157416,utRho12
rpmE,8253816,8254026,8253816,210,1240,utRho12
rpmF,2294676,2294734,2294676,58,61248,utRho12
rpmH,7768130,7768672,7768130,542,6818,utRho12
rpmI,3600854,3600854,3599998,856,10982,utRho12
rpoB,8362126,8362490,8362126,364,1002,utRho12
rpoD,6424946,6426094,6424946,1148,25768,utRho12
rpoE,5420372,5420372,5420024,348,0,utRho12
rpoH,7202006,7202006,7201566,440,5454,utRho12
rpoN,6689324,6689434,6689324,110,74,utRho12
rpoS,5736236,5736236,5735102,1134,3146,utRho12
rpoZ,7644154,7644212,7644154,58,672,utRho12
rppH,5937986,5937986,5937954,32,0,utRho12
rprA,3540744,3540744,3540744,0,0,utRho12
rpsA,1923434,1923990,1923434,556,188168,utRho12
rpsF,8850050,8850236,8850050,186,45962,utRho12
rpsI,6756580,6756580,6756414,166,12494,utRho12
rpsJ,6906884,6906884,6906540,344,14528,utRho12
rpsL,6949242,6949242,6949104,138,210,utRho12
rpsM,6885130,6885130,6884942,188,2378,utRho12
rpsO,13247144,13247144,13246736,408,3204,utRho12
rpsP,5492508,5492508,5492370,138,112,utRho12
rpsT,42420,42420,42156,264,582,utRho12
rpsU,12842584,12843124,12842584,540,2356,utRho12
rraA,8238716,8238716,8238660,56,238,utRho12
rraB,8956768,8956946,8956768,178,56,utRho12
rrsA,8070478,8071062,8070478,584,7690,utRho12
rrsB,16665468,16666636,16665468,1168,16024,utRho12
rrsC,7883032,7883616,7883032,584,8748,utRho12
rrsD,6858094,6858094,6857524,570,716,utRho12
rrsE,8415726,8416294,8415726,568,1438,utRho12
rrsG,5462896,5462896,5462314,582,5874,utRho12
rrsH,446970,447542,446970,572,1082,utRho12
rsd,8393908,8393908,8393616,292,56,utRho12
rseA,5419264,5419264,5418808,456,120,utRho12
rseP,392940,393092,392940,152,42,utRho12
rseX,4067298,4067298,4067298,0,0,utRho12
rsfS,1338144,1338144,1338072,72,266,utRho12
rsgA,8783132,8783132,8783018,114,44,utRho12
rsmA,105176,105176,104860,316,3250,utRho12
rsmB,6869982,6870414,6869982,432,444,utRho12
rsmC,9215736,9215736,9215400,336,292,utRho12
rsmD,7208594,7208786,7208594,192,0,utRho12
rsmE,6182036,6182268,6182036,232,424,utRho12
rsmG,7847512,7847512,7847360,152,1588,utRho12
rsmH,180020,180188,180020,168,20,utRho12
rsmI,6587106,6587106,6586670,436,784,utRho12
rssA,2578212,2578412,2578212,200,320,utRho12
rssB,2580440,2580484,2580440,44,110,utRho12
rstA,3364276,3364300,3364276,24,46,utRho12
rsuA,4561096,4561096,4560966,130,372,utRho12
rsxA,3411510,3411534,3411510,24,0,utRho12
rtcA,7114004,7114004,7113698,306,118,utRho12
rtcB,7116214,7116214,7116158,56,120,utRho12
rtn,4541356,4541452,4541356,96,0,utRho12
rutA,2148052,2148052,2148022,30,0,utRho12
rutG,2140090,2140090,2139678,412,174,utRho12
rutR,2148226,2148484,2148226,258,0,utRho12
ruvA,7784096,7784096,7783904,192,288,utRho12
ruvB,7782176,7782176,7781424,752,1048,utRho12
ruvC,3894878,3894878,3894752,126,0,utRho12
rybB,1776114,1776114,1776114,0,0,utRho12
rydB,3529860,3529860,3529322,538,238,utRho12
rydC,2983012,2983012,2983012,0,0,utRho12
ryfA,5307398,5307710,5307398,312,94,utRho12
ryfD,5468590,5468590,5468590,0,0,utRho12
ryhB,7162032,7162032,7162032,0,0,utRho12
ryjA,8556132,8556132,8556132,0,0,utRho12
ryjB,9055954,9055954,9055954,0,0,utRho12
sad,3229598,3229598,3229406,192,40,utRho12
safA,3168056,3168056,3167918,138,56,utRho12
sanA,4465368,4465756,4465368,388,48,utRho12
sapF,2705314,2705314,2705268,46,154,utRho12
sbcB,4165456,4165512,4165456,56,0,utRho12
sbcC,831694,831694,831506,188,102,utRho12
sbcD,833954,833954,833904,50,0,utRho12
sbmA,793106,793278,793106,172,244,utRho12
sbmC,4162650,4162650,4162524,126,0,utRho12
sdaA,3793618,3793864,3793618,246,182,utRho12
sdaC,5856070,5856458,5856070,388,748,utRho12
sdhC,1509916,1510354,1509916,438,31172,utRho12
sdhD,1510808,1511120,1510808,312,6294,utRho12
sdiA,3993834,3993834,3993664,170,288,utRho12
secE,8354354,8354716,8354354,362,238,utRho12
secG,6645180,6645180,6645010,170,978,utRho12
selA,7522594,7522594,7522498,96,992,utRho12
selB,7519850,7519850,7519722,128,112,utRho12
selC,7672396,7672444,7672396,48,40,utRho12
selD,3696058,3696058,3696016,42,2626,utRho12
seqA,1425884,1425974,1425884,90,430,utRho12
serA,6117098,6117098,6116820,278,362,utRho12
serB,9249712,9249790,9249712,78,70,utRho12
serC,3830380,3830612,3830380,232,0,utRho12
serS,1878730,1878856,1878730,126,1268,utRho12
serT,2063438,2063438,2063424,14,0,utRho12
serU,4087124,4087124,4087114,10,124,utRho12
serV,5637394,5637394,5637290,104,298,utRho12
serW,1852014,1852014,1851942,72,164,utRho12
serX,2195352,2195352,2195304,48,0,utRho12
setB,4527426,4527726,4527426,300,38,utRho12
setC,7673488,7673906,7673488,418,1720,utRho12
sfmA,1116124,1116424,1116124,300,0,utRho12
sfmC,1117606,1117948,1117606,342,0,utRho12
sfsA,323030,323030,322972,58,250,utRho12
sfsB,6669592,6669818,6669592,226,1184,utRho12
sgrR,154676,154676,154598,78,84,utRho12
sgrS,154734,154734,154734,0,0,utRho12
shiA,4107068,4107286,4107068,218,56,utRho12
sibA,4306622,4306622,4306622,0,0,utRho12
sibB,4307292,4307292,4307292,0,0,utRho12
sibC,6113702,6113702,6113702,0,0,utRho12
sibD,6389730,6389730,6389730,0,0,utRho12
sibE,6390480,6390480,6390480,0,0,utRho12
sixA,4913998,4913998,4913624,374,12,utRho12
slp,7307872,7307922,7307872,50,98,utRho12
slt,9261400,9261466,9261400,66,38,utRho12
slyA,3442028,3442028,3441648,380,192,utRho12
slyB,3439496,3439752,3439496,256,76,utRho12
slyD,6957398,6957398,6956994,404,418,utRho12
slyX,6954862,6955280,6954862,418,7598,utRho12
smf,6867372,6867372,6867120,252,58,utRho12
smpB,5509534,5509792,5509534,258,1116,utRho12
smrA,2811872,2811958,2811872,86,164,utRho12
smrB,4896872,4897212,4896872,340,330,utRho12
smtA,1946808,1947074,1946808,266,0,utRho12
sodA,8201518,8201620,8201518,102,8902,utRho12
sodB,3470646,3470756,3470646,110,474,utRho12
sodC,3449358,3449358,3449310,48,0,utRho12
sohB,2658568,2658664,2658568,96,222,utRho12
sokB,2984232,2984238,2984232,6,44,utRho12
solA,2241218,2241218,2241172,46,30,utRho12
soxR,8554894,8554938,8554894,44,176,utRho12
soxS,8554846,8554846,8554766,80,0,utRho12
speA,6172096,6172096,6171822,274,456,utRho12
speB,6167892,6167892,6167594,298,252,utRho12
speC,6218350,6218350,6218310,40,72,utRho12
spf,8099798,8099798,8099798,0,0,utRho12
sppA,3697422,3697674,3697422,252,54,utRho12
spy,3651376,3651376,3651250,126,0,utRho12
sra,3112092,3112092,3111926,166,0,utRho12
sraB,2293178,2293178,2293178,0,0,utRho12
sraC,3846132,3846132,3846132,0,0,utRho12
srlA,5651582,5651664,5651582,82,60,utRho12
srlR,5657720,5658094,5657720,374,330,utRho12
srmB,5425752,5425792,5425752,40,62,utRho12
sroA,151216,151216,151216,0,0,utRho12
sroG,6369436,6369436,6369436,0,0,utRho12
sroH,8380974,8380974,8380974,0,0,utRho12
ssb,8548022,8548250,8548022,228,0,utRho12
sseA,5304782,5304988,5304782,206,5958,utRho12
sspA,6755138,6755138,6754840,298,168,utRho12
ssrA,5511014,5511186,5511014,172,48,utRho12
ssrS,12223036,12223932,12223036,896,876,utRho12
sstT,6479726,6479888,6479726,162,56,utRho12
ssuB,1988282,1988282,1988088,194,18,utRho12
ssuE,1995126,1995126,1995024,102,24,utRho12
sthA,8321604,8321604,8321580,24,1210,utRho12
stpA,5597156,5597156,5596990,166,42,utRho12
sucA,3034344,3034824,3034344,480,4160,utRho12
sufA,3528836,3528836,3528772,64,22,utRho12
sufE,3518962,3518962,3518580,382,562,utRho12
sugE,8753588,8753750,8753588,162,1488,utRho12
sulA,2041894,2041894,2041838,56,4452,utRho12
syd,5850738,5850738,5850560,178,98,utRho12
symE,9159834,9159834,9159680,154,314,utRho12
symR,9159670,9159670,9159670,0,0,utRho12
tabA,8949566,8949724,8949566,158,70,utRho12
talA,5157140,5157332,5157140,192,50,utRho12
talB,16382,16476,16382,94,4834,utRho12
tam,3214442,3214692,3214442,250,6,utRho12
tamA,8884540,8884764,8884540,224,192,utRho12
tar,3945432,3945432,3945382,50,168,utRho12
tas,5943138,5943194,5943138,56,1350,utRho12
tatA,16087636,16087780,16087636,144,0,utRho12
tatE,1317742,1317894,1317742,152,164,utRho12
tauA,770410,770464,770410,54,0,utRho12
tdcA,6534186,6534186,6534130,56,14,utRho12
tdcG,6519652,6519652,6519298,354,94,utRho12
tdcR,6534380,6534760,6534380,380,130,utRho12
tdk,2586986,2587054,2586986,68,20,utRho12
tehA,3001072,3001146,3001072,74,0,utRho12
tesA,1039898,1039898,1039530,368,104,utRho12
tesB,950402,950402,950322,80,0,utRho12
tfaE,2418532,2418532,2418238,294,38,utRho12
tfaQ,3269912,3269912,3269770,142,92,utRho12
tff,379424,379256,379424,168,116,utRho12
tgt,852110,852274,852110,164,0,utRho12
thiD,4369346,4369346,4369032,314,78,utRho12
thiI,882936,883098,882936,162,138,utRho12
thiM,4370902,4370902,4370602,300,668,utRho12
thiQ,146170,146170,145854,316,282,utRho12
thrL,592,760,592,168,1160,utRho12
thrS,7210932,7210932,7210280,652,580,utRho12
thrU,8350762,8350776,8350762,14,2,utRho12
thrV,6847414,6847414,6847310,104,185984,utRho12
thrW,525682,525742,525682,60,1348,utRho12
thyA,5930696,5930696,5930310,386,2664,utRho12
tig,909986,910266,909986,280,1180,utRho12
tisB,7706674,7707106,7706674,432,752,utRho12
tktA,6163414,6163414,6163270,144,208,utRho12
tktB,5158616,5159272,5158616,656,1116,utRho12
tldD,6784368,6784368,6784056,312,0,utRho12
tmcA,5191876,5191876,5191718,158,80,utRho12
tnaC,15553644,15553740,15553644,96,1716,utRho12
tolB,1555074,1555480,1555074,406,426,utRho12
tolC,6356008,6356230,6356008,222,588,utRho12
tomB,961588,961588,961416,172,2750,utRho12
tonB,2622108,2622178,2622108,70,84,utRho12
topA,2661578,2662096,2661578,518,248,utRho12
torC,2116112,2116168,2116112,56,166,utRho12
torR,2115968,2115968,2115908,60,66,utRho12
torS,2112364,2112364,2112356,8,0,utRho12
torT,2112414,2112522,2112414,108,0,utRho12
tpiA,8223138,8223138,8223014,124,54,utRho12
tppB,3425342,3425538,3425342,196,6022,utRho12
tpr,2574376,2574376,2574376,0,0,utRho12
tpx,2777688,2777688,2777622,66,602,utRho12
tqsA,3347780,3347826,3347780,46,0,utRho12
treA,2494850,2494850,2494752,98,1004,utRho12
treB,8932420,8932420,8932360,60,56,utRho12
treF,7339102,7339184,7339102,82,30,utRho12
treR,8934694,8934694,8934492,202,48,utRho12
trg,2984878,2984940,2984878,62,36,utRho12
trkG,2847342,2847564,2847342,222,66,utRho12
trmA,8326590,8326590,8326540,50,2,utRho12
trpA,2634678,2634678,2634444,234,688,utRho12
trpC,2639888,2639888,2639570,318,60,utRho12
trpL,5292432,5292432,5292328,104,0,utRho12
trpR,9265408,9265520,9265408,112,152,utRho12
trpS,7027394,7027394,7027276,118,2120,utRho12
trpT,7893560,7893914,7893560,354,122414,utRho12
trxA,7931294,7931522,7931294,228,130,utRho12
trxB,1864156,1864156,1864100,56,0,utRho12
trxC,5437350,5437470,5437350,120,186,utRho12
tsaD,6421256,6421256,6421086,170,0,utRho12
tsgA,6985038,6985136,6985038,98,18,utRho12
tsr,9182824,9183314,9182824,490,86,utRho12
tsx,864490,864490,864026,464,108,utRho12
ttcA,2823970,2823970,2823896,74,3694,utRho12
ttdA,6412848,6412926,6412848,78,0,utRho12
ttdR,6412760,6412760,6412512,248,116,utRho12
tufA,6943448,6943448,6942658,790,174414,utRho12
tus,3368346,3368518,3368346,172,104,utRho12
tusA,7218040,7218040,7217992,48,0,utRho12
tusB,6950218,6950218,6949930,288,694,utRho12
tynA,2902996,2902996,2902698,298,0,utRho12
typA,8116460,8116814,8116460,354,10044,utRho12
tyrB,8534164,8534228,8534164,64,2890,utRho12
tyrP,3979004,3979362,3979004,358,460,utRho12
tyrR,2773384,2773440,2773384,56,54,utRho12
tyrS,3434566,3434566,3434444,122,0,utRho12
tyrT,2575330,2575330,2575244,86,188,utRho12
uacT,6062378,6062734,6062378,356,0,utRho12
ubiC,8504886,8505012,8504886,126,76,utRho12
ubiD,8049618,8049976,8049618,358,1354,utRho12
ubiE,8037494,8037710,8037494,216,100,utRho12
ubiG,4679078,4679134,4679078,56,0,utRho12
ucpA,5089342,5089342,5089246,96,0,utRho12
udp,8032782,8032862,8032782,80,70,utRho12
ugd,4199470,4199470,4199226,244,54,utRho12
ugpB,7184852,7184852,7184650,202,1436,utRho12
ugpQ,7176600,7176600,7176226,374,40,utRho12
uhpT,7694396,7694396,7694334,62,52,utRho12
uidA,3392304,3392304,3392142,162,6,utRho12
uidC,3386012,3386012,3385702,310,0,utRho12
uidR,3394150,3394150,3394104,46,42,utRho12
ulaA,8839854,8839960,8839854,106,148,utRho12
ulaG,8839350,8839350,8839250,100,98,utRho12
ulaR,8837124,8837124,8836906,218,66,utRho12
umpG,5741372,5741372,5740548,824,256,utRho12
umpH,1400704,1400704,1400652,52,24,utRho12
umuD,2461476,2461534,2461476,58,0,utRho12
ung,5433476,5433508,5433476,32,216,utRho12
uof,2843316,2843316,2842900,416,8128,utRho12
upp,5241818,5241818,5241744,74,218,utRho12
usg,4873780,4873780,4873298,482,232,utRho12
ushA,1009772,1009828,1009772,56,0,utRho12
uspA,7279966,7280222,7279966,256,170,utRho12
uspB,7279696,7279696,7279440,256,138,utRho12
uspC,3959172,3959506,3959172,334,214,utRho12
uspE,2797318,2797318,2797244,74,54,utRho12
uspF,2871282,2871282,2871238,44,154,utRho12
uspG,1283806,1283806,1283734,72,1772,utRho12
uvrA,8547872,8547872,8547742,130,160,utRho12
uvrB,1626304,1627052,1626304,748,386,utRho12
uvrC,3989758,3989758,3989412,346,128,utRho12
uvrD,7995814,7995966,7995814,152,188,utRho12
uvrY,3990812,3990812,3990718,94,354,utRho12
uxaB,3221474,3221474,3221360,114,0,utRho12
uxaC,6489714,6489714,6489482,232,0,utRho12
uxuA,9103036,9103272,9103036,236,4,utRho12
uxuR,9108916,9109152,9108916,236,68,utRho12
valS,8967854,8967854,8967674,180,442,utRho12
valU,5041848,5041862,5041848,14,44,utRho12
valV,3492830,3492870,3492830,40,26,utRho12
ves,3649968,3649968,3649874,94,0,utRho12
waaA,7616512,7617080,7616512,568,920,utRho12
waaH,7580298,7580298,7580162,136,72,utRho12
waaQ,7616476,7616476,7616196,280,46,utRho12
waaU,7598996,7598996,7598624,372,246,utRho12
waaY,7602272,7602272,7601930,342,6316,utRho12
wbbH,4214888,4214888,4214452,436,5274,utRho12
wbbK,4209212,4209212,4209018,194,460,utRho12
wcaM,4231868,4231868,4231792,76,0,utRho12
wrbA,2135516,2135516,2135416,100,0,utRho12
wza,4275166,4275166,4274486,680,0,utRho12
wzxC,4240674,4240674,4240316,358,2,utRho12
wzzB,4196950,4196950,4196602,348,140,utRho12
xanP,7657642,7657890,7657642,248,0,utRho12
xanQ,6048520,6048702,6048520,182,0,utRho12
xapA,5049820,5049820,5049756,64,22,utRho12
xapR,10090252,10090252,10089908,344,0,utRho12
xdhA,6000514,6000690,6000514,176,264,utRho12
xerD,6079702,6079702,6079486,216,204,utRho12
xseA,5268394,5268464,5268394,70,300,utRho12
xseB,882746,882746,882686,60,178,utRho12
xthA,3664798,3664856,3664798,58,0,utRho12
xylA,7461614,7461614,7461530,84,1640,utRho12
xylE,8484540,8484540,8484508,32,0,utRho12
xylF,7462138,7462262,7462138,124,88,utRho12
xylR,7469812,7469958,7469812,146,54,utRho12
yaaA,13230,13230,12918,312,154,utRho12
yaaI,23876,23876,23572,304,144,utRho12
yaaJ,16034,16034,15918,116,22,utRho12
yaaU,91184,91614,91184,430,0,utRho12
yaaW,23084,23084,22712,372,120,utRho12
yaaX,10060,10468,10060,408,224,utRho12
yabI,142542,142702,142542,160,50,utRho12
yacC,273880,273880,273834,46,620,utRho12
yacH,262932,262932,262520,412,244,utRho12
yacL,268678,268776,268678,98,314,utRho12
yadD,293796,293936,293796,140,138,utRho12
yadE,289930,290162,289930,232,586,utRho12
yadN,314110,314110,313766,344,456,utRho12
yadS,355572,355572,355248,324,1714,utRho12
yadV,312470,312470,312402,68,12,utRho12
yaeF,434270,434270,434006,264,0,utRho12
yaeP,428374,428374,428250,124,450,utRho12
yaeQ,428176,428582,428176,406,700,utRho12
yaeR,423716,423754,423716,38,0,utRho12
yafC,462166,462166,461762,404,96,utRho12
yafD,462128,462244,462128,116,46,utRho12
yafK,491986,491986,491610,376,1288,utRho12
yafL,493282,493424,493282,142,0,utRho12
yafN,503938,504010,503938,72,18,utRho12
yafS,469568,469632,469568,64,800,utRho12
yafT,474470,474670,474470,200,120,utRho12
yafV,480432,480432,480378,54,90,utRho12
yafZ,536052,536052,536010,42,14,utRho12
yagE,564446,564556,564446,110,48,utRho12
yagG,570414,570790,570414,376,0,utRho12
yagI,578384,578384,578324,60,132,utRho12
yagK,586236,586236,585896,340,212,utRho12
yagL,588062,588062,587836,226,344,utRho12
yagN,591342,591342,591158,184,514,utRho12
yahA,663746,664742,663746,996,1904,utRho12
yahC,670136,670136,670044,92,436,utRho12
yahE,671478,671850,671478,372,8,utRho12
yahM,690504,690808,690504,304,88,utRho12
yahN,692872,692872,692674,198,174,utRho12
yahO,692864,692968,692864,104,4,utRho12
yaiE,816296,816354,816296,58,130,utRho12
yaiI,811396,811528,811396,132,0,utRho12
yaiO,761946,761946,761684,262,24,utRho12
yaiP,767970,767970,767870,100,0,utRho12
yaiS,769660,769660,769232,428,0,utRho12
yaiV,788922,788922,788922,0,0,utRho12
yaiY,799094,799094,798666,428,176,utRho12
yaiZ,798888,799186,798888,298,624,utRho12
yajC,854410,854574,854410,164,1334,utRho12
yajD,860938,861210,860938,272,812,utRho12
yajI,866068,866068,865702,366,490,utRho12
yajL,887496,887496,887282,214,908,utRho12
yajQ,889316,889366,889316,50,122,utRho12
yajR,893374,893374,893332,42,612,utRho12
ybaB,987418,988152,987418,734,4188,utRho12
ybaL,1006590,1006590,1006476,114,110,utRho12
ybaM,980648,980648,980542,106,554,utRho12
ybaN,981436,981764,981436,328,394,utRho12
ybaO,936704,936766,936704,62,0,utRho12
ybaP,1016568,1016568,1016160,408,570,utRho12
ybaQ,1016348,1016436,1016348,88,54,utRho12
ybaS,1023146,1023282,1023146,136,116,utRho12
ybaV,927504,927874,927504,370,118,utRho12
ybaY,950490,950758,950490,268,6,utRho12
ybbB,1062724,1062724,1062452,272,0,utRho12
ybbJ,1030154,1030154,1029718,436,534,utRho12
ybbL,1031784,1031838,1031784,54,0,utRho12
ybbN,1037136,1037136,1036558,578,1168,utRho12
ybbO,1038658,1038658,1038298,360,956,utRho12
ybbY,1080718,1081130,1080718,412,0,utRho12
ybcH,1176140,1176140,1175962,178,226,utRho12
ybcI,1113264,1113264,1113106,158,2732,utRho12
ybcJ,1114050,1114050,1113746,304,146,utRho12
ybcK,1137502,1137804,1137502,302,136,utRho12
ybcL,1141690,1141786,1141690,96,0,utRho12
ybcN,1144628,1144932,1144628,304,84,utRho12
ybcQ,1147548,1147912,1147548,364,214,utRho12
ybcW,1159610,1159760,1159610,150,0,utRho12
ybdD,1263982,1264364,1263982,382,222,utRho12
ybdF,1212106,1212106,1211772,334,112,utRho12
ybdH,1267048,1267048,1266954,94,138,utRho12
ybdJ,1212822,1212822,1212398,424,0,utRho12
ybdK,1215122,1215122,1214766,356,1608,utRho12
ybdL,1267114,1267172,1267114,58,90,utRho12
ybdM,1271110,1271110,1270752,358,252,utRho12
ybdN,1273372,1273372,1273138,234,58,utRho12
ybdR,1283844,1284176,1283844,332,2018,utRho12
ybeD,1325412,1325412,1325284,128,120,utRho12
ybeF,1323090,1323090,1322756,334,1320,utRho12
ybeL,1349986,1350036,1349986,50,132,utRho12
ybeQ,1353412,1353412,1353094,318,0,utRho12
ybeR,1353120,1353422,1353120,302,0,utRho12
ybeT,1358832,1358832,1358812,20,0,utRho12
ybeU,1358924,1359016,1358924,92,0,utRho12
ybeZ,1386938,1386938,1386834,104,6522,utRho12
ybfA,1458074,1458268,1458074,194,82,utRho12
ybfE,1423878,1423878,1423796,82,308,utRho12
ybfF,1425692,1425692,1425604,88,208,utRho12
ybfH,1433282,1433282,1433194,88,34,utRho12
ybgA,1477840,1478002,1477840,162,0,utRho12
ybgC,1549288,1549504,1549288,216,26,utRho12
ybgD,1505916,1505916,1505590,326,8920,utRho12
ybgI,1485238,1485654,1485238,416,6,utRho12
ybgO,1498370,1498370,1497964,406,28,utRho12
ybgS,1570992,1570992,1570634,358,110,utRho12
ybhA,1597184,1597184,1596862,322,174,utRho12
ybhB,1616070,1616070,1615818,252,52,utRho12
ybhC,1614642,1614642,1614562,80,666,utRho12
ybhD,1601418,1601418,1601276,142,0,utRho12
ybhH,1601104,1601518,1601104,414,0,utRho12
ybhK,1633384,1633384,1633294,90,90,utRho12
ybhM,1641556,1641586,1641556,30,66,utRho12
ybhN,1645296,1645296,1644996,300,204,utRho12
ybhQ,1649202,1649260,1649202,58,248,utRho12
ybiA,1665920,1665920,1665900,20,0,utRho12
ybiI,1676968,1676968,1676912,56,390,utRho12
ybiO,1691328,1691328,1690960,368,478,utRho12
ybiP,1705252,1705252,1705194,58,488,utRho12
ybiS,1711572,1711572,1711488,84,746,utRho12
ybiT,1711894,1711926,1711894,32,0,utRho12
ybiU,1718212,1718212,1718122,90,18,utRho12
ybiV,1720176,1720176,1720056,120,0,utRho12
ybiW,1725566,1725566,1725212,354,1850,utRho12
ybiX,1678548,1678548,1678414,134,198,utRho12
ybjC,1781784,1781826,1781784,42,0,utRho12
ybjE,1830154,1830154,1829714,440,436,utRho12
ybjG,1767016,1767016,1766776,240,1986,utRho12
ybjL,1779882,1779882,1779638,244,82,utRho12
ybjM,1779770,1780178,1779770,408,276,utRho12
ybjO,1795704,1795978,1795704,274,0,utRho12
ybjP,1809046,1809046,1808934,112,0,utRho12
ybjQ,1809034,1809186,1809034,152,0,utRho12
ybjS,1813796,1813796,1813506,290,162,utRho12
ybjX,1838206,1838206,1838168,38,0,utRho12
ycaD,1891438,1891742,1891438,304,2,utRho12
ycaI,1928210,1928640,1928210,430,296,utRho12
ycaK,1899094,1899336,1899094,242,54,utRho12
ycaL,1920264,1920528,1920264,264,2,utRho12
ycaM,1894240,1894458,1894240,218,326,utRho12
ycaR,1941284,1941346,1941284,62,2962,utRho12
ycbB,1961862,1962094,1961862,232,128,utRho12
ycbJ,1943344,1943504,1943344,160,52,utRho12
ycbK,1966046,1966150,1966046,104,174,utRho12
ycbZ,2036920,2036920,2036598,322,52,utRho12
yccA,2062886,2062886,2062836,50,60,utRho12
yccF,2048730,2048730,2048696,34,80,utRho12
yccS,2047988,2047988,2047766,222,132,utRho12
yccT,2055674,2055674,2055546,128,22,utRho12
yccX,2059960,2060128,2059960,168,890,utRho12
ycdT,2185682,2185752,2185682,70,0,utRho12
ycdU,2191266,2191686,2191266,420,28,utRho12
ycdZ,2200504,2200592,2200504,88,28,utRho12
yceA,2233544,2233614,2233544,70,176,utRho12
yceD,2293298,2293588,2293298,290,7926,utRho12
yceF,2293522,2293522,2293190,332,5312,utRho12
yceH,2252154,2252314,2252154,160,938,utRho12
yceI,2237282,2237282,2236952,330,324,utRho12
yceJ,2238142,2238142,2238092,50,324,utRho12
yceM,2253208,2253612,2253208,404,188,utRho12
yceO,2239264,2239264,2238894,370,652,utRho12
yceQ,2288760,2289004,2288760,244,4398,utRho12
ycfD,2376540,2376540,2376480,60,184,utRho12
ycfJ,2334814,2335198,2334814,384,216,utRho12
ycfS,2340834,2340834,2340748,86,4,utRho12
ycfT,2350658,2350658,2350330,328,0,utRho12
ycfZ,2362760,2362760,2362534,226,926,utRho12
ycgB,2474570,2474570,2474482,88,74,utRho12
ycgG,2434614,2434656,2434614,42,472,utRho12
ycgJ,2452956,2453200,2452956,244,44,utRho12
ycgL,2455218,2455362,2455218,144,0,utRho12
ycgN,2457366,2457660,2457366,294,210,utRho12
ycgR,2489112,2489112,2489054,58,0,utRho12
ycgV,2512222,2512222,2511904,318,1700,utRho12
ycgX,2426568,2426568,2426214,354,22336,utRho12
ycgY,2490166,2490320,2490166,154,688,utRho12
ycgZ,2431504,2431578,2431504,74,38,utRho12
ychE,2596904,2597196,2596904,292,12,utRho12
ychF,2515764,2515764,2515624,140,82,utRho12
ychH,2517476,2517582,2517476,106,906,utRho12
ychJ,2578354,2578354,2578264,90,0,utRho12
ychN,2547310,2547310,2547198,112,54,utRho12
ychO,2547520,2547850,2547520,330,54,utRho12
ychQ,2533798,2533848,2533798,50,66,utRho12
yciA,2624828,2624828,2624492,336,94,utRho12
yciB,2626110,2626110,2625780,330,2042,utRho12
yciC,2627396,2627396,2627326,70,0,utRho12
yciE,2630794,2630794,2630448,346,302,utRho12
yciG,5264368,5264368,5264140,228,0,utRho12
yciI,2621784,2621784,2621730,54,90,utRho12
yciN,2661606,2661606,2661336,270,38,utRho12
yciS,2680270,2680486,2680270,216,24,utRho12
yciT,2689088,2689088,2688692,396,1020,utRho12
yciU,2614718,2614718,2614300,418,1566,utRho12
yciV,2646376,2646440,2646376,64,0,utRho12
yciW,2700472,2700472,2700214,258,1922,utRho12
yciZ,2689276,2689276,2689218,58,888,utRho12
ycjD,2703792,2703792,2703520,272,70,utRho12
ycjG,2777748,2777860,2777748,112,148,utRho12
ycjM,2740006,2740432,2740006,426,166,utRho12
ycjW,2767982,2767982,2767922,60,42,utRho12
ycjX,2768138,2768234,2768138,96,80,utRho12
ycjY,5568288,5568288,5567460,828,528,utRho12
ydaE,2836438,2836438,2836016,422,412,utRho12
ydaN,2816048,2816100,2816048,52,58,utRho12
ydaS,2840340,2840730,2840340,390,72,utRho12
ydbC,2948376,2948442,2948376,66,0,utRho12
ydbD,2950132,2950288,2950132,156,0,utRho12
ydbH,2885800,2886102,2885800,302,58,utRho12
ydbJ,2881712,2882116,2881712,404,220,utRho12
ydbK,2881692,2881692,2881568,124,66,utRho12
ydcA,2983294,2983354,2983294,60,116,utRho12
ydcF,2974404,2974470,2974404,66,18,utRho12
ydcI,2990268,2990268,2990142,126,0,utRho12
ydcJ,2990266,2990576,2990266,310,0,utRho12
ydcK,3001280,3001280,3000898,382,0,utRho12
ydcL,3004646,3004914,3004646,268,0,utRho12
ydcN,3012308,3012344,3012308,36,146,utRho12
ydcP,3013508,3013562,3013508,54,0,utRho12
ydcR,3019956,3020006,3019956,50,0,utRho12
ydcS,3022906,3023308,3022906,402,148,utRho12
ydcX,3034442,3034778,3034442,336,230,utRho12
ydcY,3035220,3035296,3035220,76,0,utRho12
ydcZ,3036750,3036750,3036662,88,456,utRho12
yddB,3155332,3155332,3155238,94,0,utRho12
yddE,3071738,3071738,3071716,22,0,utRho12
yddG,3094410,3094410,3094338,72,0,utRho12
yddJ,3089732,3089732,3089438,294,0,utRho12
yddW,3137704,3137704,3137646,58,0,utRho12
ydeA,3233910,3234056,3233910,146,50,utRho12
ydeE,3242528,3242664,3242528,136,90,utRho12
ydeI,3249118,3249118,3248994,124,18,utRho12
ydeJ,3249376,3249546,3249376,170,0,utRho12
ydeN,3165458,3165458,3165048,410,0,utRho12
ydeP,3173328,3173328,3172972,356,52,utRho12
ydeR,3176596,3176596,3176592,4,128,utRho12
ydfA,3296872,3297016,3296872,144,0,utRho12
ydfG,3254982,3255034,3254982,52,0,utRho12
ydfH,3256652,3256704,3256652,52,2,utRho12
ydfK,3265446,3266144,3265446,698,14020,utRho12
ydgA,3379588,3379704,3379588,116,0,utRho12
ydgC,3364124,3364124,3364060,64,60,utRho12
ydgD,3343906,3343920,3343906,14,122,utRho12
ydgH,3356754,3356854,3356754,100,0,utRho12
ydgJ,3408798,3408798,3408616,182,166,utRho12
ydgK,3410414,3410500,3410414,86,286,utRho12
ydhB,3479618,3479618,3479596,22,0,utRho12
ydhC,3479698,3479822,3479698,124,0,utRho12
ydhF,3451310,3451310,3451264,46,0,utRho12
ydhI,3441996,3442050,3441996,54,26,utRho12
ydhL,3451864,3451864,3451840,24,0,utRho12
ydhQ,3492404,3492404,3492254,150,0,utRho12
ydhS,3494136,3494262,3494136,126,2200,utRho12
ydhT,3499138,3499138,3499118,20,58,utRho12
ydhY,3509284,3509284,3508954,330,154,utRho12
ydhZ,3510418,3510418,3510282,136,0,utRho12
ydiE,3579206,3579226,3579206,20,0,utRho12
ydiH,3530582,3530582,3530406,176,30,utRho12
ydiM,3541852,3542142,3541852,290,86,utRho12
ydiN,3544818,3545024,3544818,206,0,utRho12
ydiP,3558656,3558656,3558602,54,0,utRho12
ydiU,3582508,3582508,3582488,20,404,utRho12
ydiV,3584174,3584174,3584040,134,128,utRho12
ydiY,3612500,3612500,3612166,334,16,utRho12
ydjA,3697400,3697400,3697352,48,54,utRho12
ydjE,3708082,3708082,3707958,124,0,utRho12
ydjF,3709848,3709848,3709708,140,0,utRho12
ydjM,3620340,3620422,3620340,82,0,utRho12
ydjO,3626696,3626696,3626288,408,100,utRho12
ydjX,3666434,3666802,3666434,368,1066,utRho12
yeaE,3731448,3731448,3731272,176,80,utRho12
yeaG,3733530,3733816,3733530,286,0,utRho12
yeaI,3740486,3740770,3740486,284,26,utRho12
yeaJ,3743874,3744082,3743874,208,156,utRho12
yeaL,3748646,3748704,3748646,58,216,utRho12
yeaM,3751296,3751296,3751152,144,0,utRho12
yeaN,3750926,3751346,3750926,420,74,utRho12
yeaO,3753554,3753818,3753554,264,82,utRho12
yeaP,3755314,3755430,3755314,116,458,utRho12
yeaQ,3758780,3758780,3758510,270,308,utRho12
yeaR,3759988,3759988,3759896,92,120,utRho12
yeaY,3781122,3781122,3781064,58,138,utRho12
yebB,3892220,3892502,3892220,282,512,utRho12
yebC,3896370,3896370,3896302,68,14,utRho12
yebE,3859464,3859464,3859414,50,246,utRho12
yebG,3861530,3861530,3861494,36,42,utRho12
yebK,3873180,3873304,3873180,124,16,utRho12
yebQ,3820314,3820552,3820314,238,8,utRho12
yebS,3832238,3832516,3832238,278,14,utRho12
yebV,3843430,3843560,3843430,130,0,utRho12
yebW,3843914,3844242,3843914,328,1380,utRho12
yecC,3995646,3995646,3995628,18,0,utRho12
yecD,3901272,3901664,3901272,392,122,utRho12
yecF,3991434,3991636,3991434,202,148,utRho12
yecH,3979304,3979304,3978980,324,608,utRho12
yecJ,3975604,3975604,3975516,88,0,utRho12
yecM,3919968,3919968,3919692,276,72,utRho12
yecR,3976400,3976444,3976400,44,20,utRho12
yecT,3923862,3923944,3923862,82,204,utRho12
yedD,4016522,4016522,4016180,342,74,utRho12
yedE,4016310,4016554,4016310,244,54,utRho12
yedI,4058922,4058922,4058732,190,46,utRho12
yedJ,4066446,4066446,4066158,288,32,utRho12
yedV,4076404,4076404,4076304,100,78,utRho12
yedX,4077680,4077912,4077680,232,0,utRho12
yedY,4078572,4078956,4078572,384,34,utRho12
yeeA,4161322,4161322,4161182,140,0,utRho12
yeeE,4171104,4171104,4171050,54,0,utRho12
yeeJ,4089526,4089822,4089526,296,3724,utRho12
yeeN,4113508,4113716,4113508,208,914,utRho12
yeeO,4119444,4119444,4119692,248,0,utRho12
yeeX,4158834,4158834,4158722,112,292,utRho12
yeeZ,4178422,4178422,4178256,166,0,utRho12
yefM,4179466,4179466,4179426,40,64,utRho12
yegD,4295288,4295348,4295288,60,0,utRho12
yegH,4275726,4275804,4275726,78,300,utRho12
yegI,4302154,4302154,4301970,184,0,utRho12
yegJ,4302032,4302370,4302032,338,88,utRho12
yegQ,4331182,4331336,4331182,154,106,utRho12
yegR,4336698,4336698,4336612,86,246,utRho12
yegS,4337086,4337424,4337086,338,92,utRho12
yegT,4357562,4357642,4357562,80,142,utRho12
yegX,4367640,4367640,4367302,338,120,utRho12
yehA,4376944,4376944,4376828,116,38,utRho12
yehE,4385818,4385818,4385592,226,0,utRho12
yehK,4407568,4407944,4407568,376,0,utRho12
yehL,4408804,4409192,4408804,388,0,utRho12
yeiB,4486146,4486146,4485934,212,0,utRho12
yeiE,4499422,4499422,4499236,186,0,utRho12
yeiG,4487776,4487820,4487776,44,308,utRho12
yeiH,4499332,4499434,4499332,102,18,utRho12
yeiI,4503306,4503400,4503306,94,4,utRho12
yeiL,4510580,4510710,4510580,130,142,utRho12
yeiP,4530834,4530900,4530834,66,638,utRho12
yeiQ,4532328,4532490,4532328,162,554,utRho12
yeiR,4535484,4535658,4535484,174,148,utRho12
yeiW,4530840,4530840,4530590,250,842,utRho12
yejA,4544624,4544728,4544624,104,0,utRho12
yejG,4556892,4556892,4556474,418,3952,utRho12
yejH,4561244,4561264,4561244,20,0,utRho12
yejK,4568218,4568218,4567894,324,406,utRho12
yejO,4578352,4578352,4577800,552,180,utRho12
yfaD,4713380,4713808,4713380,428,410,utRho12
yfaE,4696676,4697028,4696676,352,630,utRho12
yfaL,4688568,4688568,4688338,230,0,utRho12
yfaP,4656398,4656398,4656286,112,0,utRho12
yfaU,4717892,4717892,4717690,202,4,utRho12
yfaY,4727310,4727310,4727266,44,48,utRho12
yfaZ,4728744,4728744,4728550,194,0,utRho12
yfbK,4771810,4771810,4771444,366,252,utRho12
yfbL,4771500,4771720,4771500,220,212,utRho12
yfbN,4777174,4777174,4776852,322,248,utRho12
yfbO,4776916,4777162,4776916,246,206,utRho12
yfbP,4777990,4778232,4777990,242,5974,utRho12
yfbR,4817662,4817724,4817662,62,24,utRho12
yfcI,4847424,4847424,4847078,346,904,utRho12
yfcJ,4880482,4880482,4880240,242,802,utRho12
yfcL,4888502,4888502,4888338,164,62,utRho12
yfcV,4911642,4911642,4911292,350,74,utRho12
yfcZ,4921958,4921958,4921868,90,18,utRho12
yfdF,4925604,4926024,4925604,420,10958,utRho12
yfdG,4935474,4935710,4935474,236,0,utRho12
yfdP,4946844,4947040,4946844,196,0,utRho12
yfdX,4988866,4988866,4988804,62,24,utRho12
yfdY,4990672,4990672,4990584,88,24,utRho12
yfeA,5035784,5035784,5035664,120,26198,utRho12
yfeC,5036668,5036934,5036668,266,272,utRho12
yfeH,5053818,5053892,5053818,74,0,utRho12
yfeK,5074630,5074684,5074630,54,0,utRho12
yfeO,5018906,5019260,5018906,354,286,utRho12
yfeR,5054078,5054078,5053712,366,56,utRho12
yfeX,5101356,5101356,5101090,266,2,utRho12
yfeY,5102486,5102486,5102432,54,0,utRho12
yfeZ,5103842,5103842,5103452,390,86,utRho12
yffO,5123804,5124222,5123804,418,32,utRho12
yffQ,5126778,5127154,5126778,376,116,utRho12
yffS,5128800,5128986,5128800,186,222,utRho12
yfgC,5232052,5232188,5232052,136,48,utRho12
yfgF,5258062,5258062,5257876,186,362,utRho12
yfgG,5258170,5258580,5258170,410,920,utRho12
yfgH,5259344,5259584,5259344,240,28,utRho12
yfgM,5278866,5278866,5278566,300,360,utRho12
yfhH,5397414,5397518,5397414,104,202,utRho12
yfhM,5304648,5304648,5304574,74,176,utRho12
yfhR,5328408,5328726,5328408,318,8366,utRho12
yfiC,5425610,5425610,5425528,82,90,utRho12
yfiE,5430688,5430688,5430640,48,468,utRho12
yfiL,5482630,5482720,5482630,90,52,utRho12
yfiM,5448066,5448358,5448066,292,15938,utRho12
yfiR,5483354,5483750,5483354,396,238,utRho12
yfjH,5517326,5517326,5517200,126,146,utRho12
yfjI,5517710,5517970,5517710,260,56,utRho12
yfjJ,5521014,5521094,5521014,80,124,utRho12
yfjM,5531970,5531970,5531552,418,3004,utRho12
yfjP,5535080,5535420,5535080,340,1214,utRho12
yfjW,5546570,5546636,5546570,66,0,utRho12
yfjX,5551776,5551838,5551776,62,0,utRho12
ygaC,5601180,5601180,5599988,1192,294,utRho12
ygaM,5600242,5600292,5600242,50,46,utRho12
ygaU,5593628,5593628,5593572,56,66,utRho12
ygaZ,5619190,5619234,5619190,44,298,utRho12
ygbA,5713656,5713656,5713612,44,0,utRho12
ygbE,5746784,5746784,5746674,110,48,utRho12
ygbI,5722882,5722882,5722528,354,114,utRho12
ygbK,5724394,5724670,5724394,276,32,utRho12
ygbL,5727074,5727186,5727074,112,0,utRho12
ygbN,5729814,5730202,5729814,388,428,utRho12
ygcG,5811210,5811422,5811210,212,0,utRho12
ygcN,5785144,5785314,5785144,170,36,utRho12
ygcU,5799214,5799214,5798836,378,0,utRho12
ygcW,5800942,5800942,5800546,396,0,utRho12
ygdD,5883442,5883442,5883262,180,38,utRho12
ygdG,5861746,5861930,5861746,184,566,utRho12
ygdI,5886526,5886526,5886290,236,372,utRho12
ygdQ,5940784,5940840,5940784,56,24,utRho12
ygdR,5942494,5942542,5942494,48,0,utRho12
ygeA,5961606,5961606,5961270,336,100,utRho12
ygeH,5983758,5984188,5983758,430,124,utRho12
ygeI,5987162,5987276,5987162,114,714,utRho12
ygeR,6000078,6000078,5999782,296,622,utRho12
ygeV,6011694,6011694,6011572,122,0,utRho12
ygeW,6012234,6012524,6012234,290,474,utRho12
ygfB,6110946,6110946,6110888,58,28,utRho12
ygfK,6031984,6032120,6031984,136,94,utRho12
ygfS,6058328,6058328,6058024,304,0,utRho12
ygfZ,6082564,6082626,6082564,62,208,utRho12
yggC,6149512,6149512,6149378,134,22,utRho12
yggE,6136370,6136370,6136160,210,2,utRho12
yggI,6179176,6179510,6179176,334,528,utRho12
yggL,6204508,6204508,6204266,242,84,utRho12
yggM,6199514,6199514,6199130,384,218,utRho12
yggN,6203596,6203596,6203246,350,24,utRho12
yggX,18623958,18624558,18623958,600,960,utRho12
yghA,6298966,6299324,6298966,358,0,utRho12
yghB,6307058,6307126,6307058,68,6,utRho12
yghD,6222614,6222614,6222252,362,158,utRho12
yghF,6225798,6225798,6225840,42,46,utRho12
yghJ,6238640,6238640,6238224,416,98,utRho12
yghQ,6265186,6265186,6264816,370,112,utRho12
yghT,6267830,6268262,6267830,432,0,utRho12
yghU,6277400,6277454,6277400,54,74,utRho12
yghW,6293506,6293506,6293474,32,12,utRho12
yghZ,6295562,6295794,6295562,232,312,utRho12
ygiD,6365122,6365122,6364868,254,3946,utRho12
ygiH,6409066,6409388,6409066,322,110,utRho12
ygiL,6370622,6370828,6370622,206,344,utRho12
ygiM,6402084,6402414,6402084,330,32,utRho12
ygiN,6346156,6346284,6346156,128,832,utRho12
ygiQ,6322620,6322620,6322292,328,1014,utRho12
ygiS,6335462,6335462,6335436,26,62,utRho12
ygiV,6338582,6338582,6338462,120,66,utRho12
ygiW,6339774,6339774,6339352,422,152,utRho12
ygiZ,6344506,6344506,6344422,84,0,utRho12
ygjH,6442528,6442528,6442494,34,0,utRho12
ygjI,6452140,6452468,6452140,328,72,utRho12
ygjQ,6472730,6473080,6472730,350,810,utRho12
ygjR,6474564,6474586,6474564,22,0,utRho12
ygjV,6483638,6483638,6483488,150,0,utRho12
yhaB,6535632,6535708,6535632,76,0,utRho12
yhaH,6504498,6504608,6504498,110,258,utRho12
yhaI,6505400,6505822,6505400,422,180,utRho12
yhaJ,6508560,6508560,6508428,132,30,utRho12
yhaK,6508538,6508638,6508538,100,76,utRho12
yhbQ,6599878,6599932,6599878,54,384,utRho12
yhbT,6602736,6602736,6602552,184,266,utRho12
yhbU,6602558,6602970,6602558,412,266,utRho12
yhbX,6643302,6643302,6643226,76,138,utRho12
yhbY,6655518,6655580,6655518,62,920,utRho12
yhcA,6723956,6724224,6723956,268,170,utRho12
yhcB,6760364,6760382,6760364,18,0,utRho12
yhcC,6708470,6708470,6708100,370,560,utRho12
yhcF,6733440,6733852,6733440,412,368,utRho12
yhcH,6739124,6739124,6738956,168,88,utRho12
yhcM,6760312,6760312,6759994,318,170,utRho12
yhcN,6770812,6771076,6770812,264,768,utRho12
yhcO,6772606,6772606,6772258,348,0,utRho12
yhdH,6806560,6806968,6806560,408,176,utRho12
yhdJ,6823234,6823306,6823234,72,0,utRho12
yhdN,6879092,6879092,6879018,74,2928,utRho12
yhdT,6814702,6814750,6814702,48,514,utRho12
yhdU,6824994,6825242,6824994,248,806,utRho12
yhdV,6836392,6836780,6836392,388,66,utRho12
yhdW,6837944,6838298,6837944,354,0,utRho12
yheO,6953082,6953082,6952880,202,608,utRho12
yheV,6957970,6957970,6957584,386,98,utRho12
yhfA,6971902,6971902,6971636,266,666,utRho12
yhfG,6983294,6983294,6983240,54,728,utRho12
yhfL,6998622,6998896,6998622,274,206,utRho12
yhfY,7023244,7023244,7022844,400,64,utRho12
yhgA,7086294,7086334,7086294,40,0,utRho12
yhgE,7065176,7065176,7064878,298,274,utRho12
yhgF,7074352,7074770,7074352,418,2710,utRho12
yhhA,7173458,7173886,7173458,428,336,utRho12
yhhI,7248346,7248756,7248346,410,6,utRho12
yhhJ,7253696,7253696,7253606,90,46,utRho12
yhhM,7211588,7211588,7211220,368,372,utRho12
yhhN,7211150,7211502,7211150,352,356,utRho12
yhhQ,7218238,7218434,7218238,196,360,utRho12
yhhT,7223682,7223730,7223682,48,104,utRho12
yhhX,7162032,7162032,7161610,422,6,utRho12
yhhY,7162222,7162276,7162222,54,0,utRho12
yhhZ,7163516,7163726,7163516,210,102,utRho12
yhiD,7312220,7312220,7311804,416,2680,utRho12
yhiJ,7265190,7265190,7265180,10,0,utRho12
yhiM,7269270,7269682,7269270,412,1266,utRho12
yhiN,7275000,7275000,7274820,180,86,utRho12
yhjA,7338522,7338522,7338376,146,80,utRho12
yhjB,7344090,7344090,7343788,302,326,utRho12
yhjC,7344272,7344684,7344272,412,60,utRho12
yhjD,7346660,7346724,7346660,64,44,utRho12
yhjE,7349274,7349572,7349274,298,224,utRho12
yhjG,7356824,7356824,7356730,94,78,utRho12
yhjH,7358458,7358458,7358374,84,436,utRho12
yhjJ,7364032,7364032,7363880,152,370,utRho12
yhjK,7371296,7371296,7371158,138,16,utRho12
yhjR,7392750,7392750,7392370,380,38,utRho12
yhjV,7400796,7401126,7400796,330,2204,utRho12
yhjX,7424194,7424194,7424014,180,0,utRho12
yhjY,7425966,7425966,7425868,98,0,utRho12
yiaB,7455654,7455654,7455496,158,0,utRho12
yiaD,7432712,7433094,7432712,382,378,utRho12
yiaF,7438194,7438194,7438088,106,210,utRho12
yiaG,7438862,7438956,7438862,94,178,utRho12
yiaJ,7485236,7485236,7485064,172,54,utRho12
yiaK,7485348,7485466,7485348,118,2,utRho12
yiaT,7503924,7503924,7503736,188,0,utRho12
yiaU,7503792,7503984,7503792,192,0,utRho12
yiaY,7515856,7515856,7515654,202,124,utRho12
yibF,7523950,7523950,7523910,40,34,utRho12
yibG,7536128,7536354,7536128,226,62,utRho12
yibL,7553194,7553330,7553194,136,12,utRho12
yibN,7570112,7570112,7570030,82,218,utRho12
yibT,7552848,7552848,7552760,88,822,utRho12
yicC,7633290,7633352,7633290,62,10,utRho12
yicH,7660862,7660914,7660862,52,62,utRho12
yicJ,7673328,7673328,7671858,1470,10310,utRho12
yicN,7685018,7685018,7684804,214,118,utRho12
yicO,7687914,7687914,7687578,336,128,utRho12
yicR,15250308,15250308,15250236,72,0,utRho12
yidB,7755230,7755230,7754930,300,32,utRho12
yidE,7732780,7732780,7732546,234,0,utRho12
yidF,7711580,7711580,7711222,358,92,utRho12
yidQ,7735088,7735456,7735088,368,810,utRho12
yidR,7738824,7738824,7738618,206,106,utRho12
yieE,7787658,7787738,7787658,80,158,utRho12
yieH,7793314,7793548,7793314,234,4,utRho12
yieK,7798928,7798928,7798786,142,0,utRho12
yifB,7900350,7900350,7899998,352,82,utRho12
yifL,7988984,7989044,7988984,60,2298,utRho12
yigF,8005750,8005750,8005598,152,8172,utRho12
yigI,8009448,8009448,8009394,54,0,utRho12
yigM,8022100,8022152,8022100,52,0,utRho12
yihA,8101970,8101970,8101458,512,112,utRho12
yihD,8084098,8084138,8084098,40,48,utRho12
yihF,8088110,8088398,8088110,288,32,utRho12
yihG,8093304,8093304,8093204,100,76,utRho12
yihI,8102616,8102694,8102616,78,36,utRho12
yihL,8120506,8120894,8120506,388,44,utRho12
yihN,8124332,8124494,8124332,162,0,utRho12
yihO,8131942,8131942,8131532,410,0,utRho12
yihQ,8138892,8138892,8138552,340,0,utRho12
yihV,8147064,8147478,8147064,414,76,utRho12
yihX,8151096,8151106,8151096,10,136,utRho12
yiiE,8158192,8158582,8158192,390,472,utRho12
yiiF,8159124,8159502,8159124,378,550,utRho12
yiiG,8173762,8174004,8173762,242,0,utRho12
yiiM,8205506,8205644,8205506,138,586,utRho12
yiiQ,8224624,8224624,8224428,196,0,utRho12
yiiS,8225738,8225934,8225738,196,144,utRho12
yijE,8272178,8272216,8272178,38,10,utRho12
yijF,8275728,8275728,8275314,414,106,utRho12
yijO,8296858,8296858,8296634,224,230,utRho12
yjaA,8426240,8426468,8426240,228,116472,utRho12
yjaB,8428312,8428312,8428246,66,346,utRho12
yjaG,8398746,8399008,8398746,262,1838,utRho12
yjaH,8401022,8401132,8401022,110,262,utRho12
yjaZ,8379506,8379572,8379506,66,58,utRho12
yjbB,8455204,8455462,8455204,258,0,utRho12
yjbE,16943432,16943624,16943432,192,56,utRho12
yjbL,8520318,8520642,8520318,324,80,utRho12
yjbQ,8540428,8540476,8540428,48,52,utRho12
yjcB,8550328,8550328,8550082,246,256,utRho12
yjcC,8550836,8550942,8550836,106,52,utRho12
yjcD,8556628,8556958,8556628,330,22,utRho12
yjcE,8559658,8559960,8559658,302,0,utRho12
yjcF,8566212,8566212,8566150,62,0,utRho12
yjcO,8594660,8594660,8594250,410,64,utRho12
yjdA,8654128,8654270,8654128,142,0,utRho12
yjdC,8726660,8726660,8726616,44,0,utRho12
yjdK,8704780,8705168,8704780,388,318,utRho12
yjdL,8713034,8713034,8712822,212,14,utRho12
yjdM,8653672,8653672,8653468,204,68,utRho12
yjeF,8787354,8788132,8787354,778,128090,utRho12
yjeI,8745522,8745618,8745522,96,0,utRho12
yjeJ,8748806,8748806,8748468,338,904,utRho12
yjeV,8785472,8785784,8785472,312,5392,utRho12
yjfP,8833512,8833904,8833512,392,100,utRho12
yjfY,8849656,8849656,8849582,74,0,utRho12
yjfZ,8855052,8855052,8854844,208,120,utRho12
yjgA,8916162,8916162,8915730,432,138,utRho12
yjgL,8950802,8950874,8950802,72,50,utRho12
yjgM,8959342,8959342,8959074,268,178,utRho12
yjgN,8959132,8959460,8959132,328,130,utRho12
yjgR,8980170,8980170,8980126,44,46,utRho12
yjgZ,9002116,9002520,9002116,404,2606,utRho12
yjhB,9007764,9008116,9007764,352,4,utRho12
yjhG,9048452,9048452,9048188,264,970,utRho12
yjhU,9041080,9041080,9040648,432,318,utRho12
yjiA,9178096,9178096,9177730,366,464,utRho12
yjiJ,9125364,9125364,9125350,14,0,utRho12
yjiK,9127270,9127270,9127422,152,142,utRho12
yjiL,9129604,9129604,9129378,226,16,utRho12
yjiS,9143410,9143502,9143410,92,90,utRho12
yjiY,9182734,9182734,9182558,176,104,utRho12
yjjA,9200674,9200674,9200378,296,112,utRho12
yjjB,18408708,18408708,18407800,908,456,utRho12
yjjJ,9243314,9243538,9243314,224,124,utRho12
yjjK,9261132,9261132,9261044,88,70,utRho12
yjjL,9189764,9189764,9189444,320,56,utRho12
yjjM,9191894,9191894,9191702,192,68,utRho12
yjjP,9206068,9206068,9205716,352,5722,utRho12
yjjQ,9206638,9206954,9206638,316,6838,utRho12
yjjX,9267798,9267798,9267490,308,1462,utRho12
yjjY,9280716,9280804,9280716,88,300,utRho12
yjjZ,9211554,9211608,9211554,54,61490,utRho12
yjtD,9281676,9281884,9281676,208,136,utRho12
ykfB,532454,532454,532174,280,3960,utRho12
ykfI,527636,527636,527338,298,704,utRho12
ykgB,637050,637050,636638,412,98,utRho12
ykgC,640430,640430,640002,428,0,utRho12
ykgD,640232,640454,640232,222,0,utRho12
ykgE,642962,643216,642962,254,198,utRho12
ykgJ,608524,608524,608364,160,48,utRho12
ykgL,623878,624224,623878,346,316,utRho12
ykgM,625610,625610,625554,56,0,utRho12
ykgR,626570,626570,626484,86,0,utRho12
ylaC,958576,958576,958502,74,2298,utRho12
yliE,1745938,1745958,1745938,20,0,utRho12
ymcE,2103660,2103694,2103660,34,4,utRho12
ymdA,2210450,2210828,2210450,378,294,utRho12
ymdB,2211428,2211640,2211428,212,2,utRho12
ymfD,2395322,2395322,2395064,258,1208,utRho12
ymfI,2402880,2402994,2402880,114,0,utRho12
ymfJ,2404518,2404518,2404168,350,154,utRho12
ymfK,2406176,2406176,2405866,310,200,utRho12
ymfT,2405766,2406048,2405766,282,186,utRho12
ymgE,2489110,2489456,2489110,346,724,utRho12
ymgF,2437628,2437966,2437628,338,0,utRho12
ymiA,2670112,2670320,2670112,208,294,utRho12
ymjA,2715620,2715620,2715336,284,756,utRho12
ynaI,2791946,2791946,2791844,102,62,utRho12
ynaK,2850438,2850754,2850438,316,144,utRho12
ynbA,2954924,2955242,2954924,318,0,utRho12
yncD,3046552,3046552,3046130,422,142,utRho12
yncE,3046454,3046614,3046454,160,0,utRho12
yncG,3052456,3052494,3052456,38,72,utRho12
yncL,3034492,3034492,3034388,104,62,utRho12
yneE,3218364,3218364,3218044,320,0,utRho12
yneF,3223748,3223748,3223708,40,0,utRho12
yneJ,3229560,3229608,3229560,48,0,utRho12
yneK,3231100,3231526,3231100,426,64,utRho12
yneM,3245176,3245292,3245176,116,510,utRho12
ynfA,3311398,3311398,3311346,52,0,utRho12
ynfB,3311418,3311616,3311418,198,166,utRho12
ynfC,3315094,3315094,3314914,180,0,utRho12
ynfD,3314828,3315130,3314828,302,0,utRho12
ynfE,3316006,3316138,3316006,132,138,utRho12
ynfK,3334670,3334670,3334438,232,284,utRho12
ynfL,3339304,3339304,3339184,120,0,utRho12
ynfM,3339260,3339398,3339260,138,8,utRho12
ynfN,3276598,3276598,3276218,380,226,utRho12
ynfO,3273454,3273512,3273454,58,0,utRho12
ynhG,3517890,3517890,3517450,440,74,utRho12
yniA,3615158,3615592,3615158,434,406,utRho12
yniB,3618526,3618526,3618466,60,28,utRho12
yniC,3618652,3618760,3618652,108,126,utRho12
yniD,3610202,3610330,3610202,128,188,utRho12
ynjE,3678880,3678934,3678880,54,36,utRho12
ynjF,3683222,3683222,3682806,416,110,utRho12
ynjH,3684376,3684376,3684270,106,24,utRho12
ynjI,3690022,3690022,3689742,280,90,utRho12
yoaB,3786642,3786734,3786642,92,90,utRho12
yoaC,3787932,3788146,3787932,214,692,utRho12
yoaE,3803544,3803544,3803170,374,256,utRho12
yoaF,3755444,3755444,3755064,380,740,utRho12
yoaH,3789866,3789866,3789462,404,640,utRho12
yobB,3850418,3850880,3850418,462,566,utRho12
yobF,3815586,3815586,3815182,404,452,utRho12
yobH,3817800,3817850,3817800,50,376,utRho12
yodB,4084352,4084736,4084352,384,1218,utRho12
yodC,4057008,4057008,4056740,268,42,utRho12
yohC,4451358,4451358,4451262,96,74,utRho12
yohD,4451526,4451602,4451526,76,46,utRho12
yohJ,4460986,4461248,4460986,262,44,utRho12
yohO,4431172,4431314,4431172,142,88,utRho12
yojI,4617282,4617282,4617230,52,44,utRho12
ypdI,4988988,4989396,4988988,408,86,utRho12
ypfG,5165786,5165786,5165554,232,0,utRho12
ypfM,5182140,5182140,5181732,408,200,utRho12
yphB,5349590,5349590,5349376,214,0,utRho12
ypjA,5565644,5565644,5565452,192,248,utRho12
ypjB,5569636,5569636,5568858,778,0,utRho12
ypjD,5495860,5495774,5495860,86,0,utRho12
yqaE,5594170,5594170,5594056,114,26,utRho12
yqcA,5846100,5846100,5845968,132,82,utRho12
yqcE,5800944,5801184,5800944,240,0,utRho12
yqeC,6030468,6030468,6030114,354,178,utRho12
yqeF,5971618,5971618,5971184,434,42,utRho12
yqeG,5971438,5971694,5971438,256,44,utRho12
yqeH,5975016,5975072,5975016,56,70,utRho12
yqeI,5976688,5977004,5976688,316,50,utRho12
yqeK,5981140,5981140,5980720,420,1090,utRho12
yqfA,6086728,6086728,6086296,432,380,utRho12
yqgA,6219042,6219106,6219042,64,0,utRho12
yqgB,6172500,6172500,6172102,398,4962,utRho12
yqgE,6185768,6185874,6185768,106,344,utRho12
yqhA,6299150,6299150,6298942,208,0,utRho12
yqhC,6310768,6310768,6310436,332,80,utRho12
yqhD,6310604,6310710,6310604,106,46,utRho12
yqhH,6316842,6317254,6316842,412,1688,utRho12
yqiC,6369662,6369680,6369662,18,128,utRho12
yqiJ,6384108,6384416,6384108,308,46,utRho12
yqjA,6495096,6495546,6495096,450,3784,utRho12
yqjF,6500932,6501124,6500932,192,620,utRho12
yqjG,6501948,6502048,6501948,100,0,utRho12
yqjH,6433078,6433078,6432982,96,2,utRho12
yqjI,6433506,6433558,6433506,52,0,utRho12
yraH,6574552,6574852,6574552,300,120,utRho12
yraP,6592144,6592818,6592144,674,366,utRho12
yraQ,6596414,6596414,6596276,138,0,utRho12
yraR,6598024,6598024,6597692,332,154,utRho12
yrbG,13360844,13361100,13360844,256,0,utRho12
yrbL,6696842,6696904,6696842,62,736,utRho12
yrbN,6616172,6616172,6615866,306,14094,utRho12
yrdB,6860176,6860176,6860046,130,52,utRho12
yrfF,7052548,7052938,7052548,390,126,utRho12
yrhB,7169440,7169518,7169440,78,0,utRho12
ysaB,7451804,7451804,7451424,380,0,utRho12
ysgA,8032686,8032686,8032338,348,206,utRho12
ytfB,8857638,8857638,8857434,204,486,utRho12
ytfE,8864018,8864018,8863966,52,22,utRho12
ytfF,8866296,8866296,8866130,166,82,utRho12
ytfH,8868164,8868226,8868164,62,0,utRho12
ytfI,8875234,8875414,8875234,180,64,utRho12
ytfJ,8878572,8878572,8878524,48,110,utRho12
ytfK,8879022,8879174,8879022,152,388,utRho12
ytfL,8882642,8882642,8882430,212,148,utRho12
ytfQ,8899634,8899924,8899634,290,534,utRho12
ytjB,9249598,9249598,9249578,20,22,utRho12
yzfA,8896588,8896588,8896490,98,32,utRho12
zapA,6111102,6111224,6111102,122,1804,utRho12
zapB,8236772,8237030,8236772,258,262,utRho12
zapC,2011700,2011904,2011700,204,34,utRho12
zinT,4082692,4082750,4082692,58,304,utRho12
zipA,5062814,5062814,5062466,348,88,utRho12
zitB,1569716,1569716,1569646,70,108,utRho12
zntA,7212844,7212902,7212844,58,64,utRho12
zntR,6878336,6878336,6878260,76,12,utRho12
znuA,3885322,3885322,3885166,156,102,utRho12
znuC,3885268,3885324,3885268,56,102,utRho12
zraP,8403424,8403424,8403376,48,28,utRho12
zraS,8403810,8403852,8403810,42,16,utRho12
zupT,6364866,6365100,6364866,234,3944,utRho12
zur,8520282,8520282,8520006,276,286,utRho12
zwf,3872752,3872752,3872628,124,106,utRho12
C0343,2818676,2818728,2818676,52,0,utRho13
aaeB,6776526,6776526,6776376,150,0,utRho13
aaeR,6778762,6779040,6778762,278,48,utRho13
aaeX,6778860,6778860,6778674,186,56,utRho13
aat,1854920,1854920,1854864,56,58,utRho13
accA,416822,417242,416822,420,3304,utRho13
accB,6810280,6810872,6810280,592,12062,utRho13
accD,4868030,4868030,4867852,178,650,utRho13
aceB,8430804,8430956,8430804,152,0,utRho13
aceE,245938,246034,245938,96,166,utRho13
ackA,4826918,4826940,4826918,22,1420,utRho13
acnA,2670848,2671662,2670848,814,924,utRho13
acnB,263038,263230,263038,192,1246,utRho13
acpP,2303148,2303230,2303148,82,816,utRho13
acpS,5402324,5402324,5401996,328,326,utRho13
acrA,971396,971396,971238,158,156,utRho13
acrB,969370,969370,968806,564,5102,utRho13
acrD,5174950,5175190,5174950,240,96,utRho13
acrE,6827404,6827728,6827404,324,0,utRho13
acrR,971398,971522,971398,124,44,utRho13
acrZ,1589502,1589546,1589502,44,0,utRho13
acs,8575190,8575190,8574742,448,82,utRho13
actP,8569870,8569870,8569804,66,0,utRho13
ada,4620854,4620854,4620810,44,0,utRho13
add,3404404,3404466,3404404,62,192,utRho13
ade,7687802,7687928,7687802,126,0,utRho13
adhE,2596826,2596826,2596242,584,104,utRho13
adhP,3107988,3107988,3107676,312,3794,utRho13
adiA,8681112,8681112,8681042,70,24,utRho13
adiC,8674404,8674404,8674062,342,104,utRho13
adiY,8676084,8676084,8675858,226,0,utRho13
adk,994278,994350,994278,72,208,utRho13
adrA,807374,807406,807374,32,0,utRho13
aer,6438240,6438240,6438152,88,94,utRho13
aes,1000102,1000102,999946,156,74,utRho13
agaR,6557406,6557406,6557330,76,0,utRho13
agaS,6563778,6563952,6563778,174,0,utRho13
agp,2131118,2131170,2131118,52,0,utRho13
agrA,7296126,7296126,7296126,0,0,utRho13
agrB,7296588,7296588,7296588,0,0,utRho13
ahpC,1277386,1277890,1277386,504,2140,utRho13
ahpF,1278004,1279506,1278004,1502,189834,utRho13
ahr,8992698,8992698,8992418,280,0,utRho13
aidB,8828494,8828550,8828494,56,0,utRho13
ais,4731512,4731512,4731240,272,0,utRho13
alaA,4814816,4815122,4814816,306,0,utRho13
alaC,4996798,4996798,4996590,208,0,utRho13
alaE,5598140,5598328,5598140,188,0,utRho13
alaS,5644180,5644180,5644022,158,7804,utRho13
alaW,5036612,5036612,5036462,150,0,utRho13
aldA,2976380,2976464,2976380,84,608,utRho13
aldB,7513070,7513070,7513022,48,0,utRho13
alkA,4295118,4295118,4295080,38,0,utRho13
alkB,4618890,4618890,4618682,208,0,utRho13
allA,1064780,1064902,1064780,122,0,utRho13
allD,1092822,1092822,1092726,96,0,utRho13
allE,1088112,1088112,1088092,20,42,utRho13
allS,1064600,1064600,1064442,158,0,utRho13
alr,8531178,8531564,8531178,386,1834,utRho13
alsE,8617334,8617334,8616956,378,110,utRho13
alsK,8615990,8615990,8615598,392,154,utRho13
alx,6476740,6477160,6476740,420,0,utRho13
amiA,5104482,5104704,5104482,222,48,utRho13
amiC,5898378,5898378,5898020,358,0,utRho13
amn,4110062,4110122,4110062,60,0,utRho13
ampC,8758006,8758006,8757888,118,66,utRho13
ampD,237362,237466,237362,104,64,utRho13
ampG,907372,907372,907090,282,1126,utRho13
ampH,792726,792726,792574,152,112,utRho13
amyA,4012230,4012312,4012230,82,56,utRho13
anmK,3439346,3439346,3439204,142,0,utRho13
ansB,6201580,6201580,6201456,124,0,utRho13
ansP,3052040,3052040,3051960,80,90,utRho13
apaG,104068,104068,103212,856,5254,utRho13
apaH,102586,102586,102444,142,3540,utRho13
apbE,4623188,4623188,4623068,120,0,utRho13
appA,2081198,2081234,2081198,36,50,utRho13
appC,2075420,2075480,2075420,60,48,utRho13
appY,1167134,1167362,1167134,228,0,utRho13
apt,982620,982824,982620,204,150,utRho13
aqpZ,1832424,1832424,1832094,330,0,utRho13
araB,140150,140150,140096,54,0,utRho13
araC,140482,140774,140482,292,526,utRho13
araE,5964416,5964416,5964364,52,0,utRho13
araF,3972476,3972476,3972256,220,0,utRho13
araH,3967120,3967120,3967086,34,0,utRho13
araJ,825058,825058,824962,96,28,utRho13
arcA,9281602,9281602,9280612,990,10726,utRho13
arcB,6706098,6706098,6706050,48,0,utRho13
arcZ,6701154,6701154,6701154,0,0,utRho13
arfA,6877346,6877346,6877298,48,0,utRho13
argA,5898312,5898484,5898312,172,0,utRho13
argC,8309770,8310002,8309770,232,120,utRho13
argD,6980442,6980442,6980360,82,0,utRho13
argE,8310156,8310156,8309694,462,300,utRho13
argF,580680,580680,580610,70,0,utRho13
argG,6637124,6637274,6637124,150,0,utRho13
argI,8956688,8956688,8956622,66,0,utRho13
argO,6137672,6137672,6137616,56,2,utRho13
argP,6119460,6119506,6119460,46,32,utRho13
argR,6769204,6769406,6769204,202,0,utRho13
argS,3920002,3920124,3920002,122,0,utRho13
argT,4855698,4855698,4855582,116,0,utRho13
argU,1129406,1129446,1129406,40,0,utRho13
argW,4932616,4932618,4932616,2,0,utRho13
argX,7964728,7964750,7964728,22,0,utRho13
aroF,5482402,5482402,5482300,102,0,utRho13
aroG,1571182,1571266,1571182,84,258,utRho13
aroH,3576636,3576870,3576636,234,1214,utRho13
aroK,7038760,7038760,7038128,632,1030,utRho13
aroL,812560,812810,812560,250,60,utRho13
aroP,243342,243342,243102,240,0,utRho13
arpA,8445382,8445382,8444974,408,0,utRho13
arrS,7316108,7316108,7316108,0,0,utRho13
arsR,7297024,7297056,7297024,32,0,utRho13
artJ,1801252,1801252,1801150,102,0,utRho13
artP,1807686,1807686,1807468,218,70,utRho13
ascF,5678858,5679048,5678858,190,0,utRho13
ascG,5678574,5678574,5678528,46,0,utRho13
aslB,7965562,7965916,7965562,354,292,utRho13
asnA,7854258,7854310,7854258,52,0,utRho13
asnB,1398444,1398444,1398354,90,70,utRho13
asnC,23562186,23562186,23562018,168,0,utRho13
asnS,1978088,1978088,1977970,118,16274,utRho13
asnT,4089082,4089098,4089082,16,312,utRho13
asnU,4119690,4119702,4119690,12,0,utRho13
asnV,4124504,4124520,4124504,16,14,utRho13
aspA,17473728,17473728,17473308,420,212,utRho13
aspC,1971486,1971486,1971418,68,144,utRho13
aspS,3901402,3901402,3901044,358,164,utRho13
aspT,7893560,7893744,7893560,184,147588,utRho13
aspV,473826,473862,473826,36,90,utRho13
asr,3342654,3342752,3342654,98,38,utRho13
astC,3664088,3664088,3663964,124,0,utRho13
astE,3654138,3654138,3653846,292,0,utRho13
atoD,4646824,4646894,4646824,70,0,utRho13
atpB,7844540,7844540,7844102,438,710,utRho13
atpC,7832118,7832118,7831944,174,3128,utRho13
atpI,7845050,7845050,7844880,170,46,utRho13
avtA,7479348,7479410,7479348,62,220,utRho13
azoR,2965982,2965982,2965720,262,90,utRho13
azuC,3976002,3976002,3975918,84,0,utRho13
bacA,6408350,6408350,6408262,88,0,utRho13
bamA,394052,395856,394052,1804,1140,utRho13
bamB,5277950,5277950,5277304,646,1920,utRho13
bamC,5198028,5198028,5197730,298,2698,utRho13
bamD,5471922,5472292,5471922,370,1474,utRho13
bamE,5506972,5507210,5506972,238,814,utRho13
basS,8666954,8666954,8666544,410,592,utRho13
bax,7474468,7474468,7474354,114,60,utRho13
bcp,5200874,5200956,5200874,82,4762,utRho13
bcsB,7385346,7385346,7385214,132,94,utRho13
bcsE,7392644,7392916,7392644,272,0,utRho13
bdcA,8948128,8948128,8948106,22,0,utRho13
bdcR,8948192,8948248,8948192,56,0,utRho13
bdm,3112680,3112680,3112560,120,0,utRho13
betA,654522,654522,654494,28,124,utRho13
betI,658722,658722,658668,54,0,utRho13
betT,658842,658926,658842,84,0,utRho13
bfr,6933498,6933498,6933450,48,0,utRho13
bglG,23440182,23440182,23439402,780,0,utRho13
bglX,4444240,4444240,4443978,262,0,utRho13
bhsA,2337962,2338146,2337962,184,0,utRho13
bioA,1618584,1618584,1618514,70,0,utRho13
bioB,1618604,1618688,1618604,84,0,utRho13
bioH,7089716,7089716,7089688,28,0,utRho13
bisC,7433026,7433026,7432788,238,0,utRho13
blc,8755490,8755490,8755444,46,0,utRho13
blr,3409024,3409102,3409024,78,0,utRho13
bluF,2431226,2431226,2430950,276,0,utRho13
bluR,2428226,2428226,2428118,108,0,utRho13
bolA,908698,908944,908698,246,116,utRho13
borD,1157842,1157842,1157786,56,2,utRho13
brnQ,838976,839182,838976,206,632,utRho13
bssR,1756492,1756496,1756492,4,0,utRho13
bssS,2242116,2242116,2241910,206,0,utRho13
btuB,8326798,8327278,8326798,480,4874,utRho13
cadB,8720212,8720212,8720062,150,0,utRho13
cadC,8723926,8723926,8723868,58,20,utRho13
caiE,70998,70998,70742,256,0,utRho13
caiF,68436,68600,68436,164,0,utRho13
caiT,84074,84074,83862,212,0,utRho13
can,285406,285406,285340,66,0,utRho13
carA,59102,59302,59102,200,0,utRho13
carB,61550,61634,61550,84,246,utRho13
cas2,5757830,5757830,5757706,124,0,utRho13
casA,5768638,5768638,5768276,362,0,utRho13
cbl,4121882,4121882,4121828,54,0,utRho13
cbpA,2128074,2128074,2127550,524,0,utRho13
cbrA,7738628,7738754,7738628,126,0,utRho13
cbrB,7794958,7795012,7794958,54,0,utRho13
ccmH,4585242,4585242,4584820,422,92,utRho13
cdaR,364894,364926,364894,32,0,utRho13
cdd,4463638,4463688,4463638,50,0,utRho13
cdh,8219814,8219860,8219814,46,0,utRho13
cdsA,391110,391354,391110,244,1570,utRho13
cedA,3627484,3627484,3627326,158,40,utRho13
cfa,3482402,3482826,3482402,424,368,utRho13
chaC,2544844,2544972,2544844,128,0,utRho13
chbB,3643452,3643452,3643238,214,0,utRho13
chbG,3634624,3634624,3634270,354,92,utRho13
cheW,3946924,3946924,3946678,246,1146,utRho13
chiA,6939792,6939792,6939706,86,0,utRho13
chiP,1416472,1416668,1416472,196,0,utRho13
cho,3646984,3647030,3646984,46,0,utRho13
chpS,8896804,8896894,8896804,90,18,utRho13
cirA,4493884,4493884,4493538,346,0,utRho13
citC,1304078,1304078,1303712,366,0,utRho13
citT,1293264,1293264,1293160,104,0,utRho13
clcA,350104,350214,350104,110,0,utRho13
clpA,1846160,1846528,1846160,368,102,utRho13
clpB,5468410,5468410,5468346,64,266,utRho13
clpP,913154,913354,913154,200,754,utRho13
clpS,1845500,1845826,1845500,326,28,utRho13
clpX,914404,914852,914404,448,2992,utRho13
clsA,2617346,2617346,2617290,56,0,utRho13
clsC,2212584,2212710,2212584,126,622,utRho13
cmk,1922330,1922402,1922330,72,0,utRho13
cnu,3409522,3409898,3409522,376,666,utRho13
coaA,8350214,8350214,8350052,162,338,utRho13
cobC,1340092,1340092,1339814,278,336,utRho13
cobT,4129202,4129202,4128934,268,0,utRho13
cobU,4131944,4131944,4131528,416,0,utRho13
codB,709768,709844,709768,76,0,utRho13
comR,2337726,2337726,2337664,62,130,utRho13
copA,1022822,1022822,1022758,64,28,utRho13
corA,8002388,8002852,8002388,464,6014,utRho13
cpdB,8873258,8873258,8873130,128,412,utRho13
cptB,6082198,6082198,6082140,58,0,utRho13
cpxA,8210202,8210202,8209950,252,732,utRho13
cpxP,8211570,8211640,8211570,70,90,utRho13
cpxR,8211372,8211372,8211340,32,58,utRho13
cra,175894,176056,175894,162,50,utRho13
crcB,1316016,1316016,1315876,140,0,utRho13
creA,9270486,9271042,9270486,556,364,utRho13
creD,9276320,9276356,9276320,36,0,utRho13
crl,515620,515658,515620,38,666,utRho13
crp,6971906,6972240,6971906,334,6878,utRho13
crr,5070960,5071668,5070960,708,4262,utRho13
csdA,5886414,5886674,5886414,260,0,utRho13
csgB,2207718,2207902,2207718,184,0,utRho13
csgD,2206688,2206688,2206392,296,0,utRho13
csgG,2203510,2203510,2203368,142,0,utRho13
csiD,5577854,5577970,5577854,116,128,utRho13
csiE,5330802,5330870,5330802,68,0,utRho13
csiR,5590942,5591348,5590942,406,0,utRho13
cspA,7439778,7440098,7439778,320,1718,utRho13
cspB,3283430,3283430,3283108,322,2,utRho13
cspC,3815018,3815018,3814870,148,976,utRho13
cspD,1845352,1845352,1845180,172,19414,utRho13
cspE,1314294,1314584,1314294,290,38,utRho13
cspF,3283380,3283710,3283380,330,0,utRho13
cspG,2102610,2102922,2102610,312,178,utRho13
cspH,2102746,2102746,2102350,396,2,utRho13
cspI,3277624,3277624,3277334,290,0,utRho13
csrA,5638746,5638746,5638292,454,2044,utRho13
csrB,5849048,5849048,5849048,0,0,utRho13
csrC,8102072,8102072,8102072,0,0,utRho13
csrD,6806850,6806850,6806664,186,0,utRho13
cstA,1259710,1259788,1259710,78,0,utRho13
cueO,274090,274166,274090,76,0,utRho13
cueR,1027948,1027986,1027948,38,50,utRho13
curA,3037784,3038054,3037784,270,0,utRho13
cusC,1191146,1191200,1191146,54,0,utRho13
cusR,1190924,1190924,1190886,38,0,utRho13
cutA,8730784,8730784,8730712,72,24,utRho13
cutC,3918534,3918534,3917920,614,434,utRho13
cvpA,4861600,4861600,4861526,74,20,utRho13
cvrA,2484328,2484328,2484142,186,16,utRho13
cyaA,7981548,7982306,7981548,758,462,utRho13
cyaR,4334228,4334224,4334228,4,0,utRho13
cyaY,7988166,7988166,7988118,48,0,utRho13
cybB,2981522,2981804,2981522,282,0,utRho13
cycA,8859560,8859728,8859560,168,614,utRho13
cydA,1542340,1542916,1542340,576,372,utRho13
cydC,1858800,1858800,1858390,410,340,utRho13
cydD,1862062,1862062,1861924,138,38,utRho13
cydX,1548300,1548392,1548300,92,650,utRho13
cynR,717418,717418,717380,38,0,utRho13
cynT,1435092,1435196,1435092,104,0,utRho13
cyoA,903306,903306,903220,86,4702,utRho13
cyoE,895540,895540,895410,130,732,utRho13
cysB,2667576,2667710,2667576,134,58,utRho13
cysC,5748056,5748056,5747984,72,0,utRho13
cysD,5752736,5752736,5752658,78,0,utRho13
cysE,7565362,7565362,7565124,238,3770,utRho13
cysG,6995508,6995656,6995508,148,26,utRho13
cysJ,5783928,5783928,5783796,132,136,utRho13
cysK,5064688,5064818,5064688,130,104,utRho13
cysP,5087114,5087114,5087056,58,0,utRho13
cysS,1109154,1109222,1109154,68,198,utRho13
cysT,3984100,3984100,3983974,126,210,utRho13
cysZ,5062766,5062926,5062766,160,102,utRho13
cytR,8249018,8249018,8248912,106,184,utRho13
dacA,1328002,1328002,1327926,76,216,utRho13
dacB,6657714,6657926,6657714,212,0,utRho13
dacC,1761306,1761454,1761306,148,0,utRho13
dadA,2475018,2475142,2475018,124,0,utRho13
dam,7032504,7032504,7031826,678,1192,utRho13
damX,7035200,7035200,7034612,588,326,utRho13
dapA,5199568,5199568,5199520,48,0,utRho13
dapB,56576,56748,56576,172,84,utRho13
dapD,371954,371954,371894,60,318,utRho13
dapE,5183120,5183214,5183120,94,1194,utRho13
dcp,3254844,3254844,3254760,84,48,utRho13
dcrB,7219534,7219910,7219534,376,0,utRho13
dctA,7366996,7366996,7366894,102,822,utRho13
dcuA,8733686,8733686,8733546,140,0,utRho13
dcuB,8698182,8698182,8697488,694,408,utRho13
dcuC,1312166,1312166,1311936,230,0,utRho13
dcuD,6749166,6749738,6749166,572,0,utRho13
dcuR,8701130,8701130,8700068,1062,670,utRho13
dcuS,8703370,8703370,8703324,46,0,utRho13
dcyD,3999016,3999016,3998960,56,0,utRho13
ddpX,3126498,3126498,3126152,346,0,utRho13
deaD,6615818,6615818,6615720,98,92,utRho13
dedA,4869880,4869880,4869482,398,5366,utRho13
dedD,4863750,4863750,4863368,382,158,utRho13
def,6867300,6867380,6867300,80,6,utRho13
degP,361690,361768,361690,78,0,utRho13
degQ,6761308,6761486,6761308,178,610,utRho13
deoB,9239134,9239206,9239134,72,0,utRho13
deoC,9233358,9234646,9233358,1288,480,utRho13
dfp,7625406,7625462,7625406,56,138,utRho13
dgcZ,3247758,3247758,3247700,58,0,utRho13
dgkA,8512914,8513274,8512914,360,942,utRho13
dgt,358392,358474,358392,82,0,utRho13
dhaK,2501888,2501888,2501676,212,490,utRho13
dhaR,2502006,2502132,2502006,126,44,utRho13
dicB,3299194,3299218,3299194,24,0,utRho13
dicC,3295752,3295752,3295700,52,0,utRho13
dinB,501760,501796,501760,36,0,utRho13
dinD,7635398,7635520,7635398,122,0,utRho13
dinG,1666146,1666140,1666146,6,0,utRho13
dinI,2243018,2243018,2242974,44,44,utRho13
dinJ,493230,493230,493004,226,0,utRho13
dinQ,7295964,7295964,7295576,388,824,utRho13
djlA,114536,114728,114536,192,130,utRho13
dkgA,6313142,6313246,6313142,104,764,utRho13
dkgB,458196,458334,458196,138,0,utRho13
dksA,321502,321502,321208,294,2394,utRho13
dld,4444164,4444370,4444164,206,126,utRho13
dmlA,3763424,3763824,3763424,400,112,utRho13
dmlR,3763710,3763710,3763618,92,108,utRho13
dmsA,1881646,1881918,1881646,272,0,utRho13
dnaA,7767922,7767922,7767458,464,942,utRho13
dnaB,8528566,8528628,8528566,62,0,utRho13
dnaK,24096,24326,24096,230,2476,utRho13
dnaN,7765466,7765466,7764642,824,628,utRho13
dnaQ,471868,472134,471868,266,1686,utRho13
dnaT,18406460,18406460,18406068,392,0,utRho13
dnaX,984112,984184,984112,72,258,utRho13
dosP,3131486,3131486,3131466,20,0,utRho13
dpiB,1303968,1304470,1303968,502,0,utRho13
dppA,7415740,7415740,7415410,330,3352,utRho13
dps,1697900,1697900,1697822,78,72,utRho13
dsbA,8086754,8086836,8086754,82,2516,utRho13
dsbB,2466294,2466294,2466060,234,0,utRho13
dsbC,6079266,6079266,6077644,1622,1160,utRho13
dsbG,1277600,1277600,1277146,454,392,utRho13
dsdA,4958242,4958404,4958242,162,1320,utRho13
dsdC,4955492,4955492,4955258,234,0,utRho13
dsdX,4955642,4955694,4955642,52,0,utRho13
dsrA,4050626,4050626,4050626,0,0,utRho13
dsrB,4049686,4049686,4049646,40,2,utRho13
dtpD,1485340,1485340,1485112,228,20,utRho13
dusA,8523200,8523338,8523200,138,1298,utRho13
dusB,6820492,6820560,6820492,68,0,utRho13
dusC,4460790,4460790,4460770,20,0,utRho13
dut,7627704,7627864,7627704,160,2176,utRho13
dxr,386670,387042,386670,372,1184,utRho13
ebgA,6445102,6445266,6445102,164,44,utRho13
ebgR,6442874,6442932,6442874,58,60,utRho13
ecnB,8753018,8753106,8753018,88,0,utRho13
eco,4607594,4607810,4607594,216,54,utRho13
ecpA,621594,621594,621342,252,0,utRho13
ecpB,620238,620238,620052,186,0,utRho13
ecpR,622964,622964,622672,292,0,utRho13
eda,3866218,3866218,3865512,706,308,utRho13
edd,3869426,3869426,3869208,218,186,utRho13
efeO,2164308,2164486,2164308,178,56,utRho13
efeU_1,2162614,2162712,2162614,98,0,utRho13
efp,8751134,8751398,8751134,264,4412,utRho13
elaA,4763372,4763372,4763086,286,224,utRho13
elaD,4765308,4765426,4765308,118,0,utRho13
elfA,1995530,1995736,1995530,206,0,utRho13
elfD,1996642,1996980,1996642,338,0,utRho13
emrD,7707690,7707844,7707690,154,8,utRho13
emrK,4966896,4966896,4966678,218,0,utRho13
emrY,4964668,4964668,4964352,316,0,utRho13
emtA,2486250,2486360,2486250,110,0,utRho13
endA,12361100,12361388,12361100,288,0,utRho13
eno,5817692,5817692,5815882,1810,3054,utRho13
entC,1249662,1249770,1249662,108,0,utRho13
entD,1220508,1220508,1220158,350,160,utRho13
entH,1258584,1258600,1258584,16,0,utRho13
entS,1244506,1244600,1244506,94,0,utRho13
envR,6827266,6827266,6826930,336,0,utRho13
epd,12295292,12295292,12294764,528,88,utRho13
epmA,8765236,8765286,8765236,50,0,utRho13
epmB,8751406,8751406,8751314,92,2162,utRho13
eptB,7421162,7421162,7420950,212,118,utRho13
eptC,8300622,8300622,8300530,92,0,utRho13
erfK,4126708,4126708,4126646,62,38,utRho13
erpA,353122,353220,353122,98,72,utRho13
esrE,8039956,8039956,8039956,0,0,utRho13
essD,1153746,1154796,1153746,1050,16,utRho13
etk,2088606,2088606,2088420,186,0,utRho13
evgA,4967262,4967510,4967262,248,0,utRho13
exbB,6304028,6304028,6303968,60,0,utRho13
exbD,6302780,6302780,6302486,294,142,utRho13
exuR,6493016,6493304,6493016,288,82,utRho13
exuT,6490004,6490208,6490004,204,0,utRho13
fabA,2032996,2032996,2032940,56,0,utRho13
fabB,4883282,4883282,4883210,72,0,utRho13
fabH,2297032,2297518,2297032,486,1294,utRho13
fabI,2702236,2702236,2702078,158,52,utRho13
fadB,8062026,8062026,8061942,84,0,utRho13
fadD,3779614,3779614,3779492,122,0,utRho13
fadE,486812,486812,486606,206,0,utRho13
fadH,6463248,6463330,6463248,82,0,utRho13
fadI,4921022,4921022,4920938,84,0,utRho13
fadL,4922410,4922600,4922410,190,172,utRho13
fadM,928720,928804,928720,84,4,utRho13
fadR,2469810,2469876,2469810,66,0,utRho13
fbaB,4357334,4357334,4357128,206,0,utRho13
fdhE,8162722,8162722,8162456,266,2014,utRho13
fdhF,8598814,8598814,8598732,82,0,utRho13
fdnG,3094744,3094802,3094744,58,0,utRho13
fdrA,1093012,1093360,1093012,348,0,utRho13
feaB,2894994,2895038,2894994,44,0,utRho13
feaR,2894734,2894734,2894566,168,68,utRho13
fecA,9033454,9033454,9033354,100,74,utRho13
fecE,9023288,9023288,9022914,374,4014,utRho13
fecI,9036564,9036564,9036470,94,0,utRho13
feoA,7080114,7080326,7080114,212,68,utRho13
fepA,1225334,1225334,1224988,346,0,utRho13
fepB,1249454,1249454,1249020,434,730,utRho13
fepD,1244468,1244468,1244378,90,0,utRho13
fes,1225374,1225630,1225374,256,16,utRho13
ffh,5495706,5495706,5495590,116,894,utRho13
ffs,952576,952848,952576,272,0,utRho13
fhuA,334884,334968,334884,84,48,utRho13
fhuE,2323294,2323294,2323102,192,42,utRho13
fhuF,9211504,9211504,9211326,178,198,utRho13
fic,6983296,6983296,6982926,370,316,utRho13
fieF,8212864,8212938,8212864,74,0,utRho13
fimA,9085388,9086230,9085388,842,660,utRho13
fimB,9081334,9081914,9081334,580,722,utRho13
fimE,9083742,9084074,9083742,332,0,utRho13
fimZ,1129214,1129214,1128960,254,0,utRho13
fiu,1683296,1683296,1683062,234,0,utRho13
fixA,84650,84806,84650,156,0,utRho13
fkpA,6955050,6955050,6954838,212,10048,utRho13
fldA,2846084,2846084,2845860,224,2988,utRho13
fldB,6079644,6079710,6079644,66,0,utRho13
flgA,2261770,2261770,2261726,44,0,utRho13
flgB,2261986,2262036,2261986,50,0,utRho13
flgK,2276702,2276756,2276702,54,386,utRho13
flgM,2260330,2260330,2260256,74,552,utRho13
flgN,2259828,2259828,2259660,168,166,utRho13
flhB,3932432,3932432,3932382,50,50,utRho13
flhC,3955864,3955864,3955688,176,104,utRho13
flhD,3957154,3957154,3956394,760,466,utRho13
fliA,4003638,4003638,4003578,60,0,utRho13
fliC,4007352,4007352,4007212,140,240,utRho13
fliD,4007634,4007744,4007634,110,316,utRho13
fliE,4026186,4026186,4026028,158,0,utRho13
fliF,4026292,4026458,4026292,166,346,utRho13
fliL,4039168,4039236,4039168,68,26,utRho13
flk,4875824,4875900,4875824,76,0,utRho13
flu,4142634,4143078,4142634,444,56,utRho13
flxA,3292776,3292810,3292776,34,0,utRho13
fnr,2799104,2799104,2799052,52,16,utRho13
fnrS,2818258,2818258,2818258,0,0,utRho13
focA,1909628,1909628,1908932,696,218,utRho13
folA,99598,99646,99598,48,0,utRho13
folB,6409296,6409296,6409178,118,0,utRho13
folD,1115562,1115562,1115482,80,212,utRho13
folE,4487696,4487696,4487304,392,3114,utRho13
fpr,8228998,8228998,8228944,54,0,utRho13
frc,4986878,4986878,4986508,370,0,utRho13
frdA,8764824,8764824,8764636,188,46,utRho13
frdD,8758948,8758948,8758732,216,2624,utRho13
fre,8052886,8053054,8052886,168,2306,utRho13
frlA,6999518,6999820,6999518,302,0,utRho13
frr,385624,385744,385624,120,2026,utRho13
frsA,513004,513054,513004,50,36,utRho13
fruB,4527194,4527194,4526990,204,82,utRho13
frvR,8179804,8179804,8179710,94,0,utRho13
fryA,5008986,5008986,5008970,16,0,utRho13
fsaA,1727060,1727284,1727060,224,0,utRho13
fsr,1009710,1009710,1009392,318,128,utRho13
ftnA,3977364,3977432,3977364,68,0,utRho13
ftnB,3973550,3973850,3973550,300,28,utRho13
ftsA,207122,207964,207122,842,602,utRho13
ftsB,5745802,5745802,5745640,162,10,utRho13
ftsH,6654204,6654204,6653870,334,1340,utRho13
ftsK,1865858,1866448,1865858,590,2074,utRho13
ftsL,181376,182064,181376,688,1838,utRho13
ftsP,6325732,6325732,6325338,394,194,utRho13
ftsQ,205484,206310,205484,826,266,utRho13
ftsX,7204512,7204512,7204172,340,420,utRho13
ftsZ,209272,210610,209272,1338,122,utRho13
fucA,5867708,5867708,5867376,332,70,utRho13
fucP,5868238,5868470,5868238,232,0,utRho13
fumA,6753760,6753760,6753508,252,13152,utRho13
fumB,8694696,8694696,8694652,44,12,utRho13
fumC,3373418,3373418,3373176,242,0,utRho13
fur,2842892,2842892,2842584,308,5668,utRho13
fusA,6947370,6947370,6947028,342,36468,utRho13
fxsA,8737206,8737328,8737206,122,792,utRho13
gabD,5581824,5582546,5581824,722,3082,utRho13
gadA,7335214,7335214,7335160,54,0,utRho13
gadB,3144144,3144144,3144090,54,0,utRho13
gadC,3141168,3141168,3140978,190,0,utRho13
gadE,7315600,7316732,7315600,1132,0,utRho13
gadW,7329562,7329562,7329236,326,0,utRho13
gadX,14663356,14663356,14663240,116,0,utRho13
gadY,7329728,7329728,7329728,0,0,utRho13
galE,1584354,1584354,1584110,244,0,utRho13
galF,4228702,4228702,4228654,48,0,utRho13
galM,1577796,1577796,1577674,122,1198,utRho13
galP,6176510,6176568,6176510,58,0,utRho13
galR,5953138,5953198,5953138,60,326,utRho13
galS,4483420,4483420,4483336,84,0,utRho13
galU,2582810,2582914,2582810,104,694,utRho13
gapA,3724480,3725542,3724480,1062,13684,utRho13
garP,6549868,6549868,6549814,54,22,utRho13
gatY,4354468,4354468,4354408,60,26,utRho13
gatZ,4352864,4352864,4352642,222,46452,utRho13
gcd,282558,282558,282450,108,0,utRho13
gcl,1067814,1067832,1067814,18,0,utRho13
gcvA,5885278,5885278,5885134,144,0,utRho13
gcvB,5885392,5885392,5885392,0,0,utRho13
gcvR,5199758,5199812,5199758,54,178,utRho13
gcvT,6101544,6101544,6101334,210,7082,utRho13
gdhA,3684616,3684742,3684616,126,0,utRho13
gfcA,2099668,2099668,2099488,180,24,utRho13
gfcD,2096236,2096236,2095890,346,0,utRho13
ghrA,2195648,2195772,2195648,124,110,utRho13
ghrB,7434378,7434620,7434378,242,1082,utRho13
glcA,6242728,6242728,6242558,170,104,utRho13
glcC,6256412,6256544,6256412,132,0,utRho13
glcD,6256152,6256152,6256042,110,276,utRho13
gldA,8278092,8278092,8278070,22,0,utRho13
glgA,7136784,7136784,7136066,718,656,utRho13
glgB,7147314,7147314,7147004,310,254,utRho13
glgC,7139142,7139142,7138656,486,450,utRho13
glgP,7133546,7133546,7133162,384,344,utRho13
glgS,6384024,6384024,6383878,146,0,utRho13
glgX,7142838,7142838,7142638,200,52,utRho13
glk,5018922,5018922,5018852,70,0,utRho13
glmS,7827622,7827622,7827336,286,5292,utRho13
glmU,7830652,7830652,7830400,252,2,utRho13
glmY,10765360,10765360,10765360,0,0,utRho13
glmZ,7972864,7972864,7972864,0,0,utRho13
glnA,16232888,16232888,16232136,752,1416,utRho13
glnB,5375052,5375052,5374816,236,4,utRho13
glnD,377310,377310,377300,10,0,utRho13
glnE,6399602,6399602,6399282,320,136,utRho13
glnH,1696396,1696396,1696008,388,526,utRho13
glnK,945112,945196,945112,84,0,utRho13
glnL,8112742,8112742,8112678,64,0,utRho13
glnQ,1693262,1693262,1692926,336,1228,utRho13
glnS,1411998,1412186,1411998,188,1194,utRho13
gloA,3455602,3455674,3455602,72,0,utRho13
gloB,469852,469852,469564,288,1350,utRho13
glpA,4705166,4705294,4705166,128,0,utRho13
glpD,7123942,7124026,7123942,84,66,utRho13
glpE,7123698,7123698,7123646,52,38,utRho13
glpF,8236322,8236322,8236180,142,616,utRho13
glpG,7122960,7122960,7122904,56,438,utRho13
glpR,7121782,7121782,7121210,572,140,utRho13
glpT,4704902,4704902,4704748,154,658,utRho13
glpX,8231212,8231212,8231158,54,7246,utRho13
glrK,5382246,5382246,5382196,50,40,utRho13
gltA,1509534,1509534,1508936,598,22366,utRho13
gltB,6709018,6709264,6709018,246,28,utRho13
gltI,1375792,1375792,1375494,298,2974,utRho13
gltP,8588536,8588962,8588536,426,1184,utRho13
gltS,7657382,7657382,7657330,52,622,utRho13
gltX,5041568,5041568,5041344,224,320,utRho13
gluQ,320286,320286,320224,62,606,utRho13
glyA,5371148,5371148,5371014,134,86,utRho13
glyQ,7450708,7450708,7450636,72,208,utRho13
glyS,7448990,7448990,7448794,196,2696,utRho13
glyU,5998128,5998128,5998114,14,26,utRho13
glyV,8784626,8784720,8784626,94,226,utRho13
glyW,3984360,3984360,3984234,126,0,utRho13
gmhB,445612,445666,445612,54,0,utRho13
gmk,7642776,7642856,7642776,80,14,utRho13
gmr,2693686,2693686,2693484,202,60,utRho13
gnd,4202648,4202648,4202536,112,556,utRho13
gnsB,3275692,3275692,3275564,128,0,utRho13
gntK,14310580,14310580,14310368,212,88,utRho13
gntP,9102668,9102668,9102592,76,46,utRho13
gntR,7157760,7157760,7157452,308,432,utRho13
gntT,7092810,7093118,7092810,308,88,utRho13
gntU,7154170,7154170,7154122,48,0,utRho13
gntX,7089334,7089764,7089334,430,0,utRho13
gor,7292224,7292598,7292224,374,380,utRho13
gpmA,1575340,1575340,1575190,150,56,utRho13
gpmM,7570374,7570520,7570374,146,36,utRho13
gpsA,7567620,7567620,7567322,298,25780,utRho13
gpt,511828,511954,511828,126,476,utRho13
grcA,5433046,5433046,5432898,148,0,utRho13
greA,6657728,6657728,6657430,298,952,utRho13
greB,7073488,7073624,7073488,136,112,utRho13
groL,8741566,8742050,8741566,484,9766,utRho13
groS,8741232,8741376,8741232,144,12484,utRho13
grpE,5501494,5501494,5501416,78,524,utRho13
grxA,1781552,1781552,1781506,46,0,utRho13
grxB,2248206,2248206,2248108,98,50,utRho13
grxC,7569152,7569152,7568884,268,11042,utRho13
grxD,3468324,3468324,3468202,122,6260,utRho13
gspA,6911268,6911268,6910796,472,0,utRho13
gspC,6910964,6911156,6910964,192,0,utRho13
gss,6277220,6277220,6277044,176,68,utRho13
gstA,3428654,3428754,3428654,100,0,utRho13
gstB,1761038,1761038,1760960,78,0,utRho13
guaB,5268214,5268214,5268140,74,350,utRho13
gudD,5839026,5839026,5838770,256,38,utRho13
gyrA,4678914,4678914,4678840,74,8,utRho13
gyrB,7760300,7760300,7760238,62,0,utRho13
hcaE,5337964,5338064,5337964,100,80,utRho13
hcaR,5337928,5337928,5337792,136,0,utRho13
hcaT,5336106,5336106,5335692,414,508,utRho13
hchA,4071260,4071670,4071260,410,0,utRho13
hcp,1828258,1828258,1827628,630,86,utRho13
hcr,1824400,1824400,1824300,100,106,utRho13
hdeA,7313582,7313582,7313480,102,0,utRho13
hdeD,7313920,7313990,7313920,70,0,utRho13
hdfR,7896320,7896320,7895934,386,340,utRho13
hdhA,3396244,3396244,3396080,164,0,utRho13
helD,2048876,2048942,2048876,66,0,utRho13
hemA,2527166,2527428,2527166,262,64,utRho13
hemB,779722,779722,779454,268,0,utRho13
hemF,5106410,5106450,5106410,40,0,utRho13
hemH,996062,996110,996062,48,4,utRho13
hemL,349882,349882,349764,118,258,utRho13
hemN,8103886,8104090,8103886,204,94,utRho13
hepA,127176,127176,126528,648,1240,utRho13
hflD,2385372,2385372,2385262,110,238,utRho13
hfq,8799602,8800576,8799602,974,11534,utRho13
hha,961006,961006,960616,390,52,utRho13
hicA,3018442,3018572,3018442,130,0,utRho13
higA,6468682,6468682,6468288,394,38,utRho13
higB,6468960,6468960,6468910,50,2,utRho13
hinT,2323642,2323770,2323642,128,156,utRho13
hipB,3184964,3184964,3184884,80,56,utRho13
hisB,4186720,4186936,4186720,216,1122,utRho13
hisJ,4853674,4853674,4853576,98,172,utRho13
hisL,8359856,8359984,8359856,128,32,utRho13
hisS,5281284,5281284,5281150,134,338,utRho13
hlpA,400910,400964,400910,54,450,utRho13
hlyE,2460932,2460932,2460788,144,0,utRho13
hmp,5371594,5371670,5371594,76,0,utRho13
hns,2585916,2585916,2585844,72,1030,utRho13
hofM,7045856,7045856,7045502,354,0,utRho13
hokA,7441620,7441620,7441200,420,46,utRho13
hokC,33902,33902,33806,96,296,utRho13
hokE,1215462,1215672,1215462,210,0,utRho13
holC,8968546,8968546,8968560,14,1242,utRho13
holD,9215562,9215606,9215562,44,0,utRho13
holE,3850040,3850216,3850040,176,118,utRho13
hpt,282720,282862,282720,142,330,utRho13
hrpB,324150,324210,324150,60,18,utRho13
hscB,5319048,5319048,5318934,114,5228,utRho13
hscC,1367188,1367188,1366786,402,2408,utRho13
hsdS,9163004,9163004,9162924,80,0,utRho13
hslJ,2883560,2883560,2883486,74,82,utRho13
hslO,7059344,7059548,7059344,204,10916,utRho13
hslR,7058220,7058696,7058220,476,1800,utRho13
hslV,8244708,8244708,8244574,134,170,utRho13
hsrA,7881412,7881412,7881224,188,58,utRho13
htgA,21286,21660,21286,374,0,utRho13
htpG,989634,990240,989634,606,1998,utRho13
htpX,3825236,3825236,3825152,84,0,utRho13
htrE,311036,311036,310852,184,0,utRho13
htrL,7587668,7587668,7587366,302,0,utRho13
hupA,8400352,8400562,8400352,210,422,utRho13
hupB,1845220,1845804,1845220,584,2244,utRho13
hyaA,2063968,2064278,2063968,310,0,utRho13
hybO,6292726,6292726,6292522,204,424,utRho13
hycA,5700922,5700922,5700870,52,0,utRho13
hycI,5686204,5686204,5686086,118,224,utRho13
hydN,5676264,5676264,5676210,54,0,utRho13
hyfA,5202342,5202402,5202342,60,0,utRho13
hypA,11402508,11402588,11402508,80,0,utRho13
hypB,11403356,11404004,11403356,648,380,utRho13
hypF,5676210,5676210,5674850,1360,156,utRho13
hypT,9116634,9116634,9116578,56,0,utRho13
hyuA,6019660,6020056,6019660,396,8,utRho13
iaaA,1733074,1733136,1733074,62,0,utRho13
iadA,9119074,9119074,9119052,22,88,utRho13
iap,5753072,5753162,5753072,90,44,utRho13
ibaG,6673966,6673966,6673606,360,306,utRho13
ibpA,7735036,7735036,7734844,192,1066,utRho13
ibpB,7733962,7733962,7733794,168,4530,utRho13
icd,2389922,2390246,2389922,324,340,utRho13
iclR,8447304,8447304,8447256,48,80,utRho13
idi,6065876,6066130,6065876,254,0,utRho13
idnD,8988870,8988870,8988812,58,0,utRho13
idnK,8989194,8989246,8989194,52,0,utRho13
ihfA,3591442,3591442,3591104,338,452,utRho13
ihfB,1927498,1927656,1927498,158,1124,utRho13
ileS,43666,44782,43666,1116,8418,utRho13
ileX,6431194,6431196,6431194,2,0,utRho13
ilvA,15820940,15821324,15820940,384,296,utRho13
ilvC,7915824,7915940,7915824,116,0,utRho13
ilvE,15809552,15809936,15809552,384,324,utRho13
ilvI,170840,171260,170840,420,0,utRho13
ilvL,23701308,23701932,23701308,624,6,utRho13
ilvY,7915734,7915734,7915640,94,0,utRho13
inaA,4698998,4698998,4698944,54,0,utRho13
infA,1853370,1853370,1852886,484,1266,utRho13
infC,3602692,3602692,3601276,1416,5474,utRho13
insA-5,3958452,3958452,3958430,22,0,utRho13
insA-7,9036758,9037054,9036758,296,0,utRho13
insC-5,6372080,6372284,6372080,204,40,utRho13
insEF-2,785238,785238,785820,582,224,utRho13
insEF-4,2190310,2190310,2190892,582,238,utRho13
insG,9007098,9007098,9006862,236,32,utRho13
insH-1,550596,550596,550234,362,168,utRho13
insH-11,7306538,7306538,7306396,142,166,utRho13
insH-2,1151548,1151548,1151506,42,474,utRho13
insH-3,1378444,1378444,1378026,418,218,utRho13
insH-4,2791942,2792152,2791942,210,210,utRho13
insH-5,2857852,2857852,2857452,400,0,utRho13
insH-6,4135022,4135022,4134642,380,68,utRho13
insH-7,4206186,4206186,4205822,364,2510,utRho13
insH-9,6260050,6260356,6260050,306,190,utRho13
insI-3,9017372,9017372,9017234,138,48,utRho13
insJ,7441188,7441360,7441188,172,42,utRho13
insK,7442130,7442308,7442130,178,0,utRho13
insL-1,30760,30890,30760,130,2656,utRho13
insL-2,1216112,1216130,1216112,18,8,utRho13
insL-3,5028644,5028662,5028644,18,32,utRho13
insN-1,540452,540484,540452,32,0,utRho13
intD,1132202,1132202,1131956,246,0,utRho13
intR,2826520,2826520,2826470,50,0,utRho13
intS,4933026,4933090,4933026,64,12,utRho13
intZ,5117386,5117542,5117386,156,48,utRho13
iraD,9113152,9113986,9113152,834,68,utRho13
iraM,2424246,2424246,2424006,240,38,utRho13
iraP,802638,802772,802638,134,0,utRho13
iscA,5319924,5319924,5319772,152,2674,utRho13
iscR,5324398,5324398,5324262,136,20176,utRho13
iscX,5313834,5313834,5313472,362,3156,utRho13
ispF,5743968,5743968,5743560,408,1354,utRho13
ispG,5283908,5283908,5283608,300,688,utRho13
ispU,389568,389806,389568,238,78,utRho13
isrA,2811502,2811502,2811618,116,0,utRho13
istr-1,7706384,7706384,7706384,0,0,utRho13
istr-2,7706514,7706514,7706514,0,0,utRho13
ivbL,15412092,15412092,15411952,140,1112,utRho13
ivy,480638,480686,480638,48,0,utRho13
katE,3627628,3627734,3627628,106,0,utRho13
katG,8267624,8267670,8267624,46,20,utRho13
kbaZ,6557732,6557828,6557732,96,0,utRho13
kbl,7585154,7585154,7585102,52,1046,utRho13
kch,2621046,2621046,2620538,508,58,utRho13
kdgR,3820506,3820506,3820198,308,0,utRho13
kdpE,1443788,1443788,1443466,322,102,utRho13
kdpF,1457698,1457698,1457642,56,0,utRho13
kdsA,2535708,2536330,2535708,622,1444,utRho13
kdsC,6683438,6684546,6683438,1108,3072,utRho13
kduI,5968388,5968388,5968248,140,0,utRho13
kefF,94160,94492,94160,332,78,utRho13
kgtP,5451624,5451624,5451492,132,106,utRho13
kup,7862206,7862632,7862206,426,32,utRho13
lacI,735076,735076,735020,56,48,utRho13
lacZ,1465508,1465508,1465220,288,124,utRho13
ldcA,2486394,2486394,2486160,234,0,utRho13
ldhA,2885830,2885830,2885686,144,0,utRho13
ldrA,2538954,2538954,2538550,404,276,utRho13
ldrB,2540024,2540024,2539620,404,32,utRho13
ldrC,2541092,2541092,2540690,402,64,utRho13
ldrD,7400544,7400544,7400174,370,372,utRho13
lepA,5414392,5414392,5414248,144,232,utRho13
lepB,5410928,5410928,5410618,310,956,utRho13
leuD,159188,159188,158906,282,64,utRho13
leuE,3761600,3761600,3761518,82,0,utRho13
leuL,168048,168048,167416,632,0,utRho13
leuO,168308,168736,168308,428,0,utRho13
leuQ,9212864,9212864,9212802,62,16,utRho13
leuU,6644556,6644556,6644316,240,3434,utRho13
leuV,9212546,9212546,9212330,216,1464,utRho13
leuX,8992772,8992810,8992772,38,18,utRho13
lexA,8514174,8514230,8514174,56,54,utRho13
lhr,3456706,3458174,3456706,1468,1704,utRho13
ligA,5060402,5060402,5060352,50,0,utRho13
ligB,7642576,7642576,7642340,236,0,utRho13
lipA,1320602,1320602,1320432,170,134,utRho13
lipB,1324802,1324802,1324556,246,2162,utRho13
lit,2397032,2397390,2397032,358,20,utRho13
livJ,7199524,7199524,7199316,208,4,utRho13
livK,7195510,7195510,7195120,390,0,utRho13
lldP,7554578,7554798,7554578,220,6182,utRho13
lnt,1381968,1381968,1381762,206,924,utRho13
loiP,6163784,6163826,6163784,42,68,utRho13
lolA,1874656,1874738,1874656,82,446,utRho13
lolB,2527112,2527112,2527000,112,64,utRho13
lolC,2350748,2350854,2350748,106,60,utRho13
lon,917630,917776,917630,146,574,utRho13
lpcA,486936,487086,486936,150,50,utRho13
lpd,255434,255824,255434,390,6722,utRho13
lplA,9248476,9248476,9248234,242,2206,utRho13
lplT,5947878,5947878,5947724,154,86,utRho13
lpoA,6586422,6586800,6586422,378,292,utRho13
lpp,3514592,3514842,3514592,250,230,utRho13
lptA,6686598,6686760,6686598,162,1190,utRho13
lptB,6686792,6687888,6686792,1096,2148,utRho13
lptD,114672,114672,114218,454,782,utRho13
lptF,8972244,8972436,8972244,192,0,utRho13
lpxC,213016,213114,213016,98,7768,utRho13
lpxD,401920,401942,401920,22,54,utRho13
lpxL,2233418,2233418,2233164,254,138,utRho13
lpxM,3880456,3880456,3880386,70,68,utRho13
lpxP,4991156,4991290,4991156,134,40,utRho13
lrhA,4813312,4813312,4813282,30,40,utRho13
lrp,1864656,1865190,1864656,534,1268,utRho13
lspA,50028,50414,50028,386,830,utRho13
lsrA,3202920,3202980,3202920,60,0,utRho13
lsrR,3202514,3202514,3202482,32,0,utRho13
ltaE,1818640,1818640,1818588,52,0,utRho13
luxS,5630130,5630130,5629466,664,1034,utRho13
lysA,5957902,5957902,5957798,104,0,utRho13
lysC,8467232,8467232,8466466,766,1070,utRho13
lysP,4497120,4497120,4497064,56,0,utRho13
lysR,5957900,5958042,5957900,142,0,utRho13
lysT,1561028,1561108,1561028,80,108,utRho13
lysU,8709610,8709610,8709434,176,62,utRho13
macB,1840188,1840694,1840188,506,468,utRho13
maeA,3111484,3111484,3111338,146,11084,utRho13
mak,820236,820288,820236,52,2,utRho13
malE,8492928,8492928,8492838,90,46,utRho13
malI,3398456,3398456,3398360,96,44,utRho13
malK,8493472,8493568,8493472,96,0,utRho13
malP,7105020,7105020,7104946,74,272,utRho13
malQ,7100798,7100798,7100140,658,1762,utRho13
malS,14949880,14949988,14949880,108,160,utRho13
malT,7106048,7106170,7106048,122,466,utRho13
malX,3398626,3398710,3398626,84,44,utRho13
malZ,1689980,1690072,1689980,92,156,utRho13
manA,3377102,3377152,3377102,50,0,utRho13
manX,3803866,3804096,3803866,230,0,utRho13
marC,3237882,3237882,3237816,66,0,utRho13
marR,3238186,3238240,3238186,54,0,utRho13
matP,2036918,2036970,2036918,52,0,utRho13
mazE,5822736,5822736,5822678,58,0,utRho13
mazG,5821720,5821720,5821370,350,1668,utRho13
mcbA,1684306,1684306,1684112,194,36,utRho13
mcbR,3040192,3040524,3040192,332,0,utRho13
mcrA,2420278,2420692,2420278,414,0,utRho13
mcrC,9156124,9156124,9155916,208,284,utRho13
mdaB,6344814,6345060,6344814,246,0,utRho13
mdfA,1767138,1767346,1767138,208,0,utRho13
mdh,6768940,6768940,6768536,404,512,utRho13
mdoB,9198988,9198988,9198882,106,1706,utRho13
mdoD,2993290,2993712,2993290,422,12,utRho13
mdoG,2218514,2218670,2218514,156,0,utRho13
mdtA,4307958,4308032,4307958,74,0,utRho13
mdtE,7318168,7318464,7318168,296,252,utRho13
mdtK,3486538,3486914,3486538,376,190,utRho13
mdtP,8602472,8602472,8602060,412,64,utRho13
melA,8683774,8683822,8683774,48,0,utRho13
melR,8683300,8683300,8683256,44,88,utRho13
menA,8240812,8240812,8240698,114,36,utRho13
menB,4753774,4753774,4753638,136,558,utRho13
mepH,3468714,3468870,3468714,156,0,utRho13
mepM,3883666,3883666,3883270,396,396,utRho13
mepS,4539840,4539958,4539840,118,298,utRho13
metA,8428318,8428560,8428318,242,2,utRho13
metB,8257272,8257344,8257272,72,1760,utRho13
metC,6304150,6304472,6304150,322,0,utRho13
metE,8025768,8026106,8025768,338,340,utRho13
metF,8265092,8265232,8265092,140,0,utRho13
metG,4388538,4388600,4388538,62,132,utRho13
metH,8447010,8447656,8447010,646,2402,utRho13
metJ,8257116,8257116,8256790,326,98,utRho13
metK,6173154,6173412,6173154,258,132,utRho13
metN,445428,445428,445290,138,72,utRho13
metR,8025710,8025710,8025632,78,36,utRho13
metT,1394326,1394326,1394266,60,118,utRho13
metY,19910250,19910250,19909734,516,132,utRho13
metZ,11789528,11789548,11789528,20,20,utRho13
mfd,2348056,2348056,2347928,128,262,utRho13
mglA,4478782,4478782,4478578,204,2458,utRho13
mglB,4481132,4481132,4480696,436,39874,utRho13
mglC,4475918,4475918,4475506,412,1240,utRho13
mgrB,3817584,3817584,3817532,52,0,utRho13
mgrR,3245828,3245828,3245828,0,0,utRho13
mgsA,2054082,2054082,2054030,52,152,utRho13
mgtL,8934560,8934862,8934560,302,0,utRho13
mhpA,737038,737222,737038,184,0,utRho13
mhpR,737072,737072,736840,232,0,utRho13
mhpT,750772,750918,750772,146,0,utRho13
miaA,8797964,8798504,8797964,540,554,utRho13
micA,5629604,5629604,5629604,0,0,utRho13
micC,2874242,2874238,2874242,4,0,utRho13
micF,4626168,4626168,4626168,0,0,utRho13
micM,1014408,1014408,1014408,0,0,utRho13
minE,2449422,2449422,2449090,332,3134,utRho13
mioC,7852950,7852950,7852910,40,0,utRho13
mipA,3733012,3733012,3732944,68,3182,utRho13
mlaA,4930270,4930270,4930014,256,0,utRho13
mlc,3337206,3337206,3337128,78,4,utRho13
mlrA,4429498,4429732,4429498,234,0,utRho13
mltA,5894546,5894546,5894356,190,48,utRho13
mltD,468050,468050,467910,140,0,utRho13
mltF,5391534,5391602,5391534,68,0,utRho13
mmuP,550238,550650,550238,412,168,utRho13
mngA,1531622,1531968,1531622,346,0,utRho13
mngR,1531852,1531852,1531750,102,0,utRho13
mnmG,7851348,7851348,7851266,82,808,utRho13
mntH,5025470,5025470,5025412,58,2,utRho13
mntP,3810918,3811376,3810918,458,212,utRho13
mntR,1706160,1706366,1706160,206,0,utRho13
mntS,1706128,1706128,1705994,134,0,utRho13
moaA,1633654,1634088,1633654,434,548,utRho13
moaB,1635954,1636110,1635954,156,2346,utRho13
mobA,8084242,8084242,8083998,244,198,utRho13
mocA,6030112,6030320,6030112,208,242,utRho13
modA,1589990,1590178,1589990,188,18,utRho13
moeA,1732788,1732788,1732728,60,374,utRho13
mokB,2984610,2984610,2984258,352,632,utRho13
molR_1,4392888,4392948,4392888,60,0,utRho13
motA,3954604,3954604,3954278,326,40,utRho13
mpaA,2781278,2781278,2781196,82,60,utRho13
mpl,8911456,8911570,8911456,114,0,utRho13
mppA,2786108,2786454,2786108,346,0,utRho13
mprA,5621494,5621540,5621494,46,672,utRho13
mqo,4613848,4613848,4613508,340,0,utRho13
mqsA,6336742,6336742,6336492,250,404,utRho13
mqsR,6337306,6337306,6337088,218,272,utRho13
mraZ,179192,179268,179192,76,146,utRho13
mrcA,7045652,7045742,7045652,90,0,utRho13
mrcB,329442,329460,329442,18,0,utRho13
mreB,13605424,13605424,13604348,1076,1792,utRho13
mreD,6798166,6798166,6797750,416,248,utRho13
mrp,4388360,4388360,4388336,24,0,utRho13
mscK,972984,973072,972984,88,0,utRho13
mscL,6876002,6876048,6876002,46,20,utRho13
mscS,6139742,6139742,6139614,128,0,utRho13
msrA,8884522,8884522,8884352,170,114,utRho13
msrB,3725168,3725168,3724858,310,0,utRho13
msyB,2228426,2228426,2228362,64,86,utRho13
mtfA,4087236,4087302,4087236,66,4682,utRho13
mtgA,6699662,6699662,6699618,44,204,utRho13
mtlA,30177504,30178248,30177504,744,1592,utRho13
mtn,358366,358366,358306,60,0,utRho13
mtr,6611864,6611864,6611634,230,88,utRho13
mug,6430992,6430992,6430946,46,2,utRho13
murQ,5091466,5091546,5091466,80,0,utRho13
murR,5091586,5091586,5091218,368,28,utRho13
mutH,5939164,5939324,5939164,160,164,utRho13
mutL,8794092,8794824,8794092,732,824,utRho13
mutM,7622554,7622554,7622304,250,1086,utRho13
mutS,5714038,5714186,5714038,148,1980,utRho13
mutY,18617466,18618078,18617466,612,78,utRho13
nac,4123956,4123956,4123866,90,0,utRho13
nadA,1564122,1564170,1564122,48,0,utRho13
nadB,5420714,5420840,5420714,126,0,utRho13
nadC,237326,237326,237290,36,30,utRho13
nadE,3644604,3644916,3644604,312,0,utRho13
nadK,5501526,5501662,5501526,136,102,utRho13
nagA,1406350,1406350,1405502,848,19798,utRho13
nagB,1407416,1407416,1407222,194,100,utRho13
nagC,1404016,1404016,1403188,828,578,utRho13
nagE,1407680,1407888,1407680,208,112,utRho13
nagK,2357080,2357186,2357080,106,0,utRho13
nanA,6747240,6747240,6747152,88,78,utRho13
nanC,9079856,9079856,9079002,854,4032,utRho13
nanR,6749406,6749406,6748978,428,54,utRho13
nanS,9075406,9075406,9075188,218,696,utRho13
napF,4607390,4607390,4606994,396,0,utRho13
narG,2559614,2559728,2559614,114,0,utRho13
narK,2555642,2555914,2555642,272,0,utRho13
narP,4580844,4581000,4580844,156,176,utRho13
narQ,5171154,5171462,5171154,308,0,utRho13
narU,3088326,3088326,3088120,206,0,utRho13
narW,3077374,3077374,3074618,2756,224,utRho13
narX,2555554,2555554,2555236,318,0,utRho13
narZ,3085380,3085380,3085180,200,0,utRho13
ndh,2331984,2332170,2331984,186,0,utRho13
ndk,5289920,5289920,5289728,192,204,utRho13
nemR,6904084,6904092,6904084,8,0,utRho13
nepI,7683542,7683542,7683478,64,0,utRho13
nfo,4501612,4501680,4501612,68,2,utRho13
nfsB,1210906,1210906,1210848,58,28,utRho13
nfuA,7090916,7091248,7090916,332,888,utRho13
nhaA,34634,34978,34634,344,56,utRho13
nhaB,2469534,2469534,2469434,100,0,utRho13
nhoA,3067926,3068048,3067926,122,0,utRho13
nikA,7226878,7227334,7226878,456,722,utRho13
nikR,7237074,7237176,7237074,102,350,utRho13
nirB,6987974,6988022,6987974,48,0,utRho13
nlpA,7680034,7680034,7679986,48,0,utRho13
nlpC,3585654,3585654,3585462,192,0,utRho13
nlpD,5737658,5737658,5737506,152,106,utRho13
nlpI,6618080,6618080,6617848,232,0,utRho13
nmpC,1153740,1153740,1153650,90,104,utRho13
nohA,3273206,3273206,3272734,472,0,utRho13
norR,5664614,5664614,5664578,36,0,utRho13
norV,5664878,5664952,5664878,74,0,utRho13
nrdA,4689510,4689730,4689510,220,15180,utRho13
nrdD,8925676,8925676,8925320,356,3682,utRho13
nrdH,5601312,5601446,5601312,134,776,utRho13
nrdR,865954,866004,865954,50,0,utRho13
nrfA,8575342,8575528,8575342,186,0,utRho13
nsrR,8812088,8812380,8812088,292,296,utRho13
nudB,3897348,3897348,3897264,84,0,utRho13
nudC,8393428,8393806,8393428,378,180,utRho13
nudE,7052658,7052658,7052298,360,784,utRho13
nudG,3682876,3682980,3682876,104,0,utRho13
nudI,4729050,4729108,4729050,58,0,utRho13
nudJ,2388874,2388874,2388576,298,750,utRho13
nuoA,4810670,4810670,4810144,526,9142,utRho13
nuoN,4783434,4783434,4783010,424,2682,utRho13
nupC,5026018,5026084,5026018,66,46,utRho13
nupG,6211302,6211428,6211302,126,62,utRho13
ogrK,4335096,4335096,4335040,56,0,utRho13
ogt,2800568,2800568,2800472,96,40,utRho13
ohsC,5401036,5401040,5401036,4,0,utRho13
ompA,2040382,2040382,2040106,276,45330,utRho13
ompC,4625774,4625774,4625498,276,480,utRho13
ompF,1974184,1974184,1973964,220,588,utRho13
ompL,8128958,8128958,8128590,368,0,utRho13
ompN,2874158,2874158,2873786,372,0,utRho13
ompR,7073510,7073510,7073168,342,180,utRho13
ompT,1171330,1171330,1171266,64,110,utRho13
ompW,2627982,2628040,2627982,58,0,utRho13
ompX,1700418,1700900,1700418,482,610,utRho13
omrA,5952378,5952378,5952378,0,0,utRho13
omrB,5952770,5952770,5952770,0,0,utRho13
oppA,2602170,2602364,2602170,194,6876,utRho13
orn,8783168,8783208,8783168,40,0,utRho13
osmB,2686952,2686952,2686656,296,2,utRho13
osmC,3113192,3113250,3113192,58,174,utRho13
osmE,3644566,3644566,3644512,54,0,utRho13
osmF,4439046,4439046,4438962,84,746,utRho13
osmY,9222306,9222792,9222306,486,6,utRho13
otsA,3963302,3963302,3963224,78,0,utRho13
otsB,3964930,3964930,3964774,156,0,utRho13
oxc,4984288,4984288,4983900,388,0,utRho13
oxyR,8316914,8316980,8316914,66,48,utRho13
oxyS,8316788,8316788,8316788,0,0,utRho13
paaA,2907730,2907854,2907730,124,0,utRho13
paaX,2927018,2927078,2927018,60,0,utRho13
paaZ,2907340,2907340,2907284,56,0,utRho13
pabA,6981702,6981702,6981658,44,0,utRho13
pabB,3789256,3789610,3789256,354,240,utRho13
pabC,2306186,2306600,2306186,414,436,utRho13
pagP,1313052,1313114,1313052,62,0,utRho13
panB,299260,299260,299202,58,44,utRho13
panC,297840,297840,297590,250,544,utRho13
panD,293490,293490,293388,102,0,utRho13
panZ,7195656,7195968,7195656,312,140,utRho13
parC,6332060,6332060,6331946,114,698,utRho13
patA,6438916,6438988,6438916,72,10,utRho13
patD,3030830,3031156,3030830,326,0,utRho13
pbpC,5294986,5294986,5294650,336,0,utRho13
pbpG,4450132,4450132,4449740,392,304,utRho13
pck,7065358,7065636,7065358,278,7422,utRho13
pcnB,318782,318782,318252,530,790,utRho13
pdhR,244068,244184,244068,116,0,utRho13
pdxB,4875768,4875768,4875702,66,0,utRho13
pdxH,3436068,3436068,3436014,54,156,utRho13
pdxJ,5403626,5403626,5403458,168,0,utRho13
pdxK,5074638,5074638,5074474,164,62,utRho13
pepA,8972278,8972278,8971902,376,400,utRho13
pepD,511618,511618,511432,186,11270,utRho13
pepN,1981182,1981244,1981182,62,38,utRho13
pepQ,8062294,8062322,8062294,28,38,utRho13
pepT,2371646,2371688,2371646,42,0,utRho13
pfkA,8214948,8215104,8214948,156,244,utRho13
pfkB,3612646,3612740,3612646,94,0,utRho13
pflA,1902456,1902456,1902160,296,0,utRho13
pflB,1907850,1907850,1907108,742,1184,utRho13
pflD,8287716,8287990,8287716,274,0,utRho13
pgaA,2185046,2185046,2184578,468,0,utRho13
pgi,8467444,8467516,8467444,72,0,utRho13
pgk,12291428,12291428,12290488,940,6668,utRho13
pgl,1597078,1597172,1597078,94,92,utRho13
pgpB,2678324,2678660,2678324,336,72,utRho13
pgpC,5397276,5397276,5397100,176,0,utRho13
pgrR,2783744,2783982,2783744,238,0,utRho13
pheL,5475158,5475198,5475158,40,0,utRho13
pheM,7197204,7197204,7197080,124,68,utRho13
pheP,1203858,1203918,1203858,60,0,utRho13
pheU,8725254,8725254,8725252,2,80,utRho13
pheV,6220730,6220732,6220730,2,0,utRho13
phnC,8650412,8650412,8650330,82,32,utRho13
phoA,803414,803494,803414,80,26,utRho13
phoB,834202,834284,834202,82,0,utRho13
phoE,520316,520316,520200,116,0,utRho13
phoH,2169730,2169984,2169730,254,166,utRho13
phoP,2381016,2381016,2380894,122,1600,utRho13
phoQ,2379880,2379880,2379552,328,1188,utRho13
phoU,7815330,7815330,7815156,174,166,utRho13
phr,1478842,1479014,1478842,172,0,utRho13
pinE,2419054,2419370,2419054,316,0,utRho13
pinQ,3267168,3267244,3267168,76,0,utRho13
pinR,2867424,2867424,2867348,76,0,utRho13
pitA,7275224,7275284,7275224,60,64,utRho13
pitB,6272806,6272806,6272742,64,0,utRho13
pka,5439862,5439906,5439862,44,0,utRho13
plaP,4174476,4174476,4174124,352,218,utRho13
pldA,8009628,8009724,8009628,96,10,utRho13
pldB,8018028,8018340,8018028,312,176,utRho13
plsB,8513196,8513196,8512932,264,660,utRho13
pmbA,8915890,8915918,8915890,28,0,utRho13
pmrD,4747148,4747148,4747076,72,0,utRho13
pncB,1980828,1980828,1980712,116,2,utRho13
pncC,5648788,5648788,5648692,96,0,utRho13
pnp,6622652,6622652,6622336,316,178,utRho13
pntA,3355950,3355950,3355806,144,58,utRho13
pntB,3353096,3353096,3352720,376,0,utRho13
polA,8093880,8093932,8093880,52,52,utRho13
polB,131606,131606,131560,46,0,utRho13
potD,2365700,2365700,2365658,42,0,utRho13
potE,1436688,1436688,1436530,158,0,utRho13
potF,1787268,1787568,1787268,300,0,utRho13
poxB,1822152,1822152,1822098,54,0,utRho13
ppa,8899372,8899372,8899304,68,124,utRho13
ppc,8306380,8306380,8306196,184,1204,utRho13
ppdA,5928440,5928440,5928354,86,2,utRho13
ppdD,235410,235410,235098,312,44,utRho13
pphA,3846770,3846770,3845938,832,3030,utRho13
pphB,5719474,5719520,5719474,46,38,utRho13
ppiA,6984898,6984898,6984594,304,74,utRho13
ppiC,7919682,7919682,7919626,56,0,utRho13
ppiD,923638,923830,923638,192,568,utRho13
ppk,5245748,5246088,5245748,340,418,utRho13
pppA,6228958,6228958,6228704,254,62,utRho13
ppsA,3574322,3574322,3574224,98,8,utRho13
ppsR,3574678,3574890,3574678,212,0,utRho13
pptA,3065716,3066104,3065716,388,0,utRho13
pqiA,2023318,2024002,2023318,684,72,utRho13
prc,3830054,3830054,3829632,422,25512,utRho13
preT,4467978,4468066,4467978,88,0,utRho13
prfC,9218688,9218828,9218688,140,786,utRho13
prkB,6968622,6968980,6968622,358,948,utRho13
prlC,7290476,7290476,7290364,112,396,utRho13
prlF,6553944,6554004,6553944,60,168,utRho13
proB,520432,520776,520432,344,28,utRho13
proC,811372,811372,811288,84,0,utRho13
proK,7417388,7417388,7417384,4,0,utRho13
proL,4572414,4572422,4572414,8,0,utRho13
proP,8660640,8661004,8660640,364,588,utRho13
proS,437674,437674,437550,124,1688,utRho13
proV,5609126,5609630,5609126,504,68,utRho13
prpB,697292,697364,697292,72,0,utRho13
prpR,696942,696942,696886,56,0,utRho13
prs,2524354,2524354,2523750,604,101002,utRho13
psd,8781276,8781276,8780720,556,2214,utRho13
psiE,8480600,8480650,8480600,50,0,utRho13
pspA,2736076,2736158,2736076,82,0,utRho13
pspF,2736080,2736080,2735824,256,0,utRho13
pspG,8525632,8525680,8525632,48,0,utRho13
pssA,5445156,5445454,5445156,298,6504,utRho13
pstB,7817112,7817112,7816732,380,2,utRho13
pstC,7821084,7821084,7820796,288,92,utRho13
pstS,23469408,23469408,23469150,258,246,utRho13
psuG,4517114,4517114,4516734,380,2590,utRho13
psuT,4514992,4514992,4514670,322,0,utRho13
pth,2517084,2517084,2517026,58,48,utRho13
ptrA,5918022,5918022,5917768,254,12,utRho13
ptrB,3857730,3857730,3857678,52,414,utRho13
ptsG,2315252,2315738,2315252,486,2254,utRho13
ptsH,5066996,5067528,5066996,532,6684,utRho13
purA,8809328,8809374,8809328,46,8,utRho13
purC,5195562,5195562,5195236,326,190,utRho13
purD,8411972,8411972,8411862,110,160,utRho13
purE,1106284,1106284,1106200,84,272,utRho13
purH,8415254,8415254,8415064,190,70,utRho13
purL,5391178,5391178,5391086,92,666,utRho13
purM,5242306,5242394,5242306,88,222,utRho13
purR,3475378,3475688,3475378,310,672,utRho13
purT,3861438,3861762,3861438,324,0,utRho13
purU,2577512,2577512,2577248,264,432,utRho13
putA,2157850,2157850,2157764,86,0,utRho13
putP,2158336,2158610,2158336,274,2250,utRho13
puuA,2721936,2721936,2721816,120,0,utRho13
puuC,2725456,2725486,2725456,30,0,utRho13
puuD,2722104,2722240,2722104,136,0,utRho13
puuP,2718746,2718746,2718374,372,126,utRho13
pykA,3874988,3875298,3874988,310,628,utRho13
pykF,3510934,3511396,3510934,462,746,utRho13
pyrC,2245286,2245286,2245214,72,276,utRho13
pyrD,2009464,2009536,2009464,72,0,utRho13
pyrE,7631970,7631970,7631536,434,0,utRho13
pyrF,2683740,2683842,2683740,102,158,utRho13
pyrG,5819594,5819594,5819332,262,158,utRho13
pyrH,383624,383710,383624,86,1312,utRho13
pyrL,8945490,8945490,8945066,424,50,utRho13
qmcA,1031646,1031646,1031546,100,0,utRho13
qor,8528608,8528608,8528462,146,0,utRho13
qseB,6339502,6339656,6339502,154,4,utRho13
queA,849970,850022,849970,52,200,utRho13
queE,5811212,5811212,5810836,376,0,utRho13
queF,5850642,5850696,5850642,54,0,utRho13
queG,8788184,8788184,8788134,50,1394,utRho13
racC,2835630,2835630,2835526,104,0,utRho13
racR,2840898,2840898,2840482,416,0,utRho13
raiA,5474208,5474308,5474208,100,104,utRho13
rarD,8008594,8008594,8008356,238,78,utRho13
ravA,7862256,7862256,7862186,70,0,utRho13
rayT,495088,495274,495088,186,0,utRho13
rbn,4763162,4763216,4763162,54,0,utRho13
rbsD,7866644,7866702,7866644,58,68,utRho13
rcnA,4371654,4371834,4371654,180,0,utRho13
rcnB,4373768,4373920,4373768,152,26,utRho13
rcnR,4371806,4371806,4371592,214,0,utRho13
rcsA,4047672,4047936,4047672,264,4,utRho13
rcsB,4631390,4632354,4631390,964,930,utRho13
rcsC,4640162,4640162,4639656,506,642,utRho13
rcsD,4626904,4626976,4626904,72,78,utRho13
rdgB,6193240,6193362,6193240,122,624,utRho13
rdlA,2538646,2538646,2538646,0,0,utRho13
rdlB,2539712,2539716,2539712,4,0,utRho13
rdlC,2540782,2540786,2540782,4,0,utRho13
rdlD,7400272,7400272,7400272,0,0,utRho13
rdoA,8084782,8084830,8084782,48,28,utRho13
recA,11295276,11295276,11295076,200,840,utRho13
recC,5925014,5925014,5924856,158,96,utRho13
recF,7763722,7763722,7762442,1280,6958,utRho13
recN,5503518,5503590,5503518,72,32,utRho13
recQ,8011666,8011728,8011666,62,0,utRho13
relA,5828554,5828554,5827302,1252,776,utRho13
relB,3291806,3291806,3291744,62,0,utRho13
rem,3289950,3289950,3289804,146,0,utRho13
rep,7921294,7921354,7921294,60,52,utRho13
rfaD,7587730,7587974,7587730,244,0,utRho13
rfaE,6393852,6393852,6393506,346,160,utRho13
rfaH,8049930,8049930,8049642,288,610,utRho13
rfbX,4219436,4219436,4219168,268,1430,utRho13
rfe,7935600,7935832,7935600,232,0,utRho13
rhaB,8194944,8194944,8194896,48,0,utRho13
rhaD,8188770,8188770,8188544,226,0,utRho13
rhaS,8195422,8195472,8195422,50,0,utRho13
rhaT,8201132,8201132,8201050,82,38,utRho13
rhlE,1661566,1661744,1661566,178,68,utRho13
rhoL,47593944,47594772,47593944,828,30924,utRho13
rhsB,7238006,7238384,7238006,378,0,utRho13
rhsC,1458758,1459166,1458758,408,0,utRho13
rhsD,1046132,1046522,1046132,390,0,utRho13
rhtA,1700608,1700608,1700194,414,0,utRho13
rhtC,8015478,8015514,8015478,36,576,utRho13
ribA,2678468,2678468,2678320,148,72,utRho13
ribC,3486916,3486916,3486484,432,190,utRho13
ribE,869008,869294,869008,286,11960,utRho13
ribF,42766,42814,42766,48,0,utRho13
ridA,8941892,8941892,8941826,66,34,utRho13
rihA,1369204,1369204,1368824,380,184,utRho13
rihB,4510504,4510504,4510372,132,0,utRho13
rimJ,2251044,2251124,2251044,80,0,utRho13
rimK,1783752,1783934,1783752,182,838,utRho13
rimL,2997486,2997876,2997486,390,148,utRho13
rimO,1756140,1756140,1756070,70,0,utRho13
rimP,6636350,6636350,6636012,338,340,utRho13
rlmA,3814172,3814172,3814120,52,684,utRho13
rlmD,5830086,5830086,5830000,86,0,utRho13
rlmE,6655520,6655520,6655328,192,516,utRho13
rlmF,1684384,1684664,1684384,280,36,utRho13
rlmG,6471784,6471784,6471750,34,0,utRho13
rlmI,2060002,2060002,2059938,64,0,utRho13
rlmJ,7290700,7290770,7290700,70,10,utRho13
rlmL,2015344,2015688,2015344,344,1226,utRho13
rlpA,1330444,1330444,1330380,64,40,utRho13
rluA,120900,120900,120692,208,0,utRho13
rluF,8460324,8460708,8460324,384,0,utRho13
rmf,2031006,2031430,2031006,424,0,utRho13
rna,1290068,1290068,1290006,62,26,utRho13
rnb,2698258,2698258,2697824,434,2764,utRho13
rnc,10816892,10816892,10816252,640,5144,utRho13
rnd,3776122,3776122,3775982,140,46,utRho13
rne,2289746,2289746,2288734,1012,8966,utRho13
rnhA,472082,472082,472004,78,522,utRho13
rnk,1288360,1288360,1287934,426,182,utRho13
rnlA,5531788,5531836,5531788,48,0,utRho13
rnlB,5533414,5533968,5533414,554,698,utRho13
rnpB,19623552,19623552,19623552,0,0,utRho13
rob,9270706,9270706,9270620,86,96,utRho13
rodZ,5285868,5285868,5285688,180,12,utRho13
rpe,7030306,7030306,7030118,188,146,utRho13
rph,15266320,15266320,15266196,124,80,utRho13
rpiA,6118706,6118706,6118650,56,0,utRho13
rpiB,8626514,8626700,8626514,186,0,utRho13
rpiR,8626274,8626274,8625982,292,0,utRho13
rplJ,8359246,8359992,8359246,746,8140,utRho13
rplK,8356708,8356894,8356708,186,712,utRho13
rplM,6757344,6757344,6757302,42,11992,utRho13
rplN,6896444,6896444,6896298,146,7496,utRho13
rplS,5489284,5489284,5489060,224,10902,utRho13
rplT,7199052,7199052,7198996,56,1228,utRho13
rplU,6667036,6667036,6666902,134,180,utRho13
rplY,4564866,4565034,4564866,168,158,utRho13
rpmA,6666450,6666450,6666238,212,532,utRho13
rpmB,15247980,15247980,15246696,1284,98072,utRho13
rpmE,8253816,8254026,8253816,210,438,utRho13
rpmF,2294676,2294734,2294676,58,50054,utRho13
rpmH,7768130,7768672,7768130,542,5348,utRho13
rpmI,3600854,3600854,3599998,856,15384,utRho13
rpoB,8362126,8362490,8362126,364,346,utRho13
rpoD,6424946,6426094,6424946,1148,24026,utRho13
rpoE,5420372,5420372,5420024,348,0,utRho13
rpoH,7202006,7202006,7201566,440,2026,utRho13
rpoN,6689324,6689434,6689324,110,108,utRho13
rpoS,5736236,5736236,5735102,1134,6042,utRho13
rpoZ,7644154,7644212,7644154,58,548,utRho13
rppH,5937986,5937986,5937954,32,0,utRho13
rprA,3540744,3540744,3540744,0,0,utRho13
rpsA,1923434,1923990,1923434,556,140090,utRho13
rpsF,8850050,8850236,8850050,186,38642,utRho13
rpsI,6756580,6756580,6756414,166,10904,utRho13
rpsJ,6906884,6906884,6906540,344,9394,utRho13
rpsL,6949242,6949242,6949104,138,404,utRho13
rpsM,6885130,6885130,6884942,188,1616,utRho13
rpsO,13247144,13247144,13246736,408,1060,utRho13
rpsP,5492508,5492508,5492370,138,374,utRho13
rpsT,42420,42420,42156,264,640,utRho13
rpsU,12842584,12843124,12842584,540,2112,utRho13
rraA,8238716,8238716,8238660,56,228,utRho13
rraB,8956768,8956946,8956768,178,0,utRho13
rrsA,8070478,8071062,8070478,584,9714,utRho13
rrsB,16665468,16666636,16665468,1168,22668,utRho13
rrsC,7883032,7883616,7883032,584,8092,utRho13
rrsD,6858094,6858094,6857524,570,400,utRho13
rrsE,8415726,8416294,8415726,568,1634,utRho13
rrsG,5462896,5462896,5462314,582,8840,utRho13
rrsH,446970,447542,446970,572,1030,utRho13
rsd,8393908,8393908,8393616,292,264,utRho13
rseA,5419264,5419264,5418808,456,720,utRho13
rseP,392940,393092,392940,152,0,utRho13
rseX,4067298,4067298,4067298,0,0,utRho13
rsfS,1338144,1338144,1338072,72,434,utRho13
rsgA,8783132,8783132,8783018,114,112,utRho13
rsmA,105176,105176,104860,316,3468,utRho13
rsmB,6869982,6870414,6869982,432,826,utRho13
rsmC,9215736,9215736,9215400,336,448,utRho13
rsmD,7208594,7208786,7208594,192,0,utRho13
rsmE,6182036,6182268,6182036,232,802,utRho13
rsmG,7847512,7847512,7847360,152,364,utRho13
rsmH,180020,180188,180020,168,332,utRho13
rsmI,6587106,6587106,6586670,436,2184,utRho13
rssA,2578212,2578412,2578212,200,216,utRho13
rssB,2580440,2580484,2580440,44,314,utRho13
rstA,3364276,3364300,3364276,24,0,utRho13
rsuA,4561096,4561096,4560966,130,282,utRho13
rsxA,3411510,3411534,3411510,24,0,utRho13
rtcA,7114004,7114004,7113698,306,0,utRho13
rtcB,7116214,7116214,7116158,56,0,utRho13
rtn,4541356,4541452,4541356,96,0,utRho13
rutA,2148052,2148052,2148022,30,0,utRho13
rutG,2140090,2140090,2139678,412,0,utRho13
rutR,2148226,2148484,2148226,258,0,utRho13
ruvA,7784096,7784096,7783904,192,0,utRho13
ruvB,7782176,7782176,7781424,752,876,utRho13
ruvC,3894878,3894878,3894752,126,144,utRho13
rybB,1776114,1776114,1776114,0,0,utRho13
rydB,3529860,3529860,3529322,538,268,utRho13
rydC,2983012,2983012,2983012,0,0,utRho13
ryfA,5307398,5307710,5307398,312,0,utRho13
ryfD,5468590,5468590,5468590,0,0,utRho13
ryhB,7162032,7162032,7162032,0,0,utRho13
ryjA,8556132,8556132,8556132,0,0,utRho13
ryjB,9055954,9055954,9055954,0,0,utRho13
sad,3229598,3229598,3229406,192,0,utRho13
safA,3168056,3168056,3167918,138,0,utRho13
sanA,4465368,4465756,4465368,388,104,utRho13
sapF,2705314,2705314,2705268,46,34,utRho13
sbcB,4165456,4165512,4165456,56,0,utRho13
sbcC,831694,831694,831506,188,192,utRho13
sbcD,833954,833954,833904,50,0,utRho13
sbmA,793106,793278,793106,172,0,utRho13
sbmC,4162650,4162650,4162524,126,0,utRho13
sdaA,3793618,3793864,3793618,246,56,utRho13
sdaC,5856070,5856458,5856070,388,2544,utRho13
sdhC,1509916,1510354,1509916,438,94756,utRho13
sdhD,1510808,1511120,1510808,312,24690,utRho13
sdiA,3993834,3993834,3993664,170,172,utRho13
secE,8354354,8354716,8354354,362,132,utRho13
secG,6645180,6645180,6645010,170,1224,utRho13
selA,7522594,7522594,7522498,96,152,utRho13
selB,7519850,7519850,7519722,128,268,utRho13
selC,7672396,7672444,7672396,48,48,utRho13
selD,3696058,3696058,3696016,42,1610,utRho13
seqA,1425884,1425974,1425884,90,774,utRho13
serA,6117098,6117098,6116820,278,64,utRho13
serB,9249712,9249790,9249712,78,0,utRho13
serC,3830380,3830612,3830380,232,0,utRho13
serS,1878730,1878856,1878730,126,910,utRho13
serT,2063438,2063438,2063424,14,0,utRho13
serU,4087124,4087124,4087114,10,584,utRho13
serV,5637394,5637394,5637290,104,120,utRho13
serW,1852014,1852014,1851942,72,76,utRho13
serX,2195352,2195352,2195304,48,16,utRho13
setB,4527426,4527726,4527426,300,0,utRho13
setC,7673488,7673906,7673488,418,8,utRho13
sfmA,1116124,1116424,1116124,300,0,utRho13
sfmC,1117606,1117948,1117606,342,0,utRho13
sfsA,323030,323030,322972,58,1054,utRho13
sfsB,6669592,6669818,6669592,226,72,utRho13
sgrR,154676,154676,154598,78,0,utRho13
sgrS,154734,154734,154734,0,0,utRho13
shiA,4107068,4107286,4107068,218,0,utRho13
sibA,4306622,4306622,4306622,0,0,utRho13
sibB,4307292,4307292,4307292,0,0,utRho13
sibC,6113702,6113702,6113702,0,0,utRho13
sibD,6389730,6389730,6389730,0,0,utRho13
sibE,6390480,6390480,6390480,0,0,utRho13
sixA,4913998,4913998,4913624,374,44,utRho13
slp,7307872,7307922,7307872,50,0,utRho13
slt,9261400,9261466,9261400,66,0,utRho13
slyA,3442028,3442028,3441648,380,130,utRho13
slyB,3439496,3439752,3439496,256,112,utRho13
slyD,6957398,6957398,6956994,404,498,utRho13
slyX,6954862,6955280,6954862,418,9524,utRho13
smf,6867372,6867372,6867120,252,6,utRho13
smpB,5509534,5509792,5509534,258,680,utRho13
smrA,2811872,2811958,2811872,86,188,utRho13
smrB,4896872,4897212,4896872,340,114,utRho13
smtA,1946808,1947074,1946808,266,54,utRho13
sodA,8201518,8201620,8201518,102,16114,utRho13
sodB,3470646,3470756,3470646,110,144,utRho13
sodC,3449358,3449358,3449310,48,0,utRho13
sohB,2658568,2658664,2658568,96,0,utRho13
sokB,2984232,2984238,2984232,6,28,utRho13
solA,2241218,2241218,2241172,46,0,utRho13
soxR,8554894,8554938,8554894,44,0,utRho13
soxS,8554846,8554846,8554766,80,0,utRho13
speA,6172096,6172096,6171822,274,312,utRho13
speB,6167892,6167892,6167594,298,258,utRho13
speC,6218350,6218350,6218310,40,6,utRho13
spf,8099798,8099798,8099798,0,0,utRho13
sppA,3697422,3697674,3697422,252,0,utRho13
spy,3651376,3651376,3651250,126,0,utRho13
sra,3112092,3112092,3111926,166,0,utRho13
sraB,2293178,2293178,2293178,0,0,utRho13
sraC,3846132,3846132,3846132,0,0,utRho13
srlA,5651582,5651664,5651582,82,0,utRho13
srlR,5657720,5658094,5657720,374,3458,utRho13
srmB,5425752,5425792,5425752,40,434,utRho13
sroA,151216,151216,151216,0,0,utRho13
sroG,6369436,6369436,6369436,0,0,utRho13
sroH,8380974,8380974,8380974,0,0,utRho13
ssb,8548022,8548250,8548022,228,2,utRho13
sseA,5304782,5304988,5304782,206,25084,utRho13
sspA,6755138,6755138,6754840,298,942,utRho13
ssrA,5511014,5511186,5511014,172,80,utRho13
ssrS,12223036,12223932,12223036,896,2588,utRho13
sstT,6479726,6479888,6479726,162,0,utRho13
ssuB,1988282,1988282,1988088,194,48,utRho13
ssuE,1995126,1995126,1995024,102,0,utRho13
sthA,8321604,8321604,8321580,24,4362,utRho13
stpA,5597156,5597156,5596990,166,0,utRho13
sucA,3034344,3034824,3034344,480,11316,utRho13
sufA,3528836,3528836,3528772,64,0,utRho13
sufE,3518962,3518962,3518580,382,0,utRho13
sugE,8753588,8753750,8753588,162,292,utRho13
sulA,2041894,2041894,2041838,56,132,utRho13
syd,5850738,5850738,5850560,178,132,utRho13
symE,9159834,9159834,9159680,154,0,utRho13
symR,9159670,9159670,9159670,0,0,utRho13
tabA,8949566,8949724,8949566,158,0,utRho13
talA,5157140,5157332,5157140,192,46,utRho13
talB,16382,16476,16382,94,14632,utRho13
tam,3214442,3214692,3214442,250,40,utRho13
tamA,8884540,8884764,8884540,224,26,utRho13
tar,3945432,3945432,3945382,50,0,utRho13
tas,5943138,5943194,5943138,56,102,utRho13
tatA,16087636,16087780,16087636,144,488,utRho13
tatE,1317742,1317894,1317742,152,0,utRho13
tauA,770410,770464,770410,54,0,utRho13
tdcA,6534186,6534186,6534130,56,0,utRho13
tdcG,6519652,6519652,6519298,354,530,utRho13
tdcR,6534380,6534760,6534380,380,44,utRho13
tdk,2586986,2587054,2586986,68,0,utRho13
tehA,3001072,3001146,3001072,74,0,utRho13
tesA,1039898,1039898,1039530,368,428,utRho13
tesB,950402,950402,950322,80,0,utRho13
tfaE,2418532,2418532,2418238,294,0,utRho13
tfaQ,3269912,3269912,3269770,142,0,utRho13
tff,379424,379256,379424,168,144,utRho13
tgt,852110,852274,852110,164,70,utRho13
thiD,4369346,4369346,4369032,314,0,utRho13
thiI,882936,883098,882936,162,498,utRho13
thiM,4370902,4370902,4370602,300,96,utRho13
thiQ,146170,146170,145854,316,312,utRho13
thrL,592,760,592,168,460,utRho13
thrS,7210932,7210932,7210280,652,1248,utRho13
thrU,8350762,8350776,8350762,14,0,utRho13
thrV,6847414,6847414,6847310,104,201684,utRho13
thrW,525682,525742,525682,60,158,utRho13
thyA,5930696,5930696,5930310,386,3304,utRho13
tig,909986,910266,909986,280,1826,utRho13
tisB,7706674,7707106,7706674,432,618,utRho13
tktA,6163414,6163414,6163270,144,244,utRho13
tktB,5158616,5159272,5158616,656,1004,utRho13
tldD,6784368,6784368,6784056,312,0,utRho13
tmcA,5191876,5191876,5191718,158,0,utRho13
tnaC,15553644,15553740,15553644,96,5488,utRho13
tolB,1555074,1555480,1555074,406,404,utRho13
tolC,6356008,6356230,6356008,222,428,utRho13
tomB,961588,961588,961416,172,130,utRho13
tonB,2622108,2622178,2622108,70,0,utRho13
topA,2661578,2662096,2661578,518,252,utRho13
torC,2116112,2116168,2116112,56,204,utRho13
torR,2115968,2115968,2115908,60,388,utRho13
torS,2112364,2112364,2112356,8,0,utRho13
torT,2112414,2112522,2112414,108,0,utRho13
tpiA,8223138,8223138,8223014,124,342,utRho13
tppB,3425342,3425538,3425342,196,4674,utRho13
tpr,2574376,2574376,2574376,0,0,utRho13
tpx,2777688,2777688,2777622,66,324,utRho13
tqsA,3347780,3347826,3347780,46,0,utRho13
treA,2494850,2494850,2494752,98,72,utRho13
treB,8932420,8932420,8932360,60,246,utRho13
treF,7339102,7339184,7339102,82,0,utRho13
treR,8934694,8934694,8934492,202,0,utRho13
trg,2984878,2984940,2984878,62,0,utRho13
trkG,2847342,2847564,2847342,222,38,utRho13
trmA,8326590,8326590,8326540,50,0,utRho13
trpA,2634678,2634678,2634444,234,590,utRho13
trpC,2639888,2639888,2639570,318,0,utRho13
trpL,5292432,5292432,5292328,104,0,utRho13
trpR,9265408,9265520,9265408,112,220,utRho13
trpS,7027394,7027394,7027276,118,2072,utRho13
trpT,7893560,7893914,7893560,354,148954,utRho13
trxA,7931294,7931522,7931294,228,720,utRho13
trxB,1864156,1864156,1864100,56,0,utRho13
trxC,5437350,5437470,5437350,120,114,utRho13
tsaD,6421256,6421256,6421086,170,0,utRho13
tsgA,6985038,6985136,6985038,98,0,utRho13
tsr,9182824,9183314,9182824,490,132,utRho13
tsx,864490,864490,864026,464,2166,utRho13
ttcA,2823970,2823970,2823896,74,2684,utRho13
ttdA,6412848,6412926,6412848,78,0,utRho13
ttdR,6412760,6412760,6412512,248,0,utRho13
tufA,6943448,6943448,6942658,790,290268,utRho13
tus,3368346,3368518,3368346,172,146,utRho13
tusA,7218040,7218040,7217992,48,188,utRho13
tusB,6950218,6950218,6949930,288,432,utRho13
tynA,2902996,2902996,2902698,298,0,utRho13
typA,8116460,8116814,8116460,354,4898,utRho13
tyrB,8534164,8534228,8534164,64,3802,utRho13
tyrP,3979004,3979362,3979004,358,4,utRho13
tyrR,2773384,2773440,2773384,56,0,utRho13
tyrS,3434566,3434566,3434444,122,0,utRho13
tyrT,2575330,2575330,2575244,86,244,utRho13
uacT,6062378,6062734,6062378,356,0,utRho13
ubiC,8504886,8505012,8504886,126,0,utRho13
ubiD,8049618,8049976,8049618,358,682,utRho13
ubiE,8037494,8037710,8037494,216,298,utRho13
ubiG,4679078,4679134,4679078,56,0,utRho13
ucpA,5089342,5089342,5089246,96,22,utRho13
udp,8032782,8032862,8032782,80,84,utRho13
ugd,4199470,4199470,4199226,244,0,utRho13
ugpB,7184852,7184852,7184650,202,398,utRho13
ugpQ,7176600,7176600,7176226,374,102,utRho13
uhpT,7694396,7694396,7694334,62,0,utRho13
uidA,3392304,3392304,3392142,162,0,utRho13
uidC,3386012,3386012,3385702,310,0,utRho13
uidR,3394150,3394150,3394104,46,42,utRho13
ulaA,8839854,8839960,8839854,106,40,utRho13
ulaG,8839350,8839350,8839250,100,0,utRho13
ulaR,8837124,8837124,8836906,218,0,utRho13
umpG,5741372,5741372,5740548,824,1056,utRho13
umpH,1400704,1400704,1400652,52,180,utRho13
umuD,2461476,2461534,2461476,58,0,utRho13
ung,5433476,5433508,5433476,32,0,utRho13
uof,2843316,2843316,2842900,416,5772,utRho13
upp,5241818,5241818,5241744,74,830,utRho13
usg,4873780,4873780,4873298,482,370,utRho13
ushA,1009772,1009828,1009772,56,0,utRho13
uspA,7279966,7280222,7279966,256,1054,utRho13
uspB,7279696,7279696,7279440,256,6,utRho13
uspC,3959172,3959506,3959172,334,0,utRho13
uspE,2797318,2797318,2797244,74,82,utRho13
uspF,2871282,2871282,2871238,44,0,utRho13
uspG,1283806,1283806,1283734,72,310,utRho13
uvrA,8547872,8547872,8547742,130,12,utRho13
uvrB,1626304,1627052,1626304,748,1172,utRho13
uvrC,3989758,3989758,3989412,346,172,utRho13
uvrD,7995814,7995966,7995814,152,104,utRho13
uvrY,3990812,3990812,3990718,94,30,utRho13
uxaB,3221474,3221474,3221360,114,0,utRho13
uxaC,6489714,6489714,6489482,232,0,utRho13
uxuA,9103036,9103272,9103036,236,1034,utRho13
uxuR,9108916,9109152,9108916,236,84,utRho13
valS,8967854,8967854,8967674,180,834,utRho13
valU,5041848,5041862,5041848,14,2,utRho13
valV,3492830,3492870,3492830,40,10,utRho13
ves,3649968,3649968,3649874,94,0,utRho13
waaA,7616512,7617080,7616512,568,104,utRho13
waaH,7580298,7580298,7580162,136,0,utRho13
waaQ,7616476,7616476,7616196,280,0,utRho13
waaU,7598996,7598996,7598624,372,154,utRho13
waaY,7602272,7602272,7601930,342,4318,utRho13
wbbH,4214888,4214888,4214452,436,1418,utRho13
wbbK,4209212,4209212,4209018,194,226,utRho13
wcaM,4231868,4231868,4231792,76,0,utRho13
wrbA,2135516,2135516,2135416,100,0,utRho13
wza,4275166,4275166,4274486,680,0,utRho13
wzxC,4240674,4240674,4240316,358,0,utRho13
wzzB,4196950,4196950,4196602,348,0,utRho13
xanP,7657642,7657890,7657642,248,24,utRho13
xanQ,6048520,6048702,6048520,182,0,utRho13
xapA,5049820,5049820,5049756,64,42,utRho13
xapR,10090252,10090252,10089908,344,0,utRho13
xdhA,6000514,6000690,6000514,176,0,utRho13
xerD,6079702,6079702,6079486,216,0,utRho13
xseA,5268394,5268464,5268394,70,0,utRho13
xseB,882746,882746,882686,60,602,utRho13
xthA,3664798,3664856,3664798,58,0,utRho13
xylA,7461614,7461614,7461530,84,914,utRho13
xylE,8484540,8484540,8484508,32,0,utRho13
xylF,7462138,7462262,7462138,124,10,utRho13
xylR,7469812,7469958,7469812,146,0,utRho13
yaaA,13230,13230,12918,312,14,utRho13
yaaI,23876,23876,23572,304,44,utRho13
yaaJ,16034,16034,15918,116,50,utRho13
yaaU,91184,91614,91184,430,0,utRho13
yaaW,23084,23084,22712,372,0,utRho13
yaaX,10060,10468,10060,408,46,utRho13
yabI,142542,142702,142542,160,102,utRho13
yacC,273880,273880,273834,46,268,utRho13
yacH,262932,262932,262520,412,0,utRho13
yacL,268678,268776,268678,98,28,utRho13
yadD,293796,293936,293796,140,0,utRho13
yadE,289930,290162,289930,232,0,utRho13
yadN,314110,314110,313766,344,0,utRho13
yadS,355572,355572,355248,324,154,utRho13
yadV,312470,312470,312402,68,60,utRho13
yaeF,434270,434270,434006,264,0,utRho13
yaeP,428374,428374,428250,124,0,utRho13
yaeQ,428176,428582,428176,406,0,utRho13
yaeR,423716,423754,423716,38,0,utRho13
yafC,462166,462166,461762,404,210,utRho13
yafD,462128,462244,462128,116,232,utRho13
yafK,491986,491986,491610,376,540,utRho13
yafL,493282,493424,493282,142,0,utRho13
yafN,503938,504010,503938,72,0,utRho13
yafS,469568,469632,469568,64,490,utRho13
yafT,474470,474670,474470,200,0,utRho13
yafV,480432,480432,480378,54,38,utRho13
yafZ,536052,536052,536010,42,42,utRho13
yagE,564446,564556,564446,110,0,utRho13
yagG,570414,570790,570414,376,0,utRho13
yagI,578384,578384,578324,60,0,utRho13
yagK,586236,586236,585896,340,38,utRho13
yagL,588062,588062,587836,226,0,utRho13
yagN,591342,591342,591158,184,602,utRho13
yahA,663746,664742,663746,996,34,utRho13
yahC,670136,670136,670044,92,0,utRho13
yahE,671478,671850,671478,372,0,utRho13
yahM,690504,690808,690504,304,50,utRho13
yahN,692872,692872,692674,198,0,utRho13
yahO,692864,692968,692864,104,0,utRho13
yaiE,816296,816354,816296,58,30,utRho13
yaiI,811396,811528,811396,132,0,utRho13
yaiO,761946,761946,761684,262,0,utRho13
yaiP,767970,767970,767870,100,0,utRho13
yaiS,769660,769660,769232,428,0,utRho13
yaiV,788922,788922,788922,0,0,utRho13
yaiY,799094,799094,798666,428,0,utRho13
yaiZ,798888,799186,798888,298,0,utRho13
yajC,854410,854574,854410,164,1008,utRho13
yajD,860938,861210,860938,272,278,utRho13
yajI,866068,866068,865702,366,252,utRho13
yajL,887496,887496,887282,214,542,utRho13
yajQ,889316,889366,889316,50,0,utRho13
yajR,893374,893374,893332,42,0,utRho13
ybaB,987418,988152,987418,734,2934,utRho13
ybaL,1006590,1006590,1006476,114,82,utRho13
ybaM,980648,980648,980542,106,130,utRho13
ybaN,981436,981764,981436,328,518,utRho13
ybaO,936704,936766,936704,62,0,utRho13
ybaP,1016568,1016568,1016160,408,1252,utRho13
ybaQ,1016348,1016436,1016348,88,0,utRho13
ybaS,1023146,1023282,1023146,136,16,utRho13
ybaV,927504,927874,927504,370,106,utRho13
ybaY,950490,950758,950490,268,170,utRho13
ybbB,1062724,1062724,1062452,272,0,utRho13
ybbJ,1030154,1030154,1029718,436,472,utRho13
ybbL,1031784,1031838,1031784,54,0,utRho13
ybbN,1037136,1037136,1036558,578,1678,utRho13
ybbO,1038658,1038658,1038298,360,1052,utRho13
ybbY,1080718,1081130,1080718,412,0,utRho13
ybcH,1176140,1176140,1175962,178,0,utRho13
ybcI,1113264,1113264,1113106,158,200,utRho13
ybcJ,1114050,1114050,1113746,304,836,utRho13
ybcK,1137502,1137804,1137502,302,0,utRho13
ybcL,1141690,1141786,1141690,96,0,utRho13
ybcN,1144628,1144932,1144628,304,0,utRho13
ybcQ,1147548,1147912,1147548,364,0,utRho13
ybcW,1159610,1159760,1159610,150,0,utRho13
ybdD,1263982,1264364,1263982,382,248,utRho13
ybdF,1212106,1212106,1211772,334,56,utRho13
ybdH,1267048,1267048,1266954,94,18,utRho13
ybdJ,1212822,1212822,1212398,424,84,utRho13
ybdK,1215122,1215122,1214766,356,0,utRho13
ybdL,1267114,1267172,1267114,58,0,utRho13
ybdM,1271110,1271110,1270752,358,182,utRho13
ybdN,1273372,1273372,1273138,234,0,utRho13
ybdR,1283844,1284176,1283844,332,378,utRho13
ybeD,1325412,1325412,1325284,128,390,utRho13
ybeF,1323090,1323090,1322756,334,4,utRho13
ybeL,1349986,1350036,1349986,50,276,utRho13
ybeQ,1353412,1353412,1353094,318,0,utRho13
ybeR,1353120,1353422,1353120,302,0,utRho13
ybeT,1358832,1358832,1358812,20,0,utRho13
ybeU,1358924,1359016,1358924,92,0,utRho13
ybeZ,1386938,1386938,1386834,104,1252,utRho13
ybfA,1458074,1458268,1458074,194,0,utRho13
ybfE,1423878,1423878,1423796,82,0,utRho13
ybfF,1425692,1425692,1425604,88,280,utRho13
ybfH,1433282,1433282,1433194,88,0,utRho13
ybgA,1477840,1478002,1477840,162,0,utRho13
ybgC,1549288,1549504,1549288,216,0,utRho13
ybgD,1505916,1505916,1505590,326,248,utRho13
ybgI,1485238,1485654,1485238,416,0,utRho13
ybgO,1498370,1498370,1497964,406,0,utRho13
ybgS,1570992,1570992,1570634,358,0,utRho13
ybhA,1597184,1597184,1596862,322,92,utRho13
ybhB,1616070,1616070,1615818,252,264,utRho13
ybhC,1614642,1614642,1614562,80,2420,utRho13
ybhD,1601418,1601418,1601276,142,0,utRho13
ybhH,1601104,1601518,1601104,414,0,utRho13
ybhK,1633384,1633384,1633294,90,16,utRho13
ybhM,1641556,1641586,1641556,30,0,utRho13
ybhN,1645296,1645296,1644996,300,0,utRho13
ybhQ,1649202,1649260,1649202,58,0,utRho13
ybiA,1665920,1665920,1665900,20,0,utRho13
ybiI,1676968,1676968,1676912,56,0,utRho13
ybiO,1691328,1691328,1690960,368,586,utRho13
ybiP,1705252,1705252,1705194,58,84,utRho13
ybiS,1711572,1711572,1711488,84,196,utRho13
ybiT,1711894,1711926,1711894,32,0,utRho13
ybiU,1718212,1718212,1718122,90,76,utRho13
ybiV,1720176,1720176,1720056,120,0,utRho13
ybiW,1725566,1725566,1725212,354,280,utRho13
ybiX,1678548,1678548,1678414,134,252,utRho13
ybjC,1781784,1781826,1781784,42,0,utRho13
ybjE,1830154,1830154,1829714,440,70,utRho13
ybjG,1767016,1767016,1766776,240,848,utRho13
ybjL,1779882,1779882,1779638,244,0,utRho13
ybjM,1779770,1780178,1779770,408,0,utRho13
ybjO,1795704,1795978,1795704,274,0,utRho13
ybjP,1809046,1809046,1808934,112,60,utRho13
ybjQ,1809034,1809186,1809034,152,0,utRho13
ybjS,1813796,1813796,1813506,290,54,utRho13
ybjX,1838206,1838206,1838168,38,66,utRho13
ycaD,1891438,1891742,1891438,304,0,utRho13
ycaI,1928210,1928640,1928210,430,62,utRho13
ycaK,1899094,1899336,1899094,242,14,utRho13
ycaL,1920264,1920528,1920264,264,56,utRho13
ycaM,1894240,1894458,1894240,218,222,utRho13
ycaR,1941284,1941346,1941284,62,384,utRho13
ycbB,1961862,1962094,1961862,232,40,utRho13
ycbJ,1943344,1943504,1943344,160,0,utRho13
ycbK,1966046,1966150,1966046,104,754,utRho13
ycbZ,2036920,2036920,2036598,322,0,utRho13
yccA,2062886,2062886,2062836,50,46,utRho13
yccF,2048730,2048730,2048696,34,0,utRho13
yccS,2047988,2047988,2047766,222,0,utRho13
yccT,2055674,2055674,2055546,128,144,utRho13
yccX,2059960,2060128,2059960,168,0,utRho13
ycdT,2185682,2185752,2185682,70,0,utRho13
ycdU,2191266,2191686,2191266,420,0,utRho13
ycdZ,2200504,2200592,2200504,88,288,utRho13
yceA,2233544,2233614,2233544,70,0,utRho13
yceD,2293298,2293588,2293298,290,6832,utRho13
yceF,2293522,2293522,2293190,332,4534,utRho13
yceH,2252154,2252314,2252154,160,3996,utRho13
yceI,2237282,2237282,2236952,330,308,utRho13
yceJ,2238142,2238142,2238092,50,30,utRho13
yceM,2253208,2253612,2253208,404,164,utRho13
yceO,2239264,2239264,2238894,370,778,utRho13
yceQ,2288760,2289004,2288760,244,6296,utRho13
ycfD,2376540,2376540,2376480,60,76,utRho13
ycfJ,2334814,2335198,2334814,384,0,utRho13
ycfS,2340834,2340834,2340748,86,0,utRho13
ycfT,2350658,2350658,2350330,328,0,utRho13
ycfZ,2362760,2362760,2362534,226,4,utRho13
ycgB,2474570,2474570,2474482,88,0,utRho13
ycgG,2434614,2434656,2434614,42,0,utRho13
ycgJ,2452956,2453200,2452956,244,0,utRho13
ycgL,2455218,2455362,2455218,144,0,utRho13
ycgN,2457366,2457660,2457366,294,254,utRho13
ycgR,2489112,2489112,2489054,58,0,utRho13
ycgV,2512222,2512222,2511904,318,98,utRho13
ycgX,2426568,2426568,2426214,354,490,utRho13
ycgY,2490166,2490320,2490166,154,0,utRho13
ycgZ,2431504,2431578,2431504,74,0,utRho13
ychE,2596904,2597196,2596904,292,0,utRho13
ychF,2515764,2515764,2515624,140,76,utRho13
ychH,2517476,2517582,2517476,106,204,utRho13
ychJ,2578354,2578354,2578264,90,54,utRho13
ychN,2547310,2547310,2547198,112,0,utRho13
ychO,2547520,2547850,2547520,330,184,utRho13
ychQ,2533798,2533848,2533798,50,0,utRho13
yciA,2624828,2624828,2624492,336,252,utRho13
yciB,2626110,2626110,2625780,330,2136,utRho13
yciC,2627396,2627396,2627326,70,28,utRho13
yciE,2630794,2630794,2630448,346,0,utRho13
yciG,5264368,5264368,5264140,228,0,utRho13
yciI,2621784,2621784,2621730,54,0,utRho13
yciN,2661606,2661606,2661336,270,186,utRho13
yciS,2680270,2680486,2680270,216,54,utRho13
yciT,2689088,2689088,2688692,396,718,utRho13
yciU,2614718,2614718,2614300,418,424,utRho13
yciV,2646376,2646440,2646376,64,0,utRho13
yciW,2700472,2700472,2700214,258,98,utRho13
yciZ,2689276,2689276,2689218,58,214,utRho13
ycjD,2703792,2703792,2703520,272,44,utRho13
ycjG,2777748,2777860,2777748,112,294,utRho13
ycjM,2740006,2740432,2740006,426,228,utRho13
ycjW,2767982,2767982,2767922,60,8,utRho13
ycjX,2768138,2768234,2768138,96,48,utRho13
ycjY,5568288,5568288,5567460,828,0,utRho13
ydaE,2836438,2836438,2836016,422,0,utRho13
ydaN,2816048,2816100,2816048,52,0,utRho13
ydaS,2840340,2840730,2840340,390,168,utRho13
ydbC,2948376,2948442,2948376,66,0,utRho13
ydbD,2950132,2950288,2950132,156,0,utRho13
ydbH,2885800,2886102,2885800,302,152,utRho13
ydbJ,2881712,2882116,2881712,404,80,utRho13
ydbK,2881692,2881692,2881568,124,40,utRho13
ydcA,2983294,2983354,2983294,60,0,utRho13
ydcF,2974404,2974470,2974404,66,0,utRho13
ydcI,2990268,2990268,2990142,126,14,utRho13
ydcJ,2990266,2990576,2990266,310,0,utRho13
ydcK,3001280,3001280,3000898,382,0,utRho13
ydcL,3004646,3004914,3004646,268,0,utRho13
ydcN,3012308,3012344,3012308,36,0,utRho13
ydcP,3013508,3013562,3013508,54,70,utRho13
ydcR,3019956,3020006,3019956,50,0,utRho13
ydcS,3022906,3023308,3022906,402,0,utRho13
ydcX,3034442,3034778,3034442,336,100,utRho13
ydcY,3035220,3035296,3035220,76,2,utRho13
ydcZ,3036750,3036750,3036662,88,0,utRho13
yddB,3155332,3155332,3155238,94,24,utRho13
yddE,3071738,3071738,3071716,22,0,utRho13
yddG,3094410,3094410,3094338,72,0,utRho13
yddJ,3089732,3089732,3089438,294,0,utRho13
yddW,3137704,3137704,3137646,58,0,utRho13
ydeA,3233910,3234056,3233910,146,0,utRho13
ydeE,3242528,3242664,3242528,136,0,utRho13
ydeI,3249118,3249118,3248994,124,0,utRho13
ydeJ,3249376,3249546,3249376,170,0,utRho13
ydeN,3165458,3165458,3165048,410,0,utRho13
ydeP,3173328,3173328,3172972,356,0,utRho13
ydeR,3176596,3176596,3176592,4,0,utRho13
ydfA,3296872,3297016,3296872,144,0,utRho13
ydfG,3254982,3255034,3254982,52,0,utRho13
ydfH,3256652,3256704,3256652,52,32,utRho13
ydfK,3265446,3266144,3265446,698,26,utRho13
ydgA,3379588,3379704,3379588,116,154,utRho13
ydgC,3364124,3364124,3364060,64,0,utRho13
ydgD,3343906,3343920,3343906,14,0,utRho13
ydgH,3356754,3356854,3356754,100,0,utRho13
ydgJ,3408798,3408798,3408616,182,0,utRho13
ydgK,3410414,3410500,3410414,86,202,utRho13
ydhB,3479618,3479618,3479596,22,0,utRho13
ydhC,3479698,3479822,3479698,124,0,utRho13
ydhF,3451310,3451310,3451264,46,46,utRho13
ydhI,3441996,3442050,3441996,54,0,utRho13
ydhL,3451864,3451864,3451840,24,0,utRho13
ydhQ,3492404,3492404,3492254,150,118,utRho13
ydhS,3494136,3494262,3494136,126,30,utRho13
ydhT,3499138,3499138,3499118,20,0,utRho13
ydhY,3509284,3509284,3508954,330,0,utRho13
ydhZ,3510418,3510418,3510282,136,0,utRho13
ydiE,3579206,3579226,3579206,20,0,utRho13
ydiH,3530582,3530582,3530406,176,44,utRho13
ydiM,3541852,3542142,3541852,290,30,utRho13
ydiN,3544818,3545024,3544818,206,0,utRho13
ydiP,3558656,3558656,3558602,54,0,utRho13
ydiU,3582508,3582508,3582488,20,0,utRho13
ydiV,3584174,3584174,3584040,134,264,utRho13
ydiY,3612500,3612500,3612166,334,0,utRho13
ydjA,3697400,3697400,3697352,48,0,utRho13
ydjE,3708082,3708082,3707958,124,0,utRho13
ydjF,3709848,3709848,3709708,140,0,utRho13
ydjM,3620340,3620422,3620340,82,0,utRho13
ydjO,3626696,3626696,3626288,408,0,utRho13
ydjX,3666434,3666802,3666434,368,424,utRho13
yeaE,3731448,3731448,3731272,176,212,utRho13
yeaG,3733530,3733816,3733530,286,0,utRho13
yeaI,3740486,3740770,3740486,284,0,utRho13
yeaJ,3743874,3744082,3743874,208,92,utRho13
yeaL,3748646,3748704,3748646,58,166,utRho13
yeaM,3751296,3751296,3751152,144,0,utRho13
yeaN,3750926,3751346,3750926,420,0,utRho13
yeaO,3753554,3753818,3753554,264,6,utRho13
yeaP,3755314,3755430,3755314,116,262,utRho13
yeaQ,3758780,3758780,3758510,270,44,utRho13
yeaR,3759988,3759988,3759896,92,0,utRho13
yeaY,3781122,3781122,3781064,58,74,utRho13
yebB,3892220,3892502,3892220,282,4,utRho13
yebC,3896370,3896370,3896302,68,80,utRho13
yebE,3859464,3859464,3859414,50,0,utRho13
yebG,3861530,3861530,3861494,36,0,utRho13
yebK,3873180,3873304,3873180,124,388,utRho13
yebQ,3820314,3820552,3820314,238,0,utRho13
yebS,3832238,3832516,3832238,278,52,utRho13
yebV,3843430,3843560,3843430,130,0,utRho13
yebW,3843914,3844242,3843914,328,404,utRho13
yecC,3995646,3995646,3995628,18,0,utRho13
yecD,3901272,3901664,3901272,392,218,utRho13
yecF,3991434,3991636,3991434,202,74,utRho13
yecH,3979304,3979304,3978980,324,8,utRho13
yecJ,3975604,3975604,3975516,88,0,utRho13
yecM,3919968,3919968,3919692,276,0,utRho13
yecR,3976400,3976444,3976400,44,0,utRho13
yecT,3923862,3923944,3923862,82,0,utRho13
yedD,4016522,4016522,4016180,342,126,utRho13
yedE,4016310,4016554,4016310,244,68,utRho13
yedI,4058922,4058922,4058732,190,0,utRho13
yedJ,4066446,4066446,4066158,288,0,utRho13
yedV,4076404,4076404,4076304,100,0,utRho13
yedX,4077680,4077912,4077680,232,0,utRho13
yedY,4078572,4078956,4078572,384,0,utRho13
yeeA,4161322,4161322,4161182,140,84,utRho13
yeeE,4171104,4171104,4171050,54,0,utRho13
yeeJ,4089526,4089822,4089526,296,0,utRho13
yeeN,4113508,4113716,4113508,208,0,utRho13
yeeO,4119444,4119444,4119692,248,0,utRho13
yeeX,4158834,4158834,4158722,112,362,utRho13
yeeZ,4178422,4178422,4178256,166,0,utRho13
yefM,4179466,4179466,4179426,40,0,utRho13
yegD,4295288,4295348,4295288,60,0,utRho13
yegH,4275726,4275804,4275726,78,0,utRho13
yegI,4302154,4302154,4301970,184,0,utRho13
yegJ,4302032,4302370,4302032,338,0,utRho13
yegQ,4331182,4331336,4331182,154,54,utRho13
yegR,4336698,4336698,4336612,86,0,utRho13
yegS,4337086,4337424,4337086,338,0,utRho13
yegT,4357562,4357642,4357562,80,0,utRho13
yegX,4367640,4367640,4367302,338,0,utRho13
yehA,4376944,4376944,4376828,116,0,utRho13
yehE,4385818,4385818,4385592,226,0,utRho13
yehK,4407568,4407944,4407568,376,0,utRho13
yehL,4408804,4409192,4408804,388,0,utRho13
yeiB,4486146,4486146,4485934,212,244,utRho13
yeiE,4499422,4499422,4499236,186,0,utRho13
yeiG,4487776,4487820,4487776,44,178,utRho13
yeiH,4499332,4499434,4499332,102,0,utRho13
yeiI,4503306,4503400,4503306,94,64,utRho13
yeiL,4510580,4510710,4510580,130,0,utRho13
yeiP,4530834,4530900,4530834,66,580,utRho13
yeiQ,4532328,4532490,4532328,162,0,utRho13
yeiR,4535484,4535658,4535484,174,112,utRho13
yeiW,4530840,4530840,4530590,250,694,utRho13
yejA,4544624,4544728,4544624,104,0,utRho13
yejG,4556892,4556892,4556474,418,68,utRho13
yejH,4561244,4561264,4561244,20,0,utRho13
yejK,4568218,4568218,4567894,324,168,utRho13
yejO,4578352,4578352,4577800,552,152,utRho13
yfaD,4713380,4713808,4713380,428,856,utRho13
yfaE,4696676,4697028,4696676,352,1328,utRho13
yfaL,4688568,4688568,4688338,230,0,utRho13
yfaP,4656398,4656398,4656286,112,0,utRho13
yfaU,4717892,4717892,4717690,202,0,utRho13
yfaY,4727310,4727310,4727266,44,0,utRho13
yfaZ,4728744,4728744,4728550,194,0,utRho13
yfbK,4771810,4771810,4771444,366,0,utRho13
yfbL,4771500,4771720,4771500,220,0,utRho13
yfbN,4777174,4777174,4776852,322,0,utRho13
yfbO,4776916,4777162,4776916,246,0,utRho13
yfbP,4777990,4778232,4777990,242,50,utRho13
yfbR,4817662,4817724,4817662,62,0,utRho13
yfcI,4847424,4847424,4847078,346,84,utRho13
yfcJ,4880482,4880482,4880240,242,32,utRho13
yfcL,4888502,4888502,4888338,164,52,utRho13
yfcV,4911642,4911642,4911292,350,0,utRho13
yfcZ,4921958,4921958,4921868,90,32,utRho13
yfdF,4925604,4926024,4925604,420,0,utRho13
yfdG,4935474,4935710,4935474,236,70,utRho13
yfdP,4946844,4947040,4946844,196,0,utRho13
yfdX,4988866,4988866,4988804,62,0,utRho13
yfdY,4990672,4990672,4990584,88,0,utRho13
yfeA,5035784,5035784,5035664,120,3234,utRho13
yfeC,5036668,5036934,5036668,266,344,utRho13
yfeH,5053818,5053892,5053818,74,0,utRho13
yfeK,5074630,5074684,5074630,54,0,utRho13
yfeO,5018906,5019260,5018906,354,0,utRho13
yfeR,5054078,5054078,5053712,366,48,utRho13
yfeX,5101356,5101356,5101090,266,0,utRho13
yfeY,5102486,5102486,5102432,54,0,utRho13
yfeZ,5103842,5103842,5103452,390,40,utRho13
yffO,5123804,5124222,5123804,418,0,utRho13
yffQ,5126778,5127154,5126778,376,0,utRho13
yffS,5128800,5128986,5128800,186,44,utRho13
yfgC,5232052,5232188,5232052,136,44,utRho13
yfgF,5258062,5258062,5257876,186,0,utRho13
yfgG,5258170,5258580,5258170,410,4,utRho13
yfgH,5259344,5259584,5259344,240,0,utRho13
yfgM,5278866,5278866,5278566,300,832,utRho13
yfhH,5397414,5397518,5397414,104,24,utRho13
yfhM,5304648,5304648,5304574,74,18,utRho13
yfhR,5328408,5328726,5328408,318,6,utRho13
yfiC,5425610,5425610,5425528,82,0,utRho13
yfiE,5430688,5430688,5430640,48,0,utRho13
yfiL,5482630,5482720,5482630,90,0,utRho13
yfiM,5448066,5448358,5448066,292,1362,utRho13
yfiR,5483354,5483750,5483354,396,0,utRho13
yfjH,5517326,5517326,5517200,126,0,utRho13
yfjI,5517710,5517970,5517710,260,0,utRho13
yfjJ,5521014,5521094,5521014,80,0,utRho13
yfjM,5531970,5531970,5531552,418,218,utRho13
yfjP,5535080,5535420,5535080,340,48,utRho13
yfjW,5546570,5546636,5546570,66,0,utRho13
yfjX,5551776,5551838,5551776,62,0,utRho13
ygaC,5601180,5601180,5599988,1192,4,utRho13
ygaM,5600242,5600292,5600242,50,0,utRho13
ygaU,5593628,5593628,5593572,56,22,utRho13
ygaZ,5619190,5619234,5619190,44,32,utRho13
ygbA,5713656,5713656,5713612,44,0,utRho13
ygbE,5746784,5746784,5746674,110,90,utRho13
ygbI,5722882,5722882,5722528,354,0,utRho13
ygbK,5724394,5724670,5724394,276,4,utRho13
ygbL,5727074,5727186,5727074,112,0,utRho13
ygbN,5729814,5730202,5729814,388,172,utRho13
ygcG,5811210,5811422,5811210,212,0,utRho13
ygcN,5785144,5785314,5785144,170,0,utRho13
ygcU,5799214,5799214,5798836,378,0,utRho13
ygcW,5800942,5800942,5800546,396,0,utRho13
ygdD,5883442,5883442,5883262,180,124,utRho13
ygdG,5861746,5861930,5861746,184,1148,utRho13
ygdI,5886526,5886526,5886290,236,0,utRho13
ygdQ,5940784,5940840,5940784,56,62,utRho13
ygdR,5942494,5942542,5942494,48,0,utRho13
ygeA,5961606,5961606,5961270,336,0,utRho13
ygeH,5983758,5984188,5983758,430,0,utRho13
ygeI,5987162,5987276,5987162,114,0,utRho13
ygeR,6000078,6000078,5999782,296,0,utRho13
ygeV,6011694,6011694,6011572,122,0,utRho13
ygeW,6012234,6012524,6012234,290,16,utRho13
ygfB,6110946,6110946,6110888,58,40,utRho13
ygfK,6031984,6032120,6031984,136,0,utRho13
ygfS,6058328,6058328,6058024,304,0,utRho13
ygfZ,6082564,6082626,6082564,62,184,utRho13
yggC,6149512,6149512,6149378,134,0,utRho13
yggE,6136370,6136370,6136160,210,210,utRho13
yggI,6179176,6179510,6179176,334,152,utRho13
yggL,6204508,6204508,6204266,242,188,utRho13
yggM,6199514,6199514,6199130,384,0,utRho13
yggN,6203596,6203596,6203246,350,68,utRho13
yggX,18623958,18624558,18623958,600,582,utRho13
yghA,6298966,6299324,6298966,358,0,utRho13
yghB,6307058,6307126,6307058,68,62,utRho13
yghD,6222614,6222614,6222252,362,98,utRho13
yghF,6225798,6225798,6225840,42,0,utRho13
yghJ,6238640,6238640,6238224,416,16,utRho13
yghQ,6265186,6265186,6264816,370,48,utRho13
yghT,6267830,6268262,6267830,432,0,utRho13
yghU,6277400,6277454,6277400,54,96,utRho13
yghW,6293506,6293506,6293474,32,0,utRho13
yghZ,6295562,6295794,6295562,232,0,utRho13
ygiD,6365122,6365122,6364868,254,460,utRho13
ygiH,6409066,6409388,6409066,322,0,utRho13
ygiL,6370622,6370828,6370622,206,38,utRho13
ygiM,6402084,6402414,6402084,330,282,utRho13
ygiN,6346156,6346284,6346156,128,2786,utRho13
ygiQ,6322620,6322620,6322292,328,248,utRho13
ygiS,6335462,6335462,6335436,26,64,utRho13
ygiV,6338582,6338582,6338462,120,252,utRho13
ygiW,6339774,6339774,6339352,422,4,utRho13
ygiZ,6344506,6344506,6344422,84,0,utRho13
ygjH,6442528,6442528,6442494,34,0,utRho13
ygjI,6452140,6452468,6452140,328,28,utRho13
ygjQ,6472730,6473080,6472730,350,160,utRho13
ygjR,6474564,6474586,6474564,22,22,utRho13
ygjV,6483638,6483638,6483488,150,0,utRho13
yhaB,6535632,6535708,6535632,76,34,utRho13
yhaH,6504498,6504608,6504498,110,0,utRho13
yhaI,6505400,6505822,6505400,422,212,utRho13
yhaJ,6508560,6508560,6508428,132,4,utRho13
yhaK,6508538,6508638,6508538,100,0,utRho13
yhbQ,6599878,6599932,6599878,54,138,utRho13
yhbT,6602736,6602736,6602552,184,44,utRho13
yhbU,6602558,6602970,6602558,412,44,utRho13
yhbX,6643302,6643302,6643226,76,0,utRho13
yhbY,6655518,6655580,6655518,62,268,utRho13
yhcA,6723956,6724224,6723956,268,0,utRho13
yhcB,6760364,6760382,6760364,18,42,utRho13
yhcC,6708470,6708470,6708100,370,0,utRho13
yhcF,6733440,6733852,6733440,412,348,utRho13
yhcH,6739124,6739124,6738956,168,546,utRho13
yhcM,6760312,6760312,6759994,318,8,utRho13
yhcN,6770812,6771076,6770812,264,128,utRho13
yhcO,6772606,6772606,6772258,348,0,utRho13
yhdH,6806560,6806968,6806560,408,0,utRho13
yhdJ,6823234,6823306,6823234,72,0,utRho13
yhdN,6879092,6879092,6879018,74,720,utRho13
yhdT,6814702,6814750,6814702,48,54,utRho13
yhdU,6824994,6825242,6824994,248,114,utRho13
yhdV,6836392,6836780,6836392,388,0,utRho13
yhdW,6837944,6838298,6837944,354,0,utRho13
yheO,6953082,6953082,6952880,202,1116,utRho13
yheV,6957970,6957970,6957584,386,294,utRho13
yhfA,6971902,6971902,6971636,266,0,utRho13
yhfG,6983294,6983294,6983240,54,314,utRho13
yhfL,6998622,6998896,6998622,274,0,utRho13
yhfY,7023244,7023244,7022844,400,56,utRho13
yhgA,7086294,7086334,7086294,40,44,utRho13
yhgE,7065176,7065176,7064878,298,44,utRho13
yhgF,7074352,7074770,7074352,418,4250,utRho13
yhhA,7173458,7173886,7173458,428,30,utRho13
yhhI,7248346,7248756,7248346,410,0,utRho13
yhhJ,7253696,7253696,7253606,90,0,utRho13
yhhM,7211588,7211588,7211220,368,16,utRho13
yhhN,7211150,7211502,7211150,352,0,utRho13
yhhQ,7218238,7218434,7218238,196,72,utRho13
yhhT,7223682,7223730,7223682,48,0,utRho13
yhhX,7162032,7162032,7161610,422,16,utRho13
yhhY,7162222,7162276,7162222,54,0,utRho13
yhhZ,7163516,7163726,7163516,210,0,utRho13
yhiD,7312220,7312220,7311804,416,5050,utRho13
yhiJ,7265190,7265190,7265180,10,0,utRho13
yhiM,7269270,7269682,7269270,412,2,utRho13
yhiN,7275000,7275000,7274820,180,114,utRho13
yhjA,7338522,7338522,7338376,146,48,utRho13
yhjB,7344090,7344090,7343788,302,50,utRho13
yhjC,7344272,7344684,7344272,412,112,utRho13
yhjD,7346660,7346724,7346660,64,4,utRho13
yhjE,7349274,7349572,7349274,298,0,utRho13
yhjG,7356824,7356824,7356730,94,44,utRho13
yhjH,7358458,7358458,7358374,84,292,utRho13
yhjJ,7364032,7364032,7363880,152,60,utRho13
yhjK,7371296,7371296,7371158,138,0,utRho13
yhjR,7392750,7392750,7392370,380,0,utRho13
yhjV,7400796,7401126,7400796,330,444,utRho13
yhjX,7424194,7424194,7424014,180,0,utRho13
yhjY,7425966,7425966,7425868,98,0,utRho13
yiaB,7455654,7455654,7455496,158,0,utRho13
yiaD,7432712,7433094,7432712,382,24,utRho13
yiaF,7438194,7438194,7438088,106,0,utRho13
yiaG,7438862,7438956,7438862,94,136,utRho13
yiaJ,7485236,7485236,7485064,172,0,utRho13
yiaK,7485348,7485466,7485348,118,74,utRho13
yiaT,7503924,7503924,7503736,188,0,utRho13
yiaU,7503792,7503984,7503792,192,0,utRho13
yiaY,7515856,7515856,7515654,202,0,utRho13
yibF,7523950,7523950,7523910,40,0,utRho13
yibG,7536128,7536354,7536128,226,34,utRho13
yibL,7553194,7553330,7553194,136,94,utRho13
yibN,7570112,7570112,7570030,82,372,utRho13
yibT,7552848,7552848,7552760,88,130,utRho13
yicC,7633290,7633352,7633290,62,74,utRho13
yicH,7660862,7660914,7660862,52,40,utRho13
yicJ,7673328,7673328,7671858,1470,1192,utRho13
yicN,7685018,7685018,7684804,214,30,utRho13
yicO,7687914,7687914,7687578,336,0,utRho13
yicR,15250308,15250308,15250236,72,0,utRho13
yidB,7755230,7755230,7754930,300,0,utRho13
yidE,7732780,7732780,7732546,234,34,utRho13
yidF,7711580,7711580,7711222,358,266,utRho13
yidQ,7735088,7735456,7735088,368,1466,utRho13
yidR,7738824,7738824,7738618,206,0,utRho13
yieE,7787658,7787738,7787658,80,34,utRho13
yieH,7793314,7793548,7793314,234,0,utRho13
yieK,7798928,7798928,7798786,142,0,utRho13
yifB,7900350,7900350,7899998,352,2,utRho13
yifL,7988984,7989044,7988984,60,132,utRho13
yigF,8005750,8005750,8005598,152,224,utRho13
yigI,8009448,8009448,8009394,54,0,utRho13
yigM,8022100,8022152,8022100,52,0,utRho13
yihA,8101970,8101970,8101458,512,4,utRho13
yihD,8084098,8084138,8084098,40,80,utRho13
yihF,8088110,8088398,8088110,288,36,utRho13
yihG,8093304,8093304,8093204,100,0,utRho13
yihI,8102616,8102694,8102616,78,36,utRho13
yihL,8120506,8120894,8120506,388,40,utRho13
yihN,8124332,8124494,8124332,162,58,utRho13
yihO,8131942,8131942,8131532,410,0,utRho13
yihQ,8138892,8138892,8138552,340,0,utRho13
yihV,8147064,8147478,8147064,414,0,utRho13
yihX,8151096,8151106,8151096,10,194,utRho13
yiiE,8158192,8158582,8158192,390,0,utRho13
yiiF,8159124,8159502,8159124,378,0,utRho13
yiiG,8173762,8174004,8173762,242,0,utRho13
yiiM,8205506,8205644,8205506,138,0,utRho13
yiiQ,8224624,8224624,8224428,196,0,utRho13
yiiS,8225738,8225934,8225738,196,0,utRho13
yijE,8272178,8272216,8272178,38,74,utRho13
yijF,8275728,8275728,8275314,414,130,utRho13
yijO,8296858,8296858,8296634,224,68,utRho13
yjaA,8426240,8426468,8426240,228,142522,utRho13
yjaB,8428312,8428312,8428246,66,2,utRho13
yjaG,8398746,8399008,8398746,262,364,utRho13
yjaH,8401022,8401132,8401022,110,1504,utRho13
yjaZ,8379506,8379572,8379506,66,0,utRho13
yjbB,8455204,8455462,8455204,258,0,utRho13
yjbE,16943432,16943624,16943432,192,172,utRho13
yjbL,8520318,8520642,8520318,324,0,utRho13
yjbQ,8540428,8540476,8540428,48,0,utRho13
yjcB,8550328,8550328,8550082,246,4,utRho13
yjcC,8550836,8550942,8550836,106,0,utRho13
yjcD,8556628,8556958,8556628,330,232,utRho13
yjcE,8559658,8559960,8559658,302,206,utRho13
yjcF,8566212,8566212,8566150,62,0,utRho13
yjcO,8594660,8594660,8594250,410,272,utRho13
yjdA,8654128,8654270,8654128,142,0,utRho13
yjdC,8726660,8726660,8726616,44,0,utRho13
yjdK,8704780,8705168,8704780,388,24,utRho13
yjdL,8713034,8713034,8712822,212,0,utRho13
yjdM,8653672,8653672,8653468,204,208,utRho13
yjeF,8787354,8788132,8787354,778,3632,utRho13
yjeI,8745522,8745618,8745522,96,0,utRho13
yjeJ,8748806,8748806,8748468,338,0,utRho13
yjeV,8785472,8785784,8785472,312,128,utRho13
yjfP,8833512,8833904,8833512,392,66,utRho13
yjfY,8849656,8849656,8849582,74,0,utRho13
yjfZ,8855052,8855052,8854844,208,0,utRho13
yjgA,8916162,8916162,8915730,432,18,utRho13
yjgL,8950802,8950874,8950802,72,0,utRho13
yjgM,8959342,8959342,8959074,268,0,utRho13
yjgN,8959132,8959460,8959132,328,0,utRho13
yjgR,8980170,8980170,8980126,44,0,utRho13
yjgZ,9002116,9002520,9002116,404,80,utRho13
yjhB,9007764,9008116,9007764,352,212,utRho13
yjhG,9048452,9048452,9048188,264,1404,utRho13
yjhU,9041080,9041080,9040648,432,852,utRho13
yjiA,9178096,9178096,9177730,366,10968,utRho13
yjiJ,9125364,9125364,9125350,14,0,utRho13
yjiK,9127270,9127270,9127422,152,84,utRho13
yjiL,9129604,9129604,9129378,226,0,utRho13
yjiS,9143410,9143502,9143410,92,0,utRho13
yjiY,9182734,9182734,9182558,176,7534,utRho13
yjjA,9200674,9200674,9200378,296,328,utRho13
yjjB,18408708,18408708,18407800,908,0,utRho13
yjjJ,9243314,9243538,9243314,224,0,utRho13
yjjK,9261132,9261132,9261044,88,0,utRho13
yjjL,9189764,9189764,9189444,320,164,utRho13
yjjM,9191894,9191894,9191702,192,0,utRho13
yjjP,9206068,9206068,9205716,352,4,utRho13
yjjQ,9206638,9206954,9206638,316,0,utRho13
yjjX,9267798,9267798,9267490,308,1214,utRho13
yjjY,9280716,9280804,9280716,88,502,utRho13
yjjZ,9211554,9211608,9211554,54,76,utRho13
yjtD,9281676,9281884,9281676,208,0,utRho13
ykfB,532454,532454,532174,280,384,utRho13
ykfI,527636,527636,527338,298,0,utRho13
ykgB,637050,637050,636638,412,0,utRho13
ykgC,640430,640430,640002,428,0,utRho13
ykgD,640232,640454,640232,222,0,utRho13
ykgE,642962,643216,642962,254,22,utRho13
ykgJ,608524,608524,608364,160,202,utRho13
ykgL,623878,624224,623878,346,52,utRho13
ykgM,625610,625610,625554,56,0,utRho13
ykgR,626570,626570,626484,86,0,utRho13
ylaC,958576,958576,958502,74,682,utRho13
yliE,1745938,1745958,1745938,20,0,utRho13
ymcE,2103660,2103694,2103660,34,0,utRho13
ymdA,2210450,2210828,2210450,378,66,utRho13
ymdB,2211428,2211640,2211428,212,96,utRho13
ymfD,2395322,2395322,2395064,258,338,utRho13
ymfI,2402880,2402994,2402880,114,32,utRho13
ymfJ,2404518,2404518,2404168,350,90,utRho13
ymfK,2406176,2406176,2405866,310,0,utRho13
ymfT,2405766,2406048,2405766,282,92,utRho13
ymgE,2489110,2489456,2489110,346,0,utRho13
ymgF,2437628,2437966,2437628,338,32,utRho13
ymiA,2670112,2670320,2670112,208,106,utRho13
ymjA,2715620,2715620,2715336,284,244,utRho13
ynaI,2791946,2791946,2791844,102,0,utRho13
ynaK,2850438,2850754,2850438,316,0,utRho13
ynbA,2954924,2955242,2954924,318,0,utRho13
yncD,3046552,3046552,3046130,422,48,utRho13
yncE,3046454,3046614,3046454,160,28,utRho13
yncG,3052456,3052494,3052456,38,0,utRho13
yncL,3034492,3034492,3034388,104,0,utRho13
yneE,3218364,3218364,3218044,320,0,utRho13
yneF,3223748,3223748,3223708,40,0,utRho13
yneJ,3229560,3229608,3229560,48,0,utRho13
yneK,3231100,3231526,3231100,426,0,utRho13
yneM,3245176,3245292,3245176,116,0,utRho13
ynfA,3311398,3311398,3311346,52,0,utRho13
ynfB,3311418,3311616,3311418,198,242,utRho13
ynfC,3315094,3315094,3314914,180,54,utRho13
ynfD,3314828,3315130,3314828,302,54,utRho13
ynfE,3316006,3316138,3316006,132,0,utRho13
ynfK,3334670,3334670,3334438,232,200,utRho13
ynfL,3339304,3339304,3339184,120,0,utRho13
ynfM,3339260,3339398,3339260,138,0,utRho13
ynfN,3276598,3276598,3276218,380,0,utRho13
ynfO,3273454,3273512,3273454,58,0,utRho13
ynhG,3517890,3517890,3517450,440,326,utRho13
yniA,3615158,3615592,3615158,434,0,utRho13
yniB,3618526,3618526,3618466,60,0,utRho13
yniC,3618652,3618760,3618652,108,0,utRho13
yniD,3610202,3610330,3610202,128,0,utRho13
ynjE,3678880,3678934,3678880,54,0,utRho13
ynjF,3683222,3683222,3682806,416,114,utRho13
ynjH,3684376,3684376,3684270,106,0,utRho13
ynjI,3690022,3690022,3689742,280,80,utRho13
yoaB,3786642,3786734,3786642,92,92,utRho13
yoaC,3787932,3788146,3787932,214,162,utRho13
yoaE,3803544,3803544,3803170,374,292,utRho13
yoaF,3755444,3755444,3755064,380,316,utRho13
yoaH,3789866,3789866,3789462,404,774,utRho13
yobB,3850418,3850880,3850418,462,780,utRho13
yobF,3815586,3815586,3815182,404,36,utRho13
yobH,3817800,3817850,3817800,50,0,utRho13
yodB,4084352,4084736,4084352,384,0,utRho13
yodC,4057008,4057008,4056740,268,0,utRho13
yohC,4451358,4451358,4451262,96,0,utRho13
yohD,4451526,4451602,4451526,76,0,utRho13
yohJ,4460986,4461248,4460986,262,0,utRho13
yohO,4431172,4431314,4431172,142,40,utRho13
yojI,4617282,4617282,4617230,52,0,utRho13
ypdI,4988988,4989396,4988988,408,0,utRho13
ypfG,5165786,5165786,5165554,232,0,utRho13
ypfM,5182140,5182140,5181732,408,2518,utRho13
yphB,5349590,5349590,5349376,214,68,utRho13
ypjA,5565644,5565644,5565452,192,0,utRho13
ypjB,5569636,5569636,5568858,778,0,utRho13
ypjD,5495860,5495774,5495860,86,0,utRho13
yqaE,5594170,5594170,5594056,114,0,utRho13
yqcA,5846100,5846100,5845968,132,0,utRho13
yqcE,5800944,5801184,5800944,240,0,utRho13
yqeC,6030468,6030468,6030114,354,480,utRho13
yqeF,5971618,5971618,5971184,434,60,utRho13
yqeG,5971438,5971694,5971438,256,144,utRho13
yqeH,5975016,5975072,5975016,56,0,utRho13
yqeI,5976688,5977004,5976688,316,0,utRho13
yqeK,5981140,5981140,5980720,420,0,utRho13
yqfA,6086728,6086728,6086296,432,306,utRho13
yqgA,6219042,6219106,6219042,64,0,utRho13
yqgB,6172500,6172500,6172102,398,1398,utRho13
yqgE,6185768,6185874,6185768,106,980,utRho13
yqhA,6299150,6299150,6298942,208,0,utRho13
yqhC,6310768,6310768,6310436,332,246,utRho13
yqhD,6310604,6310710,6310604,106,118,utRho13
yqhH,6316842,6317254,6316842,412,136,utRho13
yqiC,6369662,6369680,6369662,18,0,utRho13
yqiJ,6384108,6384416,6384108,308,6,utRho13
yqjA,6495096,6495546,6495096,450,798,utRho13
yqjF,6500932,6501124,6500932,192,64,utRho13
yqjG,6501948,6502048,6501948,100,0,utRho13
yqjH,6433078,6433078,6432982,96,0,utRho13
yqjI,6433506,6433558,6433506,52,0,utRho13
yraH,6574552,6574852,6574552,300,0,utRho13
yraP,6592144,6592818,6592144,674,868,utRho13
yraQ,6596414,6596414,6596276,138,0,utRho13
yraR,6598024,6598024,6597692,332,0,utRho13
yrbG,13360844,13361100,13360844,256,0,utRho13
yrbL,6696842,6696904,6696842,62,100,utRho13
yrbN,6616172,6616172,6615866,306,502,utRho13
yrdB,6860176,6860176,6860046,130,0,utRho13
yrfF,7052548,7052938,7052548,390,304,utRho13
yrhB,7169440,7169518,7169440,78,0,utRho13
ysaB,7451804,7451804,7451424,380,48,utRho13
ysgA,8032686,8032686,8032338,348,202,utRho13
ytfB,8857638,8857638,8857434,204,54,utRho13
ytfE,8864018,8864018,8863966,52,0,utRho13
ytfF,8866296,8866296,8866130,166,0,utRho13
ytfH,8868164,8868226,8868164,62,0,utRho13
ytfI,8875234,8875414,8875234,180,0,utRho13
ytfJ,8878572,8878572,8878524,48,226,utRho13
ytfK,8879022,8879174,8879022,152,2596,utRho13
ytfL,8882642,8882642,8882430,212,0,utRho13
ytfQ,8899634,8899924,8899634,290,110,utRho13
ytjB,9249598,9249598,9249578,20,68,utRho13
yzfA,8896588,8896588,8896490,98,0,utRho13
zapA,6111102,6111224,6111102,122,4052,utRho13
zapB,8236772,8237030,8236772,258,138,utRho13
zapC,2011700,2011904,2011700,204,0,utRho13
zinT,4082692,4082750,4082692,58,0,utRho13
zipA,5062814,5062814,5062466,348,0,utRho13
zitB,1569716,1569716,1569646,70,0,utRho13
zntA,7212844,7212902,7212844,58,0,utRho13
zntR,6878336,6878336,6878260,76,66,utRho13
znuA,3885322,3885322,3885166,156,2,utRho13
znuC,3885268,3885324,3885268,56,2,utRho13
zraP,8403424,8403424,8403376,48,0,utRho13
zraS,8403810,8403852,8403810,42,0,utRho13
zupT,6364866,6365100,6364866,234,460,utRho13
zur,8520282,8520282,8520006,276,650,utRho13
zwf,3872752,3872752,3872628,124,62,utRho13
C0343,2818676,2818728,2818676,52,0,utRho14
aaeB,6776526,6776526,6776376,150,0,utRho14
aaeR,6778762,6779040,6778762,278,54,utRho14
aaeX,6778860,6778860,6778674,186,160,utRho14
aat,1854920,1854920,1854864,56,0,utRho14
accA,416822,417242,416822,420,2900,utRho14
accB,6810280,6810872,6810280,592,11460,utRho14
accD,4868030,4868030,4867852,178,286,utRho14
aceB,8430804,8430956,8430804,152,48,utRho14
aceE,245938,246034,245938,96,128,utRho14
ackA,4826918,4826940,4826918,22,2098,utRho14
acnA,2670848,2671662,2670848,814,926,utRho14
acnB,263038,263230,263038,192,1398,utRho14
acpP,2303148,2303230,2303148,82,956,utRho14
acpS,5402324,5402324,5401996,328,446,utRho14
acrA,971396,971396,971238,158,64,utRho14
acrB,969370,969370,968806,564,4716,utRho14
acrD,5174950,5175190,5174950,240,0,utRho14
acrE,6827404,6827728,6827404,324,0,utRho14
acrR,971398,971522,971398,124,270,utRho14
acrZ,1589502,1589546,1589502,44,50,utRho14
acs,8575190,8575190,8574742,448,314,utRho14
actP,8569870,8569870,8569804,66,0,utRho14
ada,4620854,4620854,4620810,44,0,utRho14
add,3404404,3404466,3404404,62,262,utRho14
ade,7687802,7687928,7687802,126,0,utRho14
adhE,2596826,2596826,2596242,584,52,utRho14
adhP,3107988,3107988,3107676,312,3514,utRho14
adiA,8681112,8681112,8681042,70,0,utRho14
adiC,8674404,8674404,8674062,342,0,utRho14
adiY,8676084,8676084,8675858,226,0,utRho14
adk,994278,994350,994278,72,156,utRho14
adrA,807374,807406,807374,32,0,utRho14
aer,6438240,6438240,6438152,88,76,utRho14
aes,1000102,1000102,999946,156,200,utRho14
agaR,6557406,6557406,6557330,76,0,utRho14
agaS,6563778,6563952,6563778,174,0,utRho14
agp,2131118,2131170,2131118,52,108,utRho14
agrA,7296126,7296126,7296126,0,0,utRho14
agrB,7296588,7296588,7296588,0,0,utRho14
ahpC,1277386,1277890,1277386,504,2866,utRho14
ahpF,1278004,1279506,1278004,1502,200352,utRho14
ahr,8992698,8992698,8992418,280,0,utRho14
aidB,8828494,8828550,8828494,56,0,utRho14
ais,4731512,4731512,4731240,272,0,utRho14
alaA,4814816,4815122,4814816,306,0,utRho14
alaC,4996798,4996798,4996590,208,86,utRho14
alaE,5598140,5598328,5598140,188,430,utRho14
alaS,5644180,5644180,5644022,158,8150,utRho14
alaW,5036612,5036612,5036462,150,0,utRho14
aldA,2976380,2976464,2976380,84,1042,utRho14
aldB,7513070,7513070,7513022,48,0,utRho14
alkA,4295118,4295118,4295080,38,0,utRho14
alkB,4618890,4618890,4618682,208,2,utRho14
allA,1064780,1064902,1064780,122,0,utRho14
allD,1092822,1092822,1092726,96,0,utRho14
allE,1088112,1088112,1088092,20,0,utRho14
allS,1064600,1064600,1064442,158,0,utRho14
alr,8531178,8531564,8531178,386,2042,utRho14
alsE,8617334,8617334,8616956,378,174,utRho14
alsK,8615990,8615990,8615598,392,56,utRho14
alx,6476740,6477160,6476740,420,88,utRho14
amiA,5104482,5104704,5104482,222,0,utRho14
amiC,5898378,5898378,5898020,358,2,utRho14
amn,4110062,4110122,4110062,60,0,utRho14
ampC,8758006,8758006,8757888,118,122,utRho14
ampD,237362,237466,237362,104,194,utRho14
ampG,907372,907372,907090,282,1140,utRho14
ampH,792726,792726,792574,152,178,utRho14
amyA,4012230,4012312,4012230,82,0,utRho14
anmK,3439346,3439346,3439204,142,0,utRho14
ansB,6201580,6201580,6201456,124,0,utRho14
ansP,3052040,3052040,3051960,80,58,utRho14
apaG,104068,104068,103212,856,6356,utRho14
apaH,102586,102586,102444,142,3130,utRho14
apbE,4623188,4623188,4623068,120,0,utRho14
appA,2081198,2081234,2081198,36,0,utRho14
appC,2075420,2075480,2075420,60,0,utRho14
appY,1167134,1167362,1167134,228,0,utRho14
apt,982620,982824,982620,204,142,utRho14
aqpZ,1832424,1832424,1832094,330,28,utRho14
araB,140150,140150,140096,54,0,utRho14
araC,140482,140774,140482,292,1876,utRho14
araE,5964416,5964416,5964364,52,0,utRho14
araF,3972476,3972476,3972256,220,0,utRho14
araH,3967120,3967120,3967086,34,0,utRho14
araJ,825058,825058,824962,96,24,utRho14
arcA,9281602,9281602,9280612,990,14848,utRho14
arcB,6706098,6706098,6706050,48,0,utRho14
arcZ,6701154,6701154,6701154,0,0,utRho14
arfA,6877346,6877346,6877298,48,0,utRho14
argA,5898312,5898484,5898312,172,0,utRho14
argC,8309770,8310002,8309770,232,0,utRho14
argD,6980442,6980442,6980360,82,0,utRho14
argE,8310156,8310156,8309694,462,18,utRho14
argF,580680,580680,580610,70,0,utRho14
argG,6637124,6637274,6637124,150,228,utRho14
argI,8956688,8956688,8956622,66,0,utRho14
argO,6137672,6137672,6137616,56,4,utRho14
argP,6119460,6119506,6119460,46,0,utRho14
argR,6769204,6769406,6769204,202,72,utRho14
argS,3920002,3920124,3920002,122,0,utRho14
argT,4855698,4855698,4855582,116,110,utRho14
argU,1129406,1129446,1129406,40,0,utRho14
argW,4932616,4932618,4932616,2,0,utRho14
argX,7964728,7964750,7964728,22,0,utRho14
aroF,5482402,5482402,5482300,102,0,utRho14
aroG,1571182,1571266,1571182,84,512,utRho14
aroH,3576636,3576870,3576636,234,1204,utRho14
aroK,7038760,7038760,7038128,632,1130,utRho14
aroL,812560,812810,812560,250,112,utRho14
aroP,243342,243342,243102,240,0,utRho14
arpA,8445382,8445382,8444974,408,0,utRho14
arrS,7316108,7316108,7316108,0,0,utRho14
arsR,7297024,7297056,7297024,32,0,utRho14
artJ,1801252,1801252,1801150,102,0,utRho14
artP,1807686,1807686,1807468,218,10,utRho14
ascF,5678858,5679048,5678858,190,0,utRho14
ascG,5678574,5678574,5678528,46,0,utRho14
aslB,7965562,7965916,7965562,354,484,utRho14
asnA,7854258,7854310,7854258,52,88,utRho14
asnB,1398444,1398444,1398354,90,44,utRho14
asnC,23562186,23562186,23562018,168,0,utRho14
asnS,1978088,1978088,1977970,118,17084,utRho14
asnT,4089082,4089098,4089082,16,518,utRho14
asnU,4119690,4119702,4119690,12,20,utRho14
asnV,4124504,4124520,4124504,16,24,utRho14
aspA,17473728,17473728,17473308,420,260,utRho14
aspC,1971486,1971486,1971418,68,284,utRho14
aspS,3901402,3901402,3901044,358,504,utRho14
aspT,7893560,7893744,7893560,184,132840,utRho14
aspV,473826,473862,473826,36,20,utRho14
asr,3342654,3342752,3342654,98,0,utRho14
astC,3664088,3664088,3663964,124,0,utRho14
astE,3654138,3654138,3653846,292,0,utRho14
atoD,4646824,4646894,4646824,70,4,utRho14
atpB,7844540,7844540,7844102,438,926,utRho14
atpC,7832118,7832118,7831944,174,1884,utRho14
atpI,7845050,7845050,7844880,170,140,utRho14
avtA,7479348,7479410,7479348,62,56,utRho14
azoR,2965982,2965982,2965720,262,2,utRho14
azuC,3976002,3976002,3975918,84,2,utRho14
bacA,6408350,6408350,6408262,88,4,utRho14
bamA,394052,395856,394052,1804,1894,utRho14
bamB,5277950,5277950,5277304,646,1648,utRho14
bamC,5198028,5198028,5197730,298,1922,utRho14
bamD,5471922,5472292,5471922,370,2468,utRho14
bamE,5506972,5507210,5506972,238,1032,utRho14
basS,8666954,8666954,8666544,410,840,utRho14
bax,7474468,7474468,7474354,114,4,utRho14
bcp,5200874,5200956,5200874,82,6812,utRho14
bcsB,7385346,7385346,7385214,132,0,utRho14
bcsE,7392644,7392916,7392644,272,0,utRho14
bdcA,8948128,8948128,8948106,22,2,utRho14
bdcR,8948192,8948248,8948192,56,0,utRho14
bdm,3112680,3112680,3112560,120,0,utRho14
betA,654522,654522,654494,28,204,utRho14
betI,658722,658722,658668,54,0,utRho14
betT,658842,658926,658842,84,0,utRho14
bfr,6933498,6933498,6933450,48,0,utRho14
bglG,23440182,23440182,23439402,780,552,utRho14
bglX,4444240,4444240,4443978,262,0,utRho14
bhsA,2337962,2338146,2337962,184,0,utRho14
bioA,1618584,1618584,1618514,70,0,utRho14
bioB,1618604,1618688,1618604,84,44,utRho14
bioH,7089716,7089716,7089688,28,0,utRho14
bisC,7433026,7433026,7432788,238,32,utRho14
blc,8755490,8755490,8755444,46,0,utRho14
blr,3409024,3409102,3409024,78,82,utRho14
bluF,2431226,2431226,2430950,276,0,utRho14
bluR,2428226,2428226,2428118,108,0,utRho14
bolA,908698,908944,908698,246,0,utRho14
borD,1157842,1157842,1157786,56,84,utRho14
brnQ,838976,839182,838976,206,708,utRho14
bssR,1756492,1756496,1756492,4,0,utRho14
bssS,2242116,2242116,2241910,206,0,utRho14
btuB,8326798,8327278,8326798,480,5226,utRho14
cadB,8720212,8720212,8720062,150,0,utRho14
cadC,8723926,8723926,8723868,58,0,utRho14
caiE,70998,70998,70742,256,0,utRho14
caiF,68436,68600,68436,164,2,utRho14
caiT,84074,84074,83862,212,0,utRho14
can,285406,285406,285340,66,0,utRho14
carA,59102,59302,59102,200,0,utRho14
carB,61550,61634,61550,84,228,utRho14
cas2,5757830,5757830,5757706,124,0,utRho14
casA,5768638,5768638,5768276,362,0,utRho14
cbl,4121882,4121882,4121828,54,0,utRho14
cbpA,2128074,2128074,2127550,524,0,utRho14
cbrA,7738628,7738754,7738628,126,0,utRho14
cbrB,7794958,7795012,7794958,54,0,utRho14
ccmH,4585242,4585242,4584820,422,4,utRho14
cdaR,364894,364926,364894,32,4,utRho14
cdd,4463638,4463688,4463638,50,0,utRho14
cdh,8219814,8219860,8219814,46,0,utRho14
cdsA,391110,391354,391110,244,1148,utRho14
cedA,3627484,3627484,3627326,158,0,utRho14
cfa,3482402,3482826,3482402,424,120,utRho14
chaC,2544844,2544972,2544844,128,0,utRho14
chbB,3643452,3643452,3643238,214,0,utRho14
chbG,3634624,3634624,3634270,354,0,utRho14
cheW,3946924,3946924,3946678,246,722,utRho14
chiA,6939792,6939792,6939706,86,0,utRho14
chiP,1416472,1416668,1416472,196,8,utRho14
cho,3646984,3647030,3646984,46,0,utRho14
chpS,8896804,8896894,8896804,90,2,utRho14
cirA,4493884,4493884,4493538,346,2,utRho14
citC,1304078,1304078,1303712,366,0,utRho14
citT,1293264,1293264,1293160,104,0,utRho14
clcA,350104,350214,350104,110,0,utRho14
clpA,1846160,1846528,1846160,368,334,utRho14
clpB,5468410,5468410,5468346,64,24,utRho14
clpP,913154,913354,913154,200,1634,utRho14
clpS,1845500,1845826,1845500,326,0,utRho14
clpX,914404,914852,914404,448,4396,utRho14
clsA,2617346,2617346,2617290,56,0,utRho14
clsC,2212584,2212710,2212584,126,794,utRho14
cmk,1922330,1922402,1922330,72,0,utRho14
cnu,3409522,3409898,3409522,376,770,utRho14
coaA,8350214,8350214,8350052,162,588,utRho14
cobC,1340092,1340092,1339814,278,152,utRho14
cobT,4129202,4129202,4128934,268,38,utRho14
cobU,4131944,4131944,4131528,416,0,utRho14
codB,709768,709844,709768,76,0,utRho14
comR,2337726,2337726,2337664,62,0,utRho14
copA,1022822,1022822,1022758,64,0,utRho14
corA,8002388,8002852,8002388,464,6632,utRho14
cpdB,8873258,8873258,8873130,128,368,utRho14
cptB,6082198,6082198,6082140,58,0,utRho14
cpxA,8210202,8210202,8209950,252,356,utRho14
cpxP,8211570,8211640,8211570,70,0,utRho14
cpxR,8211372,8211372,8211340,32,0,utRho14
cra,175894,176056,175894,162,0,utRho14
crcB,1316016,1316016,1315876,140,0,utRho14
creA,9270486,9271042,9270486,556,670,utRho14
creD,9276320,9276356,9276320,36,0,utRho14
crl,515620,515658,515620,38,430,utRho14
crp,6971906,6972240,6971906,334,8960,utRho14
crr,5070960,5071668,5070960,708,6010,utRho14
csdA,5886414,5886674,5886414,260,0,utRho14
csgB,2207718,2207902,2207718,184,0,utRho14
csgD,2206688,2206688,2206392,296,0,utRho14
csgG,2203510,2203510,2203368,142,0,utRho14
csiD,5577854,5577970,5577854,116,134,utRho14
csiE,5330802,5330870,5330802,68,0,utRho14
csiR,5590942,5591348,5590942,406,0,utRho14
cspA,7439778,7440098,7439778,320,2378,utRho14
cspB,3283430,3283430,3283108,322,0,utRho14
cspC,3815018,3815018,3814870,148,2086,utRho14
cspD,1845352,1845352,1845180,172,21790,utRho14
cspE,1314294,1314584,1314294,290,2,utRho14
cspF,3283380,3283710,3283380,330,2,utRho14
cspG,2102610,2102922,2102610,312,282,utRho14
cspH,2102746,2102746,2102350,396,0,utRho14
cspI,3277624,3277624,3277334,290,0,utRho14
csrA,5638746,5638746,5638292,454,2592,utRho14
csrB,5849048,5849048,5849048,0,0,utRho14
csrC,8102072,8102072,8102072,0,0,utRho14
csrD,6806850,6806850,6806664,186,100,utRho14
cstA,1259710,1259788,1259710,78,0,utRho14
cueO,274090,274166,274090,76,0,utRho14
cueR,1027948,1027986,1027948,38,0,utRho14
curA,3037784,3038054,3037784,270,0,utRho14
cusC,1191146,1191200,1191146,54,0,utRho14
cusR,1190924,1190924,1190886,38,12,utRho14
cutA,8730784,8730784,8730712,72,0,utRho14
cutC,3918534,3918534,3917920,614,410,utRho14
cvpA,4861600,4861600,4861526,74,72,utRho14
cvrA,2484328,2484328,2484142,186,0,utRho14
cyaA,7981548,7982306,7981548,758,1716,utRho14
cyaR,4334228,4334224,4334228,4,0,utRho14
cyaY,7988166,7988166,7988118,48,120,utRho14
cybB,2981522,2981804,2981522,282,0,utRho14
cycA,8859560,8859728,8859560,168,924,utRho14
cydA,1542340,1542916,1542340,576,118,utRho14
cydC,1858800,1858800,1858390,410,380,utRho14
cydD,1862062,1862062,1861924,138,0,utRho14
cydX,1548300,1548392,1548300,92,330,utRho14
cynR,717418,717418,717380,38,0,utRho14
cynT,1435092,1435196,1435092,104,0,utRho14
cyoA,903306,903306,903220,86,6468,utRho14
cyoE,895540,895540,895410,130,970,utRho14
cysB,2667576,2667710,2667576,134,316,utRho14
cysC,5748056,5748056,5747984,72,0,utRho14
cysD,5752736,5752736,5752658,78,0,utRho14
cysE,7565362,7565362,7565124,238,3896,utRho14
cysG,6995508,6995656,6995508,148,4,utRho14
cysJ,5783928,5783928,5783796,132,280,utRho14
cysK,5064688,5064818,5064688,130,568,utRho14
cysP,5087114,5087114,5087056,58,0,utRho14
cysS,1109154,1109222,1109154,68,172,utRho14
cysT,3984100,3984100,3983974,126,162,utRho14
cysZ,5062766,5062926,5062766,160,162,utRho14
cytR,8249018,8249018,8248912,106,60,utRho14
dacA,1328002,1328002,1327926,76,492,utRho14
dacB,6657714,6657926,6657714,212,0,utRho14
dacC,1761306,1761454,1761306,148,0,utRho14
dadA,2475018,2475142,2475018,124,22,utRho14
dam,7032504,7032504,7031826,678,1606,utRho14
damX,7035200,7035200,7034612,588,738,utRho14
dapA,5199568,5199568,5199520,48,0,utRho14
dapB,56576,56748,56576,172,2,utRho14
dapD,371954,371954,371894,60,218,utRho14
dapE,5183120,5183214,5183120,94,1652,utRho14
dcp,3254844,3254844,3254760,84,220,utRho14
dcrB,7219534,7219910,7219534,376,150,utRho14
dctA,7366996,7366996,7366894,102,794,utRho14
dcuA,8733686,8733686,8733546,140,0,utRho14
dcuB,8698182,8698182,8697488,694,184,utRho14
dcuC,1312166,1312166,1311936,230,0,utRho14
dcuD,6749166,6749738,6749166,572,0,utRho14
dcuR,8701130,8701130,8700068,1062,566,utRho14
dcuS,8703370,8703370,8703324,46,2,utRho14
dcyD,3999016,3999016,3998960,56,0,utRho14
ddpX,3126498,3126498,3126152,346,0,utRho14
deaD,6615818,6615818,6615720,98,160,utRho14
dedA,4869880,4869880,4869482,398,5816,utRho14
dedD,4863750,4863750,4863368,382,158,utRho14
def,6867300,6867380,6867300,80,0,utRho14
degP,361690,361768,361690,78,0,utRho14
degQ,6761308,6761486,6761308,178,556,utRho14
deoB,9239134,9239206,9239134,72,0,utRho14
deoC,9233358,9234646,9233358,1288,964,utRho14
dfp,7625406,7625462,7625406,56,66,utRho14
dgcZ,3247758,3247758,3247700,58,0,utRho14
dgkA,8512914,8513274,8512914,360,1028,utRho14
dgt,358392,358474,358392,82,0,utRho14
dhaK,2501888,2501888,2501676,212,1158,utRho14
dhaR,2502006,2502132,2502006,126,0,utRho14
dicB,3299194,3299218,3299194,24,0,utRho14
dicC,3295752,3295752,3295700,52,0,utRho14
dinB,501760,501796,501760,36,0,utRho14
dinD,7635398,7635520,7635398,122,0,utRho14
dinG,1666146,1666140,1666146,6,0,utRho14
dinI,2243018,2243018,2242974,44,0,utRho14
dinJ,493230,493230,493004,226,72,utRho14
dinQ,7295964,7295964,7295576,388,738,utRho14
djlA,114536,114728,114536,192,0,utRho14
dkgA,6313142,6313246,6313142,104,422,utRho14
dkgB,458196,458334,458196,138,0,utRho14
dksA,321502,321502,321208,294,1830,utRho14
dld,4444164,4444370,4444164,206,38,utRho14
dmlA,3763424,3763824,3763424,400,194,utRho14
dmlR,3763710,3763710,3763618,92,26,utRho14
dmsA,1881646,1881918,1881646,272,0,utRho14
dnaA,7767922,7767922,7767458,464,620,utRho14
dnaB,8528566,8528628,8528566,62,36,utRho14
dnaK,24096,24326,24096,230,3572,utRho14
dnaN,7765466,7765466,7764642,824,540,utRho14
dnaQ,471868,472134,471868,266,1032,utRho14
dnaT,18406460,18406460,18406068,392,8,utRho14
dnaX,984112,984184,984112,72,80,utRho14
dosP,3131486,3131486,3131466,20,0,utRho14
dpiB,1303968,1304470,1303968,502,0,utRho14
dppA,7415740,7415740,7415410,330,4686,utRho14
dps,1697900,1697900,1697822,78,0,utRho14
dsbA,8086754,8086836,8086754,82,2404,utRho14
dsbB,2466294,2466294,2466060,234,0,utRho14
dsbC,6079266,6079266,6077644,1622,618,utRho14
dsbG,1277600,1277600,1277146,454,956,utRho14
dsdA,4958242,4958404,4958242,162,2534,utRho14
dsdC,4955492,4955492,4955258,234,0,utRho14
dsdX,4955642,4955694,4955642,52,0,utRho14
dsrA,4050626,4050626,4050626,0,0,utRho14
dsrB,4049686,4049686,4049646,40,0,utRho14
dtpD,1485340,1485340,1485112,228,0,utRho14
dusA,8523200,8523338,8523200,138,1406,utRho14
dusB,6820492,6820560,6820492,68,2,utRho14
dusC,4460790,4460790,4460770,20,0,utRho14
dut,7627704,7627864,7627704,160,2460,utRho14
dxr,386670,387042,386670,372,1832,utRho14
ebgA,6445102,6445266,6445102,164,0,utRho14
ebgR,6442874,6442932,6442874,58,372,utRho14
ecnB,8753018,8753106,8753018,88,148,utRho14
eco,4607594,4607810,4607594,216,0,utRho14
ecpA,621594,621594,621342,252,0,utRho14
ecpB,620238,620238,620052,186,0,utRho14
ecpR,622964,622964,622672,292,0,utRho14
eda,3866218,3866218,3865512,706,184,utRho14
edd,3869426,3869426,3869208,218,66,utRho14
efeO,2164308,2164486,2164308,178,48,utRho14
efeU_1,2162614,2162712,2162614,98,0,utRho14
efp,8751134,8751398,8751134,264,3322,utRho14
elaA,4763372,4763372,4763086,286,108,utRho14
elaD,4765308,4765426,4765308,118,0,utRho14
elfA,1995530,1995736,1995530,206,0,utRho14
elfD,1996642,1996980,1996642,338,0,utRho14
emrD,7707690,7707844,7707690,154,0,utRho14
emrK,4966896,4966896,4966678,218,0,utRho14
emrY,4964668,4964668,4964352,316,0,utRho14
emtA,2486250,2486360,2486250,110,0,utRho14
endA,12361100,12361388,12361100,288,0,utRho14
eno,5817692,5817692,5815882,1810,3984,utRho14
entC,1249662,1249770,1249662,108,12,utRho14
entD,1220508,1220508,1220158,350,0,utRho14
entH,1258584,1258600,1258584,16,84,utRho14
entS,1244506,1244600,1244506,94,0,utRho14
envR,6827266,6827266,6826930,336,0,utRho14
epd,12295292,12295292,12294764,528,0,utRho14
epmA,8765236,8765286,8765236,50,0,utRho14
epmB,8751406,8751406,8751314,92,2152,utRho14
eptB,7421162,7421162,7420950,212,204,utRho14
eptC,8300622,8300622,8300530,92,48,utRho14
erfK,4126708,4126708,4126646,62,42,utRho14
erpA,353122,353220,353122,98,0,utRho14
esrE,8039956,8039956,8039956,0,0,utRho14
essD,1153746,1154796,1153746,1050,2,utRho14
etk,2088606,2088606,2088420,186,126,utRho14
evgA,4967262,4967510,4967262,248,0,utRho14
exbB,6304028,6304028,6303968,60,0,utRho14
exbD,6302780,6302780,6302486,294,166,utRho14
exuR,6493016,6493304,6493016,288,160,utRho14
exuT,6490004,6490208,6490004,204,0,utRho14
fabA,2032996,2032996,2032940,56,0,utRho14
fabB,4883282,4883282,4883210,72,0,utRho14
fabH,2297032,2297518,2297032,486,1976,utRho14
fabI,2702236,2702236,2702078,158,34,utRho14
fadB,8062026,8062026,8061942,84,0,utRho14
fadD,3779614,3779614,3779492,122,0,utRho14
fadE,486812,486812,486606,206,0,utRho14
fadH,6463248,6463330,6463248,82,0,utRho14
fadI,4921022,4921022,4920938,84,0,utRho14
fadL,4922410,4922600,4922410,190,362,utRho14
fadM,928720,928804,928720,84,2,utRho14
fadR,2469810,2469876,2469810,66,0,utRho14
fbaB,4357334,4357334,4357128,206,0,utRho14
fdhE,8162722,8162722,8162456,266,2736,utRho14
fdhF,8598814,8598814,8598732,82,0,utRho14
fdnG,3094744,3094802,3094744,58,0,utRho14
fdrA,1093012,1093360,1093012,348,0,utRho14
feaB,2894994,2895038,2894994,44,0,utRho14
feaR,2894734,2894734,2894566,168,300,utRho14
fecA,9033454,9033454,9033354,100,0,utRho14
fecE,9023288,9023288,9022914,374,3008,utRho14
fecI,9036564,9036564,9036470,94,0,utRho14
feoA,7080114,7080326,7080114,212,58,utRho14
fepA,1225334,1225334,1224988,346,0,utRho14
fepB,1249454,1249454,1249020,434,724,utRho14
fepD,1244468,1244468,1244378,90,0,utRho14
fes,1225374,1225630,1225374,256,72,utRho14
ffh,5495706,5495706,5495590,116,792,utRho14
ffs,952576,952848,952576,272,0,utRho14
fhuA,334884,334968,334884,84,0,utRho14
fhuE,2323294,2323294,2323102,192,56,utRho14
fhuF,9211504,9211504,9211326,178,230,utRho14
fic,6983296,6983296,6982926,370,120,utRho14
fieF,8212864,8212938,8212864,74,0,utRho14
fimA,9085388,9086230,9085388,842,618,utRho14
fimB,9081334,9081914,9081334,580,1038,utRho14
fimE,9083742,9084074,9083742,332,44,utRho14
fimZ,1129214,1129214,1128960,254,0,utRho14
fiu,1683296,1683296,1683062,234,0,utRho14
fixA,84650,84806,84650,156,0,utRho14
fkpA,6955050,6955050,6954838,212,11198,utRho14
fldA,2846084,2846084,2845860,224,4072,utRho14
fldB,6079644,6079710,6079644,66,0,utRho14
flgA,2261770,2261770,2261726,44,2,utRho14
flgB,2261986,2262036,2261986,50,0,utRho14
flgK,2276702,2276756,2276702,54,664,utRho14
flgM,2260330,2260330,2260256,74,1168,utRho14
flgN,2259828,2259828,2259660,168,98,utRho14
flhB,3932432,3932432,3932382,50,394,utRho14
flhC,3955864,3955864,3955688,176,120,utRho14
flhD,3957154,3957154,3956394,760,582,utRho14
fliA,4003638,4003638,4003578,60,2,utRho14
fliC,4007352,4007352,4007212,140,90,utRho14
fliD,4007634,4007744,4007634,110,194,utRho14
fliE,4026186,4026186,4026028,158,0,utRho14
fliF,4026292,4026458,4026292,166,288,utRho14
fliL,4039168,4039236,4039168,68,184,utRho14
flk,4875824,4875900,4875824,76,0,utRho14
flu,4142634,4143078,4142634,444,32,utRho14
flxA,3292776,3292810,3292776,34,16,utRho14
fnr,2799104,2799104,2799052,52,0,utRho14
fnrS,2818258,2818258,2818258,0,0,utRho14
focA,1909628,1909628,1908932,696,0,utRho14
folA,99598,99646,99598,48,0,utRho14
folB,6409296,6409296,6409178,118,0,utRho14
folD,1115562,1115562,1115482,80,180,utRho14
folE,4487696,4487696,4487304,392,4010,utRho14
fpr,8228998,8228998,8228944,54,0,utRho14
frc,4986878,4986878,4986508,370,0,utRho14
frdA,8764824,8764824,8764636,188,24,utRho14
frdD,8758948,8758948,8758732,216,2828,utRho14
fre,8052886,8053054,8052886,168,2728,utRho14
frlA,6999518,6999820,6999518,302,2,utRho14
frr,385624,385744,385624,120,2398,utRho14
frsA,513004,513054,513004,50,18,utRho14
fruB,4527194,4527194,4526990,204,0,utRho14
frvR,8179804,8179804,8179710,94,0,utRho14
fryA,5008986,5008986,5008970,16,0,utRho14
fsaA,1727060,1727284,1727060,224,2,utRho14
fsr,1009710,1009710,1009392,318,214,utRho14
ftnA,3977364,3977432,3977364,68,116,utRho14
ftnB,3973550,3973850,3973550,300,110,utRho14
ftsA,207122,207964,207122,842,1068,utRho14
ftsB,5745802,5745802,5745640,162,36,utRho14
ftsH,6654204,6654204,6653870,334,1094,utRho14
ftsK,1865858,1866448,1865858,590,1342,utRho14
ftsL,181376,182064,181376,688,2588,utRho14
ftsP,6325732,6325732,6325338,394,74,utRho14
ftsQ,205484,206310,205484,826,226,utRho14
ftsX,7204512,7204512,7204172,340,1692,utRho14
ftsZ,209272,210610,209272,1338,312,utRho14
fucA,5867708,5867708,5867376,332,8,utRho14
fucP,5868238,5868470,5868238,232,4,utRho14
fumA,6753760,6753760,6753508,252,16524,utRho14
fumB,8694696,8694696,8694652,44,0,utRho14
fumC,3373418,3373418,3373176,242,0,utRho14
fur,2842892,2842892,2842584,308,6356,utRho14
fusA,6947370,6947370,6947028,342,26422,utRho14
fxsA,8737206,8737328,8737206,122,224,utRho14
gabD,5581824,5582546,5581824,722,4820,utRho14
gadA,7335214,7335214,7335160,54,0,utRho14
gadB,3144144,3144144,3144090,54,0,utRho14
gadC,3141168,3141168,3140978,190,2,utRho14
gadE,7315600,7316732,7315600,1132,2,utRho14
gadW,7329562,7329562,7329236,326,0,utRho14
gadX,14663356,14663356,14663240,116,8,utRho14
gadY,7329728,7329728,7329728,0,0,utRho14
galE,1584354,1584354,1584110,244,2,utRho14
galF,4228702,4228702,4228654,48,2,utRho14
galM,1577796,1577796,1577674,122,1964,utRho14
galP,6176510,6176568,6176510,58,0,utRho14
galR,5953138,5953198,5953138,60,306,utRho14
galS,4483420,4483420,4483336,84,0,utRho14
galU,2582810,2582914,2582810,104,844,utRho14
gapA,3724480,3725542,3724480,1062,14852,utRho14
garP,6549868,6549868,6549814,54,88,utRho14
gatY,4354468,4354468,4354408,60,0,utRho14
gatZ,4352864,4352864,4352642,222,58740,utRho14
gcd,282558,282558,282450,108,0,utRho14
gcl,1067814,1067832,1067814,18,0,utRho14
gcvA,5885278,5885278,5885134,144,0,utRho14
gcvB,5885392,5885392,5885392,0,0,utRho14
gcvR,5199758,5199812,5199758,54,26,utRho14
gcvT,6101544,6101544,6101334,210,8920,utRho14
gdhA,3684616,3684742,3684616,126,68,utRho14
gfcA,2099668,2099668,2099488,180,8,utRho14
gfcD,2096236,2096236,2095890,346,26,utRho14
ghrA,2195648,2195772,2195648,124,128,utRho14
ghrB,7434378,7434620,7434378,242,964,utRho14
glcA,6242728,6242728,6242558,170,136,utRho14
glcC,6256412,6256544,6256412,132,30,utRho14
glcD,6256152,6256152,6256042,110,0,utRho14
gldA,8278092,8278092,8278070,22,58,utRho14
glgA,7136784,7136784,7136066,718,1826,utRho14
glgB,7147314,7147314,7147004,310,494,utRho14
glgC,7139142,7139142,7138656,486,968,utRho14
glgP,7133546,7133546,7133162,384,220,utRho14
glgS,6384024,6384024,6383878,146,0,utRho14
glgX,7142838,7142838,7142638,200,158,utRho14
glk,5018922,5018922,5018852,70,0,utRho14
glmS,7827622,7827622,7827336,286,6702,utRho14
glmU,7830652,7830652,7830400,252,0,utRho14
glmY,10765360,10765360,10765360,0,0,utRho14
glmZ,7972864,7972864,7972864,0,0,utRho14
glnA,16232888,16232888,16232136,752,1328,utRho14
glnB,5375052,5375052,5374816,236,404,utRho14
glnD,377310,377310,377300,10,0,utRho14
glnE,6399602,6399602,6399282,320,336,utRho14
glnH,1696396,1696396,1696008,388,1158,utRho14
glnK,945112,945196,945112,84,0,utRho14
glnL,8112742,8112742,8112678,64,0,utRho14
glnQ,1693262,1693262,1692926,336,3042,utRho14
glnS,1411998,1412186,1411998,188,1318,utRho14
gloA,3455602,3455674,3455602,72,0,utRho14
gloB,469852,469852,469564,288,1868,utRho14
glpA,4705166,4705294,4705166,128,68,utRho14
glpD,7123942,7124026,7123942,84,48,utRho14
glpE,7123698,7123698,7123646,52,218,utRho14
glpF,8236322,8236322,8236180,142,622,utRho14
glpG,7122960,7122960,7122904,56,34,utRho14
glpR,7121782,7121782,7121210,572,494,utRho14
glpT,4704902,4704902,4704748,154,1022,utRho14
glpX,8231212,8231212,8231158,54,7338,utRho14
glrK,5382246,5382246,5382196,50,0,utRho14
gltA,1509534,1509534,1508936,598,28656,utRho14
gltB,6709018,6709264,6709018,246,74,utRho14
gltI,1375792,1375792,1375494,298,3108,utRho14
gltP,8588536,8588962,8588536,426,1398,utRho14
gltS,7657382,7657382,7657330,52,0,utRho14
gltX,5041568,5041568,5041344,224,56,utRho14
gluQ,320286,320286,320224,62,378,utRho14
glyA,5371148,5371148,5371014,134,0,utRho14
glyQ,7450708,7450708,7450636,72,678,utRho14
glyS,7448990,7448990,7448794,196,2566,utRho14
glyU,5998128,5998128,5998114,14,0,utRho14
glyV,8784626,8784720,8784626,94,70,utRho14
glyW,3984360,3984360,3984234,126,0,utRho14
gmhB,445612,445666,445612,54,0,utRho14
gmk,7642776,7642856,7642776,80,0,utRho14
gmr,2693686,2693686,2693484,202,0,utRho14
gnd,4202648,4202648,4202536,112,726,utRho14
gnsB,3275692,3275692,3275564,128,0,utRho14
gntK,14310580,14310580,14310368,212,304,utRho14
gntP,9102668,9102668,9102592,76,86,utRho14
gntR,7157760,7157760,7157452,308,466,utRho14
gntT,7092810,7093118,7092810,308,168,utRho14
gntU,7154170,7154170,7154122,48,0,utRho14
gntX,7089334,7089764,7089334,430,0,utRho14
gor,7292224,7292598,7292224,374,432,utRho14
gpmA,1575340,1575340,1575190,150,0,utRho14
gpmM,7570374,7570520,7570374,146,156,utRho14
gpsA,7567620,7567620,7567322,298,30274,utRho14
gpt,511828,511954,511828,126,382,utRho14
grcA,5433046,5433046,5432898,148,184,utRho14
greA,6657728,6657728,6657430,298,994,utRho14
greB,7073488,7073624,7073488,136,0,utRho14
groL,8741566,8742050,8741566,484,10974,utRho14
groS,8741232,8741376,8741232,144,15218,utRho14
grpE,5501494,5501494,5501416,78,436,utRho14
grxA,1781552,1781552,1781506,46,0,utRho14
grxB,2248206,2248206,2248108,98,60,utRho14
grxC,7569152,7569152,7568884,268,13482,utRho14
grxD,3468324,3468324,3468202,122,7916,utRho14
gspA,6911268,6911268,6910796,472,0,utRho14
gspC,6910964,6911156,6910964,192,0,utRho14
gss,6277220,6277220,6277044,176,0,utRho14
gstA,3428654,3428754,3428654,100,0,utRho14
gstB,1761038,1761038,1760960,78,0,utRho14
guaB,5268214,5268214,5268140,74,266,utRho14
gudD,5839026,5839026,5838770,256,0,utRho14
gyrA,4678914,4678914,4678840,74,0,utRho14
gyrB,7760300,7760300,7760238,62,308,utRho14
hcaE,5337964,5338064,5337964,100,0,utRho14
hcaR,5337928,5337928,5337792,136,12,utRho14
hcaT,5336106,5336106,5335692,414,608,utRho14
hchA,4071260,4071670,4071260,410,0,utRho14
hcp,1828258,1828258,1827628,630,0,utRho14
hcr,1824400,1824400,1824300,100,42,utRho14
hdeA,7313582,7313582,7313480,102,0,utRho14
hdeD,7313920,7313990,7313920,70,6,utRho14
hdfR,7896320,7896320,7895934,386,320,utRho14
hdhA,3396244,3396244,3396080,164,0,utRho14
helD,2048876,2048942,2048876,66,0,utRho14
hemA,2527166,2527428,2527166,262,0,utRho14
hemB,779722,779722,779454,268,0,utRho14
hemF,5106410,5106450,5106410,40,58,utRho14
hemH,996062,996110,996062,48,0,utRho14
hemL,349882,349882,349764,118,468,utRho14
hemN,8103886,8104090,8103886,204,76,utRho14
hepA,127176,127176,126528,648,1190,utRho14
hflD,2385372,2385372,2385262,110,398,utRho14
hfq,8799602,8800576,8799602,974,11316,utRho14
hha,961006,961006,960616,390,0,utRho14
hicA,3018442,3018572,3018442,130,0,utRho14
higA,6468682,6468682,6468288,394,138,utRho14
higB,6468960,6468960,6468910,50,0,utRho14
hinT,2323642,2323770,2323642,128,50,utRho14
hipB,3184964,3184964,3184884,80,0,utRho14
hisB,4186720,4186936,4186720,216,1190,utRho14
hisJ,4853674,4853674,4853576,98,140,utRho14
hisL,8359856,8359984,8359856,128,0,utRho14
hisS,5281284,5281284,5281150,134,526,utRho14
hlpA,400910,400964,400910,54,318,utRho14
hlyE,2460932,2460932,2460788,144,0,utRho14
hmp,5371594,5371670,5371594,76,0,utRho14
hns,2585916,2585916,2585844,72,1342,utRho14
hofM,7045856,7045856,7045502,354,0,utRho14
hokA,7441620,7441620,7441200,420,14,utRho14
hokC,33902,33902,33806,96,306,utRho14
hokE,1215462,1215672,1215462,210,0,utRho14
holC,8968546,8968546,8968560,14,1340,utRho14
holD,9215562,9215606,9215562,44,78,utRho14
holE,3850040,3850216,3850040,176,100,utRho14
hpt,282720,282862,282720,142,182,utRho14
hrpB,324150,324210,324150,60,90,utRho14
hscB,5319048,5319048,5318934,114,3442,utRho14
hscC,1367188,1367188,1366786,402,3670,utRho14
hsdS,9163004,9163004,9162924,80,0,utRho14
hslJ,2883560,2883560,2883486,74,0,utRho14
hslO,7059344,7059548,7059344,204,16056,utRho14
hslR,7058220,7058696,7058220,476,2952,utRho14
hslV,8244708,8244708,8244574,134,288,utRho14
hsrA,7881412,7881412,7881224,188,96,utRho14
htgA,21286,21660,21286,374,242,utRho14
htpG,989634,990240,989634,606,2272,utRho14
htpX,3825236,3825236,3825152,84,0,utRho14
htrE,311036,311036,310852,184,2,utRho14
htrL,7587668,7587668,7587366,302,0,utRho14
hupA,8400352,8400562,8400352,210,200,utRho14
hupB,1845220,1845804,1845220,584,2284,utRho14
hyaA,2063968,2064278,2063968,310,0,utRho14
hybO,6292726,6292726,6292522,204,954,utRho14
hycA,5700922,5700922,5700870,52,0,utRho14
hycI,5686204,5686204,5686086,118,124,utRho14
hydN,5676264,5676264,5676210,54,0,utRho14
hyfA,5202342,5202402,5202342,60,0,utRho14
hypA,11402508,11402588,11402508,80,0,utRho14
hypB,11403356,11404004,11403356,648,656,utRho14
hypF,5676210,5676210,5674850,1360,78,utRho14
hypT,9116634,9116634,9116578,56,0,utRho14
hyuA,6019660,6020056,6019660,396,2,utRho14
iaaA,1733074,1733136,1733074,62,4,utRho14
iadA,9119074,9119074,9119052,22,46,utRho14
iap,5753072,5753162,5753072,90,0,utRho14
ibaG,6673966,6673966,6673606,360,4,utRho14
ibpA,7735036,7735036,7734844,192,2712,utRho14
ibpB,7733962,7733962,7733794,168,8784,utRho14
icd,2389922,2390246,2389922,324,122,utRho14
iclR,8447304,8447304,8447256,48,40,utRho14
idi,6065876,6066130,6065876,254,0,utRho14
idnD,8988870,8988870,8988812,58,0,utRho14
idnK,8989194,8989246,8989194,52,0,utRho14
ihfA,3591442,3591442,3591104,338,988,utRho14
ihfB,1927498,1927656,1927498,158,1348,utRho14
ileS,43666,44782,43666,1116,12862,utRho14
ileX,6431194,6431196,6431194,2,60,utRho14
ilvA,15820940,15821324,15820940,384,0,utRho14
ilvC,7915824,7915940,7915824,116,138,utRho14
ilvE,15809552,15809936,15809552,384,528,utRho14
ilvI,170840,171260,170840,420,0,utRho14
ilvL,23701308,23701932,23701308,624,360,utRho14
ilvY,7915734,7915734,7915640,94,0,utRho14
inaA,4698998,4698998,4698944,54,0,utRho14
infA,1853370,1853370,1852886,484,1570,utRho14
infC,3602692,3602692,3601276,1416,5832,utRho14
insA-5,3958452,3958452,3958430,22,0,utRho14
insA-7,9036758,9037054,9036758,296,22,utRho14
insC-5,6372080,6372284,6372080,204,140,utRho14
insEF-2,785238,785238,785820,582,380,utRho14
insEF-4,2190310,2190310,2190892,582,516,utRho14
insG,9007098,9007098,9006862,236,44,utRho14
insH-1,550596,550596,550234,362,254,utRho14
insH-11,7306538,7306538,7306396,142,262,utRho14
insH-2,1151548,1151548,1151506,42,594,utRho14
insH-3,1378444,1378444,1378026,418,594,utRho14
insH-4,2791942,2792152,2791942,210,184,utRho14
insH-5,2857852,2857852,2857452,400,0,utRho14
insH-6,4135022,4135022,4134642,380,22,utRho14
insH-7,4206186,4206186,4205822,364,6030,utRho14
insH-9,6260050,6260356,6260050,306,172,utRho14
insI-3,9017372,9017372,9017234,138,0,utRho14
insJ,7441188,7441360,7441188,172,12,utRho14
insK,7442130,7442308,7442130,178,0,utRho14
insL-1,30760,30890,30760,130,3348,utRho14
insL-2,1216112,1216130,1216112,18,62,utRho14
insL-3,5028644,5028662,5028644,18,98,utRho14
insN-1,540452,540484,540452,32,12,utRho14
intD,1132202,1132202,1131956,246,0,utRho14
intR,2826520,2826520,2826470,50,0,utRho14
intS,4933026,4933090,4933026,64,110,utRho14
intZ,5117386,5117542,5117386,156,2,utRho14
iraD,9113152,9113986,9113152,834,0,utRho14
iraM,2424246,2424246,2424006,240,0,utRho14
iraP,802638,802772,802638,134,0,utRho14
iscA,5319924,5319924,5319772,152,1930,utRho14
iscR,5324398,5324398,5324262,136,23578,utRho14
iscX,5313834,5313834,5313472,362,2714,utRho14
ispF,5743968,5743968,5743560,408,2054,utRho14
ispG,5283908,5283908,5283608,300,796,utRho14
ispU,389568,389806,389568,238,156,utRho14
isrA,2811502,2811502,2811618,116,0,utRho14
istr-1,7706384,7706384,7706384,0,0,utRho14
istr-2,7706514,7706514,7706514,0,0,utRho14
ivbL,15412092,15412092,15411952,140,676,utRho14
ivy,480638,480686,480638,48,0,utRho14
katE,3627628,3627734,3627628,106,0,utRho14
katG,8267624,8267670,8267624,46,256,utRho14
kbaZ,6557732,6557828,6557732,96,0,utRho14
kbl,7585154,7585154,7585102,52,954,utRho14
kch,2621046,2621046,2620538,508,142,utRho14
kdgR,3820506,3820506,3820198,308,0,utRho14
kdpE,1443788,1443788,1443466,322,14,utRho14
kdpF,1457698,1457698,1457642,56,0,utRho14
kdsA,2535708,2536330,2535708,622,2002,utRho14
kdsC,6683438,6684546,6683438,1108,2912,utRho14
kduI,5968388,5968388,5968248,140,458,utRho14
kefF,94160,94492,94160,332,84,utRho14
kgtP,5451624,5451624,5451492,132,0,utRho14
kup,7862206,7862632,7862206,426,0,utRho14
lacI,735076,735076,735020,56,62,utRho14
lacZ,1465508,1465508,1465220,288,92,utRho14
ldcA,2486394,2486394,2486160,234,0,utRho14
ldhA,2885830,2885830,2885686,144,0,utRho14
ldrA,2538954,2538954,2538550,404,230,utRho14
ldrB,2540024,2540024,2539620,404,4,utRho14
ldrC,2541092,2541092,2540690,402,36,utRho14
ldrD,7400544,7400544,7400174,370,258,utRho14
lepA,5414392,5414392,5414248,144,224,utRho14
lepB,5410928,5410928,5410618,310,720,utRho14
leuD,159188,159188,158906,282,56,utRho14
leuE,3761600,3761600,3761518,82,0,utRho14
leuL,168048,168048,167416,632,92,utRho14
leuO,168308,168736,168308,428,0,utRho14
leuQ,9212864,9212864,9212802,62,0,utRho14
leuU,6644556,6644556,6644316,240,2074,utRho14
leuV,9212546,9212546,9212330,216,1760,utRho14
leuX,8992772,8992810,8992772,38,0,utRho14
lexA,8514174,8514230,8514174,56,94,utRho14
lhr,3456706,3458174,3456706,1468,1058,utRho14
ligA,5060402,5060402,5060352,50,54,utRho14
ligB,7642576,7642576,7642340,236,0,utRho14
lipA,1320602,1320602,1320432,170,42,utRho14
lipB,1324802,1324802,1324556,246,3848,utRho14
lit,2397032,2397390,2397032,358,36,utRho14
livJ,7199524,7199524,7199316,208,148,utRho14
livK,7195510,7195510,7195120,390,100,utRho14
lldP,7554578,7554798,7554578,220,8122,utRho14
lnt,1381968,1381968,1381762,206,920,utRho14
loiP,6163784,6163826,6163784,42,0,utRho14
lolA,1874656,1874738,1874656,82,422,utRho14
lolB,2527112,2527112,2527000,112,0,utRho14
lolC,2350748,2350854,2350748,106,0,utRho14
lon,917630,917776,917630,146,164,utRho14
lpcA,486936,487086,486936,150,0,utRho14
lpd,255434,255824,255434,390,7570,utRho14
lplA,9248476,9248476,9248234,242,2576,utRho14
lplT,5947878,5947878,5947724,154,64,utRho14
lpoA,6586422,6586800,6586422,378,268,utRho14
lpp,3514592,3514842,3514592,250,384,utRho14
lptA,6686598,6686760,6686598,162,410,utRho14
lptB,6686792,6687888,6686792,1096,1828,utRho14
lptD,114672,114672,114218,454,1642,utRho14
lptF,8972244,8972436,8972244,192,0,utRho14
lpxC,213016,213114,213016,98,8190,utRho14
lpxD,401920,401942,401920,22,54,utRho14
lpxL,2233418,2233418,2233164,254,16,utRho14
lpxM,3880456,3880456,3880386,70,0,utRho14
lpxP,4991156,4991290,4991156,134,0,utRho14
lrhA,4813312,4813312,4813282,30,0,utRho14
lrp,1864656,1865190,1864656,534,532,utRho14
lspA,50028,50414,50028,386,2294,utRho14
lsrA,3202920,3202980,3202920,60,0,utRho14
lsrR,3202514,3202514,3202482,32,0,utRho14
ltaE,1818640,1818640,1818588,52,0,utRho14
luxS,5630130,5630130,5629466,664,1958,utRho14
lysA,5957902,5957902,5957798,104,0,utRho14
lysC,8467232,8467232,8466466,766,1142,utRho14
lysP,4497120,4497120,4497064,56,0,utRho14
lysR,5957900,5958042,5957900,142,0,utRho14
lysT,1561028,1561108,1561028,80,174,utRho14
lysU,8709610,8709610,8709434,176,44,utRho14
macB,1840188,1840694,1840188,506,786,utRho14
maeA,3111484,3111484,3111338,146,13578,utRho14
mak,820236,820288,820236,52,42,utRho14
malE,8492928,8492928,8492838,90,2,utRho14
malI,3398456,3398456,3398360,96,0,utRho14
malK,8493472,8493568,8493472,96,0,utRho14
malP,7105020,7105020,7104946,74,496,utRho14
malQ,7100798,7100798,7100140,658,1492,utRho14
malS,14949880,14949988,14949880,108,0,utRho14
malT,7106048,7106170,7106048,122,174,utRho14
malX,3398626,3398710,3398626,84,70,utRho14
malZ,1689980,1690072,1689980,92,168,utRho14
manA,3377102,3377152,3377102,50,0,utRho14
manX,3803866,3804096,3803866,230,108,utRho14
marC,3237882,3237882,3237816,66,0,utRho14
marR,3238186,3238240,3238186,54,0,utRho14
matP,2036918,2036970,2036918,52,2,utRho14
mazE,5822736,5822736,5822678,58,0,utRho14
mazG,5821720,5821720,5821370,350,1910,utRho14
mcbA,1684306,1684306,1684112,194,0,utRho14
mcbR,3040192,3040524,3040192,332,0,utRho14
mcrA,2420278,2420692,2420278,414,0,utRho14
mcrC,9156124,9156124,9155916,208,292,utRho14
mdaB,6344814,6345060,6344814,246,0,utRho14
mdfA,1767138,1767346,1767138,208,0,utRho14
mdh,6768940,6768940,6768536,404,306,utRho14
mdoB,9198988,9198988,9198882,106,1806,utRho14
mdoD,2993290,2993712,2993290,422,76,utRho14
mdoG,2218514,2218670,2218514,156,0,utRho14
mdtA,4307958,4308032,4307958,74,0,utRho14
mdtE,7318168,7318464,7318168,296,60,utRho14
mdtK,3486538,3486914,3486538,376,154,utRho14
mdtP,8602472,8602472,8602060,412,6,utRho14
melA,8683774,8683822,8683774,48,0,utRho14
melR,8683300,8683300,8683256,44,172,utRho14
menA,8240812,8240812,8240698,114,46,utRho14
menB,4753774,4753774,4753638,136,590,utRho14
mepH,3468714,3468870,3468714,156,0,utRho14
mepM,3883666,3883666,3883270,396,332,utRho14
mepS,4539840,4539958,4539840,118,336,utRho14
metA,8428318,8428560,8428318,242,0,utRho14
metB,8257272,8257344,8257272,72,1852,utRho14
metC,6304150,6304472,6304150,322,28,utRho14
metE,8025768,8026106,8025768,338,596,utRho14
metF,8265092,8265232,8265092,140,36,utRho14
metG,4388538,4388600,4388538,62,84,utRho14
metH,8447010,8447656,8447010,646,3892,utRho14
metJ,8257116,8257116,8256790,326,168,utRho14
metK,6173154,6173412,6173154,258,452,utRho14
metN,445428,445428,445290,138,0,utRho14
metR,8025710,8025710,8025632,78,0,utRho14
metT,1394326,1394326,1394266,60,158,utRho14
metY,19910250,19910250,19909734,516,246,utRho14
metZ,11789528,11789548,11789528,20,0,utRho14
mfd,2348056,2348056,2347928,128,162,utRho14
mglA,4478782,4478782,4478578,204,2286,utRho14
mglB,4481132,4481132,4480696,436,47788,utRho14
mglC,4475918,4475918,4475506,412,1354,utRho14
mgrB,3817584,3817584,3817532,52,0,utRho14
mgrR,3245828,3245828,3245828,0,0,utRho14
mgsA,2054082,2054082,2054030,52,248,utRho14
mgtL,8934560,8934862,8934560,302,0,utRho14
mhpA,737038,737222,737038,184,0,utRho14
mhpR,737072,737072,736840,232,84,utRho14
mhpT,750772,750918,750772,146,0,utRho14
miaA,8797964,8798504,8797964,540,930,utRho14
micA,5629604,5629604,5629604,0,0,utRho14
micC,2874242,2874238,2874242,4,0,utRho14
micF,4626168,4626168,4626168,0,0,utRho14
micM,1014408,1014408,1014408,0,0,utRho14
minE,2449422,2449422,2449090,332,3116,utRho14
mioC,7852950,7852950,7852910,40,0,utRho14
mipA,3733012,3733012,3732944,68,4500,utRho14
mlaA,4930270,4930270,4930014,256,0,utRho14
mlc,3337206,3337206,3337128,78,0,utRho14
mlrA,4429498,4429732,4429498,234,0,utRho14
mltA,5894546,5894546,5894356,190,246,utRho14
mltD,468050,468050,467910,140,0,utRho14
mltF,5391534,5391602,5391534,68,0,utRho14
mmuP,550238,550650,550238,412,258,utRho14
mngA,1531622,1531968,1531622,346,0,utRho14
mngR,1531852,1531852,1531750,102,0,utRho14
mnmG,7851348,7851348,7851266,82,1098,utRho14
mntH,5025470,5025470,5025412,58,0,utRho14
mntP,3810918,3811376,3810918,458,462,utRho14
mntR,1706160,1706366,1706160,206,0,utRho14
mntS,1706128,1706128,1705994,134,0,utRho14
moaA,1633654,1634088,1633654,434,1326,utRho14
moaB,1635954,1636110,1635954,156,1820,utRho14
mobA,8084242,8084242,8083998,244,0,utRho14
mocA,6030112,6030320,6030112,208,434,utRho14
modA,1589990,1590178,1589990,188,0,utRho14
moeA,1732788,1732788,1732728,60,242,utRho14
mokB,2984610,2984610,2984258,352,694,utRho14
molR_1,4392888,4392948,4392888,60,0,utRho14
motA,3954604,3954604,3954278,326,244,utRho14
mpaA,2781278,2781278,2781196,82,110,utRho14
mpl,8911456,8911570,8911456,114,0,utRho14
mppA,2786108,2786454,2786108,346,0,utRho14
mprA,5621494,5621540,5621494,46,810,utRho14
mqo,4613848,4613848,4613508,340,94,utRho14
mqsA,6336742,6336742,6336492,250,436,utRho14
mqsR,6337306,6337306,6337088,218,756,utRho14
mraZ,179192,179268,179192,76,58,utRho14
mrcA,7045652,7045742,7045652,90,0,utRho14
mrcB,329442,329460,329442,18,0,utRho14
mreB,13605424,13605424,13604348,1076,1632,utRho14
mreD,6798166,6798166,6797750,416,266,utRho14
mrp,4388360,4388360,4388336,24,0,utRho14
mscK,972984,973072,972984,88,0,utRho14
mscL,6876002,6876048,6876002,46,2,utRho14
mscS,6139742,6139742,6139614,128,0,utRho14
msrA,8884522,8884522,8884352,170,648,utRho14
msrB,3725168,3725168,3724858,310,0,utRho14
msyB,2228426,2228426,2228362,64,0,utRho14
mtfA,4087236,4087302,4087236,66,5422,utRho14
mtgA,6699662,6699662,6699618,44,2,utRho14
mtlA,30177504,30178248,30177504,744,2312,utRho14
mtn,358366,358366,358306,60,0,utRho14
mtr,6611864,6611864,6611634,230,14,utRho14
mug,6430992,6430992,6430946,46,2,utRho14
murQ,5091466,5091546,5091466,80,0,utRho14
murR,5091586,5091586,5091218,368,0,utRho14
mutH,5939164,5939324,5939164,160,120,utRho14
mutL,8794092,8794824,8794092,732,912,utRho14
mutM,7622554,7622554,7622304,250,1076,utRho14
mutS,5714038,5714186,5714038,148,1562,utRho14
mutY,18617466,18618078,18617466,612,0,utRho14
nac,4123956,4123956,4123866,90,0,utRho14
nadA,1564122,1564170,1564122,48,0,utRho14
nadB,5420714,5420840,5420714,126,0,utRho14
nadC,237326,237326,237290,36,16,utRho14
nadE,3644604,3644916,3644604,312,108,utRho14
nadK,5501526,5501662,5501526,136,52,utRho14
nagA,1406350,1406350,1405502,848,23998,utRho14
nagB,1407416,1407416,1407222,194,214,utRho14
nagC,1404016,1404016,1403188,828,224,utRho14
nagE,1407680,1407888,1407680,208,0,utRho14
nagK,2357080,2357186,2357080,106,2,utRho14
nanA,6747240,6747240,6747152,88,604,utRho14
nanC,9079856,9079856,9079002,854,4406,utRho14
nanR,6749406,6749406,6748978,428,0,utRho14
nanS,9075406,9075406,9075188,218,840,utRho14
napF,4607390,4607390,4606994,396,0,utRho14
narG,2559614,2559728,2559614,114,134,utRho14
narK,2555642,2555914,2555642,272,0,utRho14
narP,4580844,4581000,4580844,156,36,utRho14
narQ,5171154,5171462,5171154,308,324,utRho14
narU,3088326,3088326,3088120,206,0,utRho14
narW,3077374,3077374,3074618,2756,168,utRho14
narX,2555554,2555554,2555236,318,0,utRho14
narZ,3085380,3085380,3085180,200,0,utRho14
ndh,2331984,2332170,2331984,186,0,utRho14
ndk,5289920,5289920,5289728,192,284,utRho14
nemR,6904084,6904092,6904084,8,0,utRho14
nepI,7683542,7683542,7683478,64,4,utRho14
nfo,4501612,4501680,4501612,68,108,utRho14
nfsB,1210906,1210906,1210848,58,0,utRho14
nfuA,7090916,7091248,7090916,332,1566,utRho14
nhaA,34634,34978,34634,344,164,utRho14
nhaB,2469534,2469534,2469434,100,4,utRho14
nhoA,3067926,3068048,3067926,122,0,utRho14
nikA,7226878,7227334,7226878,456,596,utRho14
nikR,7237074,7237176,7237074,102,634,utRho14
nirB,6987974,6988022,6987974,48,0,utRho14
nlpA,7680034,7680034,7679986,48,0,utRho14
nlpC,3585654,3585654,3585462,192,0,utRho14
nlpD,5737658,5737658,5737506,152,30,utRho14
nlpI,6618080,6618080,6617848,232,132,utRho14
nmpC,1153740,1153740,1153650,90,272,utRho14
nohA,3273206,3273206,3272734,472,2,utRho14
norR,5664614,5664614,5664578,36,0,utRho14
norV,5664878,5664952,5664878,74,0,utRho14
nrdA,4689510,4689730,4689510,220,17142,utRho14
nrdD,8925676,8925676,8925320,356,4634,utRho14
nrdH,5601312,5601446,5601312,134,630,utRho14
nrdR,865954,866004,865954,50,0,utRho14
nrfA,8575342,8575528,8575342,186,22,utRho14
nsrR,8812088,8812380,8812088,292,200,utRho14
nudB,3897348,3897348,3897264,84,0,utRho14
nudC,8393428,8393806,8393428,378,0,utRho14
nudE,7052658,7052658,7052298,360,346,utRho14
nudG,3682876,3682980,3682876,104,0,utRho14
nudI,4729050,4729108,4729050,58,0,utRho14
nudJ,2388874,2388874,2388576,298,1174,utRho14
nuoA,4810670,4810670,4810144,526,8354,utRho14
nuoN,4783434,4783434,4783010,424,3362,utRho14
nupC,5026018,5026084,5026018,66,0,utRho14
nupG,6211302,6211428,6211302,126,0,utRho14
ogrK,4335096,4335096,4335040,56,0,utRho14
ogt,2800568,2800568,2800472,96,0,utRho14
ohsC,5401036,5401040,5401036,4,0,utRho14
ompA,2040382,2040382,2040106,276,49126,utRho14
ompC,4625774,4625774,4625498,276,564,utRho14
ompF,1974184,1974184,1973964,220,1066,utRho14
ompL,8128958,8128958,8128590,368,0,utRho14
ompN,2874158,2874158,2873786,372,0,utRho14
ompR,7073510,7073510,7073168,342,0,utRho14
ompT,1171330,1171330,1171266,64,166,utRho14
ompW,2627982,2628040,2627982,58,2,utRho14
ompX,1700418,1700900,1700418,482,1508,utRho14
omrA,5952378,5952378,5952378,0,0,utRho14
omrB,5952770,5952770,5952770,0,0,utRho14
oppA,2602170,2602364,2602170,194,6814,utRho14
orn,8783168,8783208,8783168,40,0,utRho14
osmB,2686952,2686952,2686656,296,0,utRho14
osmC,3113192,3113250,3113192,58,392,utRho14
osmE,3644566,3644566,3644512,54,0,utRho14
osmF,4439046,4439046,4438962,84,758,utRho14
osmY,9222306,9222792,9222306,486,2,utRho14
otsA,3963302,3963302,3963224,78,0,utRho14
otsB,3964930,3964930,3964774,156,106,utRho14
oxc,4984288,4984288,4983900,388,52,utRho14
oxyR,8316914,8316980,8316914,66,2,utRho14
oxyS,8316788,8316788,8316788,0,0,utRho14
paaA,2907730,2907854,2907730,124,0,utRho14
paaX,2927018,2927078,2927018,60,86,utRho14
paaZ,2907340,2907340,2907284,56,0,utRho14
pabA,6981702,6981702,6981658,44,2,utRho14
pabB,3789256,3789610,3789256,354,198,utRho14
pabC,2306186,2306600,2306186,414,398,utRho14
pagP,1313052,1313114,1313052,62,0,utRho14
panB,299260,299260,299202,58,0,utRho14
panC,297840,297840,297590,250,384,utRho14
panD,293490,293490,293388,102,134,utRho14
panZ,7195656,7195968,7195656,312,92,utRho14
parC,6332060,6332060,6331946,114,462,utRho14
patA,6438916,6438988,6438916,72,0,utRho14
patD,3030830,3031156,3030830,326,0,utRho14
pbpC,5294986,5294986,5294650,336,150,utRho14
pbpG,4450132,4450132,4449740,392,318,utRho14
pck,7065358,7065636,7065358,278,7228,utRho14
pcnB,318782,318782,318252,530,948,utRho14
pdhR,244068,244184,244068,116,2,utRho14
pdxB,4875768,4875768,4875702,66,0,utRho14
pdxH,3436068,3436068,3436014,54,450,utRho14
pdxJ,5403626,5403626,5403458,168,4,utRho14
pdxK,5074638,5074638,5074474,164,0,utRho14
pepA,8972278,8972278,8971902,376,126,utRho14
pepD,511618,511618,511432,186,14074,utRho14
pepN,1981182,1981244,1981182,62,0,utRho14
pepQ,8062294,8062322,8062294,28,0,utRho14
pepT,2371646,2371688,2371646,42,68,utRho14
pfkA,8214948,8215104,8214948,156,396,utRho14
pfkB,3612646,3612740,3612646,94,0,utRho14
pflA,1902456,1902456,1902160,296,228,utRho14
pflB,1907850,1907850,1907108,742,1234,utRho14
pflD,8287716,8287990,8287716,274,0,utRho14
pgaA,2185046,2185046,2184578,468,0,utRho14
pgi,8467444,8467516,8467444,72,58,utRho14
pgk,12291428,12291428,12290488,940,5480,utRho14
pgl,1597078,1597172,1597078,94,156,utRho14
pgpB,2678324,2678660,2678324,336,0,utRho14
pgpC,5397276,5397276,5397100,176,0,utRho14
pgrR,2783744,2783982,2783744,238,0,utRho14
pheL,5475158,5475198,5475158,40,0,utRho14
pheM,7197204,7197204,7197080,124,0,utRho14
pheP,1203858,1203918,1203858,60,0,utRho14
pheU,8725254,8725254,8725252,2,0,utRho14
pheV,6220730,6220732,6220730,2,0,utRho14
phnC,8650412,8650412,8650330,82,0,utRho14
phoA,803414,803494,803414,80,264,utRho14
phoB,834202,834284,834202,82,0,utRho14
phoE,520316,520316,520200,116,0,utRho14
phoH,2169730,2169984,2169730,254,198,utRho14
phoP,2381016,2381016,2380894,122,3054,utRho14
phoQ,2379880,2379880,2379552,328,872,utRho14
phoU,7815330,7815330,7815156,174,172,utRho14
phr,1478842,1479014,1478842,172,0,utRho14
pinE,2419054,2419370,2419054,316,182,utRho14
pinQ,3267168,3267244,3267168,76,2,utRho14
pinR,2867424,2867424,2867348,76,4,utRho14
pitA,7275224,7275284,7275224,60,0,utRho14
pitB,6272806,6272806,6272742,64,0,utRho14
pka,5439862,5439906,5439862,44,0,utRho14
plaP,4174476,4174476,4174124,352,0,utRho14
pldA,8009628,8009724,8009628,96,2,utRho14
pldB,8018028,8018340,8018028,312,62,utRho14
plsB,8513196,8513196,8512932,264,806,utRho14
pmbA,8915890,8915918,8915890,28,0,utRho14
pmrD,4747148,4747148,4747076,72,0,utRho14
pncB,1980828,1980828,1980712,116,2,utRho14
pncC,5648788,5648788,5648692,96,0,utRho14
pnp,6622652,6622652,6622336,316,42,utRho14
pntA,3355950,3355950,3355806,144,0,utRho14
pntB,3353096,3353096,3352720,376,400,utRho14
polA,8093880,8093932,8093880,52,2,utRho14
polB,131606,131606,131560,46,0,utRho14
potD,2365700,2365700,2365658,42,82,utRho14
potE,1436688,1436688,1436530,158,0,utRho14
potF,1787268,1787568,1787268,300,2,utRho14
poxB,1822152,1822152,1822098,54,0,utRho14
ppa,8899372,8899372,8899304,68,134,utRho14
ppc,8306380,8306380,8306196,184,634,utRho14
ppdA,5928440,5928440,5928354,86,74,utRho14
ppdD,235410,235410,235098,312,0,utRho14
pphA,3846770,3846770,3845938,832,2350,utRho14
pphB,5719474,5719520,5719474,46,0,utRho14
ppiA,6984898,6984898,6984594,304,100,utRho14
ppiC,7919682,7919682,7919626,56,0,utRho14
ppiD,923638,923830,923638,192,66,utRho14
ppk,5245748,5246088,5245748,340,210,utRho14
pppA,6228958,6228958,6228704,254,0,utRho14
ppsA,3574322,3574322,3574224,98,0,utRho14
ppsR,3574678,3574890,3574678,212,0,utRho14
pptA,3065716,3066104,3065716,388,0,utRho14
pqiA,2023318,2024002,2023318,684,16,utRho14
prc,3830054,3830054,3829632,422,27662,utRho14
preT,4467978,4468066,4467978,88,0,utRho14
prfC,9218688,9218828,9218688,140,914,utRho14
prkB,6968622,6968980,6968622,358,1066,utRho14
prlC,7290476,7290476,7290364,112,164,utRho14
prlF,6553944,6554004,6553944,60,0,utRho14
proB,520432,520776,520432,344,134,utRho14
proC,811372,811372,811288,84,0,utRho14
proK,7417388,7417388,7417384,4,0,utRho14
proL,4572414,4572422,4572414,8,0,utRho14
proP,8660640,8661004,8660640,364,216,utRho14
proS,437674,437674,437550,124,912,utRho14
proV,5609126,5609630,5609126,504,66,utRho14
prpB,697292,697364,697292,72,0,utRho14
prpR,696942,696942,696886,56,132,utRho14
prs,2524354,2524354,2523750,604,115304,utRho14
psd,8781276,8781276,8780720,556,2750,utRho14
psiE,8480600,8480650,8480600,50,0,utRho14
pspA,2736076,2736158,2736076,82,0,utRho14
pspF,2736080,2736080,2735824,256,0,utRho14
pspG,8525632,8525680,8525632,48,0,utRho14
pssA,5445156,5445454,5445156,298,7328,utRho14
pstB,7817112,7817112,7816732,380,160,utRho14
pstC,7821084,7821084,7820796,288,244,utRho14
pstS,23469408,23469408,23469150,258,6,utRho14
psuG,4517114,4517114,4516734,380,2978,utRho14
psuT,4514992,4514992,4514670,322,0,utRho14
pth,2517084,2517084,2517026,58,0,utRho14
ptrA,5918022,5918022,5917768,254,0,utRho14
ptrB,3857730,3857730,3857678,52,388,utRho14
ptsG,2315252,2315738,2315252,486,1938,utRho14
ptsH,5066996,5067528,5066996,532,7868,utRho14
purA,8809328,8809374,8809328,46,0,utRho14
purC,5195562,5195562,5195236,326,0,utRho14
purD,8411972,8411972,8411862,110,0,utRho14
purE,1106284,1106284,1106200,84,212,utRho14
purH,8415254,8415254,8415064,190,0,utRho14
purL,5391178,5391178,5391086,92,1740,utRho14
purM,5242306,5242394,5242306,88,42,utRho14
purR,3475378,3475688,3475378,310,724,utRho14
purT,3861438,3861762,3861438,324,46,utRho14
purU,2577512,2577512,2577248,264,362,utRho14
putA,2157850,2157850,2157764,86,0,utRho14
putP,2158336,2158610,2158336,274,1520,utRho14
puuA,2721936,2721936,2721816,120,0,utRho14
puuC,2725456,2725486,2725456,30,0,utRho14
puuD,2722104,2722240,2722104,136,0,utRho14
puuP,2718746,2718746,2718374,372,548,utRho14
pykA,3874988,3875298,3874988,310,566,utRho14
pykF,3510934,3511396,3510934,462,930,utRho14
pyrC,2245286,2245286,2245214,72,98,utRho14
pyrD,2009464,2009536,2009464,72,104,utRho14
pyrE,7631970,7631970,7631536,434,0,utRho14
pyrF,2683740,2683842,2683740,102,396,utRho14
pyrG,5819594,5819594,5819332,262,476,utRho14
pyrH,383624,383710,383624,86,1294,utRho14
pyrL,8945490,8945490,8945066,424,78,utRho14
qmcA,1031646,1031646,1031546,100,0,utRho14
qor,8528608,8528608,8528462,146,82,utRho14
qseB,6339502,6339656,6339502,154,2,utRho14
queA,849970,850022,849970,52,132,utRho14
queE,5811212,5811212,5810836,376,0,utRho14
queF,5850642,5850696,5850642,54,0,utRho14
queG,8788184,8788184,8788134,50,2300,utRho14
racC,2835630,2835630,2835526,104,0,utRho14
racR,2840898,2840898,2840482,416,0,utRho14
raiA,5474208,5474308,5474208,100,12,utRho14
rarD,8008594,8008594,8008356,238,194,utRho14
ravA,7862256,7862256,7862186,70,0,utRho14
rayT,495088,495274,495088,186,4,utRho14
rbn,4763162,4763216,4763162,54,0,utRho14
rbsD,7866644,7866702,7866644,58,138,utRho14
rcnA,4371654,4371834,4371654,180,0,utRho14
rcnB,4373768,4373920,4373768,152,108,utRho14
rcnR,4371806,4371806,4371592,214,0,utRho14
rcsA,4047672,4047936,4047672,264,0,utRho14
rcsB,4631390,4632354,4631390,964,2116,utRho14
rcsC,4640162,4640162,4639656,506,972,utRho14
rcsD,4626904,4626976,4626904,72,0,utRho14
rdgB,6193240,6193362,6193240,122,850,utRho14
rdlA,2538646,2538646,2538646,0,0,utRho14
rdlB,2539712,2539716,2539712,4,0,utRho14
rdlC,2540782,2540786,2540782,4,0,utRho14
rdlD,7400272,7400272,7400272,0,0,utRho14
rdoA,8084782,8084830,8084782,48,212,utRho14
recA,11295276,11295276,11295076,200,352,utRho14
recC,5925014,5925014,5924856,158,120,utRho14
recF,7763722,7763722,7762442,1280,5544,utRho14
recN,5503518,5503590,5503518,72,0,utRho14
recQ,8011666,8011728,8011666,62,0,utRho14
relA,5828554,5828554,5827302,1252,330,utRho14
relB,3291806,3291806,3291744,62,2,utRho14
rem,3289950,3289950,3289804,146,0,utRho14
rep,7921294,7921354,7921294,60,196,utRho14
rfaD,7587730,7587974,7587730,244,66,utRho14
rfaE,6393852,6393852,6393506,346,0,utRho14
rfaH,8049930,8049930,8049642,288,964,utRho14
rfbX,4219436,4219436,4219168,268,1192,utRho14
rfe,7935600,7935832,7935600,232,2,utRho14
rhaB,8194944,8194944,8194896,48,0,utRho14
rhaD,8188770,8188770,8188544,226,0,utRho14
rhaS,8195422,8195472,8195422,50,0,utRho14
rhaT,8201132,8201132,8201050,82,0,utRho14
rhlE,1661566,1661744,1661566,178,6,utRho14
rhoL,47593944,47594772,47593944,828,36756,utRho14
rhsB,7238006,7238384,7238006,378,110,utRho14
rhsC,1458758,1459166,1458758,408,0,utRho14
rhsD,1046132,1046522,1046132,390,0,utRho14
rhtA,1700608,1700608,1700194,414,0,utRho14
rhtC,8015478,8015514,8015478,36,1594,utRho14
ribA,2678468,2678468,2678320,148,0,utRho14
ribC,3486916,3486916,3486484,432,154,utRho14
ribE,869008,869294,869008,286,12812,utRho14
ribF,42766,42814,42766,48,144,utRho14
ridA,8941892,8941892,8941826,66,132,utRho14
rihA,1369204,1369204,1368824,380,2,utRho14
rihB,4510504,4510504,4510372,132,0,utRho14
rimJ,2251044,2251124,2251044,80,0,utRho14
rimK,1783752,1783934,1783752,182,1172,utRho14
rimL,2997486,2997876,2997486,390,438,utRho14
rimO,1756140,1756140,1756070,70,0,utRho14
rimP,6636350,6636350,6636012,338,550,utRho14
rlmA,3814172,3814172,3814120,52,350,utRho14
rlmD,5830086,5830086,5830000,86,26,utRho14
rlmE,6655520,6655520,6655328,192,706,utRho14
rlmF,1684384,1684664,1684384,280,0,utRho14
rlmG,6471784,6471784,6471750,34,0,utRho14
rlmI,2060002,2060002,2059938,64,188,utRho14
rlmJ,7290700,7290770,7290700,70,2,utRho14
rlmL,2015344,2015688,2015344,344,1434,utRho14
rlpA,1330444,1330444,1330380,64,166,utRho14
rluA,120900,120900,120692,208,64,utRho14
rluF,8460324,8460708,8460324,384,0,utRho14
rmf,2031006,2031430,2031006,424,4,utRho14
rna,1290068,1290068,1290006,62,0,utRho14
rnb,2698258,2698258,2697824,434,3306,utRho14
rnc,10816892,10816892,10816252,640,5720,utRho14
rnd,3776122,3776122,3775982,140,178,utRho14
rne,2289746,2289746,2288734,1012,13394,utRho14
rnhA,472082,472082,472004,78,398,utRho14
rnk,1288360,1288360,1287934,426,204,utRho14
rnlA,5531788,5531836,5531788,48,104,utRho14
rnlB,5533414,5533968,5533414,554,332,utRho14
rnpB,19623552,19623552,19623552,0,0,utRho14
rob,9270706,9270706,9270620,86,0,utRho14
rodZ,5285868,5285868,5285688,180,6,utRho14
rpe,7030306,7030306,7030118,188,422,utRho14
rph,15266320,15266320,15266196,124,192,utRho14
rpiA,6118706,6118706,6118650,56,0,utRho14
rpiB,8626514,8626700,8626514,186,0,utRho14
rpiR,8626274,8626274,8625982,292,0,utRho14
rplJ,8359246,8359992,8359246,746,9116,utRho14
rplK,8356708,8356894,8356708,186,1024,utRho14
rplM,6757344,6757344,6757302,42,12876,utRho14
rplN,6896444,6896444,6896298,146,8622,utRho14
rplS,5489284,5489284,5489060,224,12012,utRho14
rplT,7199052,7199052,7198996,56,1652,utRho14
rplU,6667036,6667036,6666902,134,90,utRho14
rplY,4564866,4565034,4564866,168,28,utRho14
rpmA,6666450,6666450,6666238,212,772,utRho14
rpmB,15247980,15247980,15246696,1284,109900,utRho14
rpmE,8253816,8254026,8253816,210,340,utRho14
rpmF,2294676,2294734,2294676,58,46420,utRho14
rpmH,7768130,7768672,7768130,542,6114,utRho14
rpmI,3600854,3600854,3599998,856,15364,utRho14
rpoB,8362126,8362490,8362126,364,64,utRho14
rpoD,6424946,6426094,6424946,1148,24774,utRho14
rpoE,5420372,5420372,5420024,348,4,utRho14
rpoH,7202006,7202006,7201566,440,3138,utRho14
rpoN,6689324,6689434,6689324,110,216,utRho14
rpoS,5736236,5736236,5735102,1134,7232,utRho14
rpoZ,7644154,7644212,7644154,58,754,utRho14
rppH,5937986,5937986,5937954,32,0,utRho14
rprA,3540744,3540744,3540744,0,0,utRho14
rpsA,1923434,1923990,1923434,556,150478,utRho14
rpsF,8850050,8850236,8850050,186,30536,utRho14
rpsI,6756580,6756580,6756414,166,9800,utRho14
rpsJ,6906884,6906884,6906540,344,10054,utRho14
rpsL,6949242,6949242,6949104,138,964,utRho14
rpsM,6885130,6885130,6884942,188,1428,utRho14
rpsO,13247144,13247144,13246736,408,1004,utRho14
rpsP,5492508,5492508,5492370,138,320,utRho14
rpsT,42420,42420,42156,264,732,utRho14
rpsU,12842584,12843124,12842584,540,3192,utRho14
rraA,8238716,8238716,8238660,56,148,utRho14
rraB,8956768,8956946,8956768,178,0,utRho14
rrsA,8070478,8071062,8070478,584,11684,utRho14
rrsB,16665468,16666636,16665468,1168,24848,utRho14
rrsC,7883032,7883616,7883032,584,10594,utRho14
rrsD,6858094,6858094,6857524,570,752,utRho14
rrsE,8415726,8416294,8415726,568,1932,utRho14
rrsG,5462896,5462896,5462314,582,10350,utRho14
rrsH,446970,447542,446970,572,1742,utRho14
rsd,8393908,8393908,8393616,292,0,utRho14
rseA,5419264,5419264,5418808,456,90,utRho14
rseP,392940,393092,392940,152,132,utRho14
rseX,4067298,4067298,4067298,0,0,utRho14
rsfS,1338144,1338144,1338072,72,336,utRho14
rsgA,8783132,8783132,8783018,114,82,utRho14
rsmA,105176,105176,104860,316,3324,utRho14
rsmB,6869982,6870414,6869982,432,1328,utRho14
rsmC,9215736,9215736,9215400,336,366,utRho14
rsmD,7208594,7208786,7208594,192,232,utRho14
rsmE,6182036,6182268,6182036,232,700,utRho14
rsmG,7847512,7847512,7847360,152,156,utRho14
rsmH,180020,180188,180020,168,210,utRho14
rsmI,6587106,6587106,6586670,436,1768,utRho14
rssA,2578212,2578412,2578212,200,520,utRho14
rssB,2580440,2580484,2580440,44,88,utRho14
rstA,3364276,3364300,3364276,24,0,utRho14
rsuA,4561096,4561096,4560966,130,86,utRho14
rsxA,3411510,3411534,3411510,24,46,utRho14
rtcA,7114004,7114004,7113698,306,6,utRho14
rtcB,7116214,7116214,7116158,56,0,utRho14
rtn,4541356,4541452,4541356,96,0,utRho14
rutA,2148052,2148052,2148022,30,0,utRho14
rutG,2140090,2140090,2139678,412,0,utRho14
rutR,2148226,2148484,2148226,258,4,utRho14
ruvA,7784096,7784096,7783904,192,0,utRho14
ruvB,7782176,7782176,7781424,752,1604,utRho14
ruvC,3894878,3894878,3894752,126,0,utRho14
rybB,1776114,1776114,1776114,0,0,utRho14
rydB,3529860,3529860,3529322,538,116,utRho14
rydC,2983012,2983012,2983012,0,0,utRho14
ryfA,5307398,5307710,5307398,312,0,utRho14
ryfD,5468590,5468590,5468590,0,0,utRho14
ryhB,7162032,7162032,7162032,0,0,utRho14
ryjA,8556132,8556132,8556132,0,0,utRho14
ryjB,9055954,9055954,9055954,0,0,utRho14
sad,3229598,3229598,3229406,192,0,utRho14
safA,3168056,3168056,3167918,138,2,utRho14
sanA,4465368,4465756,4465368,388,384,utRho14
sapF,2705314,2705314,2705268,46,0,utRho14
sbcB,4165456,4165512,4165456,56,62,utRho14
sbcC,831694,831694,831506,188,330,utRho14
sbcD,833954,833954,833904,50,6,utRho14
sbmA,793106,793278,793106,172,4,utRho14
sbmC,4162650,4162650,4162524,126,0,utRho14
sdaA,3793618,3793864,3793618,246,308,utRho14
sdaC,5856070,5856458,5856070,388,1720,utRho14
sdhC,1509916,1510354,1509916,438,124558,utRho14
sdhD,1510808,1511120,1510808,312,35108,utRho14
sdiA,3993834,3993834,3993664,170,208,utRho14
secE,8354354,8354716,8354354,362,4,utRho14
secG,6645180,6645180,6645010,170,1176,utRho14
selA,7522594,7522594,7522498,96,546,utRho14
selB,7519850,7519850,7519722,128,82,utRho14
selC,7672396,7672444,7672396,48,110,utRho14
selD,3696058,3696058,3696016,42,2438,utRho14
seqA,1425884,1425974,1425884,90,1188,utRho14
serA,6117098,6117098,6116820,278,0,utRho14
serB,9249712,9249790,9249712,78,152,utRho14
serC,3830380,3830612,3830380,232,0,utRho14
serS,1878730,1878856,1878730,126,930,utRho14
serT,2063438,2063438,2063424,14,0,utRho14
serU,4087124,4087124,4087114,10,656,utRho14
serV,5637394,5637394,5637290,104,2,utRho14
serW,1852014,1852014,1851942,72,192,utRho14
serX,2195352,2195352,2195304,48,0,utRho14
setB,4527426,4527726,4527426,300,0,utRho14
setC,7673488,7673906,7673488,418,0,utRho14
sfmA,1116124,1116424,1116124,300,0,utRho14
sfmC,1117606,1117948,1117606,342,0,utRho14
sfsA,323030,323030,322972,58,1290,utRho14
sfsB,6669592,6669818,6669592,226,70,utRho14
sgrR,154676,154676,154598,78,12,utRho14
sgrS,154734,154734,154734,0,0,utRho14
shiA,4107068,4107286,4107068,218,0,utRho14
sibA,4306622,4306622,4306622,0,0,utRho14
sibB,4307292,4307292,4307292,0,0,utRho14
sibC,6113702,6113702,6113702,0,0,utRho14
sibD,6389730,6389730,6389730,0,0,utRho14
sibE,6390480,6390480,6390480,0,0,utRho14
sixA,4913998,4913998,4913624,374,424,utRho14
slp,7307872,7307922,7307872,50,0,utRho14
slt,9261400,9261466,9261400,66,0,utRho14
slyA,3442028,3442028,3441648,380,146,utRho14
slyB,3439496,3439752,3439496,256,0,utRho14
slyD,6957398,6957398,6956994,404,982,utRho14
slyX,6954862,6955280,6954862,418,11148,utRho14
smf,6867372,6867372,6867120,252,138,utRho14
smpB,5509534,5509792,5509534,258,756,utRho14
smrA,2811872,2811958,2811872,86,2,utRho14
smrB,4896872,4897212,4896872,340,316,utRho14
smtA,1946808,1947074,1946808,266,64,utRho14
sodA,8201518,8201620,8201518,102,20394,utRho14
sodB,3470646,3470756,3470646,110,0,utRho14
sodC,3449358,3449358,3449310,48,128,utRho14
sohB,2658568,2658664,2658568,96,0,utRho14
sokB,2984232,2984238,2984232,6,274,utRho14
solA,2241218,2241218,2241172,46,0,utRho14
soxR,8554894,8554938,8554894,44,60,utRho14
soxS,8554846,8554846,8554766,80,0,utRho14
speA,6172096,6172096,6171822,274,54,utRho14
speB,6167892,6167892,6167594,298,212,utRho14
speC,6218350,6218350,6218310,40,0,utRho14
spf,8099798,8099798,8099798,0,0,utRho14
sppA,3697422,3697674,3697422,252,2,utRho14
spy,3651376,3651376,3651250,126,0,utRho14
sra,3112092,3112092,3111926,166,2,utRho14
sraB,2293178,2293178,2293178,0,0,utRho14
sraC,3846132,3846132,3846132,0,0,utRho14
srlA,5651582,5651664,5651582,82,0,utRho14
srlR,5657720,5658094,5657720,374,5510,utRho14
srmB,5425752,5425792,5425752,40,286,utRho14
sroA,151216,151216,151216,0,0,utRho14
sroG,6369436,6369436,6369436,0,0,utRho14
sroH,8380974,8380974,8380974,0,0,utRho14
ssb,8548022,8548250,8548022,228,0,utRho14
sseA,5304782,5304988,5304782,206,30334,utRho14
sspA,6755138,6755138,6754840,298,1546,utRho14
ssrA,5511014,5511186,5511014,172,10,utRho14
ssrS,12223036,12223932,12223036,896,2256,utRho14
sstT,6479726,6479888,6479726,162,0,utRho14
ssuB,1988282,1988282,1988088,194,2,utRho14
ssuE,1995126,1995126,1995024,102,0,utRho14
sthA,8321604,8321604,8321580,24,6328,utRho14
stpA,5597156,5597156,5596990,166,0,utRho14
sucA,3034344,3034824,3034344,480,13184,utRho14
sufA,3528836,3528836,3528772,64,54,utRho14
sufE,3518962,3518962,3518580,382,110,utRho14
sugE,8753588,8753750,8753588,162,216,utRho14
sulA,2041894,2041894,2041838,56,84,utRho14
syd,5850738,5850738,5850560,178,88,utRho14
symE,9159834,9159834,9159680,154,70,utRho14
symR,9159670,9159670,9159670,0,0,utRho14
tabA,8949566,8949724,8949566,158,0,utRho14
talA,5157140,5157332,5157140,192,0,utRho14
talB,16382,16476,16382,94,19482,utRho14
tam,3214442,3214692,3214442,250,180,utRho14
tamA,8884540,8884764,8884540,224,100,utRho14
tar,3945432,3945432,3945382,50,0,utRho14
tas,5943138,5943194,5943138,56,368,utRho14
tatA,16087636,16087780,16087636,144,336,utRho14
tatE,1317742,1317894,1317742,152,0,utRho14
tauA,770410,770464,770410,54,0,utRho14
tdcA,6534186,6534186,6534130,56,0,utRho14
tdcG,6519652,6519652,6519298,354,460,utRho14
tdcR,6534380,6534760,6534380,380,0,utRho14
tdk,2586986,2587054,2586986,68,0,utRho14
tehA,3001072,3001146,3001072,74,76,utRho14
tesA,1039898,1039898,1039530,368,852,utRho14
tesB,950402,950402,950322,80,0,utRho14
tfaE,2418532,2418532,2418238,294,0,utRho14
tfaQ,3269912,3269912,3269770,142,0,utRho14
tff,379424,379256,379424,168,0,utRho14
tgt,852110,852274,852110,164,0,utRho14
thiD,4369346,4369346,4369032,314,0,utRho14
thiI,882936,883098,882936,162,142,utRho14
thiM,4370902,4370902,4370602,300,410,utRho14
thiQ,146170,146170,145854,316,184,utRho14
thrL,592,760,592,168,192,utRho14
thrS,7210932,7210932,7210280,652,1188,utRho14
thrU,8350762,8350776,8350762,14,68,utRho14
thrV,6847414,6847414,6847310,104,211290,utRho14
thrW,525682,525742,525682,60,2,utRho14
thyA,5930696,5930696,5930310,386,3126,utRho14
tig,909986,910266,909986,280,1664,utRho14
tisB,7706674,7707106,7706674,432,612,utRho14
tktA,6163414,6163414,6163270,144,820,utRho14
tktB,5158616,5159272,5158616,656,2556,utRho14
tldD,6784368,6784368,6784056,312,0,utRho14
tmcA,5191876,5191876,5191718,158,0,utRho14
tnaC,15553644,15553740,15553644,96,10368,utRho14
tolB,1555074,1555480,1555074,406,2,utRho14
tolC,6356008,6356230,6356008,222,454,utRho14
tomB,961588,961588,961416,172,224,utRho14
tonB,2622108,2622178,2622108,70,0,utRho14
topA,2661578,2662096,2661578,518,124,utRho14
torC,2116112,2116168,2116112,56,152,utRho14
torR,2115968,2115968,2115908,60,158,utRho14
torS,2112364,2112364,2112356,8,0,utRho14
torT,2112414,2112522,2112414,108,0,utRho14
tpiA,8223138,8223138,8223014,124,456,utRho14
tppB,3425342,3425538,3425342,196,6088,utRho14
tpr,2574376,2574376,2574376,0,0,utRho14
tpx,2777688,2777688,2777622,66,144,utRho14
tqsA,3347780,3347826,3347780,46,0,utRho14
treA,2494850,2494850,2494752,98,148,utRho14
treB,8932420,8932420,8932360,60,230,utRho14
treF,7339102,7339184,7339102,82,304,utRho14
treR,8934694,8934694,8934492,202,0,utRho14
trg,2984878,2984940,2984878,62,0,utRho14
trkG,2847342,2847564,2847342,222,4,utRho14
trmA,8326590,8326590,8326540,50,0,utRho14
trpA,2634678,2634678,2634444,234,1024,utRho14
trpC,2639888,2639888,2639570,318,0,utRho14
trpL,5292432,5292432,5292328,104,0,utRho14
trpR,9265408,9265520,9265408,112,310,utRho14
trpS,7027394,7027394,7027276,118,2978,utRho14
trpT,7893560,7893914,7893560,354,134358,utRho14
trxA,7931294,7931522,7931294,228,264,utRho14
trxB,1864156,1864156,1864100,56,0,utRho14
trxC,5437350,5437470,5437350,120,340,utRho14
tsaD,6421256,6421256,6421086,170,0,utRho14
tsgA,6985038,6985136,6985038,98,0,utRho14
tsr,9182824,9183314,9182824,490,280,utRho14
tsx,864490,864490,864026,464,1862,utRho14
ttcA,2823970,2823970,2823896,74,3374,utRho14
ttdA,6412848,6412926,6412848,78,0,utRho14
ttdR,6412760,6412760,6412512,248,0,utRho14
tufA,6943448,6943448,6942658,790,275124,utRho14
tus,3368346,3368518,3368346,172,128,utRho14
tusA,7218040,7218040,7217992,48,106,utRho14
tusB,6950218,6950218,6949930,288,852,utRho14
tynA,2902996,2902996,2902698,298,0,utRho14
typA,8116460,8116814,8116460,354,4886,utRho14
tyrB,8534164,8534228,8534164,64,5238,utRho14
tyrP,3979004,3979362,3979004,358,0,utRho14
tyrR,2773384,2773440,2773384,56,0,utRho14
tyrS,3434566,3434566,3434444,122,0,utRho14
tyrT,2575330,2575330,2575244,86,136,utRho14
uacT,6062378,6062734,6062378,356,132,utRho14
ubiC,8504886,8505012,8504886,126,0,utRho14
ubiD,8049618,8049976,8049618,358,1058,utRho14
ubiE,8037494,8037710,8037494,216,460,utRho14
ubiG,4679078,4679134,4679078,56,0,utRho14
ucpA,5089342,5089342,5089246,96,76,utRho14
udp,8032782,8032862,8032782,80,0,utRho14
ugd,4199470,4199470,4199226,244,0,utRho14
ugpB,7184852,7184852,7184650,202,272,utRho14
ugpQ,7176600,7176600,7176226,374,36,utRho14
uhpT,7694396,7694396,7694334,62,0,utRho14
uidA,3392304,3392304,3392142,162,0,utRho14
uidC,3386012,3386012,3385702,310,0,utRho14
uidR,3394150,3394150,3394104,46,108,utRho14
ulaA,8839854,8839960,8839854,106,0,utRho14
ulaG,8839350,8839350,8839250,100,0,utRho14
ulaR,8837124,8837124,8836906,218,74,utRho14
umpG,5741372,5741372,5740548,824,528,utRho14
umpH,1400704,1400704,1400652,52,84,utRho14
umuD,2461476,2461534,2461476,58,0,utRho14
ung,5433476,5433508,5433476,32,0,utRho14
uof,2843316,2843316,2842900,416,6472,utRho14
upp,5241818,5241818,5241744,74,736,utRho14
usg,4873780,4873780,4873298,482,580,utRho14
ushA,1009772,1009828,1009772,56,0,utRho14
uspA,7279966,7280222,7279966,256,1826,utRho14
uspB,7279696,7279696,7279440,256,70,utRho14
uspC,3959172,3959506,3959172,334,0,utRho14
uspE,2797318,2797318,2797244,74,0,utRho14
uspF,2871282,2871282,2871238,44,0,utRho14
uspG,1283806,1283806,1283734,72,154,utRho14
uvrA,8547872,8547872,8547742,130,16,utRho14
uvrB,1626304,1627052,1626304,748,1888,utRho14
uvrC,3989758,3989758,3989412,346,126,utRho14
uvrD,7995814,7995966,7995814,152,208,utRho14
uvrY,3990812,3990812,3990718,94,0,utRho14
uxaB,3221474,3221474,3221360,114,0,utRho14
uxaC,6489714,6489714,6489482,232,0,utRho14
uxuA,9103036,9103272,9103036,236,1230,utRho14
uxuR,9108916,9109152,9108916,236,96,utRho14
valS,8967854,8967854,8967674,180,1276,utRho14
valU,5041848,5041862,5041848,14,0,utRho14
valV,3492830,3492870,3492830,40,0,utRho14
ves,3649968,3649968,3649874,94,0,utRho14
waaA,7616512,7617080,7616512,568,346,utRho14
waaH,7580298,7580298,7580162,136,0,utRho14
waaQ,7616476,7616476,7616196,280,108,utRho14
waaU,7598996,7598996,7598624,372,42,utRho14
waaY,7602272,7602272,7601930,342,3426,utRho14
wbbH,4214888,4214888,4214452,436,1686,utRho14
wbbK,4209212,4209212,4209018,194,318,utRho14
wcaM,4231868,4231868,4231792,76,0,utRho14
wrbA,2135516,2135516,2135416,100,0,utRho14
wza,4275166,4275166,4274486,680,0,utRho14
wzxC,4240674,4240674,4240316,358,0,utRho14
wzzB,4196950,4196950,4196602,348,0,utRho14
xanP,7657642,7657890,7657642,248,0,utRho14
xanQ,6048520,6048702,6048520,182,0,utRho14
xapA,5049820,5049820,5049756,64,0,utRho14
xapR,10090252,10090252,10089908,344,0,utRho14
xdhA,6000514,6000690,6000514,176,68,utRho14
xerD,6079702,6079702,6079486,216,0,utRho14
xseA,5268394,5268464,5268394,70,0,utRho14
xseB,882746,882746,882686,60,522,utRho14
xthA,3664798,3664856,3664798,58,0,utRho14
xylA,7461614,7461614,7461530,84,1218,utRho14
xylE,8484540,8484540,8484508,32,0,utRho14
xylF,7462138,7462262,7462138,124,292,utRho14
xylR,7469812,7469958,7469812,146,0,utRho14
yaaA,13230,13230,12918,312,62,utRho14
yaaI,23876,23876,23572,304,0,utRho14
yaaJ,16034,16034,15918,116,0,utRho14
yaaU,91184,91614,91184,430,0,utRho14
yaaW,23084,23084,22712,372,0,utRho14
yaaX,10060,10468,10060,408,72,utRho14
yabI,142542,142702,142542,160,292,utRho14
yacC,273880,273880,273834,46,1096,utRho14
yacH,262932,262932,262520,412,0,utRho14
yacL,268678,268776,268678,98,0,utRho14
yadD,293796,293936,293796,140,0,utRho14
yadE,289930,290162,289930,232,322,utRho14
yadN,314110,314110,313766,344,0,utRho14
yadS,355572,355572,355248,324,348,utRho14
yadV,312470,312470,312402,68,54,utRho14
yaeF,434270,434270,434006,264,0,utRho14
yaeP,428374,428374,428250,124,0,utRho14
yaeQ,428176,428582,428176,406,0,utRho14
yaeR,423716,423754,423716,38,42,utRho14
yafC,462166,462166,461762,404,50,utRho14
yafD,462128,462244,462128,116,50,utRho14
yafK,491986,491986,491610,376,502,utRho14
yafL,493282,493424,493282,142,72,utRho14
yafN,503938,504010,503938,72,0,utRho14
yafS,469568,469632,469568,64,936,utRho14
yafT,474470,474670,474470,200,0,utRho14
yafV,480432,480432,480378,54,0,utRho14
yafZ,536052,536052,536010,42,0,utRho14
yagE,564446,564556,564446,110,0,utRho14
yagG,570414,570790,570414,376,0,utRho14
yagI,578384,578384,578324,60,0,utRho14
yagK,586236,586236,585896,340,0,utRho14
yagL,588062,588062,587836,226,0,utRho14
yagN,591342,591342,591158,184,882,utRho14
yahA,663746,664742,663746,996,2,utRho14
yahC,670136,670136,670044,92,0,utRho14
yahE,671478,671850,671478,372,0,utRho14
yahM,690504,690808,690504,304,0,utRho14
yahN,692872,692872,692674,198,2,utRho14
yahO,692864,692968,692864,104,0,utRho14
yaiE,816296,816354,816296,58,46,utRho14
yaiI,811396,811528,811396,132,0,utRho14
yaiO,761946,761946,761684,262,0,utRho14
yaiP,767970,767970,767870,100,0,utRho14
yaiS,769660,769660,769232,428,0,utRho14
yaiV,788922,788922,788922,0,0,utRho14
yaiY,799094,799094,798666,428,2,utRho14
yaiZ,798888,799186,798888,298,2,utRho14
yajC,854410,854574,854410,164,1206,utRho14
yajD,860938,861210,860938,272,768,utRho14
yajI,866068,866068,865702,366,324,utRho14
yajL,887496,887496,887282,214,802,utRho14
yajQ,889316,889366,889316,50,0,utRho14
yajR,893374,893374,893332,42,0,utRho14
ybaB,987418,988152,987418,734,2740,utRho14
ybaL,1006590,1006590,1006476,114,2,utRho14
ybaM,980648,980648,980542,106,238,utRho14
ybaN,981436,981764,981436,328,1208,utRho14
ybaO,936704,936766,936704,62,0,utRho14
ybaP,1016568,1016568,1016160,408,1100,utRho14
ybaQ,1016348,1016436,1016348,88,0,utRho14
ybaS,1023146,1023282,1023146,136,0,utRho14
ybaV,927504,927874,927504,370,60,utRho14
ybaY,950490,950758,950490,268,184,utRho14
ybbB,1062724,1062724,1062452,272,0,utRho14
ybbJ,1030154,1030154,1029718,436,274,utRho14
ybbL,1031784,1031838,1031784,54,0,utRho14
ybbN,1037136,1037136,1036558,578,2306,utRho14
ybbO,1038658,1038658,1038298,360,2240,utRho14
ybbY,1080718,1081130,1080718,412,66,utRho14
ybcH,1176140,1176140,1175962,178,0,utRho14
ybcI,1113264,1113264,1113106,158,16,utRho14
ybcJ,1114050,1114050,1113746,304,640,utRho14
ybcK,1137502,1137804,1137502,302,0,utRho14
ybcL,1141690,1141786,1141690,96,0,utRho14
ybcN,1144628,1144932,1144628,304,0,utRho14
ybcQ,1147548,1147912,1147548,364,68,utRho14
ybcW,1159610,1159760,1159610,150,0,utRho14
ybdD,1263982,1264364,1263982,382,182,utRho14
ybdF,1212106,1212106,1211772,334,344,utRho14
ybdH,1267048,1267048,1266954,94,0,utRho14
ybdJ,1212822,1212822,1212398,424,0,utRho14
ybdK,1215122,1215122,1214766,356,44,utRho14
ybdL,1267114,1267172,1267114,58,0,utRho14
ybdM,1271110,1271110,1270752,358,8,utRho14
ybdN,1273372,1273372,1273138,234,0,utRho14
ybdR,1283844,1284176,1283844,332,118,utRho14
ybeD,1325412,1325412,1325284,128,440,utRho14
ybeF,1323090,1323090,1322756,334,0,utRho14
ybeL,1349986,1350036,1349986,50,218,utRho14
ybeQ,1353412,1353412,1353094,318,2,utRho14
ybeR,1353120,1353422,1353120,302,2,utRho14
ybeT,1358832,1358832,1358812,20,0,utRho14
ybeU,1358924,1359016,1358924,92,0,utRho14
ybeZ,1386938,1386938,1386834,104,1506,utRho14
ybfA,1458074,1458268,1458074,194,2,utRho14
ybfE,1423878,1423878,1423796,82,166,utRho14
ybfF,1425692,1425692,1425604,88,470,utRho14
ybfH,1433282,1433282,1433194,88,0,utRho14
ybgA,1477840,1478002,1477840,162,0,utRho14
ybgC,1549288,1549504,1549288,216,28,utRho14
ybgD,1505916,1505916,1505590,326,204,utRho14
ybgI,1485238,1485654,1485238,416,0,utRho14
ybgO,1498370,1498370,1497964,406,0,utRho14
ybgS,1570992,1570992,1570634,358,0,utRho14
ybhA,1597184,1597184,1596862,322,156,utRho14
ybhB,1616070,1616070,1615818,252,244,utRho14
ybhC,1614642,1614642,1614562,80,3652,utRho14
ybhD,1601418,1601418,1601276,142,0,utRho14
ybhH,1601104,1601518,1601104,414,0,utRho14
ybhK,1633384,1633384,1633294,90,0,utRho14
ybhM,1641556,1641586,1641556,30,0,utRho14
ybhN,1645296,1645296,1644996,300,68,utRho14
ybhQ,1649202,1649260,1649202,58,0,utRho14
ybiA,1665920,1665920,1665900,20,0,utRho14
ybiI,1676968,1676968,1676912,56,0,utRho14
ybiO,1691328,1691328,1690960,368,864,utRho14
ybiP,1705252,1705252,1705194,58,4,utRho14
ybiS,1711572,1711572,1711488,84,128,utRho14
ybiT,1711894,1711926,1711894,32,0,utRho14
ybiU,1718212,1718212,1718122,90,0,utRho14
ybiV,1720176,1720176,1720056,120,0,utRho14
ybiW,1725566,1725566,1725212,354,298,utRho14
ybiX,1678548,1678548,1678414,134,362,utRho14
ybjC,1781784,1781826,1781784,42,0,utRho14
ybjE,1830154,1830154,1829714,440,0,utRho14
ybjG,1767016,1767016,1766776,240,960,utRho14
ybjL,1779882,1779882,1779638,244,44,utRho14
ybjM,1779770,1780178,1779770,408,22,utRho14
ybjO,1795704,1795978,1795704,274,0,utRho14
ybjP,1809046,1809046,1808934,112,2,utRho14
ybjQ,1809034,1809186,1809034,152,0,utRho14
ybjS,1813796,1813796,1813506,290,152,utRho14
ybjX,1838206,1838206,1838168,38,0,utRho14
ycaD,1891438,1891742,1891438,304,0,utRho14
ycaI,1928210,1928640,1928210,430,136,utRho14
ycaK,1899094,1899336,1899094,242,0,utRho14
ycaL,1920264,1920528,1920264,264,0,utRho14
ycaM,1894240,1894458,1894240,218,8,utRho14
ycaR,1941284,1941346,1941284,62,976,utRho14
ycbB,1961862,1962094,1961862,232,0,utRho14
ycbJ,1943344,1943504,1943344,160,2,utRho14
ycbK,1966046,1966150,1966046,104,736,utRho14
ycbZ,2036920,2036920,2036598,322,2,utRho14
yccA,2062886,2062886,2062836,50,90,utRho14
yccF,2048730,2048730,2048696,34,0,utRho14
yccS,2047988,2047988,2047766,222,86,utRho14
yccT,2055674,2055674,2055546,128,0,utRho14
yccX,2059960,2060128,2059960,168,188,utRho14
ycdT,2185682,2185752,2185682,70,0,utRho14
ycdU,2191266,2191686,2191266,420,0,utRho14
ycdZ,2200504,2200592,2200504,88,286,utRho14
yceA,2233544,2233614,2233544,70,0,utRho14
yceD,2293298,2293588,2293298,290,7154,utRho14
yceF,2293522,2293522,2293190,332,4310,utRho14
yceH,2252154,2252314,2252154,160,3712,utRho14
yceI,2237282,2237282,2236952,330,806,utRho14
yceJ,2238142,2238142,2238092,50,0,utRho14
yceM,2253208,2253612,2253208,404,168,utRho14
yceO,2239264,2239264,2238894,370,608,utRho14
yceQ,2288760,2289004,2288760,244,8802,utRho14
ycfD,2376540,2376540,2376480,60,220,utRho14
ycfJ,2334814,2335198,2334814,384,0,utRho14
ycfS,2340834,2340834,2340748,86,0,utRho14
ycfT,2350658,2350658,2350330,328,52,utRho14
ycfZ,2362760,2362760,2362534,226,6,utRho14
ycgB,2474570,2474570,2474482,88,0,utRho14
ycgG,2434614,2434656,2434614,42,0,utRho14
ycgJ,2452956,2453200,2452956,244,0,utRho14
ycgL,2455218,2455362,2455218,144,0,utRho14
ycgN,2457366,2457660,2457366,294,184,utRho14
ycgR,2489112,2489112,2489054,58,0,utRho14
ycgV,2512222,2512222,2511904,318,4,utRho14
ycgX,2426568,2426568,2426214,354,444,utRho14
ycgY,2490166,2490320,2490166,154,0,utRho14
ycgZ,2431504,2431578,2431504,74,0,utRho14
ychE,2596904,2597196,2596904,292,8,utRho14
ychF,2515764,2515764,2515624,140,42,utRho14
ychH,2517476,2517582,2517476,106,4,utRho14
ychJ,2578354,2578354,2578264,90,0,utRho14
ychN,2547310,2547310,2547198,112,44,utRho14
ychO,2547520,2547850,2547520,330,152,utRho14
ychQ,2533798,2533848,2533798,50,0,utRho14
yciA,2624828,2624828,2624492,336,182,utRho14
yciB,2626110,2626110,2625780,330,2252,utRho14
yciC,2627396,2627396,2627326,70,0,utRho14
yciE,2630794,2630794,2630448,346,4,utRho14
yciG,5264368,5264368,5264140,228,0,utRho14
yciI,2621784,2621784,2621730,54,8,utRho14
yciN,2661606,2661606,2661336,270,32,utRho14
yciS,2680270,2680486,2680270,216,148,utRho14
yciT,2689088,2689088,2688692,396,454,utRho14
yciU,2614718,2614718,2614300,418,258,utRho14
yciV,2646376,2646440,2646376,64,0,utRho14
yciW,2700472,2700472,2700214,258,322,utRho14
yciZ,2689276,2689276,2689218,58,342,utRho14
ycjD,2703792,2703792,2703520,272,124,utRho14
ycjG,2777748,2777860,2777748,112,150,utRho14
ycjM,2740006,2740432,2740006,426,524,utRho14
ycjW,2767982,2767982,2767922,60,0,utRho14
ycjX,2768138,2768234,2768138,96,120,utRho14
ycjY,5568288,5568288,5567460,828,0,utRho14
ydaE,2836438,2836438,2836016,422,0,utRho14
ydaN,2816048,2816100,2816048,52,0,utRho14
ydaS,2840340,2840730,2840340,390,54,utRho14
ydbC,2948376,2948442,2948376,66,0,utRho14
ydbD,2950132,2950288,2950132,156,0,utRho14
ydbH,2885800,2886102,2885800,302,74,utRho14
ydbJ,2881712,2882116,2881712,404,0,utRho14
ydbK,2881692,2881692,2881568,124,134,utRho14
ydcA,2983294,2983354,2983294,60,50,utRho14
ydcF,2974404,2974470,2974404,66,36,utRho14
ydcI,2990268,2990268,2990142,126,0,utRho14
ydcJ,2990266,2990576,2990266,310,0,utRho14
ydcK,3001280,3001280,3000898,382,152,utRho14
ydcL,3004646,3004914,3004646,268,54,utRho14
ydcN,3012308,3012344,3012308,36,0,utRho14
ydcP,3013508,3013562,3013508,54,0,utRho14
ydcR,3019956,3020006,3019956,50,0,utRho14
ydcS,3022906,3023308,3022906,402,0,utRho14
ydcX,3034442,3034778,3034442,336,0,utRho14
ydcY,3035220,3035296,3035220,76,104,utRho14
ydcZ,3036750,3036750,3036662,88,140,utRho14
yddB,3155332,3155332,3155238,94,2,utRho14
yddE,3071738,3071738,3071716,22,0,utRho14
yddG,3094410,3094410,3094338,72,0,utRho14
yddJ,3089732,3089732,3089438,294,0,utRho14
yddW,3137704,3137704,3137646,58,2,utRho14
ydeA,3233910,3234056,3233910,146,2,utRho14
ydeE,3242528,3242664,3242528,136,32,utRho14
ydeI,3249118,3249118,3248994,124,0,utRho14
ydeJ,3249376,3249546,3249376,170,0,utRho14
ydeN,3165458,3165458,3165048,410,0,utRho14
ydeP,3173328,3173328,3172972,356,0,utRho14
ydeR,3176596,3176596,3176592,4,2,utRho14
ydfA,3296872,3297016,3296872,144,0,utRho14
ydfG,3254982,3255034,3254982,52,0,utRho14
ydfH,3256652,3256704,3256652,52,244,utRho14
ydfK,3265446,3266144,3265446,698,194,utRho14
ydgA,3379588,3379704,3379588,116,64,utRho14
ydgC,3364124,3364124,3364060,64,0,utRho14
ydgD,3343906,3343920,3343906,14,0,utRho14
ydgH,3356754,3356854,3356754,100,136,utRho14
ydgJ,3408798,3408798,3408616,182,74,utRho14
ydgK,3410414,3410500,3410414,86,300,utRho14
ydhB,3479618,3479618,3479596,22,0,utRho14
ydhC,3479698,3479822,3479698,124,0,utRho14
ydhF,3451310,3451310,3451264,46,0,utRho14
ydhI,3441996,3442050,3441996,54,0,utRho14
ydhL,3451864,3451864,3451840,24,0,utRho14
ydhQ,3492404,3492404,3492254,150,0,utRho14
ydhS,3494136,3494262,3494136,126,4,utRho14
ydhT,3499138,3499138,3499118,20,0,utRho14
ydhY,3509284,3509284,3508954,330,0,utRho14
ydhZ,3510418,3510418,3510282,136,0,utRho14
ydiE,3579206,3579226,3579206,20,0,utRho14
ydiH,3530582,3530582,3530406,176,0,utRho14
ydiM,3541852,3542142,3541852,290,0,utRho14
ydiN,3544818,3545024,3544818,206,0,utRho14
ydiP,3558656,3558656,3558602,54,0,utRho14
ydiU,3582508,3582508,3582488,20,240,utRho14
ydiV,3584174,3584174,3584040,134,390,utRho14
ydiY,3612500,3612500,3612166,334,0,utRho14
ydjA,3697400,3697400,3697352,48,0,utRho14
ydjE,3708082,3708082,3707958,124,0,utRho14
ydjF,3709848,3709848,3709708,140,0,utRho14
ydjM,3620340,3620422,3620340,82,0,utRho14
ydjO,3626696,3626696,3626288,408,0,utRho14
ydjX,3666434,3666802,3666434,368,596,utRho14
yeaE,3731448,3731448,3731272,176,156,utRho14
yeaG,3733530,3733816,3733530,286,0,utRho14
yeaI,3740486,3740770,3740486,284,0,utRho14
yeaJ,3743874,3744082,3743874,208,0,utRho14
yeaL,3748646,3748704,3748646,58,420,utRho14
yeaM,3751296,3751296,3751152,144,0,utRho14
yeaN,3750926,3751346,3750926,420,124,utRho14
yeaO,3753554,3753818,3753554,264,2,utRho14
yeaP,3755314,3755430,3755314,116,300,utRho14
yeaQ,3758780,3758780,3758510,270,0,utRho14
yeaR,3759988,3759988,3759896,92,0,utRho14
yeaY,3781122,3781122,3781064,58,0,utRho14
yebB,3892220,3892502,3892220,282,0,utRho14
yebC,3896370,3896370,3896302,68,2,utRho14
yebE,3859464,3859464,3859414,50,10,utRho14
yebG,3861530,3861530,3861494,36,44,utRho14
yebK,3873180,3873304,3873180,124,104,utRho14
yebQ,3820314,3820552,3820314,238,0,utRho14
yebS,3832238,3832516,3832238,278,0,utRho14
yebV,3843430,3843560,3843430,130,0,utRho14
yebW,3843914,3844242,3843914,328,716,utRho14
yecC,3995646,3995646,3995628,18,0,utRho14
yecD,3901272,3901664,3901272,392,366,utRho14
yecF,3991434,3991636,3991434,202,0,utRho14
yecH,3979304,3979304,3978980,324,0,utRho14
yecJ,3975604,3975604,3975516,88,0,utRho14
yecM,3919968,3919968,3919692,276,0,utRho14
yecR,3976400,3976444,3976400,44,0,utRho14
yecT,3923862,3923944,3923862,82,2,utRho14
yedD,4016522,4016522,4016180,342,40,utRho14
yedE,4016310,4016554,4016310,244,84,utRho14
yedI,4058922,4058922,4058732,190,0,utRho14
yedJ,4066446,4066446,4066158,288,0,utRho14
yedV,4076404,4076404,4076304,100,114,utRho14
yedX,4077680,4077912,4077680,232,0,utRho14
yedY,4078572,4078956,4078572,384,0,utRho14
yeeA,4161322,4161322,4161182,140,334,utRho14
yeeE,4171104,4171104,4171050,54,0,utRho14
yeeJ,4089526,4089822,4089526,296,0,utRho14
yeeN,4113508,4113716,4113508,208,0,utRho14
yeeO,4119444,4119444,4119692,248,0,utRho14
yeeX,4158834,4158834,4158722,112,372,utRho14
yeeZ,4178422,4178422,4178256,166,76,utRho14
yefM,4179466,4179466,4179426,40,0,utRho14
yegD,4295288,4295348,4295288,60,0,utRho14
yegH,4275726,4275804,4275726,78,0,utRho14
yegI,4302154,4302154,4301970,184,0,utRho14
yegJ,4302032,4302370,4302032,338,0,utRho14
yegQ,4331182,4331336,4331182,154,4,utRho14
yegR,4336698,4336698,4336612,86,0,utRho14
yegS,4337086,4337424,4337086,338,0,utRho14
yegT,4357562,4357642,4357562,80,0,utRho14
yegX,4367640,4367640,4367302,338,0,utRho14
yehA,4376944,4376944,4376828,116,0,utRho14
yehE,4385818,4385818,4385592,226,0,utRho14
yehK,4407568,4407944,4407568,376,0,utRho14
yehL,4408804,4409192,4408804,388,0,utRho14
yeiB,4486146,4486146,4485934,212,300,utRho14
yeiE,4499422,4499422,4499236,186,54,utRho14
yeiG,4487776,4487820,4487776,44,490,utRho14
yeiH,4499332,4499434,4499332,102,56,utRho14
yeiI,4503306,4503400,4503306,94,308,utRho14
yeiL,4510580,4510710,4510580,130,0,utRho14
yeiP,4530834,4530900,4530834,66,338,utRho14
yeiQ,4532328,4532490,4532328,162,2,utRho14
yeiR,4535484,4535658,4535484,174,180,utRho14
yeiW,4530840,4530840,4530590,250,494,utRho14
yejA,4544624,4544728,4544624,104,62,utRho14
yejG,4556892,4556892,4556474,418,434,utRho14
yejH,4561244,4561264,4561244,20,66,utRho14
yejK,4568218,4568218,4567894,324,182,utRho14
yejO,4578352,4578352,4577800,552,118,utRho14
yfaD,4713380,4713808,4713380,428,776,utRho14
yfaE,4696676,4697028,4696676,352,1582,utRho14
yfaL,4688568,4688568,4688338,230,2,utRho14
yfaP,4656398,4656398,4656286,112,0,utRho14
yfaU,4717892,4717892,4717690,202,0,utRho14
yfaY,4727310,4727310,4727266,44,0,utRho14
yfaZ,4728744,4728744,4728550,194,0,utRho14
yfbK,4771810,4771810,4771444,366,0,utRho14
yfbL,4771500,4771720,4771500,220,0,utRho14
yfbN,4777174,4777174,4776852,322,2,utRho14
yfbO,4776916,4777162,4776916,246,2,utRho14
yfbP,4777990,4778232,4777990,242,60,utRho14
yfbR,4817662,4817724,4817662,62,64,utRho14
yfcI,4847424,4847424,4847078,346,2,utRho14
yfcJ,4880482,4880482,4880240,242,0,utRho14
yfcL,4888502,4888502,4888338,164,0,utRho14
yfcV,4911642,4911642,4911292,350,26,utRho14
yfcZ,4921958,4921958,4921868,90,102,utRho14
yfdF,4925604,4926024,4925604,420,6,utRho14
yfdG,4935474,4935710,4935474,236,0,utRho14
yfdP,4946844,4947040,4946844,196,0,utRho14
yfdX,4988866,4988866,4988804,62,0,utRho14
yfdY,4990672,4990672,4990584,88,0,utRho14
yfeA,5035784,5035784,5035664,120,5376,utRho14
yfeC,5036668,5036934,5036668,266,678,utRho14
yfeH,5053818,5053892,5053818,74,0,utRho14
yfeK,5074630,5074684,5074630,54,0,utRho14
yfeO,5018906,5019260,5018906,354,0,utRho14
yfeR,5054078,5054078,5053712,366,118,utRho14
yfeX,5101356,5101356,5101090,266,0,utRho14
yfeY,5102486,5102486,5102432,54,0,utRho14
yfeZ,5103842,5103842,5103452,390,264,utRho14
yffO,5123804,5124222,5123804,418,4,utRho14
yffQ,5126778,5127154,5126778,376,4,utRho14
yffS,5128800,5128986,5128800,186,30,utRho14
yfgC,5232052,5232188,5232052,136,0,utRho14
yfgF,5258062,5258062,5257876,186,4,utRho14
yfgG,5258170,5258580,5258170,410,196,utRho14
yfgH,5259344,5259584,5259344,240,0,utRho14
yfgM,5278866,5278866,5278566,300,740,utRho14
yfhH,5397414,5397518,5397414,104,0,utRho14
yfhM,5304648,5304648,5304574,74,0,utRho14
yfhR,5328408,5328726,5328408,318,148,utRho14
yfiC,5425610,5425610,5425528,82,0,utRho14
yfiE,5430688,5430688,5430640,48,0,utRho14
yfiL,5482630,5482720,5482630,90,0,utRho14
yfiM,5448066,5448358,5448066,292,1400,utRho14
yfiR,5483354,5483750,5483354,396,118,utRho14
yfjH,5517326,5517326,5517200,126,0,utRho14
yfjI,5517710,5517970,5517710,260,0,utRho14
yfjJ,5521014,5521094,5521014,80,0,utRho14
yfjM,5531970,5531970,5531552,418,538,utRho14
yfjP,5535080,5535420,5535080,340,4,utRho14
yfjW,5546570,5546636,5546570,66,0,utRho14
yfjX,5551776,5551838,5551776,62,0,utRho14
ygaC,5601180,5601180,5599988,1192,218,utRho14
ygaM,5600242,5600292,5600242,50,2,utRho14
ygaU,5593628,5593628,5593572,56,2,utRho14
ygaZ,5619190,5619234,5619190,44,98,utRho14
ygbA,5713656,5713656,5713612,44,0,utRho14
ygbE,5746784,5746784,5746674,110,82,utRho14
ygbI,5722882,5722882,5722528,354,4,utRho14
ygbK,5724394,5724670,5724394,276,234,utRho14
ygbL,5727074,5727186,5727074,112,102,utRho14
ygbN,5729814,5730202,5729814,388,282,utRho14
ygcG,5811210,5811422,5811210,212,0,utRho14
ygcN,5785144,5785314,5785144,170,144,utRho14
ygcU,5799214,5799214,5798836,378,0,utRho14
ygcW,5800942,5800942,5800546,396,0,utRho14
ygdD,5883442,5883442,5883262,180,194,utRho14
ygdG,5861746,5861930,5861746,184,612,utRho14
ygdI,5886526,5886526,5886290,236,0,utRho14
ygdQ,5940784,5940840,5940784,56,74,utRho14
ygdR,5942494,5942542,5942494,48,108,utRho14
ygeA,5961606,5961606,5961270,336,0,utRho14
ygeH,5983758,5984188,5983758,430,2,utRho14
ygeI,5987162,5987276,5987162,114,0,utRho14
ygeR,6000078,6000078,5999782,296,0,utRho14
ygeV,6011694,6011694,6011572,122,0,utRho14
ygeW,6012234,6012524,6012234,290,0,utRho14
ygfB,6110946,6110946,6110888,58,210,utRho14
ygfK,6031984,6032120,6031984,136,144,utRho14
ygfS,6058328,6058328,6058024,304,0,utRho14
ygfZ,6082564,6082626,6082564,62,124,utRho14
yggC,6149512,6149512,6149378,134,0,utRho14
yggE,6136370,6136370,6136160,210,86,utRho14
yggI,6179176,6179510,6179176,334,166,utRho14
yggL,6204508,6204508,6204266,242,288,utRho14
yggM,6199514,6199514,6199130,384,174,utRho14
yggN,6203596,6203596,6203246,350,264,utRho14
yggX,18623958,18624558,18623958,600,1302,utRho14
yghA,6298966,6299324,6298966,358,62,utRho14
yghB,6307058,6307126,6307058,68,0,utRho14
yghD,6222614,6222614,6222252,362,120,utRho14
yghF,6225798,6225798,6225840,42,0,utRho14
yghJ,6238640,6238640,6238224,416,0,utRho14
yghQ,6265186,6265186,6264816,370,0,utRho14
yghT,6267830,6268262,6267830,432,0,utRho14
yghU,6277400,6277454,6277400,54,4,utRho14
yghW,6293506,6293506,6293474,32,0,utRho14
yghZ,6295562,6295794,6295562,232,0,utRho14
ygiD,6365122,6365122,6364868,254,416,utRho14
ygiH,6409066,6409388,6409066,322,0,utRho14
ygiL,6370622,6370828,6370622,206,0,utRho14
ygiM,6402084,6402414,6402084,330,102,utRho14
ygiN,6346156,6346284,6346156,128,5194,utRho14
ygiQ,6322620,6322620,6322292,328,98,utRho14
ygiS,6335462,6335462,6335436,26,76,utRho14
ygiV,6338582,6338582,6338462,120,92,utRho14
ygiW,6339774,6339774,6339352,422,4,utRho14
ygiZ,6344506,6344506,6344422,84,0,utRho14
ygjH,6442528,6442528,6442494,34,0,utRho14
ygjI,6452140,6452468,6452140,328,8,utRho14
ygjQ,6472730,6473080,6472730,350,32,utRho14
ygjR,6474564,6474586,6474564,22,58,utRho14
ygjV,6483638,6483638,6483488,150,0,utRho14
yhaB,6535632,6535708,6535632,76,0,utRho14
yhaH,6504498,6504608,6504498,110,2,utRho14
yhaI,6505400,6505822,6505400,422,0,utRho14
yhaJ,6508560,6508560,6508428,132,44,utRho14
yhaK,6508538,6508638,6508538,100,116,utRho14
yhbQ,6599878,6599932,6599878,54,0,utRho14
yhbT,6602736,6602736,6602552,184,136,utRho14
yhbU,6602558,6602970,6602558,412,136,utRho14
yhbX,6643302,6643302,6643226,76,0,utRho14
yhbY,6655518,6655580,6655518,62,240,utRho14
yhcA,6723956,6724224,6723956,268,0,utRho14
yhcB,6760364,6760382,6760364,18,62,utRho14
yhcC,6708470,6708470,6708100,370,86,utRho14
yhcF,6733440,6733852,6733440,412,200,utRho14
yhcH,6739124,6739124,6738956,168,550,utRho14
yhcM,6760312,6760312,6759994,318,44,utRho14
yhcN,6770812,6771076,6770812,264,40,utRho14
yhcO,6772606,6772606,6772258,348,0,utRho14
yhdH,6806560,6806968,6806560,408,122,utRho14
yhdJ,6823234,6823306,6823234,72,0,utRho14
yhdN,6879092,6879092,6879018,74,744,utRho14
yhdT,6814702,6814750,6814702,48,50,utRho14
yhdU,6824994,6825242,6824994,248,0,utRho14
yhdV,6836392,6836780,6836392,388,4,utRho14
yhdW,6837944,6838298,6837944,354,0,utRho14
yheO,6953082,6953082,6952880,202,2386,utRho14
yheV,6957970,6957970,6957584,386,494,utRho14
yhfA,6971902,6971902,6971636,266,0,utRho14
yhfG,6983294,6983294,6983240,54,2,utRho14
yhfL,6998622,6998896,6998622,274,86,utRho14
yhfY,7023244,7023244,7022844,400,26,utRho14
yhgA,7086294,7086334,7086294,40,0,utRho14
yhgE,7065176,7065176,7064878,298,86,utRho14
yhgF,7074352,7074770,7074352,418,4264,utRho14
yhhA,7173458,7173886,7173458,428,24,utRho14
yhhI,7248346,7248756,7248346,410,0,utRho14
yhhJ,7253696,7253696,7253606,90,194,utRho14
yhhM,7211588,7211588,7211220,368,0,utRho14
yhhN,7211150,7211502,7211150,352,0,utRho14
yhhQ,7218238,7218434,7218238,196,112,utRho14
yhhT,7223682,7223730,7223682,48,0,utRho14
yhhX,7162032,7162032,7161610,422,66,utRho14
yhhY,7162222,7162276,7162222,54,0,utRho14
yhhZ,7163516,7163726,7163516,210,0,utRho14
yhiD,7312220,7312220,7311804,416,7912,utRho14
yhiJ,7265190,7265190,7265180,10,0,utRho14
yhiM,7269270,7269682,7269270,412,4,utRho14
yhiN,7275000,7275000,7274820,180,172,utRho14
yhjA,7338522,7338522,7338376,146,0,utRho14
yhjB,7344090,7344090,7343788,302,2,utRho14
yhjC,7344272,7344684,7344272,412,0,utRho14
yhjD,7346660,7346724,7346660,64,124,utRho14
yhjE,7349274,7349572,7349274,298,0,utRho14
yhjG,7356824,7356824,7356730,94,0,utRho14
yhjH,7358458,7358458,7358374,84,390,utRho14
yhjJ,7364032,7364032,7363880,152,56,utRho14
yhjK,7371296,7371296,7371158,138,0,utRho14
yhjR,7392750,7392750,7392370,380,26,utRho14
yhjV,7400796,7401126,7400796,330,68,utRho14
yhjX,7424194,7424194,7424014,180,0,utRho14
yhjY,7425966,7425966,7425868,98,0,utRho14
yiaB,7455654,7455654,7455496,158,0,utRho14
yiaD,7432712,7433094,7432712,382,32,utRho14
yiaF,7438194,7438194,7438088,106,0,utRho14
yiaG,7438862,7438956,7438862,94,150,utRho14
yiaJ,7485236,7485236,7485064,172,0,utRho14
yiaK,7485348,7485466,7485348,118,2,utRho14
yiaT,7503924,7503924,7503736,188,0,utRho14
yiaU,7503792,7503984,7503792,192,0,utRho14
yiaY,7515856,7515856,7515654,202,2,utRho14
yibF,7523950,7523950,7523910,40,96,utRho14
yibG,7536128,7536354,7536128,226,0,utRho14
yibL,7553194,7553330,7553194,136,188,utRho14
yibN,7570112,7570112,7570030,82,156,utRho14
yibT,7552848,7552848,7552760,88,0,utRho14
yicC,7633290,7633352,7633290,62,0,utRho14
yicH,7660862,7660914,7660862,52,0,utRho14
yicJ,7673328,7673328,7671858,1470,886,utRho14
yicN,7685018,7685018,7684804,214,104,utRho14
yicO,7687914,7687914,7687578,336,0,utRho14
yicR,15250308,15250308,15250236,72,0,utRho14
yidB,7755230,7755230,7754930,300,0,utRho14
yidE,7732780,7732780,7732546,234,32,utRho14
yidF,7711580,7711580,7711222,358,10,utRho14
yidQ,7735088,7735456,7735088,368,2576,utRho14
yidR,7738824,7738824,7738618,206,0,utRho14
yieE,7787658,7787738,7787658,80,4,utRho14
yieH,7793314,7793548,7793314,234,0,utRho14
yieK,7798928,7798928,7798786,142,0,utRho14
yifB,7900350,7900350,7899998,352,0,utRho14
yifL,7988984,7989044,7988984,60,170,utRho14
yigF,8005750,8005750,8005598,152,230,utRho14
yigI,8009448,8009448,8009394,54,0,utRho14
yigM,8022100,8022152,8022100,52,0,utRho14
yihA,8101970,8101970,8101458,512,90,utRho14
yihD,8084098,8084138,8084098,40,0,utRho14
yihF,8088110,8088398,8088110,288,0,utRho14
yihG,8093304,8093304,8093204,100,0,utRho14
yihI,8102616,8102694,8102616,78,0,utRho14
yihL,8120506,8120894,8120506,388,0,utRho14
yihN,8124332,8124494,8124332,162,2,utRho14
yihO,8131942,8131942,8131532,410,0,utRho14
yihQ,8138892,8138892,8138552,340,0,utRho14
yihV,8147064,8147478,8147064,414,0,utRho14
yihX,8151096,8151106,8151096,10,40,utRho14
yiiE,8158192,8158582,8158192,390,0,utRho14
yiiF,8159124,8159502,8159124,378,82,utRho14
yiiG,8173762,8174004,8173762,242,0,utRho14
yiiM,8205506,8205644,8205506,138,4,utRho14
yiiQ,8224624,8224624,8224428,196,64,utRho14
yiiS,8225738,8225934,8225738,196,0,utRho14
yijE,8272178,8272216,8272178,38,16,utRho14
yijF,8275728,8275728,8275314,414,0,utRho14
yijO,8296858,8296858,8296634,224,76,utRho14
yjaA,8426240,8426468,8426240,228,129058,utRho14
yjaB,8428312,8428312,8428246,66,0,utRho14
yjaG,8398746,8399008,8398746,262,1392,utRho14
yjaH,8401022,8401132,8401022,110,1354,utRho14
yjaZ,8379506,8379572,8379506,66,96,utRho14
yjbB,8455204,8455462,8455204,258,0,utRho14
yjbE,16943432,16943624,16943432,192,0,utRho14
yjbL,8520318,8520642,8520318,324,0,utRho14
yjbQ,8540428,8540476,8540428,48,256,utRho14
yjcB,8550328,8550328,8550082,246,96,utRho14
yjcC,8550836,8550942,8550836,106,2,utRho14
yjcD,8556628,8556958,8556628,330,240,utRho14
yjcE,8559658,8559960,8559658,302,0,utRho14
yjcF,8566212,8566212,8566150,62,0,utRho14
yjcO,8594660,8594660,8594250,410,0,utRho14
yjdA,8654128,8654270,8654128,142,0,utRho14
yjdC,8726660,8726660,8726616,44,96,utRho14
yjdK,8704780,8705168,8704780,388,6,utRho14
yjdL,8713034,8713034,8712822,212,4,utRho14
yjdM,8653672,8653672,8653468,204,356,utRho14
yjeF,8787354,8788132,8787354,778,5676,utRho14
yjeI,8745522,8745618,8745522,96,0,utRho14
yjeJ,8748806,8748806,8748468,338,420,utRho14
yjeV,8785472,8785784,8785472,312,2,utRho14
yjfP,8833512,8833904,8833512,392,142,utRho14
yjfY,8849656,8849656,8849582,74,0,utRho14
yjfZ,8855052,8855052,8854844,208,0,utRho14
yjgA,8916162,8916162,8915730,432,104,utRho14
yjgL,8950802,8950874,8950802,72,0,utRho14
yjgM,8959342,8959342,8959074,268,0,utRho14
yjgN,8959132,8959460,8959132,328,0,utRho14
yjgR,8980170,8980170,8980126,44,26,utRho14
yjgZ,9002116,9002520,9002116,404,78,utRho14
yjhB,9007764,9008116,9007764,352,246,utRho14
yjhG,9048452,9048452,9048188,264,1386,utRho14
yjhU,9041080,9041080,9040648,432,422,utRho14
yjiA,9178096,9178096,9177730,366,13834,utRho14
yjiJ,9125364,9125364,9125350,14,0,utRho14
yjiK,9127270,9127270,9127422,152,286,utRho14
yjiL,9129604,9129604,9129378,226,0,utRho14
yjiS,9143410,9143502,9143410,92,0,utRho14
yjiY,9182734,9182734,9182558,176,8674,utRho14
yjjA,9200674,9200674,9200378,296,76,utRho14
yjjB,18408708,18408708,18407800,908,16,utRho14
yjjJ,9243314,9243538,9243314,224,0,utRho14
yjjK,9261132,9261132,9261044,88,8,utRho14
yjjL,9189764,9189764,9189444,320,134,utRho14
yjjM,9191894,9191894,9191702,192,0,utRho14
yjjP,9206068,9206068,9205716,352,10,utRho14
yjjQ,9206638,9206954,9206638,316,8,utRho14
yjjX,9267798,9267798,9267490,308,1348,utRho14
yjjY,9280716,9280804,9280716,88,1074,utRho14
yjjZ,9211554,9211608,9211554,54,128,utRho14
yjtD,9281676,9281884,9281676,208,154,utRho14
ykfB,532454,532454,532174,280,484,utRho14
ykfI,527636,527636,527338,298,180,utRho14
ykgB,637050,637050,636638,412,112,utRho14
ykgC,640430,640430,640002,428,0,utRho14
ykgD,640232,640454,640232,222,0,utRho14
ykgE,642962,643216,642962,254,50,utRho14
ykgJ,608524,608524,608364,160,140,utRho14
ykgL,623878,624224,623878,346,0,utRho14
ykgM,625610,625610,625554,56,2,utRho14
ykgR,626570,626570,626484,86,0,utRho14
ylaC,958576,958576,958502,74,950,utRho14
yliE,1745938,1745958,1745938,20,0,utRho14
ymcE,2103660,2103694,2103660,34,0,utRho14
ymdA,2210450,2210828,2210450,378,578,utRho14
ymdB,2211428,2211640,2211428,212,0,utRho14
ymfD,2395322,2395322,2395064,258,1186,utRho14
ymfI,2402880,2402994,2402880,114,0,utRho14
ymfJ,2404518,2404518,2404168,350,164,utRho14
ymfK,2406176,2406176,2405866,310,0,utRho14
ymfT,2405766,2406048,2405766,282,2,utRho14
ymgE,2489110,2489456,2489110,346,6,utRho14
ymgF,2437628,2437966,2437628,338,0,utRho14
ymiA,2670112,2670320,2670112,208,0,utRho14
ymjA,2715620,2715620,2715336,284,142,utRho14
ynaI,2791946,2791946,2791844,102,0,utRho14
ynaK,2850438,2850754,2850438,316,102,utRho14
ynbA,2954924,2955242,2954924,318,0,utRho14
yncD,3046552,3046552,3046130,422,34,utRho14
yncE,3046454,3046614,3046454,160,0,utRho14
yncG,3052456,3052494,3052456,38,0,utRho14
yncL,3034492,3034492,3034388,104,0,utRho14
yneE,3218364,3218364,3218044,320,0,utRho14
yneF,3223748,3223748,3223708,40,0,utRho14
yneJ,3229560,3229608,3229560,48,0,utRho14
yneK,3231100,3231526,3231100,426,0,utRho14
yneM,3245176,3245292,3245176,116,0,utRho14
ynfA,3311398,3311398,3311346,52,0,utRho14
ynfB,3311418,3311616,3311418,198,0,utRho14
ynfC,3315094,3315094,3314914,180,178,utRho14
ynfD,3314828,3315130,3314828,302,178,utRho14
ynfE,3316006,3316138,3316006,132,4,utRho14
ynfK,3334670,3334670,3334438,232,508,utRho14
ynfL,3339304,3339304,3339184,120,0,utRho14
ynfM,3339260,3339398,3339260,138,0,utRho14
ynfN,3276598,3276598,3276218,380,8,utRho14
ynfO,3273454,3273512,3273454,58,0,utRho14
ynhG,3517890,3517890,3517450,440,274,utRho14
yniA,3615158,3615592,3615158,434,0,utRho14
yniB,3618526,3618526,3618466,60,46,utRho14
yniC,3618652,3618760,3618652,108,0,utRho14
yniD,3610202,3610330,3610202,128,0,utRho14
ynjE,3678880,3678934,3678880,54,0,utRho14
ynjF,3683222,3683222,3682806,416,288,utRho14
ynjH,3684376,3684376,3684270,106,2,utRho14
ynjI,3690022,3690022,3689742,280,40,utRho14
yoaB,3786642,3786734,3786642,92,210,utRho14
yoaC,3787932,3788146,3787932,214,4,utRho14
yoaE,3803544,3803544,3803170,374,1140,utRho14
yoaF,3755444,3755444,3755064,380,300,utRho14
yoaH,3789866,3789866,3789462,404,502,utRho14
yobB,3850418,3850880,3850418,462,808,utRho14
yobF,3815586,3815586,3815182,404,2,utRho14
yobH,3817800,3817850,3817800,50,4,utRho14
yodB,4084352,4084736,4084352,384,0,utRho14
yodC,4057008,4057008,4056740,268,0,utRho14
yohC,4451358,4451358,4451262,96,0,utRho14
yohD,4451526,4451602,4451526,76,0,utRho14
yohJ,4460986,4461248,4460986,262,0,utRho14
yohO,4431172,4431314,4431172,142,0,utRho14
yojI,4617282,4617282,4617230,52,0,utRho14
ypdI,4988988,4989396,4988988,408,2,utRho14
ypfG,5165786,5165786,5165554,232,68,utRho14
ypfM,5182140,5182140,5181732,408,2634,utRho14
yphB,5349590,5349590,5349376,214,0,utRho14
ypjA,5565644,5565644,5565452,192,0,utRho14
ypjB,5569636,5569636,5568858,778,0,utRho14
ypjD,5495860,5495774,5495860,86,0,utRho14
yqaE,5594170,5594170,5594056,114,0,utRho14
yqcA,5846100,5846100,5845968,132,0,utRho14
yqcE,5800944,5801184,5800944,240,0,utRho14
yqeC,6030468,6030468,6030114,354,738,utRho14
yqeF,5971618,5971618,5971184,434,0,utRho14
yqeG,5971438,5971694,5971438,256,0,utRho14
yqeH,5975016,5975072,5975016,56,2,utRho14
yqeI,5976688,5977004,5976688,316,0,utRho14
yqeK,5981140,5981140,5980720,420,0,utRho14
yqfA,6086728,6086728,6086296,432,654,utRho14
yqgA,6219042,6219106,6219042,64,0,utRho14
yqgB,6172500,6172500,6172102,398,906,utRho14
yqgE,6185768,6185874,6185768,106,696,utRho14
yqhA,6299150,6299150,6298942,208,62,utRho14
yqhC,6310768,6310768,6310436,332,282,utRho14
yqhD,6310604,6310710,6310604,106,104,utRho14
yqhH,6316842,6317254,6316842,412,0,utRho14
yqiC,6369662,6369680,6369662,18,0,utRho14
yqiJ,6384108,6384416,6384108,308,108,utRho14
yqjA,6495096,6495546,6495096,450,738,utRho14
yqjF,6500932,6501124,6500932,192,314,utRho14
yqjG,6501948,6502048,6501948,100,0,utRho14
yqjH,6433078,6433078,6432982,96,0,utRho14
yqjI,6433506,6433558,6433506,52,56,utRho14
yraH,6574552,6574852,6574552,300,0,utRho14
yraP,6592144,6592818,6592144,674,1060,utRho14
yraQ,6596414,6596414,6596276,138,0,utRho14
yraR,6598024,6598024,6597692,332,0,utRho14
yrbG,13360844,13361100,13360844,256,104,utRho14
yrbL,6696842,6696904,6696842,62,8,utRho14
yrbN,6616172,6616172,6615866,306,596,utRho14
yrdB,6860176,6860176,6860046,130,0,utRho14
yrfF,7052548,7052938,7052548,390,378,utRho14
yrhB,7169440,7169518,7169440,78,0,utRho14
ysaB,7451804,7451804,7451424,380,0,utRho14
ysgA,8032686,8032686,8032338,348,100,utRho14
ytfB,8857638,8857638,8857434,204,890,utRho14
ytfE,8864018,8864018,8863966,52,0,utRho14
ytfF,8866296,8866296,8866130,166,0,utRho14
ytfH,8868164,8868226,8868164,62,2,utRho14
ytfI,8875234,8875414,8875234,180,0,utRho14
ytfJ,8878572,8878572,8878524,48,14,utRho14
ytfK,8879022,8879174,8879022,152,1870,utRho14
ytfL,8882642,8882642,8882430,212,0,utRho14
ytfQ,8899634,8899924,8899634,290,572,utRho14
ytjB,9249598,9249598,9249578,20,166,utRho14
yzfA,8896588,8896588,8896490,98,116,utRho14
zapA,6111102,6111224,6111102,122,5526,utRho14
zapB,8236772,8237030,8236772,258,506,utRho14
zapC,2011700,2011904,2011700,204,0,utRho14
zinT,4082692,4082750,4082692,58,0,utRho14
zipA,5062814,5062814,5062466,348,204,utRho14
zitB,1569716,1569716,1569646,70,2,utRho14
zntA,7212844,7212902,7212844,58,66,utRho14
zntR,6878336,6878336,6878260,76,0,utRho14
znuA,3885322,3885322,3885166,156,0,utRho14
znuC,3885268,3885324,3885268,56,0,utRho14
zraP,8403424,8403424,8403376,48,0,utRho14
zraS,8403810,8403852,8403810,42,0,utRho14
zupT,6364866,6365100,6364866,234,416,utRho14
zur,8520282,8520282,8520006,276,550,utRho14
zwf,3872752,3872752,3872628,124,626,utRho14
C0343,2818676,2818728,2818676,52,0,utRho15
aaeB,6776526,6776526,6776376,150,0,utRho15
aaeR,6778762,6779040,6778762,278,20,utRho15
aaeX,6778860,6778860,6778674,186,36,utRho15
aat,1854920,1854920,1854864,56,0,utRho15
accA,416822,417242,416822,420,1784,utRho15
accB,6810280,6810872,6810280,592,6300,utRho15
accD,4868030,4868030,4867852,178,404,utRho15
aceB,8430804,8430956,8430804,152,20,utRho15
aceE,245938,246034,245938,96,64,utRho15
ackA,4826918,4826940,4826918,22,654,utRho15
acnA,2670848,2671662,2670848,814,726,utRho15
acnB,263038,263230,263038,192,912,utRho15
acpP,2303148,2303230,2303148,82,254,utRho15
acpS,5402324,5402324,5401996,328,304,utRho15
acrA,971396,971396,971238,158,126,utRho15
acrB,969370,969370,968806,564,1986,utRho15
acrD,5174950,5175190,5174950,240,0,utRho15
acrE,6827404,6827728,6827404,324,4,utRho15
acrR,971398,971522,971398,124,30,utRho15
acrZ,1589502,1589546,1589502,44,0,utRho15
acs,8575190,8575190,8574742,448,12,utRho15
actP,8569870,8569870,8569804,66,12,utRho15
ada,4620854,4620854,4620810,44,0,utRho15
add,3404404,3404466,3404404,62,14,utRho15
ade,7687802,7687928,7687802,126,4,utRho15
adhE,2596826,2596826,2596242,584,160,utRho15
adhP,3107988,3107988,3107676,312,1762,utRho15
adiA,8681112,8681112,8681042,70,0,utRho15
adiC,8674404,8674404,8674062,342,12,utRho15
adiY,8676084,8676084,8675858,226,0,utRho15
adk,994278,994350,994278,72,40,utRho15
adrA,807374,807406,807374,32,0,utRho15
aer,6438240,6438240,6438152,88,14,utRho15
aes,1000102,1000102,999946,156,8,utRho15
agaR,6557406,6557406,6557330,76,0,utRho15
agaS,6563778,6563952,6563778,174,0,utRho15
agp,2131118,2131170,2131118,52,16,utRho15
agrA,7296126,7296126,7296126,0,0,utRho15
agrB,7296588,7296588,7296588,0,0,utRho15
ahpC,1277386,1277890,1277386,504,792,utRho15
ahpF,1278004,1279506,1278004,1502,92234,utRho15
ahr,8992698,8992698,8992418,280,0,utRho15
aidB,8828494,8828550,8828494,56,0,utRho15
ais,4731512,4731512,4731240,272,0,utRho15
alaA,4814816,4815122,4814816,306,0,utRho15
alaC,4996798,4996798,4996590,208,30,utRho15
alaE,5598140,5598328,5598140,188,0,utRho15
alaS,5644180,5644180,5644022,158,3812,utRho15
alaW,5036612,5036612,5036462,150,0,utRho15
aldA,2976380,2976464,2976380,84,748,utRho15
aldB,7513070,7513070,7513022,48,2,utRho15
alkA,4295118,4295118,4295080,38,56,utRho15
alkB,4618890,4618890,4618682,208,0,utRho15
allA,1064780,1064902,1064780,122,12,utRho15
allD,1092822,1092822,1092726,96,0,utRho15
allE,1088112,1088112,1088092,20,2,utRho15
allS,1064600,1064600,1064442,158,2,utRho15
alr,8531178,8531564,8531178,386,1470,utRho15
alsE,8617334,8617334,8616956,378,106,utRho15
alsK,8615990,8615990,8615598,392,26,utRho15
alx,6476740,6477160,6476740,420,0,utRho15
amiA,5104482,5104704,5104482,222,0,utRho15
amiC,5898378,5898378,5898020,358,62,utRho15
amn,4110062,4110122,4110062,60,0,utRho15
ampC,8758006,8758006,8757888,118,2,utRho15
ampD,237362,237466,237362,104,78,utRho15
ampG,907372,907372,907090,282,612,utRho15
ampH,792726,792726,792574,152,8,utRho15
amyA,4012230,4012312,4012230,82,0,utRho15
anmK,3439346,3439346,3439204,142,0,utRho15
ansB,6201580,6201580,6201456,124,2,utRho15
ansP,3052040,3052040,3051960,80,16,utRho15
apaG,104068,104068,103212,856,2744,utRho15
apaH,102586,102586,102444,142,1810,utRho15
apbE,4623188,4623188,4623068,120,28,utRho15
appA,2081198,2081234,2081198,36,32,utRho15
appC,2075420,2075480,2075420,60,0,utRho15
appY,1167134,1167362,1167134,228,6,utRho15
apt,982620,982824,982620,204,12,utRho15
aqpZ,1832424,1832424,1832094,330,2,utRho15
araB,140150,140150,140096,54,0,utRho15
araC,140482,140774,140482,292,326,utRho15
araE,5964416,5964416,5964364,52,0,utRho15
araF,3972476,3972476,3972256,220,64,utRho15
araH,3967120,3967120,3967086,34,2,utRho15
araJ,825058,825058,824962,96,4,utRho15
arcA,9281602,9281602,9280612,990,6526,utRho15
arcB,6706098,6706098,6706050,48,0,utRho15
arcZ,6701154,6701154,6701154,0,0,utRho15
arfA,6877346,6877346,6877298,48,50,utRho15
argA,5898312,5898484,5898312,172,0,utRho15
argC,8309770,8310002,8309770,232,48,utRho15
argD,6980442,6980442,6980360,82,4,utRho15
argE,8310156,8310156,8309694,462,124,utRho15
argF,580680,580680,580610,70,2,utRho15
argG,6637124,6637274,6637124,150,82,utRho15
argI,8956688,8956688,8956622,66,4,utRho15
argO,6137672,6137672,6137616,56,6,utRho15
argP,6119460,6119506,6119460,46,14,utRho15
argR,6769204,6769406,6769204,202,0,utRho15
argS,3920002,3920124,3920002,122,30,utRho15
argT,4855698,4855698,4855582,116,88,utRho15
argU,1129406,1129446,1129406,40,38,utRho15
argW,4932616,4932618,4932616,2,0,utRho15
argX,7964728,7964750,7964728,22,66,utRho15
aroF,5482402,5482402,5482300,102,0,utRho15
aroG,1571182,1571266,1571182,84,134,utRho15
aroH,3576636,3576870,3576636,234,348,utRho15
aroK,7038760,7038760,7038128,632,736,utRho15
aroL,812560,812810,812560,250,4,utRho15
aroP,243342,243342,243102,240,0,utRho15
arpA,8445382,8445382,8444974,408,34,utRho15
arrS,7316108,7316108,7316108,0,0,utRho15
arsR,7297024,7297056,7297024,32,4,utRho15
artJ,1801252,1801252,1801150,102,0,utRho15
artP,1807686,1807686,1807468,218,40,utRho15
ascF,5678858,5679048,5678858,190,0,utRho15
ascG,5678574,5678574,5678528,46,0,utRho15
aslB,7965562,7965916,7965562,354,510,utRho15
asnA,7854258,7854310,7854258,52,2,utRho15
asnB,1398444,1398444,1398354,90,14,utRho15
asnC,23562186,23562186,23562018,168,0,utRho15
asnS,1978088,1978088,1977970,118,8286,utRho15
asnT,4089082,4089098,4089082,16,392,utRho15
asnU,4119690,4119702,4119690,12,0,utRho15
asnV,4124504,4124520,4124504,16,30,utRho15
aspA,17473728,17473728,17473308,420,220,utRho15
aspC,1971486,1971486,1971418,68,78,utRho15
aspS,3901402,3901402,3901044,358,110,utRho15
aspT,7893560,7893744,7893560,184,61464,utRho15
aspV,473826,473862,473826,36,10,utRho15
asr,3342654,3342752,3342654,98,0,utRho15
astC,3664088,3664088,3663964,124,0,utRho15
astE,3654138,3654138,3653846,292,0,utRho15
atoD,4646824,4646894,4646824,70,48,utRho15
atpB,7844540,7844540,7844102,438,322,utRho15
atpC,7832118,7832118,7831944,174,1746,utRho15
atpI,7845050,7845050,7844880,170,72,utRho15
avtA,7479348,7479410,7479348,62,122,utRho15
azoR,2965982,2965982,2965720,262,20,utRho15
azuC,3976002,3976002,3975918,84,0,utRho15
bacA,6408350,6408350,6408262,88,2,utRho15
bamA,394052,395856,394052,1804,1034,utRho15
bamB,5277950,5277950,5277304,646,776,utRho15
bamC,5198028,5198028,5197730,298,1412,utRho15
bamD,5471922,5472292,5471922,370,802,utRho15
bamE,5506972,5507210,5506972,238,702,utRho15
basS,8666954,8666954,8666544,410,382,utRho15
bax,7474468,7474468,7474354,114,0,utRho15
bcp,5200874,5200956,5200874,82,2976,utRho15
bcsB,7385346,7385346,7385214,132,2,utRho15
bcsE,7392644,7392916,7392644,272,0,utRho15
bdcA,8948128,8948128,8948106,22,18,utRho15
bdcR,8948192,8948248,8948192,56,8,utRho15
bdm,3112680,3112680,3112560,120,0,utRho15
betA,654522,654522,654494,28,66,utRho15
betI,658722,658722,658668,54,22,utRho15
betT,658842,658926,658842,84,4,utRho15
bfr,6933498,6933498,6933450,48,0,utRho15
bglG,23440182,23440182,23439402,780,6,utRho15
bglX,4444240,4444240,4443978,262,20,utRho15
bhsA,2337962,2338146,2337962,184,2,utRho15
bioA,1618584,1618584,1618514,70,0,utRho15
bioB,1618604,1618688,1618604,84,4,utRho15
bioH,7089716,7089716,7089688,28,0,utRho15
bisC,7433026,7433026,7432788,238,36,utRho15
blc,8755490,8755490,8755444,46,0,utRho15
blr,3409024,3409102,3409024,78,4,utRho15
bluF,2431226,2431226,2430950,276,6,utRho15
bluR,2428226,2428226,2428118,108,0,utRho15
bolA,908698,908944,908698,246,0,utRho15
borD,1157842,1157842,1157786,56,6,utRho15
brnQ,838976,839182,838976,206,482,utRho15
bssR,1756492,1756496,1756492,4,2,utRho15
bssS,2242116,2242116,2241910,206,60,utRho15
btuB,8326798,8327278,8326798,480,2432,utRho15
cadB,8720212,8720212,8720062,150,32,utRho15
cadC,8723926,8723926,8723868,58,0,utRho15
caiE,70998,70998,70742,256,4,utRho15
caiF,68436,68600,68436,164,4,utRho15
caiT,84074,84074,83862,212,0,utRho15
can,285406,285406,285340,66,74,utRho15
carA,59102,59302,59102,200,0,utRho15
carB,61550,61634,61550,84,162,utRho15
cas2,5757830,5757830,5757706,124,60,utRho15
casA,5768638,5768638,5768276,362,0,utRho15
cbl,4121882,4121882,4121828,54,4,utRho15
cbpA,2128074,2128074,2127550,524,14,utRho15
cbrA,7738628,7738754,7738628,126,0,utRho15
cbrB,7794958,7795012,7794958,54,34,utRho15
ccmH,4585242,4585242,4584820,422,2,utRho15
cdaR,364894,364926,364894,32,2,utRho15
cdd,4463638,4463688,4463638,50,132,utRho15
cdh,8219814,8219860,8219814,46,22,utRho15
cdsA,391110,391354,391110,244,748,utRho15
cedA,3627484,3627484,3627326,158,26,utRho15
cfa,3482402,3482826,3482402,424,340,utRho15
chaC,2544844,2544972,2544844,128,6,utRho15
chbB,3643452,3643452,3643238,214,0,utRho15
chbG,3634624,3634624,3634270,354,8,utRho15
cheW,3946924,3946924,3946678,246,514,utRho15
chiA,6939792,6939792,6939706,86,4,utRho15
chiP,1416472,1416668,1416472,196,36,utRho15
cho,3646984,3647030,3646984,46,18,utRho15
chpS,8896804,8896894,8896804,90,2,utRho15
cirA,4493884,4493884,4493538,346,2,utRho15
citC,1304078,1304078,1303712,366,6,utRho15
citT,1293264,1293264,1293160,104,0,utRho15
clcA,350104,350214,350104,110,0,utRho15
clpA,1846160,1846528,1846160,368,166,utRho15
clpB,5468410,5468410,5468346,64,60,utRho15
clpP,913154,913354,913154,200,456,utRho15
clpS,1845500,1845826,1845500,326,4,utRho15
clpX,914404,914852,914404,448,2186,utRho15
clsA,2617346,2617346,2617290,56,0,utRho15
clsC,2212584,2212710,2212584,126,176,utRho15
cmk,1922330,1922402,1922330,72,18,utRho15
cnu,3409522,3409898,3409522,376,248,utRho15
coaA,8350214,8350214,8350052,162,358,utRho15
cobC,1340092,1340092,1339814,278,154,utRho15
cobT,4129202,4129202,4128934,268,6,utRho15
cobU,4131944,4131944,4131528,416,28,utRho15
codB,709768,709844,709768,76,48,utRho15
comR,2337726,2337726,2337664,62,0,utRho15
copA,1022822,1022822,1022758,64,0,utRho15
corA,8002388,8002852,8002388,464,3174,utRho15
cpdB,8873258,8873258,8873130,128,244,utRho15
cptB,6082198,6082198,6082140,58,2,utRho15
cpxA,8210202,8210202,8209950,252,260,utRho15
cpxP,8211570,8211640,8211570,70,50,utRho15
cpxR,8211372,8211372,8211340,32,20,utRho15
cra,175894,176056,175894,162,24,utRho15
crcB,1316016,1316016,1315876,140,0,utRho15
creA,9270486,9271042,9270486,556,274,utRho15
creD,9276320,9276356,9276320,36,12,utRho15
crl,515620,515658,515620,38,406,utRho15
crp,6971906,6972240,6971906,334,4126,utRho15
crr,5070960,5071668,5070960,708,2874,utRho15
csdA,5886414,5886674,5886414,260,2,utRho15
csgB,2207718,2207902,2207718,184,0,utRho15
csgD,2206688,2206688,2206392,296,0,utRho15
csgG,2203510,2203510,2203368,142,64,utRho15
csiD,5577854,5577970,5577854,116,130,utRho15
csiE,5330802,5330870,5330802,68,2,utRho15
csiR,5590942,5591348,5590942,406,84,utRho15
cspA,7439778,7440098,7439778,320,2650,utRho15
cspB,3283430,3283430,3283108,322,0,utRho15
cspC,3815018,3815018,3814870,148,590,utRho15
cspD,1845352,1845352,1845180,172,11592,utRho15
cspE,1314294,1314584,1314294,290,0,utRho15
cspF,3283380,3283710,3283380,330,32,utRho15
cspG,2102610,2102922,2102610,312,622,utRho15
cspH,2102746,2102746,2102350,396,14,utRho15
cspI,3277624,3277624,3277334,290,0,utRho15
csrA,5638746,5638746,5638292,454,824,utRho15
csrB,5849048,5849048,5849048,0,0,utRho15
csrC,8102072,8102072,8102072,0,0,utRho15
csrD,6806850,6806850,6806664,186,92,utRho15
cstA,1259710,1259788,1259710,78,20,utRho15
cueO,274090,274166,274090,76,0,utRho15
cueR,1027948,1027986,1027948,38,2,utRho15
curA,3037784,3038054,3037784,270,2,utRho15
cusC,1191146,1191200,1191146,54,4,utRho15
cusR,1190924,1190924,1190886,38,8,utRho15
cutA,8730784,8730784,8730712,72,52,utRho15
cutC,3918534,3918534,3917920,614,54,utRho15
cvpA,4861600,4861600,4861526,74,22,utRho15
cvrA,2484328,2484328,2484142,186,2,utRho15
cyaA,7981548,7982306,7981548,758,324,utRho15
cyaR,4334228,4334224,4334228,4,2,utRho15
cyaY,7988166,7988166,7988118,48,18,utRho15
cybB,2981522,2981804,2981522,282,2,utRho15
cycA,8859560,8859728,8859560,168,296,utRho15
cydA,1542340,1542916,1542340,576,66,utRho15
cydC,1858800,1858800,1858390,410,110,utRho15
cydD,1862062,1862062,1861924,138,28,utRho15
cydX,1548300,1548392,1548300,92,248,utRho15
cynR,717418,717418,717380,38,2,utRho15
cynT,1435092,1435196,1435092,104,0,utRho15
cyoA,903306,903306,903220,86,2516,utRho15
cyoE,895540,895540,895410,130,650,utRho15
cysB,2667576,2667710,2667576,134,62,utRho15
cysC,5748056,5748056,5747984,72,2,utRho15
cysD,5752736,5752736,5752658,78,0,utRho15
cysE,7565362,7565362,7565124,238,2014,utRho15
cysG,6995508,6995656,6995508,148,12,utRho15
cysJ,5783928,5783928,5783796,132,136,utRho15
cysK,5064688,5064818,5064688,130,62,utRho15
cysP,5087114,5087114,5087056,58,6,utRho15
cysS,1109154,1109222,1109154,68,48,utRho15
cysT,3984100,3984100,3983974,126,102,utRho15
cysZ,5062766,5062926,5062766,160,30,utRho15
cytR,8249018,8249018,8248912,106,68,utRho15
dacA,1328002,1328002,1327926,76,204,utRho15
dacB,6657714,6657926,6657714,212,10,utRho15
dacC,1761306,1761454,1761306,148,32,utRho15
dadA,2475018,2475142,2475018,124,0,utRho15
dam,7032504,7032504,7031826,678,796,utRho15
damX,7035200,7035200,7034612,588,248,utRho15
dapA,5199568,5199568,5199520,48,0,utRho15
dapB,56576,56748,56576,172,74,utRho15
dapD,371954,371954,371894,60,122,utRho15
dapE,5183120,5183214,5183120,94,782,utRho15
dcp,3254844,3254844,3254760,84,70,utRho15
dcrB,7219534,7219910,7219534,376,6,utRho15
dctA,7366996,7366996,7366894,102,468,utRho15
dcuA,8733686,8733686,8733546,140,0,utRho15
dcuB,8698182,8698182,8697488,694,76,utRho15
dcuC,1312166,1312166,1311936,230,0,utRho15
dcuD,6749166,6749738,6749166,572,8,utRho15
dcuR,8701130,8701130,8700068,1062,486,utRho15
dcuS,8703370,8703370,8703324,46,10,utRho15
dcyD,3999016,3999016,3998960,56,0,utRho15
ddpX,3126498,3126498,3126152,346,4,utRho15
deaD,6615818,6615818,6615720,98,68,utRho15
dedA,4869880,4869880,4869482,398,2748,utRho15
dedD,4863750,4863750,4863368,382,0,utRho15
def,6867300,6867380,6867300,80,4,utRho15
degP,361690,361768,361690,78,0,utRho15
degQ,6761308,6761486,6761308,178,200,utRho15
deoB,9239134,9239206,9239134,72,0,utRho15
deoC,9233358,9234646,9233358,1288,312,utRho15
dfp,7625406,7625462,7625406,56,36,utRho15
dgcZ,3247758,3247758,3247700,58,0,utRho15
dgkA,8512914,8513274,8512914,360,368,utRho15
dgt,358392,358474,358392,82,0,utRho15
dhaK,2501888,2501888,2501676,212,172,utRho15
dhaR,2502006,2502132,2502006,126,4,utRho15
dicB,3299194,3299218,3299194,24,0,utRho15
dicC,3295752,3295752,3295700,52,0,utRho15
dinB,501760,501796,501760,36,0,utRho15
dinD,7635398,7635520,7635398,122,0,utRho15
dinG,1666146,1666140,1666146,6,0,utRho15
dinI,2243018,2243018,2242974,44,34,utRho15
dinJ,493230,493230,493004,226,14,utRho15
dinQ,7295964,7295964,7295576,388,602,utRho15
djlA,114536,114728,114536,192,0,utRho15
dkgA,6313142,6313246,6313142,104,264,utRho15
dkgB,458196,458334,458196,138,0,utRho15
dksA,321502,321502,321208,294,996,utRho15
dld,4444164,4444370,4444164,206,28,utRho15
dmlA,3763424,3763824,3763424,400,38,utRho15
dmlR,3763710,3763710,3763618,92,0,utRho15
dmsA,1881646,1881918,1881646,272,0,utRho15
dnaA,7767922,7767922,7767458,464,470,utRho15
dnaB,8528566,8528628,8528566,62,84,utRho15
dnaK,24096,24326,24096,230,2106,utRho15
dnaN,7765466,7765466,7764642,824,460,utRho15
dnaQ,471868,472134,471868,266,524,utRho15
dnaT,18406460,18406460,18406068,392,80,utRho15
dnaX,984112,984184,984112,72,58,utRho15
dosP,3131486,3131486,3131466,20,2,utRho15
dpiB,1303968,1304470,1303968,502,0,utRho15
dppA,7415740,7415740,7415410,330,2988,utRho15
dps,1697900,1697900,1697822,78,0,utRho15
dsbA,8086754,8086836,8086754,82,1446,utRho15
dsbB,2466294,2466294,2466060,234,2,utRho15
dsbC,6079266,6079266,6077644,1622,526,utRho15
dsbG,1277600,1277600,1277146,454,284,utRho15
dsdA,4958242,4958404,4958242,162,576,utRho15
dsdC,4955492,4955492,4955258,234,2,utRho15
dsdX,4955642,4955694,4955642,52,0,utRho15
dsrA,4050626,4050626,4050626,0,0,utRho15
dsrB,4049686,4049686,4049646,40,2,utRho15
dtpD,1485340,1485340,1485112,228,32,utRho15
dusA,8523200,8523338,8523200,138,598,utRho15
dusB,6820492,6820560,6820492,68,0,utRho15
dusC,4460790,4460790,4460770,20,0,utRho15
dut,7627704,7627864,7627704,160,1068,utRho15
dxr,386670,387042,386670,372,352,utRho15
ebgA,6445102,6445266,6445102,164,12,utRho15
ebgR,6442874,6442932,6442874,58,32,utRho15
ecnB,8753018,8753106,8753018,88,0,utRho15
eco,4607594,4607810,4607594,216,22,utRho15
ecpA,621594,621594,621342,252,4,utRho15
ecpB,620238,620238,620052,186,2,utRho15
ecpR,622964,622964,622672,292,2,utRho15
eda,3866218,3866218,3865512,706,146,utRho15
edd,3869426,3869426,3869208,218,134,utRho15
efeO,2164308,2164486,2164308,178,180,utRho15
efeU_1,2162614,2162712,2162614,98,0,utRho15
efp,8751134,8751398,8751134,264,1970,utRho15
elaA,4763372,4763372,4763086,286,28,utRho15
elaD,4765308,4765426,4765308,118,6,utRho15
elfA,1995530,1995736,1995530,206,0,utRho15
elfD,1996642,1996980,1996642,338,2,utRho15
emrD,7707690,7707844,7707690,154,0,utRho15
emrK,4966896,4966896,4966678,218,2,utRho15
emrY,4964668,4964668,4964352,316,44,utRho15
emtA,2486250,2486360,2486250,110,2,utRho15
endA,12361100,12361388,12361100,288,0,utRho15
eno,5817692,5817692,5815882,1810,2102,utRho15
entC,1249662,1249770,1249662,108,0,utRho15
entD,1220508,1220508,1220158,350,30,utRho15
entH,1258584,1258600,1258584,16,44,utRho15
entS,1244506,1244600,1244506,94,0,utRho15
envR,6827266,6827266,6826930,336,0,utRho15
epd,12295292,12295292,12294764,528,100,utRho15
epmA,8765236,8765286,8765236,50,2,utRho15
epmB,8751406,8751406,8751314,92,800,utRho15
eptB,7421162,7421162,7420950,212,0,utRho15
eptC,8300622,8300622,8300530,92,76,utRho15
erfK,4126708,4126708,4126646,62,40,utRho15
erpA,353122,353220,353122,98,0,utRho15
esrE,8039956,8039956,8039956,0,0,utRho15
essD,1153746,1154796,1153746,1050,64,utRho15
etk,2088606,2088606,2088420,186,8,utRho15
evgA,4967262,4967510,4967262,248,2,utRho15
exbB,6304028,6304028,6303968,60,2,utRho15
exbD,6302780,6302780,6302486,294,34,utRho15
exuR,6493016,6493304,6493016,288,0,utRho15
exuT,6490004,6490208,6490004,204,0,utRho15
fabA,2032996,2032996,2032940,56,118,utRho15
fabB,4883282,4883282,4883210,72,0,utRho15
fabH,2297032,2297518,2297032,486,1030,utRho15
fabI,2702236,2702236,2702078,158,0,utRho15
fadB,8062026,8062026,8061942,84,0,utRho15
fadD,3779614,3779614,3779492,122,0,utRho15
fadE,486812,486812,486606,206,0,utRho15
fadH,6463248,6463330,6463248,82,6,utRho15
fadI,4921022,4921022,4920938,84,16,utRho15
fadL,4922410,4922600,4922410,190,60,utRho15
fadM,928720,928804,928720,84,40,utRho15
fadR,2469810,2469876,2469810,66,0,utRho15
fbaB,4357334,4357334,4357128,206,2,utRho15
fdhE,8162722,8162722,8162456,266,1124,utRho15
fdhF,8598814,8598814,8598732,82,0,utRho15
fdnG,3094744,3094802,3094744,58,0,utRho15
fdrA,1093012,1093360,1093012,348,28,utRho15
feaB,2894994,2895038,2894994,44,0,utRho15
feaR,2894734,2894734,2894566,168,78,utRho15
fecA,9033454,9033454,9033354,100,20,utRho15
fecE,9023288,9023288,9022914,374,1874,utRho15
fecI,9036564,9036564,9036470,94,4,utRho15
feoA,7080114,7080326,7080114,212,112,utRho15
fepA,1225334,1225334,1224988,346,2,utRho15
fepB,1249454,1249454,1249020,434,172,utRho15
fepD,1244468,1244468,1244378,90,0,utRho15
fes,1225374,1225630,1225374,256,34,utRho15
ffh,5495706,5495706,5495590,116,420,utRho15
ffs,952576,952848,952576,272,14,utRho15
fhuA,334884,334968,334884,84,30,utRho15
fhuE,2323294,2323294,2323102,192,6,utRho15
fhuF,9211504,9211504,9211326,178,428,utRho15
fic,6983296,6983296,6982926,370,124,utRho15
fieF,8212864,8212938,8212864,74,0,utRho15
fimA,9085388,9086230,9085388,842,490,utRho15
fimB,9081334,9081914,9081334,580,696,utRho15
fimE,9083742,9084074,9083742,332,12,utRho15
fimZ,1129214,1129214,1128960,254,0,utRho15
fiu,1683296,1683296,1683062,234,42,utRho15
fixA,84650,84806,84650,156,0,utRho15
fkpA,6955050,6955050,6954838,212,5240,utRho15
fldA,2846084,2846084,2845860,224,1384,utRho15
fldB,6079644,6079710,6079644,66,0,utRho15
flgA,2261770,2261770,2261726,44,4,utRho15
flgB,2261986,2262036,2261986,50,0,utRho15
flgK,2276702,2276756,2276702,54,278,utRho15
flgM,2260330,2260330,2260256,74,376,utRho15
flgN,2259828,2259828,2259660,168,26,utRho15
flhB,3932432,3932432,3932382,50,56,utRho15
flhC,3955864,3955864,3955688,176,60,utRho15
flhD,3957154,3957154,3956394,760,168,utRho15
fliA,4003638,4003638,4003578,60,2,utRho15
fliC,4007352,4007352,4007212,140,94,utRho15
fliD,4007634,4007744,4007634,110,92,utRho15
fliE,4026186,4026186,4026028,158,2,utRho15
fliF,4026292,4026458,4026292,166,248,utRho15
fliL,4039168,4039236,4039168,68,66,utRho15
flk,4875824,4875900,4875824,76,0,utRho15
flu,4142634,4143078,4142634,444,28,utRho15
flxA,3292776,3292810,3292776,34,0,utRho15
fnr,2799104,2799104,2799052,52,60,utRho15
fnrS,2818258,2818258,2818258,0,0,utRho15
focA,1909628,1909628,1908932,696,160,utRho15
folA,99598,99646,99598,48,2,utRho15
folB,6409296,6409296,6409178,118,0,utRho15
folD,1115562,1115562,1115482,80,48,utRho15
folE,4487696,4487696,4487304,392,1996,utRho15
fpr,8228998,8228998,8228944,54,22,utRho15
frc,4986878,4986878,4986508,370,16,utRho15
frdA,8764824,8764824,8764636,188,32,utRho15
frdD,8758948,8758948,8758732,216,1562,utRho15
fre,8052886,8053054,8052886,168,1108,utRho15
frlA,6999518,6999820,6999518,302,12,utRho15
frr,385624,385744,385624,120,628,utRho15
frsA,513004,513054,513004,50,52,utRho15
fruB,4527194,4527194,4526990,204,12,utRho15
frvR,8179804,8179804,8179710,94,0,utRho15
fryA,5008986,5008986,5008970,16,6,utRho15
fsaA,1727060,1727284,1727060,224,2,utRho15
fsr,1009710,1009710,1009392,318,92,utRho15
ftnA,3977364,3977432,3977364,68,2,utRho15
ftnB,3973550,3973850,3973550,300,32,utRho15
ftsA,207122,207964,207122,842,206,utRho15
ftsB,5745802,5745802,5745640,162,20,utRho15
ftsH,6654204,6654204,6653870,334,588,utRho15
ftsK,1865858,1866448,1865858,590,1272,utRho15
ftsL,181376,182064,181376,688,1312,utRho15
ftsP,6325732,6325732,6325338,394,218,utRho15
ftsQ,205484,206310,205484,826,286,utRho15
ftsX,7204512,7204512,7204172,340,744,utRho15
ftsZ,209272,210610,209272,1338,192,utRho15
fucA,5867708,5867708,5867376,332,8,utRho15
fucP,5868238,5868470,5868238,232,2,utRho15
fumA,6753760,6753760,6753508,252,7060,utRho15
fumB,8694696,8694696,8694652,44,0,utRho15
fumC,3373418,3373418,3373176,242,28,utRho15
fur,2842892,2842892,2842584,308,3064,utRho15
fusA,6947370,6947370,6947028,342,14946,utRho15
fxsA,8737206,8737328,8737206,122,318,utRho15
gabD,5581824,5582546,5581824,722,2102,utRho15
gadA,7335214,7335214,7335160,54,0,utRho15
gadB,3144144,3144144,3144090,54,4,utRho15
gadC,3141168,3141168,3140978,190,2,utRho15
gadE,7315600,7316732,7315600,1132,18,utRho15
gadW,7329562,7329562,7329236,326,38,utRho15
gadX,14663356,14663356,14663240,116,0,utRho15
gadY,7329728,7329728,7329728,0,0,utRho15
galE,1584354,1584354,1584110,244,48,utRho15
galF,4228702,4228702,4228654,48,0,utRho15
galM,1577796,1577796,1577674,122,1068,utRho15
galP,6176510,6176568,6176510,58,0,utRho15
galR,5953138,5953198,5953138,60,42,utRho15
galS,4483420,4483420,4483336,84,0,utRho15
galU,2582810,2582914,2582810,104,354,utRho15
gapA,3724480,3725542,3724480,1062,7092,utRho15
garP,6549868,6549868,6549814,54,22,utRho15
gatY,4354468,4354468,4354408,60,66,utRho15
gatZ,4352864,4352864,4352642,222,27812,utRho15
gcd,282558,282558,282450,108,0,utRho15
gcl,1067814,1067832,1067814,18,0,utRho15
gcvA,5885278,5885278,5885134,144,2,utRho15
gcvB,5885392,5885392,5885392,0,0,utRho15
gcvR,5199758,5199812,5199758,54,148,utRho15
gcvT,6101544,6101544,6101334,210,3130,utRho15
gdhA,3684616,3684742,3684616,126,0,utRho15
gfcA,2099668,2099668,2099488,180,4,utRho15
gfcD,2096236,2096236,2095890,346,12,utRho15
ghrA,2195648,2195772,2195648,124,96,utRho15
ghrB,7434378,7434620,7434378,242,500,utRho15
glcA,6242728,6242728,6242558,170,6,utRho15
glcC,6256412,6256544,6256412,132,0,utRho15
glcD,6256152,6256152,6256042,110,16,utRho15
gldA,8278092,8278092,8278070,22,26,utRho15
glgA,7136784,7136784,7136066,718,758,utRho15
glgB,7147314,7147314,7147004,310,174,utRho15
glgC,7139142,7139142,7138656,486,234,utRho15
glgP,7133546,7133546,7133162,384,344,utRho15
glgS,6384024,6384024,6383878,146,0,utRho15
glgX,7142838,7142838,7142638,200,0,utRho15
glk,5018922,5018922,5018852,70,16,utRho15
glmS,7827622,7827622,7827336,286,3004,utRho15
glmU,7830652,7830652,7830400,252,0,utRho15
glmY,10765360,10765360,10765360,0,0,utRho15
glmZ,7972864,7972864,7972864,0,0,utRho15
glnA,16232888,16232888,16232136,752,1040,utRho15
glnB,5375052,5375052,5374816,236,52,utRho15
glnD,377310,377310,377300,10,0,utRho15
glnE,6399602,6399602,6399282,320,180,utRho15
glnH,1696396,1696396,1696008,388,454,utRho15
glnK,945112,945196,945112,84,2,utRho15
glnL,8112742,8112742,8112678,64,0,utRho15
glnQ,1693262,1693262,1692926,336,760,utRho15
glnS,1411998,1412186,1411998,188,428,utRho15
gloA,3455602,3455674,3455602,72,0,utRho15
gloB,469852,469852,469564,288,1086,utRho15
glpA,4705166,4705294,4705166,128,0,utRho15
glpD,7123942,7124026,7123942,84,26,utRho15
glpE,7123698,7123698,7123646,52,112,utRho15
glpF,8236322,8236322,8236180,142,344,utRho15
glpG,7122960,7122960,7122904,56,206,utRho15
glpR,7121782,7121782,7121210,572,62,utRho15
glpT,4704902,4704902,4704748,154,480,utRho15
glpX,8231212,8231212,8231158,54,2248,utRho15
glrK,5382246,5382246,5382196,50,2,utRho15
gltA,1509534,1509534,1508936,598,12674,utRho15
gltB,6709018,6709264,6709018,246,80,utRho15
gltI,1375792,1375792,1375494,298,1356,utRho15
gltP,8588536,8588962,8588536,426,750,utRho15
gltS,7657382,7657382,7657330,52,148,utRho15
gltX,5041568,5041568,5041344,224,68,utRho15
gluQ,320286,320286,320224,62,360,utRho15
glyA,5371148,5371148,5371014,134,60,utRho15
glyQ,7450708,7450708,7450636,72,98,utRho15
glyS,7448990,7448990,7448794,196,1472,utRho15
glyU,5998128,5998128,5998114,14,0,utRho15
glyV,8784626,8784720,8784626,94,78,utRho15
glyW,3984360,3984360,3984234,126,18,utRho15
gmhB,445612,445666,445612,54,0,utRho15
gmk,7642776,7642856,7642776,80,2,utRho15
gmr,2693686,2693686,2693484,202,42,utRho15
gnd,4202648,4202648,4202536,112,496,utRho15
gnsB,3275692,3275692,3275564,128,46,utRho15
gntK,14310580,14310580,14310368,212,32,utRho15
gntP,9102668,9102668,9102592,76,2,utRho15
gntR,7157760,7157760,7157452,308,324,utRho15
gntT,7092810,7093118,7092810,308,38,utRho15
gntU,7154170,7154170,7154122,48,0,utRho15
gntX,7089334,7089764,7089334,430,54,utRho15
gor,7292224,7292598,7292224,374,368,utRho15
gpmA,1575340,1575340,1575190,150,20,utRho15
gpmM,7570374,7570520,7570374,146,0,utRho15
gpsA,7567620,7567620,7567322,298,13468,utRho15
gpt,511828,511954,511828,126,136,utRho15
grcA,5433046,5433046,5432898,148,42,utRho15
greA,6657728,6657728,6657430,298,620,utRho15
greB,7073488,7073624,7073488,136,22,utRho15
groL,8741566,8742050,8741566,484,6078,utRho15
groS,8741232,8741376,8741232,144,7810,utRho15
grpE,5501494,5501494,5501416,78,168,utRho15
grxA,1781552,1781552,1781506,46,16,utRho15
grxB,2248206,2248206,2248108,98,14,utRho15
grxC,7569152,7569152,7568884,268,6560,utRho15
grxD,3468324,3468324,3468202,122,2682,utRho15
gspA,6911268,6911268,6910796,472,4,utRho15
gspC,6910964,6911156,6910964,192,2,utRho15
gss,6277220,6277220,6277044,176,42,utRho15
gstA,3428654,3428754,3428654,100,0,utRho15
gstB,1761038,1761038,1760960,78,42,utRho15
guaB,5268214,5268214,5268140,74,86,utRho15
gudD,5839026,5839026,5838770,256,4,utRho15
gyrA,4678914,4678914,4678840,74,2,utRho15
gyrB,7760300,7760300,7760238,62,76,utRho15
hcaE,5337964,5338064,5337964,100,46,utRho15
hcaR,5337928,5337928,5337792,136,54,utRho15
hcaT,5336106,5336106,5335692,414,288,utRho15
hchA,4071260,4071670,4071260,410,34,utRho15
hcp,1828258,1828258,1827628,630,12,utRho15
hcr,1824400,1824400,1824300,100,2,utRho15
hdeA,7313582,7313582,7313480,102,0,utRho15
hdeD,7313920,7313990,7313920,70,12,utRho15
hdfR,7896320,7896320,7895934,386,414,utRho15
hdhA,3396244,3396244,3396080,164,2,utRho15
helD,2048876,2048942,2048876,66,0,utRho15
hemA,2527166,2527428,2527166,262,80,utRho15
hemB,779722,779722,779454,268,58,utRho15
hemF,5106410,5106450,5106410,40,52,utRho15
hemH,996062,996110,996062,48,4,utRho15
hemL,349882,349882,349764,118,88,utRho15
hemN,8103886,8104090,8103886,204,52,utRho15
hepA,127176,127176,126528,648,538,utRho15
hflD,2385372,2385372,2385262,110,238,utRho15
hfq,8799602,8800576,8799602,974,7618,utRho15
hha,961006,961006,960616,390,70,utRho15
hicA,3018442,3018572,3018442,130,0,utRho15
higA,6468682,6468682,6468288,394,4,utRho15
higB,6468960,6468960,6468910,50,0,utRho15
hinT,2323642,2323770,2323642,128,0,utRho15
hipB,3184964,3184964,3184884,80,32,utRho15
hisB,4186720,4186936,4186720,216,506,utRho15
hisJ,4853674,4853674,4853576,98,44,utRho15
hisL,8359856,8359984,8359856,128,20,utRho15
hisS,5281284,5281284,5281150,134,416,utRho15
hlpA,400910,400964,400910,54,170,utRho15
hlyE,2460932,2460932,2460788,144,10,utRho15
hmp,5371594,5371670,5371594,76,0,utRho15
hns,2585916,2585916,2585844,72,564,utRho15
hofM,7045856,7045856,7045502,354,2,utRho15
hokA,7441620,7441620,7441200,420,38,utRho15
hokC,33902,33902,33806,96,116,utRho15
hokE,1215462,1215672,1215462,210,0,utRho15
holC,8968546,8968546,8968560,14,452,utRho15
holD,9215562,9215606,9215562,44,0,utRho15
holE,3850040,3850216,3850040,176,80,utRho15
hpt,282720,282862,282720,142,154,utRho15
hrpB,324150,324210,324150,60,8,utRho15
hscB,5319048,5319048,5318934,114,2074,utRho15
hscC,1367188,1367188,1366786,402,1264,utRho15
hsdS,9163004,9163004,9162924,80,54,utRho15
hslJ,2883560,2883560,2883486,74,34,utRho15
hslO,7059344,7059548,7059344,204,7302,utRho15
hslR,7058220,7058696,7058220,476,950,utRho15
hslV,8244708,8244708,8244574,134,206,utRho15
hsrA,7881412,7881412,7881224,188,82,utRho15
htgA,21286,21660,21286,374,170,utRho15
htpG,989634,990240,989634,606,976,utRho15
htpX,3825236,3825236,3825152,84,0,utRho15
htrE,311036,311036,310852,184,24,utRho15
htrL,7587668,7587668,7587366,302,0,utRho15
hupA,8400352,8400562,8400352,210,144,utRho15
hupB,1845220,1845804,1845220,584,1048,utRho15
hyaA,2063968,2064278,2063968,310,0,utRho15
hybO,6292726,6292726,6292522,204,242,utRho15
hycA,5700922,5700922,5700870,52,0,utRho15
hycI,5686204,5686204,5686086,118,106,utRho15
hydN,5676264,5676264,5676210,54,0,utRho15
hyfA,5202342,5202402,5202342,60,30,utRho15
hypA,11402508,11402588,11402508,80,0,utRho15
hypB,11403356,11404004,11403356,648,304,utRho15
hypF,5676210,5676210,5674850,1360,138,utRho15
hypT,9116634,9116634,9116578,56,2,utRho15
hyuA,6019660,6020056,6019660,396,0,utRho15
iaaA,1733074,1733136,1733074,62,0,utRho15
iadA,9119074,9119074,9119052,22,58,utRho15
iap,5753072,5753162,5753072,90,0,utRho15
ibaG,6673966,6673966,6673606,360,82,utRho15
ibpA,7735036,7735036,7734844,192,1072,utRho15
ibpB,7733962,7733962,7733794,168,3402,utRho15
icd,2389922,2390246,2389922,324,272,utRho15
iclR,8447304,8447304,8447256,48,34,utRho15
idi,6065876,6066130,6065876,254,0,utRho15
idnD,8988870,8988870,8988812,58,4,utRho15
idnK,8989194,8989246,8989194,52,0,utRho15
ihfA,3591442,3591442,3591104,338,358,utRho15
ihfB,1927498,1927656,1927498,158,720,utRho15
ileS,43666,44782,43666,1116,4910,utRho15
ileX,6431194,6431196,6431194,2,0,utRho15
ilvA,15820940,15821324,15820940,384,16,utRho15
ilvC,7915824,7915940,7915824,116,2,utRho15
ilvE,15809552,15809936,15809552,384,192,utRho15
ilvI,170840,171260,170840,420,0,utRho15
ilvL,23701308,23701932,23701308,624,0,utRho15
ilvY,7915734,7915734,7915640,94,0,utRho15
inaA,4698998,4698998,4698944,54,14,utRho15
infA,1853370,1853370,1852886,484,694,utRho15
infC,3602692,3602692,3601276,1416,2690,utRho15
insA-5,3958452,3958452,3958430,22,4,utRho15
insA-7,9036758,9037054,9036758,296,98,utRho15
insC-5,6372080,6372284,6372080,204,58,utRho15
insEF-2,785238,785238,785820,582,198,utRho15
insEF-4,2190310,2190310,2190892,582,152,utRho15
insG,9007098,9007098,9006862,236,14,utRho15
insH-1,550596,550596,550234,362,178,utRho15
insH-11,7306538,7306538,7306396,142,110,utRho15
insH-2,1151548,1151548,1151506,42,272,utRho15
insH-3,1378444,1378444,1378026,418,150,utRho15
insH-4,2791942,2792152,2791942,210,134,utRho15
insH-5,2857852,2857852,2857452,400,0,utRho15
insH-6,4135022,4135022,4134642,380,46,utRho15
insH-7,4206186,4206186,4205822,364,2900,utRho15
insH-9,6260050,6260356,6260050,306,150,utRho15
insI-3,9017372,9017372,9017234,138,22,utRho15
insJ,7441188,7441360,7441188,172,18,utRho15
insK,7442130,7442308,7442130,178,0,utRho15
insL-1,30760,30890,30760,130,2378,utRho15
insL-2,1216112,1216130,1216112,18,8,utRho15
insL-3,5028644,5028662,5028644,18,44,utRho15
insN-1,540452,540484,540452,32,0,utRho15
intD,1132202,1132202,1131956,246,64,utRho15
intR,2826520,2826520,2826470,50,2,utRho15
intS,4933026,4933090,4933026,64,24,utRho15
intZ,5117386,5117542,5117386,156,42,utRho15
iraD,9113152,9113986,9113152,834,12,utRho15
iraM,2424246,2424246,2424006,240,0,utRho15
iraP,802638,802772,802638,134,0,utRho15
iscA,5319924,5319924,5319772,152,1256,utRho15
iscR,5324398,5324398,5324262,136,10460,utRho15
iscX,5313834,5313834,5313472,362,1342,utRho15
ispF,5743968,5743968,5743560,408,758,utRho15
ispG,5283908,5283908,5283608,300,600,utRho15
ispU,389568,389806,389568,238,46,utRho15
isrA,2811502,2811502,2811618,116,24,utRho15
istr-1,7706384,7706384,7706384,0,0,utRho15
istr-2,7706514,7706514,7706514,0,0,utRho15
ivbL,15412092,15412092,15411952,140,512,utRho15
ivy,480638,480686,480638,48,2,utRho15
katE,3627628,3627734,3627628,106,2,utRho15
katG,8267624,8267670,8267624,46,84,utRho15
kbaZ,6557732,6557828,6557732,96,0,utRho15
kbl,7585154,7585154,7585102,52,638,utRho15
kch,2621046,2621046,2620538,508,0,utRho15
kdgR,3820506,3820506,3820198,308,0,utRho15
kdpE,1443788,1443788,1443466,322,102,utRho15
kdpF,1457698,1457698,1457642,56,12,utRho15
kdsA,2535708,2536330,2535708,622,686,utRho15
kdsC,6683438,6684546,6683438,1108,1420,utRho15
kduI,5968388,5968388,5968248,140,74,utRho15
kefF,94160,94492,94160,332,8,utRho15
kgtP,5451624,5451624,5451492,132,10,utRho15
kup,7862206,7862632,7862206,426,10,utRho15
lacI,735076,735076,735020,56,60,utRho15
lacZ,1465508,1465508,1465220,288,12,utRho15
ldcA,2486394,2486394,2486160,234,6,utRho15
ldhA,2885830,2885830,2885686,144,0,utRho15
ldrA,2538954,2538954,2538550,404,56,utRho15
ldrB,2540024,2540024,2539620,404,14,utRho15
ldrC,2541092,2541092,2540690,402,10,utRho15
ldrD,7400544,7400544,7400174,370,110,utRho15
lepA,5414392,5414392,5414248,144,122,utRho15
lepB,5410928,5410928,5410618,310,422,utRho15
leuD,159188,159188,158906,282,0,utRho15
leuE,3761600,3761600,3761518,82,2,utRho15
leuL,168048,168048,167416,632,0,utRho15
leuO,168308,168736,168308,428,4,utRho15
leuQ,9212864,9212864,9212802,62,2,utRho15
leuU,6644556,6644556,6644316,240,1846,utRho15
leuV,9212546,9212546,9212330,216,790,utRho15
leuX,8992772,8992810,8992772,38,4,utRho15
lexA,8514174,8514230,8514174,56,14,utRho15
lhr,3456706,3458174,3456706,1468,608,utRho15
ligA,5060402,5060402,5060352,50,28,utRho15
ligB,7642576,7642576,7642340,236,26,utRho15
lipA,1320602,1320602,1320432,170,62,utRho15
lipB,1324802,1324802,1324556,246,1594,utRho15
lit,2397032,2397390,2397032,358,8,utRho15
livJ,7199524,7199524,7199316,208,30,utRho15
livK,7195510,7195510,7195120,390,22,utRho15
lldP,7554578,7554798,7554578,220,3134,utRho15
lnt,1381968,1381968,1381762,206,408,utRho15
loiP,6163784,6163826,6163784,42,8,utRho15
lolA,1874656,1874738,1874656,82,184,utRho15
lolB,2527112,2527112,2527000,112,28,utRho15
lolC,2350748,2350854,2350748,106,0,utRho15
lon,917630,917776,917630,146,268,utRho15
lpcA,486936,487086,486936,150,16,utRho15
lpd,255434,255824,255434,390,4358,utRho15
lplA,9248476,9248476,9248234,242,1082,utRho15
lplT,5947878,5947878,5947724,154,24,utRho15
lpoA,6586422,6586800,6586422,378,114,utRho15
lpp,3514592,3514842,3514592,250,168,utRho15
lptA,6686598,6686760,6686598,162,188,utRho15
lptB,6686792,6687888,6686792,1096,990,utRho15
lptD,114672,114672,114218,454,770,utRho15
lptF,8972244,8972436,8972244,192,4,utRho15
lpxC,213016,213114,213016,98,4426,utRho15
lpxD,401920,401942,401920,22,22,utRho15
lpxL,2233418,2233418,2233164,254,20,utRho15
lpxM,3880456,3880456,3880386,70,2,utRho15
lpxP,4991156,4991290,4991156,134,20,utRho15
lrhA,4813312,4813312,4813282,30,32,utRho15
lrp,1864656,1865190,1864656,534,568,utRho15
lspA,50028,50414,50028,386,714,utRho15
lsrA,3202920,3202980,3202920,60,0,utRho15
lsrR,3202514,3202514,3202482,32,2,utRho15
ltaE,1818640,1818640,1818588,52,0,utRho15
luxS,5630130,5630130,5629466,664,620,utRho15
lysA,5957902,5957902,5957798,104,0,utRho15
lysC,8467232,8467232,8466466,766,356,utRho15
lysP,4497120,4497120,4497064,56,2,utRho15
lysR,5957900,5958042,5957900,142,0,utRho15
lysT,1561028,1561108,1561028,80,60,utRho15
lysU,8709610,8709610,8709434,176,130,utRho15
macB,1840188,1840694,1840188,506,200,utRho15
maeA,3111484,3111484,3111338,146,5696,utRho15
mak,820236,820288,820236,52,24,utRho15
malE,8492928,8492928,8492838,90,34,utRho15
malI,3398456,3398456,3398360,96,0,utRho15
malK,8493472,8493568,8493472,96,2,utRho15
malP,7105020,7105020,7104946,74,142,utRho15
malQ,7100798,7100798,7100140,658,1390,utRho15
malS,14949880,14949988,14949880,108,0,utRho15
malT,7106048,7106170,7106048,122,104,utRho15
malX,3398626,3398710,3398626,84,8,utRho15
malZ,1689980,1690072,1689980,92,20,utRho15
manA,3377102,3377152,3377102,50,0,utRho15
manX,3803866,3804096,3803866,230,92,utRho15
marC,3237882,3237882,3237816,66,22,utRho15
marR,3238186,3238240,3238186,54,0,utRho15
matP,2036918,2036970,2036918,52,0,utRho15
mazE,5822736,5822736,5822678,58,10,utRho15
mazG,5821720,5821720,5821370,350,1768,utRho15
mcbA,1684306,1684306,1684112,194,0,utRho15
mcbR,3040192,3040524,3040192,332,0,utRho15
mcrA,2420278,2420692,2420278,414,2,utRho15
mcrC,9156124,9156124,9155916,208,94,utRho15
mdaB,6344814,6345060,6344814,246,8,utRho15
mdfA,1767138,1767346,1767138,208,0,utRho15
mdh,6768940,6768940,6768536,404,352,utRho15
mdoB,9198988,9198988,9198882,106,632,utRho15
mdoD,2993290,2993712,2993290,422,0,utRho15
mdoG,2218514,2218670,2218514,156,16,utRho15
mdtA,4307958,4308032,4307958,74,2,utRho15
mdtE,7318168,7318464,7318168,296,112,utRho15
mdtK,3486538,3486914,3486538,376,96,utRho15
mdtP,8602472,8602472,8602060,412,24,utRho15
melA,8683774,8683822,8683774,48,0,utRho15
melR,8683300,8683300,8683256,44,24,utRho15
menA,8240812,8240812,8240698,114,4,utRho15
menB,4753774,4753774,4753638,136,308,utRho15
mepH,3468714,3468870,3468714,156,0,utRho15
mepM,3883666,3883666,3883270,396,308,utRho15
mepS,4539840,4539958,4539840,118,132,utRho15
metA,8428318,8428560,8428318,242,6,utRho15
metB,8257272,8257344,8257272,72,798,utRho15
metC,6304150,6304472,6304150,322,12,utRho15
metE,8025768,8026106,8025768,338,282,utRho15
metF,8265092,8265232,8265092,140,0,utRho15
metG,4388538,4388600,4388538,62,74,utRho15
metH,8447010,8447656,8447010,646,1352,utRho15
metJ,8257116,8257116,8256790,326,82,utRho15
metK,6173154,6173412,6173154,258,96,utRho15
metN,445428,445428,445290,138,28,utRho15
metR,8025710,8025710,8025632,78,0,utRho15
metT,1394326,1394326,1394266,60,86,utRho15
metY,19910250,19910250,19909734,516,108,utRho15
metZ,11789528,11789548,11789528,20,16,utRho15
mfd,2348056,2348056,2347928,128,182,utRho15
mglA,4478782,4478782,4478578,204,1238,utRho15
mglB,4481132,4481132,4480696,436,24410,utRho15
mglC,4475918,4475918,4475506,412,430,utRho15
mgrB,3817584,3817584,3817532,52,0,utRho15
mgrR,3245828,3245828,3245828,0,0,utRho15
mgsA,2054082,2054082,2054030,52,58,utRho15
mgtL,8934560,8934862,8934560,302,8,utRho15
mhpA,737038,737222,737038,184,6,utRho15
mhpR,737072,737072,736840,232,38,utRho15
mhpT,750772,750918,750772,146,0,utRho15
miaA,8797964,8798504,8797964,540,396,utRho15
micA,5629604,5629604,5629604,0,0,utRho15
micC,2874242,2874238,2874242,4,0,utRho15
micF,4626168,4626168,4626168,0,0,utRho15
micM,1014408,1014408,1014408,0,0,utRho15
minE,2449422,2449422,2449090,332,2350,utRho15
mioC,7852950,7852950,7852910,40,16,utRho15
mipA,3733012,3733012,3732944,68,1826,utRho15
mlaA,4930270,4930270,4930014,256,0,utRho15
mlc,3337206,3337206,3337128,78,0,utRho15
mlrA,4429498,4429732,4429498,234,0,utRho15
mltA,5894546,5894546,5894356,190,0,utRho15
mltD,468050,468050,467910,140,0,utRho15
mltF,5391534,5391602,5391534,68,0,utRho15
mmuP,550238,550650,550238,412,220,utRho15
mngA,1531622,1531968,1531622,346,0,utRho15
mngR,1531852,1531852,1531750,102,0,utRho15
mnmG,7851348,7851348,7851266,82,368,utRho15
mntH,5025470,5025470,5025412,58,0,utRho15
mntP,3810918,3811376,3810918,458,232,utRho15
mntR,1706160,1706366,1706160,206,0,utRho15
mntS,1706128,1706128,1705994,134,2,utRho15
moaA,1633654,1634088,1633654,434,360,utRho15
moaB,1635954,1636110,1635954,156,690,utRho15
mobA,8084242,8084242,8083998,244,28,utRho15
mocA,6030112,6030320,6030112,208,28,utRho15
modA,1589990,1590178,1589990,188,2,utRho15
moeA,1732788,1732788,1732728,60,188,utRho15
mokB,2984610,2984610,2984258,352,262,utRho15
molR_1,4392888,4392948,4392888,60,4,utRho15
motA,3954604,3954604,3954278,326,2,utRho15
mpaA,2781278,2781278,2781196,82,18,utRho15
mpl,8911456,8911570,8911456,114,0,utRho15
mppA,2786108,2786454,2786108,346,32,utRho15
mprA,5621494,5621540,5621494,46,442,utRho15
mqo,4613848,4613848,4613508,340,4,utRho15
mqsA,6336742,6336742,6336492,250,458,utRho15
mqsR,6337306,6337306,6337088,218,118,utRho15
mraZ,179192,179268,179192,76,0,utRho15
mrcA,7045652,7045742,7045652,90,0,utRho15
mrcB,329442,329460,329442,18,0,utRho15
mreB,13605424,13605424,13604348,1076,1364,utRho15
mreD,6798166,6798166,6797750,416,58,utRho15
mrp,4388360,4388360,4388336,24,0,utRho15
mscK,972984,973072,972984,88,0,utRho15
mscL,6876002,6876048,6876002,46,10,utRho15
mscS,6139742,6139742,6139614,128,16,utRho15
msrA,8884522,8884522,8884352,170,254,utRho15
msrB,3725168,3725168,3724858,310,0,utRho15
msyB,2228426,2228426,2228362,64,0,utRho15
mtfA,4087236,4087302,4087236,66,2178,utRho15
mtgA,6699662,6699662,6699618,44,48,utRho15
mtlA,30177504,30178248,30177504,744,1480,utRho15
mtn,358366,358366,358306,60,6,utRho15
mtr,6611864,6611864,6611634,230,0,utRho15
mug,6430992,6430992,6430946,46,0,utRho15
murQ,5091466,5091546,5091466,80,8,utRho15
murR,5091586,5091586,5091218,368,8,utRho15
mutH,5939164,5939324,5939164,160,16,utRho15
mutL,8794092,8794824,8794092,732,232,utRho15
mutM,7622554,7622554,7622304,250,300,utRho15
mutS,5714038,5714186,5714038,148,584,utRho15
mutY,18617466,18618078,18617466,612,54,utRho15
nac,4123956,4123956,4123866,90,2,utRho15
nadA,1564122,1564170,1564122,48,0,utRho15
nadB,5420714,5420840,5420714,126,0,utRho15
nadC,237326,237326,237290,36,2,utRho15
nadE,3644604,3644916,3644604,312,4,utRho15
nadK,5501526,5501662,5501526,136,64,utRho15
nagA,1406350,1406350,1405502,848,12074,utRho15
nagB,1407416,1407416,1407222,194,110,utRho15
nagC,1404016,1404016,1403188,828,542,utRho15
nagE,1407680,1407888,1407680,208,0,utRho15
nagK,2357080,2357186,2357080,106,4,utRho15
nanA,6747240,6747240,6747152,88,108,utRho15
nanC,9079856,9079856,9079002,854,1648,utRho15
nanR,6749406,6749406,6748978,428,46,utRho15
nanS,9075406,9075406,9075188,218,356,utRho15
napF,4607390,4607390,4606994,396,0,utRho15
narG,2559614,2559728,2559614,114,2,utRho15
narK,2555642,2555914,2555642,272,2,utRho15
narP,4580844,4581000,4580844,156,30,utRho15
narQ,5171154,5171462,5171154,308,66,utRho15
narU,3088326,3088326,3088120,206,0,utRho15
narW,3077374,3077374,3074618,2756,60,utRho15
narX,2555554,2555554,2555236,318,2,utRho15
narZ,3085380,3085380,3085180,200,0,utRho15
ndh,2331984,2332170,2331984,186,0,utRho15
ndk,5289920,5289920,5289728,192,178,utRho15
nemR,6904084,6904092,6904084,8,0,utRho15
nepI,7683542,7683542,7683478,64,2,utRho15
nfo,4501612,4501680,4501612,68,114,utRho15
nfsB,1210906,1210906,1210848,58,2,utRho15
nfuA,7090916,7091248,7090916,332,516,utRho15
nhaA,34634,34978,34634,344,12,utRho15
nhaB,2469534,2469534,2469434,100,0,utRho15
nhoA,3067926,3068048,3067926,122,4,utRho15
nikA,7226878,7227334,7226878,456,176,utRho15
nikR,7237074,7237176,7237074,102,266,utRho15
nirB,6987974,6988022,6987974,48,0,utRho15
nlpA,7680034,7680034,7679986,48,0,utRho15
nlpC,3585654,3585654,3585462,192,0,utRho15
nlpD,5737658,5737658,5737506,152,14,utRho15
nlpI,6618080,6618080,6617848,232,0,utRho15
nmpC,1153740,1153740,1153650,90,50,utRho15
nohA,3273206,3273206,3272734,472,2,utRho15
norR,5664614,5664614,5664578,36,0,utRho15
norV,5664878,5664952,5664878,74,2,utRho15
nrdA,4689510,4689730,4689510,220,8752,utRho15
nrdD,8925676,8925676,8925320,356,2190,utRho15
nrdH,5601312,5601446,5601312,134,404,utRho15
nrdR,865954,866004,865954,50,2,utRho15
nrfA,8575342,8575528,8575342,186,2,utRho15
nsrR,8812088,8812380,8812088,292,458,utRho15
nudB,3897348,3897348,3897264,84,14,utRho15
nudC,8393428,8393806,8393428,378,26,utRho15
nudE,7052658,7052658,7052298,360,234,utRho15
nudG,3682876,3682980,3682876,104,12,utRho15
nudI,4729050,4729108,4729050,58,0,utRho15
nudJ,2388874,2388874,2388576,298,598,utRho15
nuoA,4810670,4810670,4810144,526,4438,utRho15
nuoN,4783434,4783434,4783010,424,1208,utRho15
nupC,5026018,5026084,5026018,66,0,utRho15
nupG,6211302,6211428,6211302,126,0,utRho15
ogrK,4335096,4335096,4335040,56,0,utRho15
ogt,2800568,2800568,2800472,96,60,utRho15
ohsC,5401036,5401040,5401036,4,0,utRho15
ompA,2040382,2040382,2040106,276,23848,utRho15
ompC,4625774,4625774,4625498,276,412,utRho15
ompF,1974184,1974184,1973964,220,472,utRho15
ompL,8128958,8128958,8128590,368,4,utRho15
ompN,2874158,2874158,2873786,372,0,utRho15
ompR,7073510,7073510,7073168,342,44,utRho15
ompT,1171330,1171330,1171266,64,50,utRho15
ompW,2627982,2628040,2627982,58,0,utRho15
ompX,1700418,1700900,1700418,482,622,utRho15
omrA,5952378,5952378,5952378,0,0,utRho15
omrB,5952770,5952770,5952770,0,0,utRho15
oppA,2602170,2602364,2602170,194,3642,utRho15
orn,8783168,8783208,8783168,40,18,utRho15
osmB,2686952,2686952,2686656,296,16,utRho15
osmC,3113192,3113250,3113192,58,132,utRho15
osmE,3644566,3644566,3644512,54,2,utRho15
osmF,4439046,4439046,4438962,84,396,utRho15
osmY,9222306,9222792,9222306,486,50,utRho15
otsA,3963302,3963302,3963224,78,0,utRho15
otsB,3964930,3964930,3964774,156,0,utRho15
oxc,4984288,4984288,4983900,388,10,utRho15
oxyR,8316914,8316980,8316914,66,4,utRho15
oxyS,8316788,8316788,8316788,0,0,utRho15
paaA,2907730,2907854,2907730,124,0,utRho15
paaX,2927018,2927078,2927018,60,18,utRho15
paaZ,2907340,2907340,2907284,56,0,utRho15
pabA,6981702,6981702,6981658,44,2,utRho15
pabB,3789256,3789610,3789256,354,120,utRho15
pabC,2306186,2306600,2306186,414,272,utRho15
pagP,1313052,1313114,1313052,62,0,utRho15
panB,299260,299260,299202,58,100,utRho15
panC,297840,297840,297590,250,218,utRho15
panD,293490,293490,293388,102,12,utRho15
panZ,7195656,7195968,7195656,312,72,utRho15
parC,6332060,6332060,6331946,114,300,utRho15
patA,6438916,6438988,6438916,72,0,utRho15
patD,3030830,3031156,3030830,326,2,utRho15
pbpC,5294986,5294986,5294650,336,6,utRho15
pbpG,4450132,4450132,4449740,392,132,utRho15
pck,7065358,7065636,7065358,278,3064,utRho15
pcnB,318782,318782,318252,530,188,utRho15
pdhR,244068,244184,244068,116,0,utRho15
pdxB,4875768,4875768,4875702,66,2,utRho15
pdxH,3436068,3436068,3436014,54,118,utRho15
pdxJ,5403626,5403626,5403458,168,54,utRho15
pdxK,5074638,5074638,5074474,164,0,utRho15
pepA,8972278,8972278,8971902,376,106,utRho15
pepD,511618,511618,511432,186,6940,utRho15
pepN,1981182,1981244,1981182,62,134,utRho15
pepQ,8062294,8062322,8062294,28,0,utRho15
pepT,2371646,2371688,2371646,42,2,utRho15
pfkA,8214948,8215104,8214948,156,102,utRho15
pfkB,3612646,3612740,3612646,94,0,utRho15
pflA,1902456,1902456,1902160,296,54,utRho15
pflB,1907850,1907850,1907108,742,1076,utRho15
pflD,8287716,8287990,8287716,274,0,utRho15
pgaA,2185046,2185046,2184578,468,0,utRho15
pgi,8467444,8467516,8467444,72,72,utRho15
pgk,12291428,12291428,12290488,940,4580,utRho15
pgl,1597078,1597172,1597078,94,0,utRho15
pgpB,2678324,2678660,2678324,336,2,utRho15
pgpC,5397276,5397276,5397100,176,0,utRho15
pgrR,2783744,2783982,2783744,238,0,utRho15
pheL,5475158,5475198,5475158,40,0,utRho15
pheM,7197204,7197204,7197080,124,0,utRho15
pheP,1203858,1203918,1203858,60,0,utRho15
pheU,8725254,8725254,8725252,2,0,utRho15
pheV,6220730,6220732,6220730,2,34,utRho15
phnC,8650412,8650412,8650330,82,18,utRho15
phoA,803414,803494,803414,80,20,utRho15
phoB,834202,834284,834202,82,8,utRho15
phoE,520316,520316,520200,116,4,utRho15
phoH,2169730,2169984,2169730,254,120,utRho15
phoP,2381016,2381016,2380894,122,1410,utRho15
phoQ,2379880,2379880,2379552,328,658,utRho15
phoU,7815330,7815330,7815156,174,36,utRho15
phr,1478842,1479014,1478842,172,0,utRho15
pinE,2419054,2419370,2419054,316,0,utRho15
pinQ,3267168,3267244,3267168,76,6,utRho15
pinR,2867424,2867424,2867348,76,6,utRho15
pitA,7275224,7275284,7275224,60,24,utRho15
pitB,6272806,6272806,6272742,64,0,utRho15
pka,5439862,5439906,5439862,44,6,utRho15
plaP,4174476,4174476,4174124,352,48,utRho15
pldA,8009628,8009724,8009628,96,46,utRho15
pldB,8018028,8018340,8018028,312,110,utRho15
plsB,8513196,8513196,8512932,264,230,utRho15
pmbA,8915890,8915918,8915890,28,0,utRho15
pmrD,4747148,4747148,4747076,72,0,utRho15
pncB,1980828,1980828,1980712,116,0,utRho15
pncC,5648788,5648788,5648692,96,0,utRho15
pnp,6622652,6622652,6622336,316,68,utRho15
pntA,3355950,3355950,3355806,144,0,utRho15
pntB,3353096,3353096,3352720,376,14,utRho15
polA,8093880,8093932,8093880,52,32,utRho15
polB,131606,131606,131560,46,0,utRho15
potD,2365700,2365700,2365658,42,26,utRho15
potE,1436688,1436688,1436530,158,2,utRho15
potF,1787268,1787568,1787268,300,18,utRho15
poxB,1822152,1822152,1822098,54,0,utRho15
ppa,8899372,8899372,8899304,68,72,utRho15
ppc,8306380,8306380,8306196,184,678,utRho15
ppdA,5928440,5928440,5928354,86,16,utRho15
ppdD,235410,235410,235098,312,14,utRho15
pphA,3846770,3846770,3845938,832,1894,utRho15
pphB,5719474,5719520,5719474,46,0,utRho15
ppiA,6984898,6984898,6984594,304,34,utRho15
ppiC,7919682,7919682,7919626,56,0,utRho15
ppiD,923638,923830,923638,192,328,utRho15
ppk,5245748,5246088,5245748,340,172,utRho15
pppA,6228958,6228958,6228704,254,0,utRho15
ppsA,3574322,3574322,3574224,98,0,utRho15
ppsR,3574678,3574890,3574678,212,0,utRho15
pptA,3065716,3066104,3065716,388,6,utRho15
pqiA,2023318,2024002,2023318,684,114,utRho15
prc,3830054,3830054,3829632,422,11574,utRho15
preT,4467978,4468066,4467978,88,142,utRho15
prfC,9218688,9218828,9218688,140,328,utRho15
prkB,6968622,6968980,6968622,358,640,utRho15
prlC,7290476,7290476,7290364,112,154,utRho15
prlF,6553944,6554004,6553944,60,150,utRho15
proB,520432,520776,520432,344,10,utRho15
proC,811372,811372,811288,84,2,utRho15
proK,7417388,7417388,7417384,4,44,utRho15
proL,4572414,4572422,4572414,8,16,utRho15
proP,8660640,8661004,8660640,364,216,utRho15
proS,437674,437674,437550,124,750,utRho15
proV,5609126,5609630,5609126,504,22,utRho15
prpB,697292,697364,697292,72,12,utRho15
prpR,696942,696942,696886,56,0,utRho15
prs,2524354,2524354,2523750,604,48290,utRho15
psd,8781276,8781276,8780720,556,1434,utRho15
psiE,8480600,8480650,8480600,50,24,utRho15
pspA,2736076,2736158,2736076,82,0,utRho15
pspF,2736080,2736080,2735824,256,0,utRho15
pspG,8525632,8525680,8525632,48,0,utRho15
pssA,5445156,5445454,5445156,298,4202,utRho15
pstB,7817112,7817112,7816732,380,140,utRho15
pstC,7821084,7821084,7820796,288,28,utRho15
pstS,23469408,23469408,23469150,258,90,utRho15
psuG,4517114,4517114,4516734,380,1144,utRho15
psuT,4514992,4514992,4514670,322,0,utRho15
pth,2517084,2517084,2517026,58,0,utRho15
ptrA,5918022,5918022,5917768,254,0,utRho15
ptrB,3857730,3857730,3857678,52,166,utRho15
ptsG,2315252,2315738,2315252,486,642,utRho15
ptsH,5066996,5067528,5066996,532,3370,utRho15
purA,8809328,8809374,8809328,46,0,utRho15
purC,5195562,5195562,5195236,326,60,utRho15
purD,8411972,8411972,8411862,110,38,utRho15
purE,1106284,1106284,1106200,84,144,utRho15
purH,8415254,8415254,8415064,190,0,utRho15
purL,5391178,5391178,5391086,92,378,utRho15
purM,5242306,5242394,5242306,88,14,utRho15
purR,3475378,3475688,3475378,310,182,utRho15
purT,3861438,3861762,3861438,324,2,utRho15
purU,2577512,2577512,2577248,264,322,utRho15
putA,2157850,2157850,2157764,86,0,utRho15
putP,2158336,2158610,2158336,274,1190,utRho15
puuA,2721936,2721936,2721816,120,0,utRho15
puuC,2725456,2725486,2725456,30,0,utRho15
puuD,2722104,2722240,2722104,136,0,utRho15
puuP,2718746,2718746,2718374,372,302,utRho15
pykA,3874988,3875298,3874988,310,154,utRho15
pykF,3510934,3511396,3510934,462,292,utRho15
pyrC,2245286,2245286,2245214,72,60,utRho15
pyrD,2009464,2009536,2009464,72,46,utRho15
pyrE,7631970,7631970,7631536,434,2,utRho15
pyrF,2683740,2683842,2683740,102,218,utRho15
pyrG,5819594,5819594,5819332,262,390,utRho15
pyrH,383624,383710,383624,86,538,utRho15
pyrL,8945490,8945490,8945066,424,52,utRho15
qmcA,1031646,1031646,1031546,100,20,utRho15
qor,8528608,8528608,8528462,146,72,utRho15
qseB,6339502,6339656,6339502,154,10,utRho15
queA,849970,850022,849970,52,70,utRho15
queE,5811212,5811212,5810836,376,4,utRho15
queF,5850642,5850696,5850642,54,0,utRho15
queG,8788184,8788184,8788134,50,1134,utRho15
racC,2835630,2835630,2835526,104,0,utRho15
racR,2840898,2840898,2840482,416,24,utRho15
raiA,5474208,5474308,5474208,100,2,utRho15
rarD,8008594,8008594,8008356,238,208,utRho15
ravA,7862256,7862256,7862186,70,26,utRho15
rayT,495088,495274,495088,186,2,utRho15
rbn,4763162,4763216,4763162,54,0,utRho15
rbsD,7866644,7866702,7866644,58,20,utRho15
rcnA,4371654,4371834,4371654,180,0,utRho15
rcnB,4373768,4373920,4373768,152,34,utRho15
rcnR,4371806,4371806,4371592,214,0,utRho15
rcsA,4047672,4047936,4047672,264,26,utRho15
rcsB,4631390,4632354,4631390,964,714,utRho15
rcsC,4640162,4640162,4639656,506,144,utRho15
rcsD,4626904,4626976,4626904,72,30,utRho15
rdgB,6193240,6193362,6193240,122,292,utRho15
rdlA,2538646,2538646,2538646,0,0,utRho15
rdlB,2539712,2539716,2539712,4,0,utRho15
rdlC,2540782,2540786,2540782,4,0,utRho15
rdlD,7400272,7400272,7400272,0,0,utRho15
rdoA,8084782,8084830,8084782,48,64,utRho15
recA,11295276,11295276,11295076,200,472,utRho15
recC,5925014,5925014,5924856,158,56,utRho15
recF,7763722,7763722,7762442,1280,2780,utRho15
recN,5503518,5503590,5503518,72,0,utRho15
recQ,8011666,8011728,8011666,62,54,utRho15
relA,5828554,5828554,5827302,1252,348,utRho15
relB,3291806,3291806,3291744,62,0,utRho15
rem,3289950,3289950,3289804,146,0,utRho15
rep,7921294,7921354,7921294,60,26,utRho15
rfaD,7587730,7587974,7587730,244,6,utRho15
rfaE,6393852,6393852,6393506,346,68,utRho15
rfaH,8049930,8049930,8049642,288,752,utRho15
rfbX,4219436,4219436,4219168,268,762,utRho15
rfe,7935600,7935832,7935600,232,20,utRho15
rhaB,8194944,8194944,8194896,48,2,utRho15
rhaD,8188770,8188770,8188544,226,0,utRho15
rhaS,8195422,8195472,8195422,50,0,utRho15
rhaT,8201132,8201132,8201050,82,2,utRho15
rhlE,1661566,1661744,1661566,178,4,utRho15
rhoL,47593944,47594772,47593944,828,16680,utRho15
rhsB,7238006,7238384,7238006,378,10,utRho15
rhsC,1458758,1459166,1458758,408,0,utRho15
rhsD,1046132,1046522,1046132,390,0,utRho15
rhtA,1700608,1700608,1700194,414,50,utRho15
rhtC,8015478,8015514,8015478,36,350,utRho15
ribA,2678468,2678468,2678320,148,2,utRho15
ribC,3486916,3486916,3486484,432,126,utRho15
ribE,869008,869294,869008,286,6556,utRho15
ribF,42766,42814,42766,48,0,utRho15
ridA,8941892,8941892,8941826,66,18,utRho15
rihA,1369204,1369204,1368824,380,248,utRho15
rihB,4510504,4510504,4510372,132,0,utRho15
rimJ,2251044,2251124,2251044,80,38,utRho15
rimK,1783752,1783934,1783752,182,510,utRho15
rimL,2997486,2997876,2997486,390,246,utRho15
rimO,1756140,1756140,1756070,70,2,utRho15
rimP,6636350,6636350,6636012,338,470,utRho15
rlmA,3814172,3814172,3814120,52,260,utRho15
rlmD,5830086,5830086,5830000,86,80,utRho15
rlmE,6655520,6655520,6655328,192,498,utRho15
rlmF,1684384,1684664,1684384,280,0,utRho15
rlmG,6471784,6471784,6471750,34,0,utRho15
rlmI,2060002,2060002,2059938,64,0,utRho15
rlmJ,7290700,7290770,7290700,70,62,utRho15
rlmL,2015344,2015688,2015344,344,844,utRho15
rlpA,1330444,1330444,1330380,64,68,utRho15
rluA,120900,120900,120692,208,22,utRho15
rluF,8460324,8460708,8460324,384,0,utRho15
rmf,2031006,2031430,2031006,424,274,utRho15
rna,1290068,1290068,1290006,62,0,utRho15
rnb,2698258,2698258,2697824,434,1000,utRho15
rnc,10816892,10816892,10816252,640,2308,utRho15
rnd,3776122,3776122,3775982,140,60,utRho15
rne,2289746,2289746,2288734,1012,6064,utRho15
rnhA,472082,472082,472004,78,218,utRho15
rnk,1288360,1288360,1287934,426,52,utRho15
rnlA,5531788,5531836,5531788,48,18,utRho15
rnlB,5533414,5533968,5533414,554,158,utRho15
rnpB,19623552,19623552,19623552,0,0,utRho15
rob,9270706,9270706,9270620,86,0,utRho15
rodZ,5285868,5285868,5285688,180,34,utRho15
rpe,7030306,7030306,7030118,188,78,utRho15
rph,15266320,15266320,15266196,124,32,utRho15
rpiA,6118706,6118706,6118650,56,94,utRho15
rpiB,8626514,8626700,8626514,186,0,utRho15
rpiR,8626274,8626274,8625982,292,0,utRho15
rplJ,8359246,8359992,8359246,746,4884,utRho15
rplK,8356708,8356894,8356708,186,540,utRho15
rplM,6757344,6757344,6757302,42,6340,utRho15
rplN,6896444,6896444,6896298,146,4258,utRho15
rplS,5489284,5489284,5489060,224,6540,utRho15
rplT,7199052,7199052,7198996,56,268,utRho15
rplU,6667036,6667036,6666902,134,50,utRho15
rplY,4564866,4565034,4564866,168,52,utRho15
rpmA,6666450,6666450,6666238,212,416,utRho15
rpmB,15247980,15247980,15246696,1284,50028,utRho15
rpmE,8253816,8254026,8253816,210,170,utRho15
rpmF,2294676,2294734,2294676,58,21544,utRho15
rpmH,7768130,7768672,7768130,542,2584,utRho15
rpmI,3600854,3600854,3599998,856,8632,utRho15
rpoB,8362126,8362490,8362126,364,118,utRho15
rpoD,6424946,6426094,6424946,1148,14266,utRho15
rpoE,5420372,5420372,5420024,348,2,utRho15
rpoH,7202006,7202006,7201566,440,1472,utRho15
rpoN,6689324,6689434,6689324,110,36,utRho15
rpoS,5736236,5736236,5735102,1134,3616,utRho15
rpoZ,7644154,7644212,7644154,58,206,utRho15
rppH,5937986,5937986,5937954,32,0,utRho15
rprA,3540744,3540744,3540744,0,0,utRho15
rpsA,1923434,1923990,1923434,556,73202,utRho15
rpsF,8850050,8850236,8850050,186,16464,utRho15
rpsI,6756580,6756580,6756414,166,4522,utRho15
rpsJ,6906884,6906884,6906540,344,6122,utRho15
rpsL,6949242,6949242,6949104,138,496,utRho15
rpsM,6885130,6885130,6884942,188,812,utRho15
rpsO,13247144,13247144,13246736,408,632,utRho15
rpsP,5492508,5492508,5492370,138,206,utRho15
rpsT,42420,42420,42156,264,576,utRho15
rpsU,12842584,12843124,12842584,540,1616,utRho15
rraA,8238716,8238716,8238660,56,176,utRho15
rraB,8956768,8956946,8956768,178,2,utRho15
rrsA,8070478,8071062,8070478,584,6058,utRho15
rrsB,16665468,16666636,16665468,1168,12692,utRho15
rrsC,7883032,7883616,7883032,584,5200,utRho15
rrsD,6858094,6858094,6857524,570,362,utRho15
rrsE,8415726,8416294,8415726,568,610,utRho15
rrsG,5462896,5462896,5462314,582,4716,utRho15
rrsH,446970,447542,446970,572,1544,utRho15
rsd,8393908,8393908,8393616,292,30,utRho15
rseA,5419264,5419264,5418808,456,548,utRho15
rseP,392940,393092,392940,152,0,utRho15
rseX,4067298,4067298,4067298,0,0,utRho15
rsfS,1338144,1338144,1338072,72,56,utRho15
rsgA,8783132,8783132,8783018,114,132,utRho15
rsmA,105176,105176,104860,316,1570,utRho15
rsmB,6869982,6870414,6869982,432,376,utRho15
rsmC,9215736,9215736,9215400,336,124,utRho15
rsmD,7208594,7208786,7208594,192,82,utRho15
rsmE,6182036,6182268,6182036,232,170,utRho15
rsmG,7847512,7847512,7847360,152,218,utRho15
rsmH,180020,180188,180020,168,140,utRho15
rsmI,6587106,6587106,6586670,436,932,utRho15
rssA,2578212,2578412,2578212,200,236,utRho15
rssB,2580440,2580484,2580440,44,108,utRho15
rstA,3364276,3364300,3364276,24,0,utRho15
rsuA,4561096,4561096,4560966,130,108,utRho15
rsxA,3411510,3411534,3411510,24,8,utRho15
rtcA,7114004,7114004,7113698,306,24,utRho15
rtcB,7116214,7116214,7116158,56,0,utRho15
rtn,4541356,4541452,4541356,96,0,utRho15
rutA,2148052,2148052,2148022,30,0,utRho15
rutG,2140090,2140090,2139678,412,0,utRho15
rutR,2148226,2148484,2148226,258,0,utRho15
ruvA,7784096,7784096,7783904,192,0,utRho15
ruvB,7782176,7782176,7781424,752,736,utRho15
ruvC,3894878,3894878,3894752,126,34,utRho15
rybB,1776114,1776114,1776114,0,0,utRho15
rydB,3529860,3529860,3529322,538,74,utRho15
rydC,2983012,2983012,2983012,0,0,utRho15
ryfA,5307398,5307710,5307398,312,0,utRho15
ryfD,5468590,5468590,5468590,0,0,utRho15
ryhB,7162032,7162032,7162032,0,0,utRho15
ryjA,8556132,8556132,8556132,0,0,utRho15
ryjB,9055954,9055954,9055954,0,0,utRho15
sad,3229598,3229598,3229406,192,4,utRho15
safA,3168056,3168056,3167918,138,4,utRho15
sanA,4465368,4465756,4465368,388,100,utRho15
sapF,2705314,2705314,2705268,46,38,utRho15
sbcB,4165456,4165512,4165456,56,0,utRho15
sbcC,831694,831694,831506,188,102,utRho15
sbcD,833954,833954,833904,50,42,utRho15
sbmA,793106,793278,793106,172,8,utRho15
sbmC,4162650,4162650,4162524,126,0,utRho15
sdaA,3793618,3793864,3793618,246,86,utRho15
sdaC,5856070,5856458,5856070,388,1494,utRho15
sdhC,1509916,1510354,1509916,438,54518,utRho15
sdhD,1510808,1511120,1510808,312,11658,utRho15
sdiA,3993834,3993834,3993664,170,50,utRho15
secE,8354354,8354716,8354354,362,68,utRho15
secG,6645180,6645180,6645010,170,938,utRho15
selA,7522594,7522594,7522498,96,316,utRho15
selB,7519850,7519850,7519722,128,150,utRho15
selC,7672396,7672444,7672396,48,4,utRho15
selD,3696058,3696058,3696016,42,1366,utRho15
seqA,1425884,1425974,1425884,90,520,utRho15
serA,6117098,6117098,6116820,278,2,utRho15
serB,9249712,9249790,9249712,78,24,utRho15
serC,3830380,3830612,3830380,232,0,utRho15
serS,1878730,1878856,1878730,126,622,utRho15
serT,2063438,2063438,2063424,14,0,utRho15
serU,4087124,4087124,4087114,10,382,utRho15
serV,5637394,5637394,5637290,104,0,utRho15
serW,1852014,1852014,1851942,72,32,utRho15
serX,2195352,2195352,2195304,48,14,utRho15
setB,4527426,4527726,4527426,300,0,utRho15
setC,7673488,7673906,7673488,418,12,utRho15
sfmA,1116124,1116424,1116124,300,0,utRho15
sfmC,1117606,1117948,1117606,342,0,utRho15
sfsA,323030,323030,322972,58,460,utRho15
sfsB,6669592,6669818,6669592,226,46,utRho15
sgrR,154676,154676,154598,78,2,utRho15
sgrS,154734,154734,154734,0,0,utRho15
shiA,4107068,4107286,4107068,218,0,utRho15
sibA,4306622,4306622,4306622,0,0,utRho15
sibB,4307292,4307292,4307292,0,0,utRho15
sibC,6113702,6113702,6113702,0,0,utRho15
sibD,6389730,6389730,6389730,0,0,utRho15
sibE,6390480,6390480,6390480,0,0,utRho15
sixA,4913998,4913998,4913624,374,28,utRho15
slp,7307872,7307922,7307872,50,0,utRho15
slt,9261400,9261466,9261400,66,4,utRho15
slyA,3442028,3442028,3441648,380,8,utRho15
slyB,3439496,3439752,3439496,256,0,utRho15
slyD,6957398,6957398,6956994,404,556,utRho15
slyX,6954862,6955280,6954862,418,5042,utRho15
smf,6867372,6867372,6867120,252,6,utRho15
smpB,5509534,5509792,5509534,258,548,utRho15
smrA,2811872,2811958,2811872,86,74,utRho15
smrB,4896872,4897212,4896872,340,28,utRho15
smtA,1946808,1947074,1946808,266,44,utRho15
sodA,8201518,8201620,8201518,102,8702,utRho15
sodB,3470646,3470756,3470646,110,10,utRho15
sodC,3449358,3449358,3449310,48,36,utRho15
sohB,2658568,2658664,2658568,96,22,utRho15
sokB,2984232,2984238,2984232,6,90,utRho15
solA,2241218,2241218,2241172,46,0,utRho15
soxR,8554894,8554938,8554894,44,0,utRho15
soxS,8554846,8554846,8554766,80,0,utRho15
speA,6172096,6172096,6171822,274,64,utRho15
speB,6167892,6167892,6167594,298,108,utRho15
speC,6218350,6218350,6218310,40,0,utRho15
spf,8099798,8099798,8099798,0,0,utRho15
sppA,3697422,3697674,3697422,252,12,utRho15
spy,3651376,3651376,3651250,126,34,utRho15
sra,3112092,3112092,3111926,166,0,utRho15
sraB,2293178,2293178,2293178,0,0,utRho15
sraC,3846132,3846132,3846132,0,0,utRho15
srlA,5651582,5651664,5651582,82,0,utRho15
srlR,5657720,5658094,5657720,374,2416,utRho15
srmB,5425752,5425792,5425752,40,128,utRho15
sroA,151216,151216,151216,0,0,utRho15
sroG,6369436,6369436,6369436,0,0,utRho15
sroH,8380974,8380974,8380974,0,0,utRho15
ssb,8548022,8548250,8548022,228,54,utRho15
sseA,5304782,5304988,5304782,206,13390,utRho15
sspA,6755138,6755138,6754840,298,526,utRho15
ssrA,5511014,5511186,5511014,172,70,utRho15
ssrS,12223036,12223932,12223036,896,1460,utRho15
sstT,6479726,6479888,6479726,162,16,utRho15
ssuB,1988282,1988282,1988088,194,2,utRho15
ssuE,1995126,1995126,1995024,102,0,utRho15
sthA,8321604,8321604,8321580,24,2130,utRho15
stpA,5597156,5597156,5596990,166,0,utRho15
sucA,3034344,3034824,3034344,480,5828,utRho15
sufA,3528836,3528836,3528772,64,20,utRho15
sufE,3518962,3518962,3518580,382,120,utRho15
sugE,8753588,8753750,8753588,162,52,utRho15
sulA,2041894,2041894,2041838,56,40,utRho15
syd,5850738,5850738,5850560,178,0,utRho15
symE,9159834,9159834,9159680,154,14,utRho15
symR,9159670,9159670,9159670,0,0,utRho15
tabA,8949566,8949724,8949566,158,2,utRho15
talA,5157140,5157332,5157140,192,0,utRho15
talB,16382,16476,16382,94,8350,utRho15
tam,3214442,3214692,3214442,250,120,utRho15
tamA,8884540,8884764,8884540,224,74,utRho15
tar,3945432,3945432,3945382,50,2,utRho15
tas,5943138,5943194,5943138,56,114,utRho15
tatA,16087636,16087780,16087636,144,40,utRho15
tatE,1317742,1317894,1317742,152,0,utRho15
tauA,770410,770464,770410,54,0,utRho15
tdcA,6534186,6534186,6534130,56,0,utRho15
tdcG,6519652,6519652,6519298,354,206,utRho15
tdcR,6534380,6534760,6534380,380,0,utRho15
tdk,2586986,2587054,2586986,68,24,utRho15
tehA,3001072,3001146,3001072,74,0,utRho15
tesA,1039898,1039898,1039530,368,130,utRho15
tesB,950402,950402,950322,80,0,utRho15
tfaE,2418532,2418532,2418238,294,12,utRho15
tfaQ,3269912,3269912,3269770,142,2,utRho15
tff,379424,379256,379424,168,30,utRho15
tgt,852110,852274,852110,164,0,utRho15
thiD,4369346,4369346,4369032,314,2,utRho15
thiI,882936,883098,882936,162,270,utRho15
thiM,4370902,4370902,4370602,300,44,utRho15
thiQ,146170,146170,145854,316,192,utRho15
thrL,592,760,592,168,80,utRho15
thrS,7210932,7210932,7210280,652,288,utRho15
thrU,8350762,8350776,8350762,14,16,utRho15
thrV,6847414,6847414,6847310,104,92968,utRho15
thrW,525682,525742,525682,60,36,utRho15
thyA,5930696,5930696,5930310,386,1290,utRho15
tig,909986,910266,909986,280,692,utRho15
tisB,7706674,7707106,7706674,432,420,utRho15
tktA,6163414,6163414,6163270,144,124,utRho15
tktB,5158616,5159272,5158616,656,706,utRho15
tldD,6784368,6784368,6784056,312,16,utRho15
tmcA,5191876,5191876,5191718,158,0,utRho15
tnaC,15553644,15553740,15553644,96,4800,utRho15
tolB,1555074,1555480,1555074,406,226,utRho15
tolC,6356008,6356230,6356008,222,444,utRho15
tomB,961588,961588,961416,172,190,utRho15
tonB,2622108,2622178,2622108,70,0,utRho15
topA,2661578,2662096,2661578,518,198,utRho15
torC,2116112,2116168,2116112,56,74,utRho15
torR,2115968,2115968,2115908,60,90,utRho15
torS,2112364,2112364,2112356,8,0,utRho15
torT,2112414,2112522,2112414,108,0,utRho15
tpiA,8223138,8223138,8223014,124,158,utRho15
tppB,3425342,3425538,3425342,196,3094,utRho15
tpr,2574376,2574376,2574376,0,0,utRho15
tpx,2777688,2777688,2777622,66,118,utRho15
tqsA,3347780,3347826,3347780,46,4,utRho15
treA,2494850,2494850,2494752,98,8,utRho15
treB,8932420,8932420,8932360,60,230,utRho15
treF,7339102,7339184,7339102,82,4,utRho15
treR,8934694,8934694,8934492,202,10,utRho15
trg,2984878,2984940,2984878,62,0,utRho15
trkG,2847342,2847564,2847342,222,2,utRho15
trmA,8326590,8326590,8326540,50,22,utRho15
trpA,2634678,2634678,2634444,234,378,utRho15
trpC,2639888,2639888,2639570,318,116,utRho15
trpL,5292432,5292432,5292328,104,0,utRho15
trpR,9265408,9265520,9265408,112,108,utRho15
trpS,7027394,7027394,7027276,118,1786,utRho15
trpT,7893560,7893914,7893560,354,62544,utRho15
trxA,7931294,7931522,7931294,228,358,utRho15
trxB,1864156,1864156,1864100,56,28,utRho15
trxC,5437350,5437470,5437350,120,52,utRho15
tsaD,6421256,6421256,6421086,170,10,utRho15
tsgA,6985038,6985136,6985038,98,0,utRho15
tsr,9182824,9183314,9182824,490,52,utRho15
tsx,864490,864490,864026,464,852,utRho15
ttcA,2823970,2823970,2823896,74,1176,utRho15
ttdA,6412848,6412926,6412848,78,0,utRho15
ttdR,6412760,6412760,6412512,248,2,utRho15
tufA,6943448,6943448,6942658,790,138074,utRho15
tus,3368346,3368518,3368346,172,2,utRho15
tusA,7218040,7218040,7217992,48,58,utRho15
tusB,6950218,6950218,6949930,288,444,utRho15
tynA,2902996,2902996,2902698,298,0,utRho15
typA,8116460,8116814,8116460,354,2040,utRho15
tyrB,8534164,8534228,8534164,64,2082,utRho15
tyrP,3979004,3979362,3979004,358,10,utRho15
tyrR,2773384,2773440,2773384,56,36,utRho15
tyrS,3434566,3434566,3434444,122,0,utRho15
tyrT,2575330,2575330,2575244,86,62,utRho15
uacT,6062378,6062734,6062378,356,30,utRho15
ubiC,8504886,8505012,8504886,126,2,utRho15
ubiD,8049618,8049976,8049618,358,758,utRho15
ubiE,8037494,8037710,8037494,216,128,utRho15
ubiG,4679078,4679134,4679078,56,0,utRho15
ucpA,5089342,5089342,5089246,96,66,utRho15
udp,8032782,8032862,8032782,80,0,utRho15
ugd,4199470,4199470,4199226,244,0,utRho15
ugpB,7184852,7184852,7184650,202,262,utRho15
ugpQ,7176600,7176600,7176226,374,52,utRho15
uhpT,7694396,7694396,7694334,62,6,utRho15
uidA,3392304,3392304,3392142,162,0,utRho15
uidC,3386012,3386012,3385702,310,0,utRho15
uidR,3394150,3394150,3394104,46,80,utRho15
ulaA,8839854,8839960,8839854,106,26,utRho15
ulaG,8839350,8839350,8839250,100,0,utRho15
ulaR,8837124,8837124,8836906,218,4,utRho15
umpG,5741372,5741372,5740548,824,100,utRho15
umpH,1400704,1400704,1400652,52,82,utRho15
umuD,2461476,2461534,2461476,58,0,utRho15
ung,5433476,5433508,5433476,32,2,utRho15
uof,2843316,2843316,2842900,416,3152,utRho15
upp,5241818,5241818,5241744,74,308,utRho15
usg,4873780,4873780,4873298,482,120,utRho15
ushA,1009772,1009828,1009772,56,0,utRho15
uspA,7279966,7280222,7279966,256,526,utRho15
uspB,7279696,7279696,7279440,256,58,utRho15
uspC,3959172,3959506,3959172,334,0,utRho15
uspE,2797318,2797318,2797244,74,8,utRho15
uspF,2871282,2871282,2871238,44,0,utRho15
uspG,1283806,1283806,1283734,72,76,utRho15
uvrA,8547872,8547872,8547742,130,42,utRho15
uvrB,1626304,1627052,1626304,748,838,utRho15
uvrC,3989758,3989758,3989412,346,94,utRho15
uvrD,7995814,7995966,7995814,152,122,utRho15
uvrY,3990812,3990812,3990718,94,2,utRho15
uxaB,3221474,3221474,3221360,114,0,utRho15
uxaC,6489714,6489714,6489482,232,38,utRho15
uxuA,9103036,9103272,9103036,236,646,utRho15
uxuR,9108916,9109152,9108916,236,18,utRho15
valS,8967854,8967854,8967674,180,296,utRho15
valU,5041848,5041862,5041848,14,20,utRho15
valV,3492830,3492870,3492830,40,24,utRho15
ves,3649968,3649968,3649874,94,14,utRho15
waaA,7616512,7617080,7616512,568,166,utRho15
waaH,7580298,7580298,7580162,136,6,utRho15
waaQ,7616476,7616476,7616196,280,58,utRho15
waaU,7598996,7598996,7598624,372,80,utRho15
waaY,7602272,7602272,7601930,342,2340,utRho15
wbbH,4214888,4214888,4214452,436,978,utRho15
wbbK,4209212,4209212,4209018,194,132,utRho15
wcaM,4231868,4231868,4231792,76,0,utRho15
wrbA,2135516,2135516,2135416,100,2,utRho15
wza,4275166,4275166,4274486,680,4,utRho15
wzxC,4240674,4240674,4240316,358,0,utRho15
wzzB,4196950,4196950,4196602,348,26,utRho15
xanP,7657642,7657890,7657642,248,0,utRho15
xanQ,6048520,6048702,6048520,182,0,utRho15
xapA,5049820,5049820,5049756,64,0,utRho15
xapR,10090252,10090252,10089908,344,0,utRho15
xdhA,6000514,6000690,6000514,176,38,utRho15
xerD,6079702,6079702,6079486,216,0,utRho15
xseA,5268394,5268464,5268394,70,46,utRho15
xseB,882746,882746,882686,60,330,utRho15
xthA,3664798,3664856,3664798,58,0,utRho15
xylA,7461614,7461614,7461530,84,632,utRho15
xylE,8484540,8484540,8484508,32,0,utRho15
xylF,7462138,7462262,7462138,124,4,utRho15
xylR,7469812,7469958,7469812,146,44,utRho15
yaaA,13230,13230,12918,312,22,utRho15
yaaI,23876,23876,23572,304,6,utRho15
yaaJ,16034,16034,15918,116,0,utRho15
yaaU,91184,91614,91184,430,50,utRho15
yaaW,23084,23084,22712,372,4,utRho15
yaaX,10060,10468,10060,408,34,utRho15
yabI,142542,142702,142542,160,0,utRho15
yacC,273880,273880,273834,46,390,utRho15
yacH,262932,262932,262520,412,12,utRho15
yacL,268678,268776,268678,98,0,utRho15
yadD,293796,293936,293796,140,0,utRho15
yadE,289930,290162,289930,232,6,utRho15
yadN,314110,314110,313766,344,0,utRho15
yadS,355572,355572,355248,324,76,utRho15
yadV,312470,312470,312402,68,48,utRho15
yaeF,434270,434270,434006,264,0,utRho15
yaeP,428374,428374,428250,124,8,utRho15
yaeQ,428176,428582,428176,406,12,utRho15
yaeR,423716,423754,423716,38,24,utRho15
yafC,462166,462166,461762,404,114,utRho15
yafD,462128,462244,462128,116,120,utRho15
yafK,491986,491986,491610,376,326,utRho15
yafL,493282,493424,493282,142,10,utRho15
yafN,503938,504010,503938,72,4,utRho15
yafS,469568,469632,469568,64,476,utRho15
yafT,474470,474670,474470,200,0,utRho15
yafV,480432,480432,480378,54,2,utRho15
yafZ,536052,536052,536010,42,2,utRho15
yagE,564446,564556,564446,110,12,utRho15
yagG,570414,570790,570414,376,4,utRho15
yagI,578384,578384,578324,60,2,utRho15
yagK,586236,586236,585896,340,48,utRho15
yagL,588062,588062,587836,226,6,utRho15
yagN,591342,591342,591158,184,292,utRho15
yahA,663746,664742,663746,996,12,utRho15
yahC,670136,670136,670044,92,8,utRho15
yahE,671478,671850,671478,372,0,utRho15
yahM,690504,690808,690504,304,0,utRho15
yahN,692872,692872,692674,198,6,utRho15
yahO,692864,692968,692864,104,0,utRho15
yaiE,816296,816354,816296,58,14,utRho15
yaiI,811396,811528,811396,132,0,utRho15
yaiO,761946,761946,761684,262,6,utRho15
yaiP,767970,767970,767870,100,8,utRho15
yaiS,769660,769660,769232,428,0,utRho15
yaiV,788922,788922,788922,0,0,utRho15
yaiY,799094,799094,798666,428,0,utRho15
yaiZ,798888,799186,798888,298,0,utRho15
yajC,854410,854574,854410,164,426,utRho15
yajD,860938,861210,860938,272,198,utRho15
yajI,866068,866068,865702,366,208,utRho15
yajL,887496,887496,887282,214,508,utRho15
yajQ,889316,889366,889316,50,0,utRho15
yajR,893374,893374,893332,42,110,utRho15
ybaB,987418,988152,987418,734,2226,utRho15
ybaL,1006590,1006590,1006476,114,4,utRho15
ybaM,980648,980648,980542,106,48,utRho15
ybaN,981436,981764,981436,328,332,utRho15
ybaO,936704,936766,936704,62,0,utRho15
ybaP,1016568,1016568,1016160,408,352,utRho15
ybaQ,1016348,1016436,1016348,88,0,utRho15
ybaS,1023146,1023282,1023146,136,58,utRho15
ybaV,927504,927874,927504,370,204,utRho15
ybaY,950490,950758,950490,268,52,utRho15
ybbB,1062724,1062724,1062452,272,28,utRho15
ybbJ,1030154,1030154,1029718,436,148,utRho15
ybbL,1031784,1031838,1031784,54,0,utRho15
ybbN,1037136,1037136,1036558,578,1588,utRho15
ybbO,1038658,1038658,1038298,360,438,utRho15
ybbY,1080718,1081130,1080718,412,8,utRho15
ybcH,1176140,1176140,1175962,178,4,utRho15
ybcI,1113264,1113264,1113106,158,134,utRho15
ybcJ,1114050,1114050,1113746,304,262,utRho15
ybcK,1137502,1137804,1137502,302,4,utRho15
ybcL,1141690,1141786,1141690,96,0,utRho15
ybcN,1144628,1144932,1144628,304,0,utRho15
ybcQ,1147548,1147912,1147548,364,2,utRho15
ybcW,1159610,1159760,1159610,150,0,utRho15
ybdD,1263982,1264364,1263982,382,28,utRho15
ybdF,1212106,1212106,1211772,334,104,utRho15
ybdH,1267048,1267048,1266954,94,0,utRho15
ybdJ,1212822,1212822,1212398,424,46,utRho15
ybdK,1215122,1215122,1214766,356,24,utRho15
ybdL,1267114,1267172,1267114,58,30,utRho15
ybdM,1271110,1271110,1270752,358,8,utRho15
ybdN,1273372,1273372,1273138,234,4,utRho15
ybdR,1283844,1284176,1283844,332,96,utRho15
ybeD,1325412,1325412,1325284,128,292,utRho15
ybeF,1323090,1323090,1322756,334,10,utRho15
ybeL,1349986,1350036,1349986,50,112,utRho15
ybeQ,1353412,1353412,1353094,318,0,utRho15
ybeR,1353120,1353422,1353120,302,0,utRho15
ybeT,1358832,1358832,1358812,20,0,utRho15
ybeU,1358924,1359016,1358924,92,0,utRho15
ybeZ,1386938,1386938,1386834,104,690,utRho15
ybfA,1458074,1458268,1458074,194,6,utRho15
ybfE,1423878,1423878,1423796,82,34,utRho15
ybfF,1425692,1425692,1425604,88,72,utRho15
ybfH,1433282,1433282,1433194,88,0,utRho15
ybgA,1477840,1478002,1477840,162,0,utRho15
ybgC,1549288,1549504,1549288,216,0,utRho15
ybgD,1505916,1505916,1505590,326,108,utRho15
ybgI,1485238,1485654,1485238,416,0,utRho15
ybgO,1498370,1498370,1497964,406,8,utRho15
ybgS,1570992,1570992,1570634,358,2,utRho15
ybhA,1597184,1597184,1596862,322,0,utRho15
ybhB,1616070,1616070,1615818,252,140,utRho15
ybhC,1614642,1614642,1614562,80,1462,utRho15
ybhD,1601418,1601418,1601276,142,0,utRho15
ybhH,1601104,1601518,1601104,414,0,utRho15
ybhK,1633384,1633384,1633294,90,4,utRho15
ybhM,1641556,1641586,1641556,30,2,utRho15
ybhN,1645296,1645296,1644996,300,6,utRho15
ybhQ,1649202,1649260,1649202,58,8,utRho15
ybiA,1665920,1665920,1665900,20,0,utRho15
ybiI,1676968,1676968,1676912,56,60,utRho15
ybiO,1691328,1691328,1690960,368,396,utRho15
ybiP,1705252,1705252,1705194,58,14,utRho15
ybiS,1711572,1711572,1711488,84,220,utRho15
ybiT,1711894,1711926,1711894,32,0,utRho15
ybiU,1718212,1718212,1718122,90,2,utRho15
ybiV,1720176,1720176,1720056,120,0,utRho15
ybiW,1725566,1725566,1725212,354,130,utRho15
ybiX,1678548,1678548,1678414,134,120,utRho15
ybjC,1781784,1781826,1781784,42,0,utRho15
ybjE,1830154,1830154,1829714,440,54,utRho15
ybjG,1767016,1767016,1766776,240,710,utRho15
ybjL,1779882,1779882,1779638,244,6,utRho15
ybjM,1779770,1780178,1779770,408,38,utRho15
ybjO,1795704,1795978,1795704,274,4,utRho15
ybjP,1809046,1809046,1808934,112,0,utRho15
ybjQ,1809034,1809186,1809034,152,0,utRho15
ybjS,1813796,1813796,1813506,290,74,utRho15
ybjX,1838206,1838206,1838168,38,0,utRho15
ycaD,1891438,1891742,1891438,304,0,utRho15
ycaI,1928210,1928640,1928210,430,18,utRho15
ycaK,1899094,1899336,1899094,242,0,utRho15
ycaL,1920264,1920528,1920264,264,0,utRho15
ycaM,1894240,1894458,1894240,218,0,utRho15
ycaR,1941284,1941346,1941284,62,394,utRho15
ycbB,1961862,1962094,1961862,232,0,utRho15
ycbJ,1943344,1943504,1943344,160,0,utRho15
ycbK,1966046,1966150,1966046,104,762,utRho15
ycbZ,2036920,2036920,2036598,322,2,utRho15
yccA,2062886,2062886,2062836,50,2,utRho15
yccF,2048730,2048730,2048696,34,0,utRho15
yccS,2047988,2047988,2047766,222,2,utRho15
yccT,2055674,2055674,2055546,128,0,utRho15
yccX,2059960,2060128,2059960,168,30,utRho15
ycdT,2185682,2185752,2185682,70,0,utRho15
ycdU,2191266,2191686,2191266,420,4,utRho15
ycdZ,2200504,2200592,2200504,88,88,utRho15
yceA,2233544,2233614,2233544,70,10,utRho15
yceD,2293298,2293588,2293298,290,3396,utRho15
yceF,2293522,2293522,2293190,332,2296,utRho15
yceH,2252154,2252314,2252154,160,2174,utRho15
yceI,2237282,2237282,2236952,330,364,utRho15
yceJ,2238142,2238142,2238092,50,4,utRho15
yceM,2253208,2253612,2253208,404,208,utRho15
yceO,2239264,2239264,2238894,370,368,utRho15
yceQ,2288760,2289004,2288760,244,4182,utRho15
ycfD,2376540,2376540,2376480,60,58,utRho15
ycfJ,2334814,2335198,2334814,384,4,utRho15
ycfS,2340834,2340834,2340748,86,0,utRho15
ycfT,2350658,2350658,2350330,328,0,utRho15
ycfZ,2362760,2362760,2362534,226,86,utRho15
ycgB,2474570,2474570,2474482,88,2,utRho15
ycgG,2434614,2434656,2434614,42,4,utRho15
ycgJ,2452956,2453200,2452956,244,12,utRho15
ycgL,2455218,2455362,2455218,144,2,utRho15
ycgN,2457366,2457660,2457366,294,46,utRho15
ycgR,2489112,2489112,2489054,58,0,utRho15
ycgV,2512222,2512222,2511904,318,0,utRho15
ycgX,2426568,2426568,2426214,354,552,utRho15
ycgY,2490166,2490320,2490166,154,4,utRho15
ycgZ,2431504,2431578,2431504,74,0,utRho15
ychE,2596904,2597196,2596904,292,0,utRho15
ychF,2515764,2515764,2515624,140,8,utRho15
ychH,2517476,2517582,2517476,106,58,utRho15
ychJ,2578354,2578354,2578264,90,2,utRho15
ychN,2547310,2547310,2547198,112,46,utRho15
ychO,2547520,2547850,2547520,330,20,utRho15
ychQ,2533798,2533848,2533798,50,0,utRho15
yciA,2624828,2624828,2624492,336,30,utRho15
yciB,2626110,2626110,2625780,330,1098,utRho15
yciC,2627396,2627396,2627326,70,12,utRho15
yciE,2630794,2630794,2630448,346,4,utRho15
yciG,5264368,5264368,5264140,228,0,utRho15
yciI,2621784,2621784,2621730,54,12,utRho15
yciN,2661606,2661606,2661336,270,18,utRho15
yciS,2680270,2680486,2680270,216,0,utRho15
yciT,2689088,2689088,2688692,396,246,utRho15
yciU,2614718,2614718,2614300,418,242,utRho15
yciV,2646376,2646440,2646376,64,0,utRho15
yciW,2700472,2700472,2700214,258,24,utRho15
yciZ,2689276,2689276,2689218,58,106,utRho15
ycjD,2703792,2703792,2703520,272,22,utRho15
ycjG,2777748,2777860,2777748,112,58,utRho15
ycjM,2740006,2740432,2740006,426,52,utRho15
ycjW,2767982,2767982,2767922,60,0,utRho15
ycjX,2768138,2768234,2768138,96,0,utRho15
ycjY,5568288,5568288,5567460,828,0,utRho15
ydaE,2836438,2836438,2836016,422,0,utRho15
ydaN,2816048,2816100,2816048,52,0,utRho15
ydaS,2840340,2840730,2840340,390,60,utRho15
ydbC,2948376,2948442,2948376,66,0,utRho15
ydbD,2950132,2950288,2950132,156,40,utRho15
ydbH,2885800,2886102,2885800,302,0,utRho15
ydbJ,2881712,2882116,2881712,404,0,utRho15
ydbK,2881692,2881692,2881568,124,26,utRho15
ydcA,2983294,2983354,2983294,60,2,utRho15
ydcF,2974404,2974470,2974404,66,8,utRho15
ydcI,2990268,2990268,2990142,126,0,utRho15
ydcJ,2990266,2990576,2990266,310,0,utRho15
ydcK,3001280,3001280,3000898,382,0,utRho15
ydcL,3004646,3004914,3004646,268,0,utRho15
ydcN,3012308,3012344,3012308,36,4,utRho15
ydcP,3013508,3013562,3013508,54,0,utRho15
ydcR,3019956,3020006,3019956,50,2,utRho15
ydcS,3022906,3023308,3022906,402,2,utRho15
ydcX,3034442,3034778,3034442,336,2,utRho15
ydcY,3035220,3035296,3035220,76,24,utRho15
ydcZ,3036750,3036750,3036662,88,36,utRho15
yddB,3155332,3155332,3155238,94,2,utRho15
yddE,3071738,3071738,3071716,22,0,utRho15
yddG,3094410,3094410,3094338,72,0,utRho15
yddJ,3089732,3089732,3089438,294,6,utRho15
yddW,3137704,3137704,3137646,58,12,utRho15
ydeA,3233910,3234056,3233910,146,36,utRho15
ydeE,3242528,3242664,3242528,136,4,utRho15
ydeI,3249118,3249118,3248994,124,2,utRho15
ydeJ,3249376,3249546,3249376,170,2,utRho15
ydeN,3165458,3165458,3165048,410,2,utRho15
ydeP,3173328,3173328,3172972,356,0,utRho15
ydeR,3176596,3176596,3176592,4,0,utRho15
ydfA,3296872,3297016,3296872,144,0,utRho15
ydfG,3254982,3255034,3254982,52,0,utRho15
ydfH,3256652,3256704,3256652,52,46,utRho15
ydfK,3265446,3266144,3265446,698,160,utRho15
ydgA,3379588,3379704,3379588,116,80,utRho15
ydgC,3364124,3364124,3364060,64,2,utRho15
ydgD,3343906,3343920,3343906,14,46,utRho15
ydgH,3356754,3356854,3356754,100,50,utRho15
ydgJ,3408798,3408798,3408616,182,0,utRho15
ydgK,3410414,3410500,3410414,86,32,utRho15
ydhB,3479618,3479618,3479596,22,2,utRho15
ydhC,3479698,3479822,3479698,124,0,utRho15
ydhF,3451310,3451310,3451264,46,0,utRho15
ydhI,3441996,3442050,3441996,54,0,utRho15
ydhL,3451864,3451864,3451840,24,2,utRho15
ydhQ,3492404,3492404,3492254,150,2,utRho15
ydhS,3494136,3494262,3494136,126,32,utRho15
ydhT,3499138,3499138,3499118,20,0,utRho15
ydhY,3509284,3509284,3508954,330,6,utRho15
ydhZ,3510418,3510418,3510282,136,2,utRho15
ydiE,3579206,3579226,3579206,20,0,utRho15
ydiH,3530582,3530582,3530406,176,0,utRho15
ydiM,3541852,3542142,3541852,290,4,utRho15
ydiN,3544818,3545024,3544818,206,0,utRho15
ydiP,3558656,3558656,3558602,54,0,utRho15
ydiU,3582508,3582508,3582488,20,6,utRho15
ydiV,3584174,3584174,3584040,134,14,utRho15
ydiY,3612500,3612500,3612166,334,2,utRho15
ydjA,3697400,3697400,3697352,48,58,utRho15
ydjE,3708082,3708082,3707958,124,0,utRho15
ydjF,3709848,3709848,3709708,140,0,utRho15
ydjM,3620340,3620422,3620340,82,0,utRho15
ydjO,3626696,3626696,3626288,408,4,utRho15
ydjX,3666434,3666802,3666434,368,536,utRho15
yeaE,3731448,3731448,3731272,176,68,utRho15
yeaG,3733530,3733816,3733530,286,0,utRho15
yeaI,3740486,3740770,3740486,284,0,utRho15
yeaJ,3743874,3744082,3743874,208,0,utRho15
yeaL,3748646,3748704,3748646,58,160,utRho15
yeaM,3751296,3751296,3751152,144,0,utRho15
yeaN,3750926,3751346,3750926,420,4,utRho15
yeaO,3753554,3753818,3753554,264,4,utRho15
yeaP,3755314,3755430,3755314,116,192,utRho15
yeaQ,3758780,3758780,3758510,270,12,utRho15
yeaR,3759988,3759988,3759896,92,2,utRho15
yeaY,3781122,3781122,3781064,58,90,utRho15
yebB,3892220,3892502,3892220,282,4,utRho15
yebC,3896370,3896370,3896302,68,8,utRho15
yebE,3859464,3859464,3859414,50,24,utRho15
yebG,3861530,3861530,3861494,36,0,utRho15
yebK,3873180,3873304,3873180,124,28,utRho15
yebQ,3820314,3820552,3820314,238,0,utRho15
yebS,3832238,3832516,3832238,278,24,utRho15
yebV,3843430,3843560,3843430,130,0,utRho15
yebW,3843914,3844242,3843914,328,190,utRho15
yecC,3995646,3995646,3995628,18,0,utRho15
yecD,3901272,3901664,3901272,392,136,utRho15
yecF,3991434,3991636,3991434,202,0,utRho15
yecH,3979304,3979304,3978980,324,8,utRho15
yecJ,3975604,3975604,3975516,88,0,utRho15
yecM,3919968,3919968,3919692,276,20,utRho15
yecR,3976400,3976444,3976400,44,0,utRho15
yecT,3923862,3923944,3923862,82,2,utRho15
yedD,4016522,4016522,4016180,342,46,utRho15
yedE,4016310,4016554,4016310,244,54,utRho15
yedI,4058922,4058922,4058732,190,4,utRho15
yedJ,4066446,4066446,4066158,288,6,utRho15
yedV,4076404,4076404,4076304,100,6,utRho15
yedX,4077680,4077912,4077680,232,0,utRho15
yedY,4078572,4078956,4078572,384,4,utRho15
yeeA,4161322,4161322,4161182,140,0,utRho15
yeeE,4171104,4171104,4171050,54,0,utRho15
yeeJ,4089526,4089822,4089526,296,6,utRho15
yeeN,4113508,4113716,4113508,208,82,utRho15
yeeO,4119444,4119444,4119692,248,0,utRho15
yeeX,4158834,4158834,4158722,112,114,utRho15
yeeZ,4178422,4178422,4178256,166,0,utRho15
yefM,4179466,4179466,4179426,40,30,utRho15
yegD,4295288,4295348,4295288,60,56,utRho15
yegH,4275726,4275804,4275726,78,20,utRho15
yegI,4302154,4302154,4301970,184,0,utRho15
yegJ,4302032,4302370,4302032,338,0,utRho15
yegQ,4331182,4331336,4331182,154,12,utRho15
yegR,4336698,4336698,4336612,86,4,utRho15
yegS,4337086,4337424,4337086,338,2,utRho15
yegT,4357562,4357642,4357562,80,8,utRho15
yegX,4367640,4367640,4367302,338,22,utRho15
yehA,4376944,4376944,4376828,116,0,utRho15
yehE,4385818,4385818,4385592,226,2,utRho15
yehK,4407568,4407944,4407568,376,0,utRho15
yehL,4408804,4409192,4408804,388,0,utRho15
yeiB,4486146,4486146,4485934,212,76,utRho15
yeiE,4499422,4499422,4499236,186,0,utRho15
yeiG,4487776,4487820,4487776,44,282,utRho15
yeiH,4499332,4499434,4499332,102,0,utRho15
yeiI,4503306,4503400,4503306,94,66,utRho15
yeiL,4510580,4510710,4510580,130,0,utRho15
yeiP,4530834,4530900,4530834,66,196,utRho15
yeiQ,4532328,4532490,4532328,162,2,utRho15
yeiR,4535484,4535658,4535484,174,80,utRho15
yeiW,4530840,4530840,4530590,250,228,utRho15
yejA,4544624,4544728,4544624,104,0,utRho15
yejG,4556892,4556892,4556474,418,242,utRho15
yejH,4561244,4561264,4561244,20,2,utRho15
yejK,4568218,4568218,4567894,324,42,utRho15
yejO,4578352,4578352,4577800,552,92,utRho15
yfaD,4713380,4713808,4713380,428,336,utRho15
yfaE,4696676,4697028,4696676,352,620,utRho15
yfaL,4688568,4688568,4688338,230,0,utRho15
yfaP,4656398,4656398,4656286,112,2,utRho15
yfaU,4717892,4717892,4717690,202,2,utRho15
yfaY,4727310,4727310,4727266,44,0,utRho15
yfaZ,4728744,4728744,4728550,194,0,utRho15
yfbK,4771810,4771810,4771444,366,0,utRho15
yfbL,4771500,4771720,4771500,220,0,utRho15
yfbN,4777174,4777174,4776852,322,32,utRho15
yfbO,4776916,4777162,4776916,246,16,utRho15
yfbP,4777990,4778232,4777990,242,118,utRho15
yfbR,4817662,4817724,4817662,62,2,utRho15
yfcI,4847424,4847424,4847078,346,54,utRho15
yfcJ,4880482,4880482,4880240,242,98,utRho15
yfcL,4888502,4888502,4888338,164,26,utRho15
yfcV,4911642,4911642,4911292,350,2,utRho15
yfcZ,4921958,4921958,4921868,90,36,utRho15
yfdF,4925604,4926024,4925604,420,46,utRho15
yfdG,4935474,4935710,4935474,236,0,utRho15
yfdP,4946844,4947040,4946844,196,2,utRho15
yfdX,4988866,4988866,4988804,62,0,utRho15
yfdY,4990672,4990672,4990584,88,4,utRho15
yfeA,5035784,5035784,5035664,120,2116,utRho15
yfeC,5036668,5036934,5036668,266,146,utRho15
yfeH,5053818,5053892,5053818,74,0,utRho15
yfeK,5074630,5074684,5074630,54,0,utRho15
yfeO,5018906,5019260,5018906,354,28,utRho15
yfeR,5054078,5054078,5053712,366,0,utRho15
yfeX,5101356,5101356,5101090,266,0,utRho15
yfeY,5102486,5102486,5102432,54,0,utRho15
yfeZ,5103842,5103842,5103452,390,10,utRho15
yffO,5123804,5124222,5123804,418,0,utRho15
yffQ,5126778,5127154,5126778,376,28,utRho15
yffS,5128800,5128986,5128800,186,20,utRho15
yfgC,5232052,5232188,5232052,136,4,utRho15
yfgF,5258062,5258062,5257876,186,12,utRho15
yfgG,5258170,5258580,5258170,410,128,utRho15
yfgH,5259344,5259584,5259344,240,26,utRho15
yfgM,5278866,5278866,5278566,300,406,utRho15
yfhH,5397414,5397518,5397414,104,14,utRho15
yfhM,5304648,5304648,5304574,74,6,utRho15
yfhR,5328408,5328726,5328408,318,82,utRho15
yfiC,5425610,5425610,5425528,82,0,utRho15
yfiE,5430688,5430688,5430640,48,2,utRho15
yfiL,5482630,5482720,5482630,90,0,utRho15
yfiM,5448066,5448358,5448066,292,1298,utRho15
yfiR,5483354,5483750,5483354,396,0,utRho15
yfjH,5517326,5517326,5517200,126,0,utRho15
yfjI,5517710,5517970,5517710,260,0,utRho15
yfjJ,5521014,5521094,5521014,80,6,utRho15
yfjM,5531970,5531970,5531552,418,214,utRho15
yfjP,5535080,5535420,5535080,340,16,utRho15
yfjW,5546570,5546636,5546570,66,0,utRho15
yfjX,5551776,5551838,5551776,62,0,utRho15
ygaC,5601180,5601180,5599988,1192,52,utRho15
ygaM,5600242,5600292,5600242,50,2,utRho15
ygaU,5593628,5593628,5593572,56,2,utRho15
ygaZ,5619190,5619234,5619190,44,36,utRho15
ygbA,5713656,5713656,5713612,44,2,utRho15
ygbE,5746784,5746784,5746674,110,136,utRho15
ygbI,5722882,5722882,5722528,354,0,utRho15
ygbK,5724394,5724670,5724394,276,8,utRho15
ygbL,5727074,5727186,5727074,112,0,utRho15
ygbN,5729814,5730202,5729814,388,166,utRho15
ygcG,5811210,5811422,5811210,212,6,utRho15
ygcN,5785144,5785314,5785144,170,2,utRho15
ygcU,5799214,5799214,5798836,378,6,utRho15
ygcW,5800942,5800942,5800546,396,0,utRho15
ygdD,5883442,5883442,5883262,180,90,utRho15
ygdG,5861746,5861930,5861746,184,518,utRho15
ygdI,5886526,5886526,5886290,236,2,utRho15
ygdQ,5940784,5940840,5940784,56,4,utRho15
ygdR,5942494,5942542,5942494,48,44,utRho15
ygeA,5961606,5961606,5961270,336,24,utRho15
ygeH,5983758,5984188,5983758,430,4,utRho15
ygeI,5987162,5987276,5987162,114,40,utRho15
ygeR,6000078,6000078,5999782,296,8,utRho15
ygeV,6011694,6011694,6011572,122,0,utRho15
ygeW,6012234,6012524,6012234,290,22,utRho15
ygfB,6110946,6110946,6110888,58,64,utRho15
ygfK,6031984,6032120,6031984,136,28,utRho15
ygfS,6058328,6058328,6058024,304,0,utRho15
ygfZ,6082564,6082626,6082564,62,48,utRho15
yggC,6149512,6149512,6149378,134,152,utRho15
yggE,6136370,6136370,6136160,210,80,utRho15
yggI,6179176,6179510,6179176,334,90,utRho15
yggL,6204508,6204508,6204266,242,48,utRho15
yggM,6199514,6199514,6199130,384,18,utRho15
yggN,6203596,6203596,6203246,350,2,utRho15
yggX,18623958,18624558,18623958,600,1284,utRho15
yghA,6298966,6299324,6298966,358,54,utRho15
yghB,6307058,6307126,6307058,68,78,utRho15
yghD,6222614,6222614,6222252,362,22,utRho15
yghF,6225798,6225798,6225840,42,4,utRho15
yghJ,6238640,6238640,6238224,416,4,utRho15
yghQ,6265186,6265186,6264816,370,0,utRho15
yghT,6267830,6268262,6267830,432,0,utRho15
yghU,6277400,6277454,6277400,54,20,utRho15
yghW,6293506,6293506,6293474,32,0,utRho15
yghZ,6295562,6295794,6295562,232,4,utRho15
ygiD,6365122,6365122,6364868,254,436,utRho15
ygiH,6409066,6409388,6409066,322,40,utRho15
ygiL,6370622,6370828,6370622,206,4,utRho15
ygiM,6402084,6402414,6402084,330,310,utRho15
ygiN,6346156,6346284,6346156,128,1692,utRho15
ygiQ,6322620,6322620,6322292,328,194,utRho15
ygiS,6335462,6335462,6335436,26,4,utRho15
ygiV,6338582,6338582,6338462,120,16,utRho15
ygiW,6339774,6339774,6339352,422,24,utRho15
ygiZ,6344506,6344506,6344422,84,0,utRho15
ygjH,6442528,6442528,6442494,34,2,utRho15
ygjI,6452140,6452468,6452140,328,50,utRho15
ygjQ,6472730,6473080,6472730,350,108,utRho15
ygjR,6474564,6474586,6474564,22,0,utRho15
ygjV,6483638,6483638,6483488,150,28,utRho15
yhaB,6535632,6535708,6535632,76,0,utRho15
yhaH,6504498,6504608,6504498,110,6,utRho15
yhaI,6505400,6505822,6505400,422,26,utRho15
yhaJ,6508560,6508560,6508428,132,80,utRho15
yhaK,6508538,6508638,6508538,100,2,utRho15
yhbQ,6599878,6599932,6599878,54,6,utRho15
yhbT,6602736,6602736,6602552,184,2,utRho15
yhbU,6602558,6602970,6602558,412,4,utRho15
yhbX,6643302,6643302,6643226,76,2,utRho15
yhbY,6655518,6655580,6655518,62,322,utRho15
yhcA,6723956,6724224,6723956,268,12,utRho15
yhcB,6760364,6760382,6760364,18,68,utRho15
yhcC,6708470,6708470,6708100,370,8,utRho15
yhcF,6733440,6733852,6733440,412,114,utRho15
yhcH,6739124,6739124,6738956,168,262,utRho15
yhcM,6760312,6760312,6759994,318,60,utRho15
yhcN,6770812,6771076,6770812,264,28,utRho15
yhcO,6772606,6772606,6772258,348,46,utRho15
yhdH,6806560,6806968,6806560,408,194,utRho15
yhdJ,6823234,6823306,6823234,72,0,utRho15
yhdN,6879092,6879092,6879018,74,306,utRho15
yhdT,6814702,6814750,6814702,48,124,utRho15
yhdU,6824994,6825242,6824994,248,0,utRho15
yhdV,6836392,6836780,6836392,388,64,utRho15
yhdW,6837944,6838298,6837944,354,0,utRho15
yheO,6953082,6953082,6952880,202,754,utRho15
yheV,6957970,6957970,6957584,386,78,utRho15
yhfA,6971902,6971902,6971636,266,26,utRho15
yhfG,6983294,6983294,6983240,54,86,utRho15
yhfL,6998622,6998896,6998622,274,38,utRho15
yhfY,7023244,7023244,7022844,400,102,utRho15
yhgA,7086294,7086334,7086294,40,0,utRho15
yhgE,7065176,7065176,7064878,298,18,utRho15
yhgF,7074352,7074770,7074352,418,1686,utRho15
yhhA,7173458,7173886,7173458,428,4,utRho15
yhhI,7248346,7248756,7248346,410,0,utRho15
yhhJ,7253696,7253696,7253606,90,36,utRho15
yhhM,7211588,7211588,7211220,368,60,utRho15
yhhN,7211150,7211502,7211150,352,20,utRho15
yhhQ,7218238,7218434,7218238,196,62,utRho15
yhhT,7223682,7223730,7223682,48,12,utRho15
yhhX,7162032,7162032,7161610,422,8,utRho15
yhhY,7162222,7162276,7162222,54,0,utRho15
yhhZ,7163516,7163726,7163516,210,2,utRho15
yhiD,7312220,7312220,7311804,416,3818,utRho15
yhiJ,7265190,7265190,7265180,10,0,utRho15
yhiM,7269270,7269682,7269270,412,2,utRho15
yhiN,7275000,7275000,7274820,180,60,utRho15
yhjA,7338522,7338522,7338376,146,0,utRho15
yhjB,7344090,7344090,7343788,302,4,utRho15
yhjC,7344272,7344684,7344272,412,0,utRho15
yhjD,7346660,7346724,7346660,64,38,utRho15
yhjE,7349274,7349572,7349274,298,36,utRho15
yhjG,7356824,7356824,7356730,94,0,utRho15
yhjH,7358458,7358458,7358374,84,80,utRho15
yhjJ,7364032,7364032,7363880,152,114,utRho15
yhjK,7371296,7371296,7371158,138,0,utRho15
yhjR,7392750,7392750,7392370,380,78,utRho15
yhjV,7400796,7401126,7400796,330,78,utRho15
yhjX,7424194,7424194,7424014,180,0,utRho15
yhjY,7425966,7425966,7425868,98,22,utRho15
yiaB,7455654,7455654,7455496,158,2,utRho15
yiaD,7432712,7433094,7432712,382,40,utRho15
yiaF,7438194,7438194,7438088,106,4,utRho15
yiaG,7438862,7438956,7438862,94,38,utRho15
yiaJ,7485236,7485236,7485064,172,20,utRho15
yiaK,7485348,7485466,7485348,118,44,utRho15
yiaT,7503924,7503924,7503736,188,0,utRho15
yiaU,7503792,7503984,7503792,192,2,utRho15
yiaY,7515856,7515856,7515654,202,6,utRho15
yibF,7523950,7523950,7523910,40,0,utRho15
yibG,7536128,7536354,7536128,226,4,utRho15
yibL,7553194,7553330,7553194,136,102,utRho15
yibN,7570112,7570112,7570030,82,272,utRho15
yibT,7552848,7552848,7552760,88,38,utRho15
yicC,7633290,7633352,7633290,62,30,utRho15
yicH,7660862,7660914,7660862,52,0,utRho15
yicJ,7673328,7673328,7671858,1470,468,utRho15
yicN,7685018,7685018,7684804,214,10,utRho15
yicO,7687914,7687914,7687578,336,4,utRho15
yicR,15250308,15250308,15250236,72,0,utRho15
yidB,7755230,7755230,7754930,300,0,utRho15
yidE,7732780,7732780,7732546,234,44,utRho15
yidF,7711580,7711580,7711222,358,42,utRho15
yidQ,7735088,7735456,7735088,368,1164,utRho15
yidR,7738824,7738824,7738618,206,2,utRho15
yieE,7787658,7787738,7787658,80,2,utRho15
yieH,7793314,7793548,7793314,234,4,utRho15
yieK,7798928,7798928,7798786,142,2,utRho15
yifB,7900350,7900350,7899998,352,54,utRho15
yifL,7988984,7989044,7988984,60,54,utRho15
yigF,8005750,8005750,8005598,152,116,utRho15
yigI,8009448,8009448,8009394,54,54,utRho15
yigM,8022100,8022152,8022100,52,0,utRho15
yihA,8101970,8101970,8101458,512,56,utRho15
yihD,8084098,8084138,8084098,40,0,utRho15
yihF,8088110,8088398,8088110,288,2,utRho15
yihG,8093304,8093304,8093204,100,2,utRho15
yihI,8102616,8102694,8102616,78,18,utRho15
yihL,8120506,8120894,8120506,388,0,utRho15
yihN,8124332,8124494,8124332,162,4,utRho15
yihO,8131942,8131942,8131532,410,0,utRho15
yihQ,8138892,8138892,8138552,340,4,utRho15
yihV,8147064,8147478,8147064,414,2,utRho15
yihX,8151096,8151106,8151096,10,66,utRho15
yiiE,8158192,8158582,8158192,390,2,utRho15
yiiF,8159124,8159502,8159124,378,0,utRho15
yiiG,8173762,8174004,8173762,242,0,utRho15
yiiM,8205506,8205644,8205506,138,16,utRho15
yiiQ,8224624,8224624,8224428,196,126,utRho15
yiiS,8225738,8225934,8225738,196,2,utRho15
yijE,8272178,8272216,8272178,38,62,utRho15
yijF,8275728,8275728,8275314,414,68,utRho15
yijO,8296858,8296858,8296634,224,56,utRho15
yjaA,8426240,8426468,8426240,228,59272,utRho15
yjaB,8428312,8428312,8428246,66,8,utRho15
yjaG,8398746,8399008,8398746,262,624,utRho15
yjaH,8401022,8401132,8401022,110,358,utRho15
yjaZ,8379506,8379572,8379506,66,0,utRho15
yjbB,8455204,8455462,8455204,258,56,utRho15
yjbE,16943432,16943624,16943432,192,0,utRho15
yjbL,8520318,8520642,8520318,324,0,utRho15
yjbQ,8540428,8540476,8540428,48,36,utRho15
yjcB,8550328,8550328,8550082,246,170,utRho15
yjcC,8550836,8550942,8550836,106,4,utRho15
yjcD,8556628,8556958,8556628,330,8,utRho15
yjcE,8559658,8559960,8559658,302,2,utRho15
yjcF,8566212,8566212,8566150,62,0,utRho15
yjcO,8594660,8594660,8594250,410,126,utRho15
yjdA,8654128,8654270,8654128,142,0,utRho15
yjdC,8726660,8726660,8726616,44,30,utRho15
yjdK,8704780,8705168,8704780,388,22,utRho15
yjdL,8713034,8713034,8712822,212,0,utRho15
yjdM,8653672,8653672,8653468,204,202,utRho15
yjeF,8787354,8788132,8787354,778,2718,utRho15
yjeI,8745522,8745618,8745522,96,0,utRho15
yjeJ,8748806,8748806,8748468,338,30,utRho15
yjeV,8785472,8785784,8785472,312,40,utRho15
yjfP,8833512,8833904,8833512,392,2,utRho15
yjfY,8849656,8849656,8849582,74,2,utRho15
yjfZ,8855052,8855052,8854844,208,0,utRho15
yjgA,8916162,8916162,8915730,432,64,utRho15
yjgL,8950802,8950874,8950802,72,0,utRho15
yjgM,8959342,8959342,8959074,268,0,utRho15
yjgN,8959132,8959460,8959132,328,0,utRho15
yjgR,8980170,8980170,8980126,44,42,utRho15
yjgZ,9002116,9002520,9002116,404,190,utRho15
yjhB,9007764,9008116,9007764,352,328,utRho15
yjhG,9048452,9048452,9048188,264,438,utRho15
yjhU,9041080,9041080,9040648,432,136,utRho15
yjiA,9178096,9178096,9177730,366,5000,utRho15
yjiJ,9125364,9125364,9125350,14,2,utRho15
yjiK,9127270,9127270,9127422,152,8,utRho15
yjiL,9129604,9129604,9129378,226,16,utRho15
yjiS,9143410,9143502,9143410,92,0,utRho15
yjiY,9182734,9182734,9182558,176,3968,utRho15
yjjA,9200674,9200674,9200378,296,36,utRho15
yjjB,18408708,18408708,18407800,908,108,utRho15
yjjJ,9243314,9243538,9243314,224,10,utRho15
yjjK,9261132,9261132,9261044,88,6,utRho15
yjjL,9189764,9189764,9189444,320,50,utRho15
yjjM,9191894,9191894,9191702,192,4,utRho15
yjjP,9206068,9206068,9205716,352,92,utRho15
yjjQ,9206638,9206954,9206638,316,46,utRho15
yjjX,9267798,9267798,9267490,308,702,utRho15
yjjY,9280716,9280804,9280716,88,590,utRho15
yjjZ,9211554,9211608,9211554,54,270,utRho15
yjtD,9281676,9281884,9281676,208,8,utRho15
ykfB,532454,532454,532174,280,402,utRho15
ykfI,527636,527636,527338,298,18,utRho15
ykgB,637050,637050,636638,412,0,utRho15
ykgC,640430,640430,640002,428,2,utRho15
ykgD,640232,640454,640232,222,2,utRho15
ykgE,642962,643216,642962,254,48,utRho15
ykgJ,608524,608524,608364,160,128,utRho15
ykgL,623878,624224,623878,346,4,utRho15
ykgM,625610,625610,625554,56,0,utRho15
ykgR,626570,626570,626484,86,0,utRho15
ylaC,958576,958576,958502,74,380,utRho15
yliE,1745938,1745958,1745938,20,0,utRho15
ymcE,2103660,2103694,2103660,34,0,utRho15
ymdA,2210450,2210828,2210450,378,104,utRho15
ymdB,2211428,2211640,2211428,212,2,utRho15
ymfD,2395322,2395322,2395064,258,296,utRho15
ymfI,2402880,2402994,2402880,114,2,utRho15
ymfJ,2404518,2404518,2404168,350,184,utRho15
ymfK,2406176,2406176,2405866,310,0,utRho15
ymfT,2405766,2406048,2405766,282,92,utRho15
ymgE,2489110,2489456,2489110,346,4,utRho15
ymgF,2437628,2437966,2437628,338,0,utRho15
ymiA,2670112,2670320,2670112,208,58,utRho15
ymjA,2715620,2715620,2715336,284,208,utRho15
ynaI,2791946,2791946,2791844,102,0,utRho15
ynaK,2850438,2850754,2850438,316,6,utRho15
ynbA,2954924,2955242,2954924,318,0,utRho15
yncD,3046552,3046552,3046130,422,46,utRho15
yncE,3046454,3046614,3046454,160,0,utRho15
yncG,3052456,3052494,3052456,38,4,utRho15
yncL,3034492,3034492,3034388,104,4,utRho15
yneE,3218364,3218364,3218044,320,0,utRho15
yneF,3223748,3223748,3223708,40,0,utRho15
yneJ,3229560,3229608,3229560,48,2,utRho15
yneK,3231100,3231526,3231100,426,0,utRho15
yneM,3245176,3245292,3245176,116,2,utRho15
ynfA,3311398,3311398,3311346,52,0,utRho15
ynfB,3311418,3311616,3311418,198,128,utRho15
ynfC,3315094,3315094,3314914,180,0,utRho15
ynfD,3314828,3315130,3314828,302,18,utRho15
ynfE,3316006,3316138,3316006,132,0,utRho15
ynfK,3334670,3334670,3334438,232,94,utRho15
ynfL,3339304,3339304,3339184,120,0,utRho15
ynfM,3339260,3339398,3339260,138,34,utRho15
ynfN,3276598,3276598,3276218,380,2,utRho15
ynfO,3273454,3273512,3273454,58,0,utRho15
ynhG,3517890,3517890,3517450,440,252,utRho15
yniA,3615158,3615592,3615158,434,0,utRho15
yniB,3618526,3618526,3618466,60,0,utRho15
yniC,3618652,3618760,3618652,108,8,utRho15
yniD,3610202,3610330,3610202,128,0,utRho15
ynjE,3678880,3678934,3678880,54,0,utRho15
ynjF,3683222,3683222,3682806,416,44,utRho15
ynjH,3684376,3684376,3684270,106,34,utRho15
ynjI,3690022,3690022,3689742,280,96,utRho15
yoaB,3786642,3786734,3786642,92,0,utRho15
yoaC,3787932,3788146,3787932,214,28,utRho15
yoaE,3803544,3803544,3803170,374,268,utRho15
yoaF,3755444,3755444,3755064,380,212,utRho15
yoaH,3789866,3789866,3789462,404,616,utRho15
yobB,3850418,3850880,3850418,462,428,utRho15
yobF,3815586,3815586,3815182,404,2,utRho15
yobH,3817800,3817850,3817800,50,20,utRho15
yodB,4084352,4084736,4084352,384,6,utRho15
yodC,4057008,4057008,4056740,268,4,utRho15
yohC,4451358,4451358,4451262,96,0,utRho15
yohD,4451526,4451602,4451526,76,0,utRho15
yohJ,4460986,4461248,4460986,262,2,utRho15
yohO,4431172,4431314,4431172,142,26,utRho15
yojI,4617282,4617282,4617230,52,0,utRho15
ypdI,4988988,4989396,4988988,408,0,utRho15
ypfG,5165786,5165786,5165554,232,0,utRho15
ypfM,5182140,5182140,5181732,408,1818,utRho15
yphB,5349590,5349590,5349376,214,0,utRho15
ypjA,5565644,5565644,5565452,192,6,utRho15
ypjB,5569636,5569636,5568858,778,2,utRho15
ypjD,5495860,5495774,5495860,86,30,utRho15
yqaE,5594170,5594170,5594056,114,22,utRho15
yqcA,5846100,5846100,5845968,132,24,utRho15
yqcE,5800944,5801184,5800944,240,0,utRho15
yqeC,6030468,6030468,6030114,354,94,utRho15
yqeF,5971618,5971618,5971184,434,44,utRho15
yqeG,5971438,5971694,5971438,256,58,utRho15
yqeH,5975016,5975072,5975016,56,26,utRho15
yqeI,5976688,5977004,5976688,316,0,utRho15
yqeK,5981140,5981140,5980720,420,20,utRho15
yqfA,6086728,6086728,6086296,432,458,utRho15
yqgA,6219042,6219106,6219042,64,0,utRho15
yqgB,6172500,6172500,6172102,398,478,utRho15
yqgE,6185768,6185874,6185768,106,510,utRho15
yqhA,6299150,6299150,6298942,208,54,utRho15
yqhC,6310768,6310768,6310436,332,156,utRho15
yqhD,6310604,6310710,6310604,106,132,utRho15
yqhH,6316842,6317254,6316842,412,20,utRho15
yqiC,6369662,6369680,6369662,18,10,utRho15
yqiJ,6384108,6384416,6384108,308,6,utRho15
yqjA,6495096,6495546,6495096,450,694,utRho15
yqjF,6500932,6501124,6500932,192,182,utRho15
yqjG,6501948,6502048,6501948,100,0,utRho15
yqjH,6433078,6433078,6432982,96,2,utRho15
yqjI,6433506,6433558,6433506,52,0,utRho15
yraH,6574552,6574852,6574552,300,2,utRho15
yraP,6592144,6592818,6592144,674,156,utRho15
yraQ,6596414,6596414,6596276,138,0,utRho15
yraR,6598024,6598024,6597692,332,30,utRho15
yrbG,13360844,13361100,13360844,256,0,utRho15
yrbL,6696842,6696904,6696842,62,10,utRho15
yrbN,6616172,6616172,6615866,306,512,utRho15
yrdB,6860176,6860176,6860046,130,30,utRho15
yrfF,7052548,7052938,7052548,390,266,utRho15
yrhB,7169440,7169518,7169440,78,0,utRho15
ysaB,7451804,7451804,7451424,380,4,utRho15
ysgA,8032686,8032686,8032338,348,78,utRho15
ytfB,8857638,8857638,8857434,204,32,utRho15
ytfE,8864018,8864018,8863966,52,0,utRho15
ytfF,8866296,8866296,8866130,166,2,utRho15
ytfH,8868164,8868226,8868164,62,10,utRho15
ytfI,8875234,8875414,8875234,180,0,utRho15
ytfJ,8878572,8878572,8878524,48,74,utRho15
ytfK,8879022,8879174,8879022,152,1080,utRho15
ytfL,8882642,8882642,8882430,212,0,utRho15
ytfQ,8899634,8899924,8899634,290,170,utRho15
ytjB,9249598,9249598,9249578,20,0,utRho15
yzfA,8896588,8896588,8896490,98,2,utRho15
zapA,6111102,6111224,6111102,122,3014,utRho15
zapB,8236772,8237030,8236772,258,358,utRho15
zapC,2011700,2011904,2011700,204,0,utRho15
zinT,4082692,4082750,4082692,58,2,utRho15
zipA,5062814,5062814,5062466,348,0,utRho15
zitB,1569716,1569716,1569646,70,0,utRho15
zntA,7212844,7212902,7212844,58,0,utRho15
zntR,6878336,6878336,6878260,76,4,utRho15
znuA,3885322,3885322,3885166,156,16,utRho15
znuC,3885268,3885324,3885268,56,16,utRho15
zraP,8403424,8403424,8403376,48,0,utRho15
zraS,8403810,8403852,8403810,42,0,utRho15
zupT,6364866,6365100,6364866,234,382,utRho15
zur,8520282,8520282,8520006,276,134,utRho15
zwf,3872752,3872752,3872628,124,114,utRho15
C0343,2818676,2818728,2818676,52,0,utRho16
aaeB,6776526,6776526,6776376,150,208,utRho16
aaeR,6778762,6779040,6778762,278,860,utRho16
aaeX,6778860,6778860,6778674,186,1164,utRho16
aat,1854920,1854920,1854864,56,0,utRho16
accA,416822,417242,416822,420,1828,utRho16
accB,6810280,6810872,6810280,592,4884,utRho16
accD,4868030,4868030,4867852,178,160,utRho16
aceB,8430804,8430956,8430804,152,392,utRho16
aceE,245938,246034,245938,96,96,utRho16
ackA,4826918,4826940,4826918,22,622,utRho16
acnA,2670848,2671662,2670848,814,600,utRho16
acnB,263038,263230,263038,192,348,utRho16
acpP,2303148,2303230,2303148,82,378,utRho16
acpS,5402324,5402324,5401996,328,234,utRho16
acrA,971396,971396,971238,158,44,utRho16
acrB,969370,969370,968806,564,1338,utRho16
acrD,5174950,5175190,5174950,240,40,utRho16
acrE,6827404,6827728,6827404,324,386,utRho16
acrR,971398,971522,971398,124,82,utRho16
acrZ,1589502,1589546,1589502,44,168,utRho16
acs,8575190,8575190,8574742,448,1328,utRho16
actP,8569870,8569870,8569804,66,26,utRho16
ada,4620854,4620854,4620810,44,0,utRho16
add,3404404,3404466,3404404,62,320,utRho16
ade,7687802,7687928,7687802,126,284,utRho16
adhE,2596826,2596826,2596242,584,130,utRho16
adhP,3107988,3107988,3107676,312,1288,utRho16
adiA,8681112,8681112,8681042,70,152,utRho16
adiC,8674404,8674404,8674062,342,208,utRho16
adiY,8676084,8676084,8675858,226,70,utRho16
adk,994278,994350,994278,72,1208,utRho16
adrA,807374,807406,807374,32,106,utRho16
aer,6438240,6438240,6438152,88,56,utRho16
aes,1000102,1000102,999946,156,1828,utRho16
agaR,6557406,6557406,6557330,76,14,utRho16
agaS,6563778,6563952,6563778,174,38,utRho16
agp,2131118,2131170,2131118,52,0,utRho16
agrA,7296126,7296126,7296126,0,0,utRho16
agrB,7296588,7296588,7296588,0,0,utRho16
ahpC,1277386,1277890,1277386,504,522,utRho16
ahpF,1278004,1279506,1278004,1502,44634,utRho16
ahr,8992698,8992698,8992418,280,314,utRho16
aidB,8828494,8828550,8828494,56,20,utRho16
ais,4731512,4731512,4731240,272,4,utRho16
alaA,4814816,4815122,4814816,306,124,utRho16
alaC,4996798,4996798,4996590,208,20,utRho16
alaE,5598140,5598328,5598140,188,262,utRho16
alaS,5644180,5644180,5644022,158,2558,utRho16
alaW,5036612,5036612,5036462,150,0,utRho16
aldA,2976380,2976464,2976380,84,356,utRho16
aldB,7513070,7513070,7513022,48,568,utRho16
alkA,4295118,4295118,4295080,38,158,utRho16
alkB,4618890,4618890,4618682,208,8,utRho16
allA,1064780,1064902,1064780,122,24,utRho16
allD,1092822,1092822,1092726,96,132,utRho16
allE,1088112,1088112,1088092,20,0,utRho16
allS,1064600,1064600,1064442,158,78,utRho16
alr,8531178,8531564,8531178,386,1898,utRho16
alsE,8617334,8617334,8616956,378,846,utRho16
alsK,8615990,8615990,8615598,392,1586,utRho16
alx,6476740,6477160,6476740,420,146,utRho16
amiA,5104482,5104704,5104482,222,0,utRho16
amiC,5898378,5898378,5898020,358,690,utRho16
amn,4110062,4110122,4110062,60,116,utRho16
ampC,8758006,8758006,8757888,118,226,utRho16
ampD,237362,237466,237362,104,56,utRho16
ampG,907372,907372,907090,282,362,utRho16
ampH,792726,792726,792574,152,250,utRho16
amyA,4012230,4012312,4012230,82,82,utRho16
anmK,3439346,3439346,3439204,142,0,utRho16
ansB,6201580,6201580,6201456,124,622,utRho16
ansP,3052040,3052040,3051960,80,260,utRho16
apaG,104068,104068,103212,856,3786,utRho16
apaH,102586,102586,102444,142,3724,utRho16
apbE,4623188,4623188,4623068,120,0,utRho16
appA,2081198,2081234,2081198,36,50,utRho16
appC,2075420,2075480,2075420,60,0,utRho16
appY,1167134,1167362,1167134,228,6,utRho16
apt,982620,982824,982620,204,300,utRho16
aqpZ,1832424,1832424,1832094,330,286,utRho16
araB,140150,140150,140096,54,20,utRho16
araC,140482,140774,140482,292,1134,utRho16
araE,5964416,5964416,5964364,52,30,utRho16
araF,3972476,3972476,3972256,220,114,utRho16
araH,3967120,3967120,3967086,34,298,utRho16
araJ,825058,825058,824962,96,1300,utRho16
arcA,9281602,9281602,9280612,990,2314,utRho16
arcB,6706098,6706098,6706050,48,82,utRho16
arcZ,6701154,6701154,6701154,0,0,utRho16
arfA,6877346,6877346,6877298,48,922,utRho16
argA,5898312,5898484,5898312,172,198,utRho16
argC,8309770,8310002,8309770,232,44,utRho16
argD,6980442,6980442,6980360,82,432,utRho16
argE,8310156,8310156,8309694,462,112,utRho16
argF,580680,580680,580610,70,38,utRho16
argG,6637124,6637274,6637124,150,236,utRho16
argI,8956688,8956688,8956622,66,590,utRho16
argO,6137672,6137672,6137616,56,292,utRho16
argP,6119460,6119506,6119460,46,324,utRho16
argR,6769204,6769406,6769204,202,36,utRho16
argS,3920002,3920124,3920002,122,0,utRho16
argT,4855698,4855698,4855582,116,276,utRho16
argU,1129406,1129446,1129406,40,264,utRho16
argW,4932616,4932618,4932616,2,0,utRho16
argX,7964728,7964750,7964728,22,54,utRho16
aroF,5482402,5482402,5482300,102,0,utRho16
aroG,1571182,1571266,1571182,84,172,utRho16
aroH,3576636,3576870,3576636,234,646,utRho16
aroK,7038760,7038760,7038128,632,1044,utRho16
aroL,812560,812810,812560,250,1162,utRho16
aroP,243342,243342,243102,240,132,utRho16
arpA,8445382,8445382,8444974,408,380,utRho16
arrS,7316108,7316108,7316108,0,0,utRho16
arsR,7297024,7297056,7297024,32,34,utRho16
artJ,1801252,1801252,1801150,102,0,utRho16
artP,1807686,1807686,1807468,218,1768,utRho16
ascF,5678858,5679048,5678858,190,0,utRho16
ascG,5678574,5678574,5678528,46,0,utRho16
aslB,7965562,7965916,7965562,354,4886,utRho16
asnA,7854258,7854310,7854258,52,440,utRho16
asnB,1398444,1398444,1398354,90,660,utRho16
asnC,23562186,23562186,23562018,168,426,utRho16
asnS,1978088,1978088,1977970,118,5210,utRho16
asnT,4089082,4089098,4089082,16,124,utRho16
asnU,4119690,4119702,4119690,12,0,utRho16
asnV,4124504,4124520,4124504,16,156,utRho16
aspA,17473728,17473728,17473308,420,128,utRho16
aspC,1971486,1971486,1971418,68,544,utRho16
aspS,3901402,3901402,3901044,358,222,utRho16
aspT,7893560,7893744,7893560,184,90266,utRho16
aspV,473826,473862,473826,36,48,utRho16
asr,3342654,3342752,3342654,98,0,utRho16
astC,3664088,3664088,3663964,124,44,utRho16
astE,3654138,3654138,3653846,292,370,utRho16
atoD,4646824,4646894,4646824,70,982,utRho16
atpB,7844540,7844540,7844102,438,420,utRho16
atpC,7832118,7832118,7831944,174,1278,utRho16
atpI,7845050,7845050,7844880,170,108,utRho16
avtA,7479348,7479410,7479348,62,896,utRho16
azoR,2965982,2965982,2965720,262,132,utRho16
azuC,3976002,3976002,3975918,84,96,utRho16
bacA,6408350,6408350,6408262,88,568,utRho16
bamA,394052,395856,394052,1804,358,utRho16
bamB,5277950,5277950,5277304,646,530,utRho16
bamC,5198028,5198028,5197730,298,108,utRho16
bamD,5471922,5472292,5471922,370,4878,utRho16
bamE,5506972,5507210,5506972,238,300,utRho16
basS,8666954,8666954,8666544,410,1622,utRho16
bax,7474468,7474468,7474354,114,156,utRho16
bcp,5200874,5200956,5200874,82,1522,utRho16
bcsB,7385346,7385346,7385214,132,20,utRho16
bcsE,7392644,7392916,7392644,272,0,utRho16
bdcA,8948128,8948128,8948106,22,2386,utRho16
bdcR,8948192,8948248,8948192,56,1196,utRho16
bdm,3112680,3112680,3112560,120,0,utRho16
betA,654522,654522,654494,28,58,utRho16
betI,658722,658722,658668,54,236,utRho16
betT,658842,658926,658842,84,390,utRho16
bfr,6933498,6933498,6933450,48,180,utRho16
bglG,23440182,23440182,23439402,780,1134,utRho16
bglX,4444240,4444240,4443978,262,90,utRho16
bhsA,2337962,2338146,2337962,184,54,utRho16
bioA,1618584,1618584,1618514,70,0,utRho16
bioB,1618604,1618688,1618604,84,0,utRho16
bioH,7089716,7089716,7089688,28,58,utRho16
bisC,7433026,7433026,7432788,238,342,utRho16
blc,8755490,8755490,8755444,46,0,utRho16
blr,3409024,3409102,3409024,78,238,utRho16
bluF,2431226,2431226,2430950,276,406,utRho16
bluR,2428226,2428226,2428118,108,22,utRho16
bolA,908698,908944,908698,246,0,utRho16
borD,1157842,1157842,1157786,56,196,utRho16
brnQ,838976,839182,838976,206,598,utRho16
bssR,1756492,1756496,1756492,4,50,utRho16
bssS,2242116,2242116,2241910,206,252,utRho16
btuB,8326798,8327278,8326798,480,3146,utRho16
cadB,8720212,8720212,8720062,150,316,utRho16
cadC,8723926,8723926,8723868,58,0,utRho16
caiE,70998,70998,70742,256,364,utRho16
caiF,68436,68600,68436,164,598,utRho16
caiT,84074,84074,83862,212,190,utRho16
can,285406,285406,285340,66,158,utRho16
carA,59102,59302,59102,200,264,utRho16
carB,61550,61634,61550,84,76,utRho16
cas2,5757830,5757830,5757706,124,460,utRho16
casA,5768638,5768638,5768276,362,28,utRho16
cbl,4121882,4121882,4121828,54,1792,utRho16
cbpA,2128074,2128074,2127550,524,202,utRho16
cbrA,7738628,7738754,7738628,126,48,utRho16
cbrB,7794958,7795012,7794958,54,124,utRho16
ccmH,4585242,4585242,4584820,422,770,utRho16
cdaR,364894,364926,364894,32,148,utRho16
cdd,4463638,4463688,4463638,50,28,utRho16
cdh,8219814,8219860,8219814,46,1070,utRho16
cdsA,391110,391354,391110,244,532,utRho16
cedA,3627484,3627484,3627326,158,664,utRho16
cfa,3482402,3482826,3482402,424,956,utRho16
chaC,2544844,2544972,2544844,128,1006,utRho16
chbB,3643452,3643452,3643238,214,36,utRho16
chbG,3634624,3634624,3634270,354,490,utRho16
cheW,3946924,3946924,3946678,246,570,utRho16
chiA,6939792,6939792,6939706,86,38,utRho16
chiP,1416472,1416668,1416472,196,46,utRho16
cho,3646984,3647030,3646984,46,40,utRho16
chpS,8896804,8896894,8896804,90,152,utRho16
cirA,4493884,4493884,4493538,346,124,utRho16
citC,1304078,1304078,1303712,366,184,utRho16
citT,1293264,1293264,1293160,104,0,utRho16
clcA,350104,350214,350104,110,0,utRho16
clpA,1846160,1846528,1846160,368,162,utRho16
clpB,5468410,5468410,5468346,64,64,utRho16
clpP,913154,913354,913154,200,176,utRho16
clpS,1845500,1845826,1845500,326,42,utRho16
clpX,914404,914852,914404,448,908,utRho16
clsA,2617346,2617346,2617290,56,0,utRho16
clsC,2212584,2212710,2212584,126,266,utRho16
cmk,1922330,1922402,1922330,72,60,utRho16
cnu,3409522,3409898,3409522,376,1050,utRho16
coaA,8350214,8350214,8350052,162,676,utRho16
cobC,1340092,1340092,1339814,278,312,utRho16
cobT,4129202,4129202,4128934,268,370,utRho16
cobU,4131944,4131944,4131528,416,808,utRho16
codB,709768,709844,709768,76,494,utRho16
comR,2337726,2337726,2337664,62,0,utRho16
copA,1022822,1022822,1022758,64,0,utRho16
corA,8002388,8002852,8002388,464,19176,utRho16
cpdB,8873258,8873258,8873130,128,616,utRho16
cptB,6082198,6082198,6082140,58,92,utRho16
cpxA,8210202,8210202,8209950,252,168,utRho16
cpxP,8211570,8211640,8211570,70,6,utRho16
cpxR,8211372,8211372,8211340,32,2,utRho16
cra,175894,176056,175894,162,70,utRho16
crcB,1316016,1316016,1315876,140,242,utRho16
creA,9270486,9271042,9270486,556,504,utRho16
creD,9276320,9276356,9276320,36,506,utRho16
crl,515620,515658,515620,38,784,utRho16
crp,6971906,6972240,6971906,334,2598,utRho16
crr,5070960,5071668,5070960,708,1714,utRho16
csdA,5886414,5886674,5886414,260,272,utRho16
csgB,2207718,2207902,2207718,184,86,utRho16
csgD,2206688,2206688,2206392,296,380,utRho16
csgG,2203510,2203510,2203368,142,306,utRho16
csiD,5577854,5577970,5577854,116,242,utRho16
csiE,5330802,5330870,5330802,68,88,utRho16
csiR,5590942,5591348,5590942,406,246,utRho16
cspA,7439778,7440098,7439778,320,8108,utRho16
cspB,3283430,3283430,3283108,322,92,utRho16
cspC,3815018,3815018,3814870,148,466,utRho16
cspD,1845352,1845352,1845180,172,3328,utRho16
cspE,1314294,1314584,1314294,290,0,utRho16
cspF,3283380,3283710,3283380,330,118,utRho16
cspG,2102610,2102922,2102610,312,426,utRho16
cspH,2102746,2102746,2102350,396,0,utRho16
cspI,3277624,3277624,3277334,290,6,utRho16
csrA,5638746,5638746,5638292,454,802,utRho16
csrB,5849048,5849048,5849048,0,0,utRho16
csrC,8102072,8102072,8102072,0,0,utRho16
csrD,6806850,6806850,6806664,186,334,utRho16
cstA,1259710,1259788,1259710,78,0,utRho16
cueO,274090,274166,274090,76,48,utRho16
cueR,1027948,1027986,1027948,38,138,utRho16
curA,3037784,3038054,3037784,270,662,utRho16
cusC,1191146,1191200,1191146,54,104,utRho16
cusR,1190924,1190924,1190886,38,240,utRho16
cutA,8730784,8730784,8730712,72,780,utRho16
cutC,3918534,3918534,3917920,614,486,utRho16
cvpA,4861600,4861600,4861526,74,94,utRho16
cvrA,2484328,2484328,2484142,186,54,utRho16
cyaA,7981548,7982306,7981548,758,1296,utRho16
cyaR,4334228,4334224,4334228,4,56,utRho16
cyaY,7988166,7988166,7988118,48,344,utRho16
cybB,2981522,2981804,2981522,282,218,utRho16
cycA,8859560,8859728,8859560,168,796,utRho16
cydA,1542340,1542916,1542340,576,228,utRho16
cydC,1858800,1858800,1858390,410,92,utRho16
cydD,1862062,1862062,1861924,138,64,utRho16
cydX,1548300,1548392,1548300,92,146,utRho16
cynR,717418,717418,717380,38,310,utRho16
cynT,1435092,1435196,1435092,104,124,utRho16
cyoA,903306,903306,903220,86,1998,utRho16
cyoE,895540,895540,895410,130,406,utRho16
cysB,2667576,2667710,2667576,134,470,utRho16
cysC,5748056,5748056,5747984,72,42,utRho16
cysD,5752736,5752736,5752658,78,28,utRho16
cysE,7565362,7565362,7565124,238,1366,utRho16
cysG,6995508,6995656,6995508,148,1040,utRho16
cysJ,5783928,5783928,5783796,132,2806,utRho16
cysK,5064688,5064818,5064688,130,380,utRho16
cysP,5087114,5087114,5087056,58,590,utRho16
cysS,1109154,1109222,1109154,68,96,utRho16
cysT,3984100,3984100,3983974,126,60,utRho16
cysZ,5062766,5062926,5062766,160,68,utRho16
cytR,8249018,8249018,8248912,106,148,utRho16
dacA,1328002,1328002,1327926,76,224,utRho16
dacB,6657714,6657926,6657714,212,60,utRho16
dacC,1761306,1761454,1761306,148,844,utRho16
dadA,2475018,2475142,2475018,124,36,utRho16
dam,7032504,7032504,7031826,678,830,utRho16
damX,7035200,7035200,7034612,588,428,utRho16
dapA,5199568,5199568,5199520,48,0,utRho16
dapB,56576,56748,56576,172,638,utRho16
dapD,371954,371954,371894,60,48,utRho16
dapE,5183120,5183214,5183120,94,1210,utRho16
dcp,3254844,3254844,3254760,84,32,utRho16
dcrB,7219534,7219910,7219534,376,450,utRho16
dctA,7366996,7366996,7366894,102,326,utRho16
dcuA,8733686,8733686,8733546,140,48,utRho16
dcuB,8698182,8698182,8697488,694,2840,utRho16
dcuC,1312166,1312166,1311936,230,232,utRho16
dcuD,6749166,6749738,6749166,572,552,utRho16
dcuR,8701130,8701130,8700068,1062,2408,utRho16
dcuS,8703370,8703370,8703324,46,1102,utRho16
dcyD,3999016,3999016,3998960,56,0,utRho16
ddpX,3126498,3126498,3126152,346,512,utRho16
deaD,6615818,6615818,6615720,98,1560,utRho16
dedA,4869880,4869880,4869482,398,3278,utRho16
dedD,4863750,4863750,4863368,382,0,utRho16
def,6867300,6867380,6867300,80,500,utRho16
degP,361690,361768,361690,78,0,utRho16
degQ,6761308,6761486,6761308,178,3724,utRho16
deoB,9239134,9239206,9239134,72,0,utRho16
deoC,9233358,9234646,9233358,1288,838,utRho16
dfp,7625406,7625462,7625406,56,36,utRho16
dgcZ,3247758,3247758,3247700,58,204,utRho16
dgkA,8512914,8513274,8512914,360,270,utRho16
dgt,358392,358474,358392,82,864,utRho16
dhaK,2501888,2501888,2501676,212,158,utRho16
dhaR,2502006,2502132,2502006,126,42,utRho16
dicB,3299194,3299218,3299194,24,0,utRho16
dicC,3295752,3295752,3295700,52,0,utRho16
dinB,501760,501796,501760,36,56,utRho16
dinD,7635398,7635520,7635398,122,62,utRho16
dinG,1666146,1666140,1666146,6,14,utRho16
dinI,2243018,2243018,2242974,44,440,utRho16
dinJ,493230,493230,493004,226,278,utRho16
dinQ,7295964,7295964,7295576,388,396,utRho16
djlA,114536,114728,114536,192,278,utRho16
dkgA,6313142,6313246,6313142,104,212,utRho16
dkgB,458196,458334,458196,138,78,utRho16
dksA,321502,321502,321208,294,674,utRho16
dld,4444164,4444370,4444164,206,38,utRho16
dmlA,3763424,3763824,3763424,400,1384,utRho16
dmlR,3763710,3763710,3763618,92,270,utRho16
dmsA,1881646,1881918,1881646,272,0,utRho16
dnaA,7767922,7767922,7767458,464,1490,utRho16
dnaB,8528566,8528628,8528566,62,464,utRho16
dnaK,24096,24326,24096,230,3930,utRho16
dnaN,7765466,7765466,7764642,824,240,utRho16
dnaQ,471868,472134,471868,266,2078,utRho16
dnaT,18406460,18406460,18406068,392,9840,utRho16
dnaX,984112,984184,984112,72,764,utRho16
dosP,3131486,3131486,3131466,20,64,utRho16
dpiB,1303968,1304470,1303968,502,0,utRho16
dppA,7415740,7415740,7415410,330,1780,utRho16
dps,1697900,1697900,1697822,78,64,utRho16
dsbA,8086754,8086836,8086754,82,1032,utRho16
dsbB,2466294,2466294,2466060,234,106,utRho16
dsbC,6079266,6079266,6077644,1622,1482,utRho16
dsbG,1277600,1277600,1277146,454,290,utRho16
dsdA,4958242,4958404,4958242,162,440,utRho16
dsdC,4955492,4955492,4955258,234,164,utRho16
dsdX,4955642,4955694,4955642,52,60,utRho16
dsrA,4050626,4050626,4050626,0,0,utRho16
dsrB,4049686,4049686,4049646,40,316,utRho16
dtpD,1485340,1485340,1485112,228,118,utRho16
dusA,8523200,8523338,8523200,138,1348,utRho16
dusB,6820492,6820560,6820492,68,28,utRho16
dusC,4460790,4460790,4460770,20,0,utRho16
dut,7627704,7627864,7627704,160,792,utRho16
dxr,386670,387042,386670,372,210,utRho16
ebgA,6445102,6445266,6445102,164,472,utRho16
ebgR,6442874,6442932,6442874,58,112,utRho16
ecnB,8753018,8753106,8753018,88,280,utRho16
eco,4607594,4607810,4607594,216,0,utRho16
ecpA,621594,621594,621342,252,148,utRho16
ecpB,620238,620238,620052,186,126,utRho16
ecpR,622964,622964,622672,292,124,utRho16
eda,3866218,3866218,3865512,706,96,utRho16
edd,3869426,3869426,3869208,218,56,utRho16
efeO,2164308,2164486,2164308,178,40,utRho16
efeU_1,2162614,2162712,2162614,98,172,utRho16
efp,8751134,8751398,8751134,264,1836,utRho16
elaA,4763372,4763372,4763086,286,16,utRho16
elaD,4765308,4765426,4765308,118,86,utRho16
elfA,1995530,1995736,1995530,206,0,utRho16
elfD,1996642,1996980,1996642,338,44,utRho16
emrD,7707690,7707844,7707690,154,18,utRho16
emrK,4966896,4966896,4966678,218,104,utRho16
emrY,4964668,4964668,4964352,316,280,utRho16
emtA,2486250,2486360,2486250,110,186,utRho16
endA,12361100,12361388,12361100,288,28,utRho16
eno,5817692,5817692,5815882,1810,2912,utRho16
entC,1249662,1249770,1249662,108,0,utRho16
entD,1220508,1220508,1220158,350,0,utRho16
entH,1258584,1258600,1258584,16,0,utRho16
entS,1244506,1244600,1244506,94,46,utRho16
envR,6827266,6827266,6826930,336,84,utRho16
epd,12295292,12295292,12294764,528,524,utRho16
epmA,8765236,8765286,8765236,50,200,utRho16
epmB,8751406,8751406,8751314,92,452,utRho16
eptB,7421162,7421162,7420950,212,252,utRho16
eptC,8300622,8300622,8300530,92,646,utRho16
erfK,4126708,4126708,4126646,62,414,utRho16
erpA,353122,353220,353122,98,178,utRho16
esrE,8039956,8039956,8039956,0,0,utRho16
essD,1153746,1154796,1153746,1050,2322,utRho16
etk,2088606,2088606,2088420,186,976,utRho16
evgA,4967262,4967510,4967262,248,186,utRho16
exbB,6304028,6304028,6303968,60,200,utRho16
exbD,6302780,6302780,6302486,294,62,utRho16
exuR,6493016,6493304,6493016,288,500,utRho16
exuT,6490004,6490208,6490004,204,102,utRho16
fabA,2032996,2032996,2032940,56,108,utRho16
fabB,4883282,4883282,4883210,72,32,utRho16
fabH,2297032,2297518,2297032,486,1122,utRho16
fabI,2702236,2702236,2702078,158,288,utRho16
fadB,8062026,8062026,8061942,84,72,utRho16
fadD,3779614,3779614,3779492,122,32,utRho16
fadE,486812,486812,486606,206,192,utRho16
fadH,6463248,6463330,6463248,82,462,utRho16
fadI,4921022,4921022,4920938,84,202,utRho16
fadL,4922410,4922600,4922410,190,208,utRho16
fadM,928720,928804,928720,84,2,utRho16
fadR,2469810,2469876,2469810,66,0,utRho16
fbaB,4357334,4357334,4357128,206,78,utRho16
fdhE,8162722,8162722,8162456,266,788,utRho16
fdhF,8598814,8598814,8598732,82,414,utRho16
fdnG,3094744,3094802,3094744,58,8,utRho16
fdrA,1093012,1093360,1093012,348,768,utRho16
feaB,2894994,2895038,2894994,44,62,utRho16
feaR,2894734,2894734,2894566,168,0,utRho16
fecA,9033454,9033454,9033354,100,50,utRho16
fecE,9023288,9023288,9022914,374,1990,utRho16
fecI,9036564,9036564,9036470,94,490,utRho16
feoA,7080114,7080326,7080114,212,54,utRho16
fepA,1225334,1225334,1224988,346,324,utRho16
fepB,1249454,1249454,1249020,434,298,utRho16
fepD,1244468,1244468,1244378,90,0,utRho16
fes,1225374,1225630,1225374,256,212,utRho16
ffh,5495706,5495706,5495590,116,398,utRho16
ffs,952576,952848,952576,272,2876,utRho16
fhuA,334884,334968,334884,84,184,utRho16
fhuE,2323294,2323294,2323102,192,272,utRho16
fhuF,9211504,9211504,9211326,178,67056,utRho16
fic,6983296,6983296,6982926,370,2064,utRho16
fieF,8212864,8212938,8212864,74,186,utRho16
fimA,9085388,9086230,9085388,842,2142,utRho16
fimB,9081334,9081914,9081334,580,3392,utRho16
fimE,9083742,9084074,9083742,332,2084,utRho16
fimZ,1129214,1129214,1128960,254,0,utRho16
fiu,1683296,1683296,1683062,234,250,utRho16
fixA,84650,84806,84650,156,94,utRho16
fkpA,6955050,6955050,6954838,212,2624,utRho16
fldA,2846084,2846084,2845860,224,2560,utRho16
fldB,6079644,6079710,6079644,66,166,utRho16
flgA,2261770,2261770,2261726,44,1118,utRho16
flgB,2261986,2262036,2261986,50,94,utRho16
flgK,2276702,2276756,2276702,54,500,utRho16
flgM,2260330,2260330,2260256,74,26,utRho16
flgN,2259828,2259828,2259660,168,440,utRho16
flhB,3932432,3932432,3932382,50,324,utRho16
flhC,3955864,3955864,3955688,176,126,utRho16
flhD,3957154,3957154,3956394,760,1786,utRho16
fliA,4003638,4003638,4003578,60,202,utRho16
fliC,4007352,4007352,4007212,140,100,utRho16
fliD,4007634,4007744,4007634,110,694,utRho16
fliE,4026186,4026186,4026028,158,644,utRho16
fliF,4026292,4026458,4026292,166,746,utRho16
fliL,4039168,4039236,4039168,68,170,utRho16
flk,4875824,4875900,4875824,76,132,utRho16
flu,4142634,4143078,4142634,444,110,utRho16
flxA,3292776,3292810,3292776,34,12,utRho16
fnr,2799104,2799104,2799052,52,70,utRho16
fnrS,2818258,2818258,2818258,0,0,utRho16
focA,1909628,1909628,1908932,696,2064,utRho16
folA,99598,99646,99598,48,54,utRho16
folB,6409296,6409296,6409178,118,52,utRho16
folD,1115562,1115562,1115482,80,158,utRho16
folE,4487696,4487696,4487304,392,1786,utRho16
fpr,8228998,8228998,8228944,54,204,utRho16
frc,4986878,4986878,4986508,370,212,utRho16
frdA,8764824,8764824,8764636,188,464,utRho16
frdD,8758948,8758948,8758732,216,4924,utRho16
fre,8052886,8053054,8052886,168,516,utRho16
frlA,6999518,6999820,6999518,302,744,utRho16
frr,385624,385744,385624,120,638,utRho16
frsA,513004,513054,513004,50,40,utRho16
fruB,4527194,4527194,4526990,204,0,utRho16
frvR,8179804,8179804,8179710,94,46,utRho16
fryA,5008986,5008986,5008970,16,788,utRho16
fsaA,1727060,1727284,1727060,224,398,utRho16
fsr,1009710,1009710,1009392,318,120,utRho16
ftnA,3977364,3977432,3977364,68,0,utRho16
ftnB,3973550,3973850,3973550,300,100,utRho16
ftsA,207122,207964,207122,842,332,utRho16
ftsB,5745802,5745802,5745640,162,830,utRho16
ftsH,6654204,6654204,6653870,334,988,utRho16
ftsK,1865858,1866448,1865858,590,366,utRho16
ftsL,181376,182064,181376,688,1202,utRho16
ftsP,6325732,6325732,6325338,394,166,utRho16
ftsQ,205484,206310,205484,826,80,utRho16
ftsX,7204512,7204512,7204172,340,490,utRho16
ftsZ,209272,210610,209272,1338,4,utRho16
fucA,5867708,5867708,5867376,332,4322,utRho16
fucP,5868238,5868470,5868238,232,438,utRho16
fumA,6753760,6753760,6753508,252,2008,utRho16
fumB,8694696,8694696,8694652,44,44,utRho16
fumC,3373418,3373418,3373176,242,44,utRho16
fur,2842892,2842892,2842584,308,2648,utRho16
fusA,6947370,6947370,6947028,342,13008,utRho16
fxsA,8737206,8737328,8737206,122,492,utRho16
gabD,5581824,5582546,5581824,722,3360,utRho16
gadA,7335214,7335214,7335160,54,0,utRho16
gadB,3144144,3144144,3144090,54,98,utRho16
gadC,3141168,3141168,3140978,190,88,utRho16
gadE,7315600,7316732,7315600,1132,1136,utRho16
gadW,7329562,7329562,7329236,326,190,utRho16
gadX,14663356,14663356,14663240,116,968,utRho16
gadY,7329728,7329728,7329728,0,0,utRho16
galE,1584354,1584354,1584110,244,104,utRho16
galF,4228702,4228702,4228654,48,76,utRho16
galM,1577796,1577796,1577674,122,366,utRho16
galP,6176510,6176568,6176510,58,16,utRho16
galR,5953138,5953198,5953138,60,154,utRho16
galS,4483420,4483420,4483336,84,0,utRho16
galU,2582810,2582914,2582810,104,60,utRho16
gapA,3724480,3725542,3724480,1062,2394,utRho16
garP,6549868,6549868,6549814,54,570,utRho16
gatY,4354468,4354468,4354408,60,80,utRho16
gatZ,4352864,4352864,4352642,222,10838,utRho16
gcd,282558,282558,282450,108,30,utRho16
gcl,1067814,1067832,1067814,18,0,utRho16
gcvA,5885278,5885278,5885134,144,0,utRho16
gcvB,5885392,5885392,5885392,0,0,utRho16
gcvR,5199758,5199812,5199758,54,44,utRho16
gcvT,6101544,6101544,6101334,210,1514,utRho16
gdhA,3684616,3684742,3684616,126,0,utRho16
gfcA,2099668,2099668,2099488,180,1280,utRho16
gfcD,2096236,2096236,2095890,346,1496,utRho16
ghrA,2195648,2195772,2195648,124,212,utRho16
ghrB,7434378,7434620,7434378,242,2890,utRho16
glcA,6242728,6242728,6242558,170,340,utRho16
glcC,6256412,6256544,6256412,132,182,utRho16
glcD,6256152,6256152,6256042,110,300,utRho16
gldA,8278092,8278092,8278070,22,94,utRho16
glgA,7136784,7136784,7136066,718,6366,utRho16
glgB,7147314,7147314,7147004,310,912,utRho16
glgC,7139142,7139142,7138656,486,1530,utRho16
glgP,7133546,7133546,7133162,384,3074,utRho16
glgS,6384024,6384024,6383878,146,296,utRho16
glgX,7142838,7142838,7142638,200,150,utRho16
glk,5018922,5018922,5018852,70,246,utRho16
glmS,7827622,7827622,7827336,286,966,utRho16
glmU,7830652,7830652,7830400,252,328,utRho16
glmY,10765360,10765360,10765360,0,0,utRho16
glmZ,7972864,7972864,7972864,0,0,utRho16
glnA,16232888,16232888,16232136,752,368,utRho16
glnB,5375052,5375052,5374816,236,576,utRho16
glnD,377310,377310,377300,10,0,utRho16
glnE,6399602,6399602,6399282,320,98,utRho16
glnH,1696396,1696396,1696008,388,246,utRho16
glnK,945112,945196,945112,84,200,utRho16
glnL,8112742,8112742,8112678,64,122,utRho16
glnQ,1693262,1693262,1692926,336,160,utRho16
glnS,1411998,1412186,1411998,188,1186,utRho16
gloA,3455602,3455674,3455602,72,40,utRho16
gloB,469852,469852,469564,288,1122,utRho16
glpA,4705166,4705294,4705166,128,0,utRho16
glpD,7123942,7124026,7123942,84,0,utRho16
glpE,7123698,7123698,7123646,52,38,utRho16
glpF,8236322,8236322,8236180,142,240,utRho16
glpG,7122960,7122960,7122904,56,84,utRho16
glpR,7121782,7121782,7121210,572,2064,utRho16
glpT,4704902,4704902,4704748,154,162,utRho16
glpX,8231212,8231212,8231158,54,7598,utRho16
glrK,5382246,5382246,5382196,50,672,utRho16
gltA,1509534,1509534,1508936,598,4398,utRho16
gltB,6709018,6709264,6709018,246,914,utRho16
gltI,1375792,1375792,1375494,298,4168,utRho16
gltP,8588536,8588962,8588536,426,1966,utRho16
gltS,7657382,7657382,7657330,52,1572,utRho16
gltX,5041568,5041568,5041344,224,138,utRho16
gluQ,320286,320286,320224,62,142,utRho16
glyA,5371148,5371148,5371014,134,66,utRho16
glyQ,7450708,7450708,7450636,72,512,utRho16
glyS,7448990,7448990,7448794,196,868,utRho16
glyU,5998128,5998128,5998114,14,0,utRho16
glyV,8784626,8784720,8784626,94,340,utRho16
glyW,3984360,3984360,3984234,126,0,utRho16
gmhB,445612,445666,445612,54,0,utRho16
gmk,7642776,7642856,7642776,80,2,utRho16
gmr,2693686,2693686,2693484,202,674,utRho16
gnd,4202648,4202648,4202536,112,348,utRho16
gnsB,3275692,3275692,3275564,128,96,utRho16
gntK,14310580,14310580,14310368,212,884,utRho16
gntP,9102668,9102668,9102592,76,316,utRho16
gntR,7157760,7157760,7157452,308,648,utRho16
gntT,7092810,7093118,7092810,308,3076,utRho16
gntU,7154170,7154170,7154122,48,192,utRho16
gntX,7089334,7089764,7089334,430,298,utRho16
gor,7292224,7292598,7292224,374,96,utRho16
gpmA,1575340,1575340,1575190,150,0,utRho16
gpmM,7570374,7570520,7570374,146,38,utRho16
gpsA,7567620,7567620,7567322,298,5718,utRho16
gpt,511828,511954,511828,126,872,utRho16
grcA,5433046,5433046,5432898,148,928,utRho16
greA,6657728,6657728,6657430,298,694,utRho16
greB,7073488,7073624,7073488,136,52,utRho16
groL,8741566,8742050,8741566,484,4748,utRho16
groS,8741232,8741376,8741232,144,8368,utRho16
grpE,5501494,5501494,5501416,78,178,utRho16
grxA,1781552,1781552,1781506,46,0,utRho16
grxB,2248206,2248206,2248108,98,1278,utRho16
grxC,7569152,7569152,7568884,268,3122,utRho16
grxD,3468324,3468324,3468202,122,728,utRho16
gspA,6911268,6911268,6910796,472,130,utRho16
gspC,6910964,6911156,6910964,192,38,utRho16
gss,6277220,6277220,6277044,176,364,utRho16
gstA,3428654,3428754,3428654,100,0,utRho16
gstB,1761038,1761038,1760960,78,146,utRho16
guaB,5268214,5268214,5268140,74,102,utRho16
gudD,5839026,5839026,5838770,256,348,utRho16
gyrA,4678914,4678914,4678840,74,0,utRho16
gyrB,7760300,7760300,7760238,62,224,utRho16
hcaE,5337964,5338064,5337964,100,5868,utRho16
hcaR,5337928,5337928,5337792,136,8096,utRho16
hcaT,5336106,5336106,5335692,414,892,utRho16
hchA,4071260,4071670,4071260,410,60,utRho16
hcp,1828258,1828258,1827628,630,968,utRho16
hcr,1824400,1824400,1824300,100,136,utRho16
hdeA,7313582,7313582,7313480,102,30,utRho16
hdeD,7313920,7313990,7313920,70,574,utRho16
hdfR,7896320,7896320,7895934,386,868,utRho16
hdhA,3396244,3396244,3396080,164,52,utRho16
helD,2048876,2048942,2048876,66,0,utRho16
hemA,2527166,2527428,2527166,262,340,utRho16
hemB,779722,779722,779454,268,2298,utRho16
hemF,5106410,5106450,5106410,40,0,utRho16
hemH,996062,996110,996062,48,912,utRho16
hemL,349882,349882,349764,118,234,utRho16
hemN,8103886,8104090,8103886,204,236,utRho16
hepA,127176,127176,126528,648,3022,utRho16
hflD,2385372,2385372,2385262,110,20,utRho16
hfq,8799602,8800576,8799602,974,11428,utRho16
hha,961006,961006,960616,390,172,utRho16
hicA,3018442,3018572,3018442,130,116,utRho16
higA,6468682,6468682,6468288,394,1960,utRho16
higB,6468960,6468960,6468910,50,0,utRho16
hinT,2323642,2323770,2323642,128,112,utRho16
hipB,3184964,3184964,3184884,80,0,utRho16
hisB,4186720,4186936,4186720,216,88,utRho16
hisJ,4853674,4853674,4853576,98,102,utRho16
hisL,8359856,8359984,8359856,128,308,utRho16
hisS,5281284,5281284,5281150,134,52,utRho16
hlpA,400910,400964,400910,54,44,utRho16
hlyE,2460932,2460932,2460788,144,1046,utRho16
hmp,5371594,5371670,5371594,76,0,utRho16
hns,2585916,2585916,2585844,72,246,utRho16
hofM,7045856,7045856,7045502,354,200,utRho16
hokA,7441620,7441620,7441200,420,2662,utRho16
hokC,33902,33902,33806,96,142,utRho16
hokE,1215462,1215672,1215462,210,0,utRho16
holC,8968546,8968546,8968560,14,198,utRho16
holD,9215562,9215606,9215562,44,28,utRho16
holE,3850040,3850216,3850040,176,2190,utRho16
hpt,282720,282862,282720,142,898,utRho16
hrpB,324150,324210,324150,60,0,utRho16
hscB,5319048,5319048,5318934,114,3996,utRho16
hscC,1367188,1367188,1366786,402,872,utRho16
hsdS,9163004,9163004,9162924,80,222,utRho16
hslJ,2883560,2883560,2883486,74,288,utRho16
hslO,7059344,7059548,7059344,204,7788,utRho16
hslR,7058220,7058696,7058220,476,2024,utRho16
hslV,8244708,8244708,8244574,134,248,utRho16
hsrA,7881412,7881412,7881224,188,166,utRho16
htgA,21286,21660,21286,374,14362,utRho16
htpG,989634,990240,989634,606,20220,utRho16
htpX,3825236,3825236,3825152,84,2,utRho16
htrE,311036,311036,310852,184,532,utRho16
htrL,7587668,7587668,7587366,302,116,utRho16
hupA,8400352,8400562,8400352,210,70,utRho16
hupB,1845220,1845804,1845220,584,884,utRho16
hyaA,2063968,2064278,2063968,310,50,utRho16
hybO,6292726,6292726,6292522,204,9638,utRho16
hycA,5700922,5700922,5700870,52,0,utRho16
hycI,5686204,5686204,5686086,118,934,utRho16
hydN,5676264,5676264,5676210,54,0,utRho16
hyfA,5202342,5202402,5202342,60,172,utRho16
hypA,11402508,11402588,11402508,80,160,utRho16
hypB,11403356,11404004,11403356,648,28,utRho16
hypF,5676210,5676210,5674850,1360,1384,utRho16
hypT,9116634,9116634,9116578,56,60,utRho16
hyuA,6019660,6020056,6019660,396,556,utRho16
iaaA,1733074,1733136,1733074,62,52,utRho16
iadA,9119074,9119074,9119052,22,692,utRho16
iap,5753072,5753162,5753072,90,66,utRho16
ibaG,6673966,6673966,6673606,360,170,utRho16
ibpA,7735036,7735036,7734844,192,6856,utRho16
ibpB,7733962,7733962,7733794,168,20300,utRho16
icd,2389922,2390246,2389922,324,86,utRho16
iclR,8447304,8447304,8447256,48,66,utRho16
idi,6065876,6066130,6065876,254,28,utRho16
idnD,8988870,8988870,8988812,58,18,utRho16
idnK,8989194,8989246,8989194,52,44,utRho16
ihfA,3591442,3591442,3591104,338,416,utRho16
ihfB,1927498,1927656,1927498,158,194,utRho16
ileS,43666,44782,43666,1116,2872,utRho16
ileX,6431194,6431196,6431194,2,0,utRho16
ilvA,15820940,15821324,15820940,384,1252,utRho16
ilvC,7915824,7915940,7915824,116,264,utRho16
ilvE,15809552,15809936,15809552,384,1568,utRho16
ilvI,170840,171260,170840,420,204,utRho16
ilvL,23701308,23701932,23701308,624,552,utRho16
ilvY,7915734,7915734,7915640,94,236,utRho16
inaA,4698998,4698998,4698944,54,338,utRho16
infA,1853370,1853370,1852886,484,1068,utRho16
infC,3602692,3602692,3601276,1416,2368,utRho16
insA-5,3958452,3958452,3958430,22,154,utRho16
insA-7,9036758,9037054,9036758,296,1438,utRho16
insC-5,6372080,6372284,6372080,204,6404,utRho16
insEF-2,785238,785238,785820,582,2934,utRho16
insEF-4,2190310,2190310,2190892,582,3004,utRho16
insG,9007098,9007098,9006862,236,10,utRho16
insH-1,550596,550596,550234,362,23618,utRho16
insH-11,7306538,7306538,7306396,142,176,utRho16
insH-2,1151548,1151548,1151506,42,308,utRho16
insH-3,1378444,1378444,1378026,418,780,utRho16
insH-4,2791942,2792152,2791942,210,248,utRho16
insH-5,2857852,2857852,2857452,400,714,utRho16
insH-6,4135022,4135022,4134642,380,658,utRho16
insH-7,4206186,4206186,4205822,364,1516,utRho16
insH-9,6260050,6260356,6260050,306,1094,utRho16
insI-3,9017372,9017372,9017234,138,1450,utRho16
insJ,7441188,7441360,7441188,172,978,utRho16
insK,7442130,7442308,7442130,178,38,utRho16
insL-1,30760,30890,30760,130,3686,utRho16
insL-2,1216112,1216130,1216112,18,258,utRho16
insL-3,5028644,5028662,5028644,18,276,utRho16
insN-1,540452,540484,540452,32,176,utRho16
intD,1132202,1132202,1131956,246,17860,utRho16
intR,2826520,2826520,2826470,50,0,utRho16
intS,4933026,4933090,4933026,64,3892,utRho16
intZ,5117386,5117542,5117386,156,3882,utRho16
iraD,9113152,9113986,9113152,834,896,utRho16
iraM,2424246,2424246,2424006,240,140,utRho16
iraP,802638,802772,802638,134,0,utRho16
iscA,5319924,5319924,5319772,152,600,utRho16
iscR,5324398,5324398,5324262,136,8378,utRho16
iscX,5313834,5313834,5313472,362,1862,utRho16
ispF,5743968,5743968,5743560,408,2694,utRho16
ispG,5283908,5283908,5283608,300,718,utRho16
ispU,389568,389806,389568,238,74,utRho16
isrA,2811502,2811502,2811618,116,10,utRho16
istr-1,7706384,7706384,7706384,0,0,utRho16
istr-2,7706514,7706514,7706514,0,0,utRho16
ivbL,15412092,15412092,15411952,140,280,utRho16
ivy,480638,480686,480638,48,72,utRho16
katE,3627628,3627734,3627628,106,588,utRho16
katG,8267624,8267670,8267624,46,250,utRho16
kbaZ,6557732,6557828,6557732,96,0,utRho16
kbl,7585154,7585154,7585102,52,540,utRho16
kch,2621046,2621046,2620538,508,408,utRho16
kdgR,3820506,3820506,3820198,308,52,utRho16
kdpE,1443788,1443788,1443466,322,128,utRho16
kdpF,1457698,1457698,1457642,56,0,utRho16
kdsA,2535708,2536330,2535708,622,1274,utRho16
kdsC,6683438,6684546,6683438,1108,2280,utRho16
kduI,5968388,5968388,5968248,140,8378,utRho16
kefF,94160,94492,94160,332,1540,utRho16
kgtP,5451624,5451624,5451492,132,150,utRho16
kup,7862206,7862632,7862206,426,132,utRho16
lacI,735076,735076,735020,56,226,utRho16
lacZ,1465508,1465508,1465220,288,740,utRho16
ldcA,2486394,2486394,2486160,234,402,utRho16
ldhA,2885830,2885830,2885686,144,48,utRho16
ldrA,2538954,2538954,2538550,404,2066,utRho16
ldrB,2540024,2540024,2539620,404,894,utRho16
ldrC,2541092,2541092,2540690,402,358,utRho16
ldrD,7400544,7400544,7400174,370,1820,utRho16
lepA,5414392,5414392,5414248,144,110,utRho16
lepB,5410928,5410928,5410618,310,316,utRho16
leuD,159188,159188,158906,282,190,utRho16
leuE,3761600,3761600,3761518,82,114,utRho16
leuL,168048,168048,167416,632,34,utRho16
leuO,168308,168736,168308,428,432,utRho16
leuQ,9212864,9212864,9212802,62,28,utRho16
leuU,6644556,6644556,6644316,240,1572,utRho16
leuV,9212546,9212546,9212330,216,1238,utRho16
leuX,8992772,8992810,8992772,38,60,utRho16
lexA,8514174,8514230,8514174,56,446,utRho16
lhr,3456706,3458174,3456706,1468,4998,utRho16
ligA,5060402,5060402,5060352,50,0,utRho16
ligB,7642576,7642576,7642340,236,738,utRho16
lipA,1320602,1320602,1320432,170,216,utRho16
lipB,1324802,1324802,1324556,246,9234,utRho16
lit,2397032,2397390,2397032,358,990,utRho16
livJ,7199524,7199524,7199316,208,1230,utRho16
livK,7195510,7195510,7195120,390,392,utRho16
lldP,7554578,7554798,7554578,220,5320,utRho16
lnt,1381968,1381968,1381762,206,502,utRho16
loiP,6163784,6163826,6163784,42,188,utRho16
lolA,1874656,1874738,1874656,82,160,utRho16
lolB,2527112,2527112,2527000,112,196,utRho16
lolC,2350748,2350854,2350748,106,0,utRho16
lon,917630,917776,917630,146,110,utRho16
lpcA,486936,487086,486936,150,206,utRho16
lpd,255434,255824,255434,390,2132,utRho16
lplA,9248476,9248476,9248234,242,992,utRho16
lplT,5947878,5947878,5947724,154,228,utRho16
lpoA,6586422,6586800,6586422,378,580,utRho16
lpp,3514592,3514842,3514592,250,336,utRho16
lptA,6686598,6686760,6686598,162,228,utRho16
lptB,6686792,6687888,6686792,1096,1558,utRho16
lptD,114672,114672,114218,454,624,utRho16
lptF,8972244,8972436,8972244,192,104,utRho16
lpxC,213016,213114,213016,98,2708,utRho16
lpxD,401920,401942,401920,22,0,utRho16
lpxL,2233418,2233418,2233164,254,0,utRho16
lpxM,3880456,3880456,3880386,70,72,utRho16
lpxP,4991156,4991290,4991156,134,172,utRho16
lrhA,4813312,4813312,4813282,30,48,utRho16
lrp,1864656,1865190,1864656,534,428,utRho16
lspA,50028,50414,50028,386,184,utRho16
lsrA,3202920,3202980,3202920,60,118,utRho16
lsrR,3202514,3202514,3202482,32,172,utRho16
ltaE,1818640,1818640,1818588,52,156,utRho16
luxS,5630130,5630130,5629466,664,15796,utRho16
lysA,5957902,5957902,5957798,104,78,utRho16
lysC,8467232,8467232,8466466,766,1432,utRho16
lysP,4497120,4497120,4497064,56,162,utRho16
lysR,5957900,5958042,5957900,142,44,utRho16
lysT,1561028,1561108,1561028,80,52,utRho16
lysU,8709610,8709610,8709434,176,146,utRho16
macB,1840188,1840694,1840188,506,2082,utRho16
maeA,3111484,3111484,3111338,146,4586,utRho16
mak,820236,820288,820236,52,76,utRho16
malE,8492928,8492928,8492838,90,0,utRho16
malI,3398456,3398456,3398360,96,0,utRho16
malK,8493472,8493568,8493472,96,148,utRho16
malP,7105020,7105020,7104946,74,1498,utRho16
malQ,7100798,7100798,7100140,658,608,utRho16
malS,14949880,14949988,14949880,108,0,utRho16
malT,7106048,7106170,7106048,122,154,utRho16
malX,3398626,3398710,3398626,84,0,utRho16
malZ,1689980,1690072,1689980,92,1592,utRho16
manA,3377102,3377152,3377102,50,0,utRho16
manX,3803866,3804096,3803866,230,160,utRho16
marC,3237882,3237882,3237816,66,188,utRho16
marR,3238186,3238240,3238186,54,232,utRho16
matP,2036918,2036970,2036918,52,96,utRho16
mazE,5822736,5822736,5822678,58,30,utRho16
mazG,5821720,5821720,5821370,350,1888,utRho16
mcbA,1684306,1684306,1684112,194,2,utRho16
mcbR,3040192,3040524,3040192,332,68,utRho16
mcrA,2420278,2420692,2420278,414,256,utRho16
mcrC,9156124,9156124,9155916,208,1204,utRho16
mdaB,6344814,6345060,6344814,246,336,utRho16
mdfA,1767138,1767346,1767138,208,40,utRho16
mdh,6768940,6768940,6768536,404,180,utRho16
mdoB,9198988,9198988,9198882,106,7032,utRho16
mdoD,2993290,2993712,2993290,422,42,utRho16
mdoG,2218514,2218670,2218514,156,238,utRho16
mdtA,4307958,4308032,4307958,74,468,utRho16
mdtE,7318168,7318464,7318168,296,14482,utRho16
mdtK,3486538,3486914,3486538,376,1790,utRho16
mdtP,8602472,8602472,8602060,412,804,utRho16
melA,8683774,8683822,8683774,48,16,utRho16
melR,8683300,8683300,8683256,44,570,utRho16
menA,8240812,8240812,8240698,114,44,utRho16
menB,4753774,4753774,4753638,136,412,utRho16
mepH,3468714,3468870,3468714,156,0,utRho16
mepM,3883666,3883666,3883270,396,334,utRho16
mepS,4539840,4539958,4539840,118,304,utRho16
metA,8428318,8428560,8428318,242,386,utRho16
metB,8257272,8257344,8257272,72,1050,utRho16
metC,6304150,6304472,6304150,322,308,utRho16
metE,8025768,8026106,8025768,338,1044,utRho16
metF,8265092,8265232,8265092,140,184,utRho16
metG,4388538,4388600,4388538,62,104,utRho16
metH,8447010,8447656,8447010,646,2234,utRho16
metJ,8257116,8257116,8256790,326,484,utRho16
metK,6173154,6173412,6173154,258,166,utRho16
metN,445428,445428,445290,138,136,utRho16
metR,8025710,8025710,8025632,78,84,utRho16
metT,1394326,1394326,1394266,60,252,utRho16
metY,19910250,19910250,19909734,516,1104,utRho16
metZ,11789528,11789548,11789528,20,0,utRho16
mfd,2348056,2348056,2347928,128,70,utRho16
mglA,4478782,4478782,4478578,204,808,utRho16
mglB,4481132,4481132,4480696,436,8638,utRho16
mglC,4475918,4475918,4475506,412,370,utRho16
mgrB,3817584,3817584,3817532,52,0,utRho16
mgrR,3245828,3245828,3245828,0,0,utRho16
mgsA,2054082,2054082,2054030,52,0,utRho16
mgtL,8934560,8934862,8934560,302,18,utRho16
mhpA,737038,737222,737038,184,370,utRho16
mhpR,737072,737072,736840,232,110,utRho16
mhpT,750772,750918,750772,146,0,utRho16
miaA,8797964,8798504,8797964,540,6442,utRho16
micA,5629604,5629604,5629604,0,0,utRho16
micC,2874242,2874238,2874242,4,0,utRho16
micF,4626168,4626168,4626168,0,0,utRho16
micM,1014408,1014408,1014408,0,0,utRho16
minE,2449422,2449422,2449090,332,994,utRho16
mioC,7852950,7852950,7852910,40,0,utRho16
mipA,3733012,3733012,3732944,68,1062,utRho16
mlaA,4930270,4930270,4930014,256,2,utRho16
mlc,3337206,3337206,3337128,78,136,utRho16
mlrA,4429498,4429732,4429498,234,522,utRho16
mltA,5894546,5894546,5894356,190,196,utRho16
mltD,468050,468050,467910,140,30,utRho16
mltF,5391534,5391602,5391534,68,8,utRho16
mmuP,550238,550650,550238,412,27042,utRho16
mngA,1531622,1531968,1531622,346,196,utRho16
mngR,1531852,1531852,1531750,102,92,utRho16
mnmG,7851348,7851348,7851266,82,3184,utRho16
mntH,5025470,5025470,5025412,58,2,utRho16
mntP,3810918,3811376,3810918,458,2164,utRho16
mntR,1706160,1706366,1706160,206,0,utRho16
mntS,1706128,1706128,1705994,134,0,utRho16
moaA,1633654,1634088,1633654,434,1016,utRho16
moaB,1635954,1636110,1635954,156,1052,utRho16
mobA,8084242,8084242,8083998,244,270,utRho16
mocA,6030112,6030320,6030112,208,482,utRho16
modA,1589990,1590178,1589990,188,456,utRho16
moeA,1732788,1732788,1732728,60,198,utRho16
mokB,2984610,2984610,2984258,352,682,utRho16
molR_1,4392888,4392948,4392888,60,108,utRho16
motA,3954604,3954604,3954278,326,80,utRho16
mpaA,2781278,2781278,2781196,82,368,utRho16
mpl,8911456,8911570,8911456,114,122,utRho16
mppA,2786108,2786454,2786108,346,140,utRho16
mprA,5621494,5621540,5621494,46,1418,utRho16
mqo,4613848,4613848,4613508,340,416,utRho16
mqsA,6336742,6336742,6336492,250,552,utRho16
mqsR,6337306,6337306,6337088,218,488,utRho16
mraZ,179192,179268,179192,76,0,utRho16
mrcA,7045652,7045742,7045652,90,52,utRho16
mrcB,329442,329460,329442,18,0,utRho16
mreB,13605424,13605424,13604348,1076,740,utRho16
mreD,6798166,6798166,6797750,416,202,utRho16
mrp,4388360,4388360,4388336,24,44,utRho16
mscK,972984,973072,972984,88,0,utRho16
mscL,6876002,6876048,6876002,46,444,utRho16
mscS,6139742,6139742,6139614,128,148,utRho16
msrA,8884522,8884522,8884352,170,432,utRho16
msrB,3725168,3725168,3724858,310,0,utRho16
msyB,2228426,2228426,2228362,64,100,utRho16
mtfA,4087236,4087302,4087236,66,614,utRho16
mtgA,6699662,6699662,6699618,44,1554,utRho16
mtlA,30177504,30178248,30177504,744,3776,utRho16
mtn,358366,358366,358306,60,1464,utRho16
mtr,6611864,6611864,6611634,230,246,utRho16
mug,6430992,6430992,6430946,46,42,utRho16
murQ,5091466,5091546,5091466,80,38,utRho16
murR,5091586,5091586,5091218,368,288,utRho16
mutH,5939164,5939324,5939164,160,92,utRho16
mutL,8794092,8794824,8794092,732,7166,utRho16
mutM,7622554,7622554,7622304,250,1112,utRho16
mutS,5714038,5714186,5714038,148,702,utRho16
mutY,18617466,18618078,18617466,612,792,utRho16
nac,4123956,4123956,4123866,90,1132,utRho16
nadA,1564122,1564170,1564122,48,62,utRho16
nadB,5420714,5420840,5420714,126,68,utRho16
nadC,237326,237326,237290,36,56,utRho16
nadE,3644604,3644916,3644604,312,234,utRho16
nadK,5501526,5501662,5501526,136,366,utRho16
nagA,1406350,1406350,1405502,848,4546,utRho16
nagB,1407416,1407416,1407222,194,88,utRho16
nagC,1404016,1404016,1403188,828,124,utRho16
nagE,1407680,1407888,1407680,208,74,utRho16
nagK,2357080,2357186,2357080,106,36,utRho16
nanA,6747240,6747240,6747152,88,36,utRho16
nanC,9079856,9079856,9079002,854,602,utRho16
nanR,6749406,6749406,6748978,428,632,utRho16
nanS,9075406,9075406,9075188,218,256,utRho16
napF,4607390,4607390,4606994,396,46,utRho16
narG,2559614,2559728,2559614,114,1120,utRho16
narK,2555642,2555914,2555642,272,394,utRho16
narP,4580844,4581000,4580844,156,218,utRho16
narQ,5171154,5171462,5171154,308,202,utRho16
narU,3088326,3088326,3088120,206,116,utRho16
narW,3077374,3077374,3074618,2756,964,utRho16
narX,2555554,2555554,2555236,318,350,utRho16
narZ,3085380,3085380,3085180,200,0,utRho16
ndh,2331984,2332170,2331984,186,458,utRho16
ndk,5289920,5289920,5289728,192,28,utRho16
nemR,6904084,6904092,6904084,8,632,utRho16
nepI,7683542,7683542,7683478,64,78,utRho16
nfo,4501612,4501680,4501612,68,32,utRho16
nfsB,1210906,1210906,1210848,58,282,utRho16
nfuA,7090916,7091248,7090916,332,778,utRho16
nhaA,34634,34978,34634,344,434,utRho16
nhaB,2469534,2469534,2469434,100,32,utRho16
nhoA,3067926,3068048,3067926,122,84,utRho16
nikA,7226878,7227334,7226878,456,9256,utRho16
nikR,7237074,7237176,7237074,102,380,utRho16
nirB,6987974,6988022,6987974,48,116,utRho16
nlpA,7680034,7680034,7679986,48,0,utRho16
nlpC,3585654,3585654,3585462,192,86,utRho16
nlpD,5737658,5737658,5737506,152,74,utRho16
nlpI,6618080,6618080,6617848,232,0,utRho16
nmpC,1153740,1153740,1153650,90,0,utRho16
nohA,3273206,3273206,3272734,472,586,utRho16
norR,5664614,5664614,5664578,36,52,utRho16
norV,5664878,5664952,5664878,74,244,utRho16
nrdA,4689510,4689730,4689510,220,4264,utRho16
nrdD,8925676,8925676,8925320,356,8756,utRho16
nrdH,5601312,5601446,5601312,134,1420,utRho16
nrdR,865954,866004,865954,50,0,utRho16
nrfA,8575342,8575528,8575342,186,0,utRho16
nsrR,8812088,8812380,8812088,292,5802,utRho16
nudB,3897348,3897348,3897264,84,52,utRho16
nudC,8393428,8393806,8393428,378,138,utRho16
nudE,7052658,7052658,7052298,360,766,utRho16
nudG,3682876,3682980,3682876,104,30,utRho16
nudI,4729050,4729108,4729050,58,0,utRho16
nudJ,2388874,2388874,2388576,298,686,utRho16
nuoA,4810670,4810670,4810144,526,3890,utRho16
nuoN,4783434,4783434,4783010,424,648,utRho16
nupC,5026018,5026084,5026018,66,0,utRho16
nupG,6211302,6211428,6211302,126,0,utRho16
ogrK,4335096,4335096,4335040,56,50,utRho16
ogt,2800568,2800568,2800472,96,88,utRho16
ohsC,5401036,5401040,5401036,4,0,utRho16
ompA,2040382,2040382,2040106,276,18232,utRho16
ompC,4625774,4625774,4625498,276,214,utRho16
ompF,1974184,1974184,1973964,220,600,utRho16
ompL,8128958,8128958,8128590,368,574,utRho16
ompN,2874158,2874158,2873786,372,24,utRho16
ompR,7073510,7073510,7073168,342,116,utRho16
ompT,1171330,1171330,1171266,64,212,utRho16
ompW,2627982,2628040,2627982,58,0,utRho16
ompX,1700418,1700900,1700418,482,2078,utRho16
omrA,5952378,5952378,5952378,0,0,utRho16
omrB,5952770,5952770,5952770,0,0,utRho16
oppA,2602170,2602364,2602170,194,4936,utRho16
orn,8783168,8783208,8783168,40,0,utRho16
osmB,2686952,2686952,2686656,296,1572,utRho16
osmC,3113192,3113250,3113192,58,292,utRho16
osmE,3644566,3644566,3644512,54,148,utRho16
osmF,4439046,4439046,4438962,84,1820,utRho16
osmY,9222306,9222792,9222306,486,1026,utRho16
otsA,3963302,3963302,3963224,78,488,utRho16
otsB,3964930,3964930,3964774,156,558,utRho16
oxc,4984288,4984288,4983900,388,888,utRho16
oxyR,8316914,8316980,8316914,66,1162,utRho16
oxyS,8316788,8316788,8316788,0,0,utRho16
paaA,2907730,2907854,2907730,124,18,utRho16
paaX,2927018,2927078,2927018,60,0,utRho16
paaZ,2907340,2907340,2907284,56,40,utRho16
pabA,6981702,6981702,6981658,44,352,utRho16
pabB,3789256,3789610,3789256,354,844,utRho16
pabC,2306186,2306600,2306186,414,1196,utRho16
pagP,1313052,1313114,1313052,62,0,utRho16
panB,299260,299260,299202,58,7772,utRho16
panC,297840,297840,297590,250,350,utRho16
panD,293490,293490,293388,102,138,utRho16
panZ,7195656,7195968,7195656,312,374,utRho16
parC,6332060,6332060,6331946,114,414,utRho16
patA,6438916,6438988,6438916,72,118,utRho16
patD,3030830,3031156,3030830,326,130,utRho16
pbpC,5294986,5294986,5294650,336,218,utRho16
pbpG,4450132,4450132,4449740,392,368,utRho16
pck,7065358,7065636,7065358,278,3542,utRho16
pcnB,318782,318782,318252,530,672,utRho16
pdhR,244068,244184,244068,116,0,utRho16
pdxB,4875768,4875768,4875702,66,226,utRho16
pdxH,3436068,3436068,3436014,54,252,utRho16
pdxJ,5403626,5403626,5403458,168,112,utRho16
pdxK,5074638,5074638,5074474,164,132,utRho16
pepA,8972278,8972278,8971902,376,94,utRho16
pepD,511618,511618,511432,186,1788,utRho16
pepN,1981182,1981244,1981182,62,0,utRho16
pepQ,8062294,8062322,8062294,28,10,utRho16
pepT,2371646,2371688,2371646,42,408,utRho16
pfkA,8214948,8215104,8214948,156,266,utRho16
pfkB,3612646,3612740,3612646,94,0,utRho16
pflA,1902456,1902456,1902160,296,40,utRho16
pflB,1907850,1907850,1907108,742,1626,utRho16
pflD,8287716,8287990,8287716,274,0,utRho16
pgaA,2185046,2185046,2184578,468,134,utRho16
pgi,8467444,8467516,8467444,72,0,utRho16
pgk,12291428,12291428,12290488,940,3808,utRho16
pgl,1597078,1597172,1597078,94,0,utRho16
pgpB,2678324,2678660,2678324,336,324,utRho16
pgpC,5397276,5397276,5397100,176,172,utRho16
pgrR,2783744,2783982,2783744,238,346,utRho16
pheL,5475158,5475198,5475158,40,94,utRho16
pheM,7197204,7197204,7197080,124,220,utRho16
pheP,1203858,1203918,1203858,60,60,utRho16
pheU,8725254,8725254,8725252,2,0,utRho16
pheV,6220730,6220732,6220730,2,0,utRho16
phnC,8650412,8650412,8650330,82,174,utRho16
phoA,803414,803494,803414,80,482,utRho16
phoB,834202,834284,834202,82,0,utRho16
phoE,520316,520316,520200,116,816,utRho16
phoH,2169730,2169984,2169730,254,506,utRho16
phoP,2381016,2381016,2380894,122,1758,utRho16
phoQ,2379880,2379880,2379552,328,1038,utRho16
phoU,7815330,7815330,7815156,174,98,utRho16
phr,1478842,1479014,1478842,172,70,utRho16
pinE,2419054,2419370,2419054,316,896,utRho16
pinQ,3267168,3267244,3267168,76,260,utRho16
pinR,2867424,2867424,2867348,76,280,utRho16
pitA,7275224,7275284,7275224,60,34,utRho16
pitB,6272806,6272806,6272742,64,172,utRho16
pka,5439862,5439906,5439862,44,438,utRho16
plaP,4174476,4174476,4174124,352,276,utRho16
pldA,8009628,8009724,8009628,96,1550,utRho16
pldB,8018028,8018340,8018028,312,3108,utRho16
plsB,8513196,8513196,8512932,264,224,utRho16
pmbA,8915890,8915918,8915890,28,140,utRho16
pmrD,4747148,4747148,4747076,72,46,utRho16
pncB,1980828,1980828,1980712,116,0,utRho16
pncC,5648788,5648788,5648692,96,0,utRho16
pnp,6622652,6622652,6622336,316,192,utRho16
pntA,3355950,3355950,3355806,144,36,utRho16
pntB,3353096,3353096,3352720,376,80,utRho16
polA,8093880,8093932,8093880,52,274,utRho16
polB,131606,131606,131560,46,0,utRho16
potD,2365700,2365700,2365658,42,30,utRho16
potE,1436688,1436688,1436530,158,120,utRho16
potF,1787268,1787568,1787268,300,406,utRho16
poxB,1822152,1822152,1822098,54,182,utRho16
ppa,8899372,8899372,8899304,68,56,utRho16
ppc,8306380,8306380,8306196,184,654,utRho16
ppdA,5928440,5928440,5928354,86,2786,utRho16
ppdD,235410,235410,235098,312,308,utRho16
pphA,3846770,3846770,3845938,832,4130,utRho16
pphB,5719474,5719520,5719474,46,238,utRho16
ppiA,6984898,6984898,6984594,304,220,utRho16
ppiC,7919682,7919682,7919626,56,10,utRho16
ppiD,923638,923830,923638,192,398,utRho16
ppk,5245748,5246088,5245748,340,470,utRho16
pppA,6228958,6228958,6228704,254,314,utRho16
ppsA,3574322,3574322,3574224,98,0,utRho16
ppsR,3574678,3574890,3574678,212,96,utRho16
pptA,3065716,3066104,3065716,388,432,utRho16
pqiA,2023318,2024002,2023318,684,98,utRho16
prc,3830054,3830054,3829632,422,5752,utRho16
preT,4467978,4468066,4467978,88,2654,utRho16
prfC,9218688,9218828,9218688,140,1562,utRho16
prkB,6968622,6968980,6968622,358,1500,utRho16
prlC,7290476,7290476,7290364,112,514,utRho16
prlF,6553944,6554004,6553944,60,690,utRho16
proB,520432,520776,520432,344,564,utRho16
proC,811372,811372,811288,84,82,utRho16
proK,7417388,7417388,7417384,4,0,utRho16
proL,4572414,4572422,4572414,8,0,utRho16
proP,8660640,8661004,8660640,364,160,utRho16
proS,437674,437674,437550,124,486,utRho16
proV,5609126,5609630,5609126,504,3050,utRho16
prpB,697292,697364,697292,72,226,utRho16
prpR,696942,696942,696886,56,82,utRho16
prs,2524354,2524354,2523750,604,29714,utRho16
psd,8781276,8781276,8780720,556,1404,utRho16
psiE,8480600,8480650,8480600,50,50,utRho16
pspA,2736076,2736158,2736076,82,0,utRho16
pspF,2736080,2736080,2735824,256,0,utRho16
pspG,8525632,8525680,8525632,48,80,utRho16
pssA,5445156,5445454,5445156,298,4724,utRho16
pstB,7817112,7817112,7816732,380,276,utRho16
pstC,7821084,7821084,7820796,288,192,utRho16
pstS,23469408,23469408,23469150,258,462,utRho16
psuG,4517114,4517114,4516734,380,4428,utRho16
psuT,4514992,4514992,4514670,322,0,utRho16
pth,2517084,2517084,2517026,58,16,utRho16
ptrA,5918022,5918022,5917768,254,38,utRho16
ptrB,3857730,3857730,3857678,52,2982,utRho16
ptsG,2315252,2315738,2315252,486,2210,utRho16
ptsH,5066996,5067528,5066996,532,3148,utRho16
purA,8809328,8809374,8809328,46,24,utRho16
purC,5195562,5195562,5195236,326,56,utRho16
purD,8411972,8411972,8411862,110,154,utRho16
purE,1106284,1106284,1106200,84,1062,utRho16
purH,8415254,8415254,8415064,190,22,utRho16
purL,5391178,5391178,5391086,92,350,utRho16
purM,5242306,5242394,5242306,88,0,utRho16
purR,3475378,3475688,3475378,310,322,utRho16
purT,3861438,3861762,3861438,324,462,utRho16
purU,2577512,2577512,2577248,264,278,utRho16
putA,2157850,2157850,2157764,86,0,utRho16
putP,2158336,2158610,2158336,274,210,utRho16
puuA,2721936,2721936,2721816,120,0,utRho16
puuC,2725456,2725486,2725456,30,0,utRho16
puuD,2722104,2722240,2722104,136,0,utRho16
puuP,2718746,2718746,2718374,372,1116,utRho16
pykA,3874988,3875298,3874988,310,58,utRho16
pykF,3510934,3511396,3510934,462,1048,utRho16
pyrC,2245286,2245286,2245214,72,0,utRho16
pyrD,2009464,2009536,2009464,72,78,utRho16
pyrE,7631970,7631970,7631536,434,630,utRho16
pyrF,2683740,2683842,2683740,102,278,utRho16
pyrG,5819594,5819594,5819332,262,2168,utRho16
pyrH,383624,383710,383624,86,644,utRho16
pyrL,8945490,8945490,8945066,424,818,utRho16
qmcA,1031646,1031646,1031546,100,736,utRho16
qor,8528608,8528608,8528462,146,862,utRho16
qseB,6339502,6339656,6339502,154,1144,utRho16
queA,849970,850022,849970,52,632,utRho16
queE,5811212,5811212,5810836,376,388,utRho16
queF,5850642,5850696,5850642,54,116,utRho16
queG,8788184,8788184,8788134,50,59610,utRho16
racC,2835630,2835630,2835526,104,0,utRho16
racR,2840898,2840898,2840482,416,122,utRho16
raiA,5474208,5474308,5474208,100,62,utRho16
rarD,8008594,8008594,8008356,238,892,utRho16
ravA,7862256,7862256,7862186,70,68,utRho16
rayT,495088,495274,495088,186,142,utRho16
rbn,4763162,4763216,4763162,54,0,utRho16
rbsD,7866644,7866702,7866644,58,48,utRho16
rcnA,4371654,4371834,4371654,180,86,utRho16
rcnB,4373768,4373920,4373768,152,54,utRho16
rcnR,4371806,4371806,4371592,214,142,utRho16
rcsA,4047672,4047936,4047672,264,2412,utRho16
rcsB,4631390,4632354,4631390,964,320,utRho16
rcsC,4640162,4640162,4639656,506,296,utRho16
rcsD,4626904,4626976,4626904,72,196,utRho16
rdgB,6193240,6193362,6193240,122,500,utRho16
rdlA,2538646,2538646,2538646,0,0,utRho16
rdlB,2539712,2539716,2539712,4,16,utRho16
rdlC,2540782,2540786,2540782,4,0,utRho16
rdlD,7400272,7400272,7400272,0,0,utRho16
rdoA,8084782,8084830,8084782,48,58,utRho16
recA,11295276,11295276,11295076,200,192,utRho16
recC,5925014,5925014,5924856,158,112,utRho16
recF,7763722,7763722,7762442,1280,6640,utRho16
recN,5503518,5503590,5503518,72,0,utRho16
recQ,8011666,8011728,8011666,62,132,utRho16
relA,5828554,5828554,5827302,1252,374,utRho16
relB,3291806,3291806,3291744,62,0,utRho16
rem,3289950,3289950,3289804,146,0,utRho16
rep,7921294,7921354,7921294,60,14,utRho16
rfaD,7587730,7587974,7587730,244,522,utRho16
rfaE,6393852,6393852,6393506,346,304,utRho16
rfaH,8049930,8049930,8049642,288,2262,utRho16
rfbX,4219436,4219436,4219168,268,434,utRho16
rfe,7935600,7935832,7935600,232,172,utRho16
rhaB,8194944,8194944,8194896,48,70,utRho16
rhaD,8188770,8188770,8188544,226,170,utRho16
rhaS,8195422,8195472,8195422,50,54,utRho16
rhaT,8201132,8201132,8201050,82,148,utRho16
rhlE,1661566,1661744,1661566,178,90,utRho16
rhoL,47593944,47594772,47593944,828,68340,utRho16
rhsB,7238006,7238384,7238006,378,2324,utRho16
rhsC,1458758,1459166,1458758,408,0,utRho16
rhsD,1046132,1046522,1046132,390,64,utRho16
rhtA,1700608,1700608,1700194,414,286,utRho16
rhtC,8015478,8015514,8015478,36,1426,utRho16
ribA,2678468,2678468,2678320,148,246,utRho16
ribC,3486916,3486916,3486484,432,3236,utRho16
ribE,869008,869294,869008,286,3418,utRho16
ribF,42766,42814,42766,48,14,utRho16
ridA,8941892,8941892,8941826,66,194,utRho16
rihA,1369204,1369204,1368824,380,6602,utRho16
rihB,4510504,4510504,4510372,132,238,utRho16
rimJ,2251044,2251124,2251044,80,102,utRho16
rimK,1783752,1783934,1783752,182,588,utRho16
rimL,2997486,2997876,2997486,390,64,utRho16
rimO,1756140,1756140,1756070,70,70,utRho16
rimP,6636350,6636350,6636012,338,220,utRho16
rlmA,3814172,3814172,3814120,52,1128,utRho16
rlmD,5830086,5830086,5830000,86,22,utRho16
rlmE,6655520,6655520,6655328,192,930,utRho16
rlmF,1684384,1684664,1684384,280,24,utRho16
rlmG,6471784,6471784,6471750,34,32,utRho16
rlmI,2060002,2060002,2059938,64,88,utRho16
rlmJ,7290700,7290770,7290700,70,0,utRho16
rlmL,2015344,2015688,2015344,344,1030,utRho16
rlpA,1330444,1330444,1330380,64,56,utRho16
rluA,120900,120900,120692,208,222,utRho16
rluF,8460324,8460708,8460324,384,54,utRho16
rmf,2031006,2031430,2031006,424,904,utRho16
rna,1290068,1290068,1290006,62,32,utRho16
rnb,2698258,2698258,2697824,434,4810,utRho16
rnc,10816892,10816892,10816252,640,5520,utRho16
rnd,3776122,3776122,3775982,140,4,utRho16
rne,2289746,2289746,2288734,1012,3998,utRho16
rnhA,472082,472082,472004,78,726,utRho16
rnk,1288360,1288360,1287934,426,88,utRho16
rnlA,5531788,5531836,5531788,48,320,utRho16
rnlB,5533414,5533968,5533414,554,604,utRho16
rnpB,19623552,19623552,19623552,0,0,utRho16
rob,9270706,9270706,9270620,86,160,utRho16
rodZ,5285868,5285868,5285688,180,16,utRho16
rpe,7030306,7030306,7030118,188,24,utRho16
rph,15266320,15266320,15266196,124,0,utRho16
rpiA,6118706,6118706,6118650,56,1334,utRho16
rpiB,8626514,8626700,8626514,186,440,utRho16
rpiR,8626274,8626274,8625982,292,90,utRho16
rplJ,8359246,8359992,8359246,746,4152,utRho16
rplK,8356708,8356894,8356708,186,870,utRho16
rplM,6757344,6757344,6757302,42,4464,utRho16
rplN,6896444,6896444,6896298,146,6356,utRho16
rplS,5489284,5489284,5489060,224,5224,utRho16
rplT,7199052,7199052,7198996,56,816,utRho16
rplU,6667036,6667036,6666902,134,0,utRho16
rplY,4564866,4565034,4564866,168,68,utRho16
rpmA,6666450,6666450,6666238,212,346,utRho16
rpmB,15247980,15247980,15246696,1284,49352,utRho16
rpmE,8253816,8254026,8253816,210,696,utRho16
rpmF,2294676,2294734,2294676,58,14378,utRho16
rpmH,7768130,7768672,7768130,542,3508,utRho16
rpmI,3600854,3600854,3599998,856,9032,utRho16
rpoB,8362126,8362490,8362126,364,988,utRho16
rpoD,6424946,6426094,6424946,1148,21742,utRho16
rpoE,5420372,5420372,5420024,348,46,utRho16
rpoH,7202006,7202006,7201566,440,2702,utRho16
rpoN,6689324,6689434,6689324,110,38,utRho16
rpoS,5736236,5736236,5735102,1134,2968,utRho16
rpoZ,7644154,7644212,7644154,58,272,utRho16
rppH,5937986,5937986,5937954,32,0,utRho16
rprA,3540744,3540744,3540744,0,0,utRho16
rpsA,1923434,1923990,1923434,556,76834,utRho16
rpsF,8850050,8850236,8850050,186,13926,utRho16
rpsI,6756580,6756580,6756414,166,5062,utRho16
rpsJ,6906884,6906884,6906540,344,3886,utRho16
rpsL,6949242,6949242,6949104,138,760,utRho16
rpsM,6885130,6885130,6884942,188,880,utRho16
rpsO,13247144,13247144,13246736,408,460,utRho16
rpsP,5492508,5492508,5492370,138,246,utRho16
rpsT,42420,42420,42156,264,384,utRho16
rpsU,12842584,12843124,12842584,540,1872,utRho16
rraA,8238716,8238716,8238660,56,224,utRho16
rraB,8956768,8956946,8956768,178,422,utRho16
rrsA,8070478,8071062,8070478,584,4734,utRho16
rrsB,16665468,16666636,16665468,1168,9892,utRho16
rrsC,7883032,7883616,7883032,584,4838,utRho16
rrsD,6858094,6858094,6857524,570,1084,utRho16
rrsE,8415726,8416294,8415726,568,664,utRho16
rrsG,5462896,5462896,5462314,582,3688,utRho16
rrsH,446970,447542,446970,572,1076,utRho16
rsd,8393908,8393908,8393616,292,252,utRho16
rseA,5419264,5419264,5418808,456,6,utRho16
rseP,392940,393092,392940,152,106,utRho16
rseX,4067298,4067298,4067298,0,0,utRho16
rsfS,1338144,1338144,1338072,72,74,utRho16
rsgA,8783132,8783132,8783018,114,52,utRho16
rsmA,105176,105176,104860,316,1526,utRho16
rsmB,6869982,6870414,6869982,432,132,utRho16
rsmC,9215736,9215736,9215400,336,138,utRho16
rsmD,7208594,7208786,7208594,192,26,utRho16
rsmE,6182036,6182268,6182036,232,760,utRho16
rsmG,7847512,7847512,7847360,152,2330,utRho16
rsmH,180020,180188,180020,168,140,utRho16
rsmI,6587106,6587106,6586670,436,1206,utRho16
rssA,2578212,2578412,2578212,200,178,utRho16
rssB,2580440,2580484,2580440,44,184,utRho16
rstA,3364276,3364300,3364276,24,0,utRho16
rsuA,4561096,4561096,4560966,130,120,utRho16
rsxA,3411510,3411534,3411510,24,36,utRho16
rtcA,7114004,7114004,7113698,306,1914,utRho16
rtcB,7116214,7116214,7116158,56,88,utRho16
rtn,4541356,4541452,4541356,96,0,utRho16
rutA,2148052,2148052,2148022,30,0,utRho16
rutG,2140090,2140090,2139678,412,8,utRho16
rutR,2148226,2148484,2148226,258,750,utRho16
ruvA,7784096,7784096,7783904,192,40,utRho16
ruvB,7782176,7782176,7781424,752,496,utRho16
ruvC,3894878,3894878,3894752,126,110,utRho16
rybB,1776114,1776114,1776114,0,0,utRho16
rydB,3529860,3529860,3529322,538,232,utRho16
rydC,2983012,2983012,2983012,0,0,utRho16
ryfA,5307398,5307710,5307398,312,140,utRho16
ryfD,5468590,5468590,5468590,0,0,utRho16
ryhB,7162032,7162032,7162032,0,0,utRho16
ryjA,8556132,8556132,8556132,0,0,utRho16
ryjB,9055954,9055954,9055954,0,0,utRho16
sad,3229598,3229598,3229406,192,54,utRho16
safA,3168056,3168056,3167918,138,676,utRho16
sanA,4465368,4465756,4465368,388,336,utRho16
sapF,2705314,2705314,2705268,46,144,utRho16
sbcB,4165456,4165512,4165456,56,0,utRho16
sbcC,831694,831694,831506,188,80,utRho16
sbcD,833954,833954,833904,50,100,utRho16
sbmA,793106,793278,793106,172,1604,utRho16
sbmC,4162650,4162650,4162524,126,74,utRho16
sdaA,3793618,3793864,3793618,246,126,utRho16
sdaC,5856070,5856458,5856070,388,1934,utRho16
sdhC,1509916,1510354,1509916,438,30778,utRho16
sdhD,1510808,1511120,1510808,312,7140,utRho16
sdiA,3993834,3993834,3993664,170,370,utRho16
secE,8354354,8354716,8354354,362,64,utRho16
secG,6645180,6645180,6645010,170,808,utRho16
selA,7522594,7522594,7522498,96,1574,utRho16
selB,7519850,7519850,7519722,128,162,utRho16
selC,7672396,7672444,7672396,48,126,utRho16
selD,3696058,3696058,3696016,42,732,utRho16
seqA,1425884,1425974,1425884,90,118,utRho16
serA,6117098,6117098,6116820,278,438,utRho16
serB,9249712,9249790,9249712,78,66,utRho16
serC,3830380,3830612,3830380,232,0,utRho16
serS,1878730,1878856,1878730,126,834,utRho16
serT,2063438,2063438,2063424,14,0,utRho16
serU,4087124,4087124,4087114,10,130,utRho16
serV,5637394,5637394,5637290,104,116,utRho16
serW,1852014,1852014,1851942,72,90,utRho16
serX,2195352,2195352,2195304,48,50,utRho16
setB,4527426,4527726,4527426,300,102,utRho16
setC,7673488,7673906,7673488,418,2052,utRho16
sfmA,1116124,1116424,1116124,300,0,utRho16
sfmC,1117606,1117948,1117606,342,148,utRho16
sfsA,323030,323030,322972,58,452,utRho16
sfsB,6669592,6669818,6669592,226,830,utRho16
sgrR,154676,154676,154598,78,0,utRho16
sgrS,154734,154734,154734,0,0,utRho16
shiA,4107068,4107286,4107068,218,102,utRho16
sibA,4306622,4306622,4306622,0,0,utRho16
sibB,4307292,4307292,4307292,0,0,utRho16
sibC,6113702,6113702,6113702,0,0,utRho16
sibD,6389730,6389730,6389730,0,0,utRho16
sibE,6390480,6390480,6390480,0,0,utRho16
sixA,4913998,4913998,4913624,374,18,utRho16
slp,7307872,7307922,7307872,50,136,utRho16
slt,9261400,9261466,9261400,66,58,utRho16
slyA,3442028,3442028,3441648,380,278,utRho16
slyB,3439496,3439752,3439496,256,0,utRho16
slyD,6957398,6957398,6956994,404,364,utRho16
slyX,6954862,6955280,6954862,418,2342,utRho16
smf,6867372,6867372,6867120,252,668,utRho16
smpB,5509534,5509792,5509534,258,732,utRho16
smrA,2811872,2811958,2811872,86,356,utRho16
smrB,4896872,4897212,4896872,340,802,utRho16
smtA,1946808,1947074,1946808,266,58,utRho16
sodA,8201518,8201620,8201518,102,2002,utRho16
sodB,3470646,3470756,3470646,110,1196,utRho16
sodC,3449358,3449358,3449310,48,76,utRho16
sohB,2658568,2658664,2658568,96,288,utRho16
sokB,2984232,2984238,2984232,6,164,utRho16
solA,2241218,2241218,2241172,46,42,utRho16
soxR,8554894,8554938,8554894,44,84,utRho16
soxS,8554846,8554846,8554766,80,84,utRho16
speA,6172096,6172096,6171822,274,400,utRho16
speB,6167892,6167892,6167594,298,210,utRho16
speC,6218350,6218350,6218310,40,0,utRho16
spf,8099798,8099798,8099798,0,0,utRho16
sppA,3697422,3697674,3697422,252,440,utRho16
spy,3651376,3651376,3651250,126,0,utRho16
sra,3112092,3112092,3111926,166,36,utRho16
sraB,2293178,2293178,2293178,0,0,utRho16
sraC,3846132,3846132,3846132,0,0,utRho16
srlA,5651582,5651664,5651582,82,200,utRho16
srlR,5657720,5658094,5657720,374,1512,utRho16
srmB,5425752,5425792,5425752,40,24,utRho16
sroA,151216,151216,151216,0,0,utRho16
sroG,6369436,6369436,6369436,0,0,utRho16
sroH,8380974,8380974,8380974,0,0,utRho16
ssb,8548022,8548250,8548022,228,124,utRho16
sseA,5304782,5304988,5304782,206,3122,utRho16
sspA,6755138,6755138,6754840,298,268,utRho16
ssrA,5511014,5511186,5511014,172,22,utRho16
ssrS,12223036,12223932,12223036,896,2912,utRho16
sstT,6479726,6479888,6479726,162,88,utRho16
ssuB,1988282,1988282,1988088,194,172,utRho16
ssuE,1995126,1995126,1995024,102,0,utRho16
sthA,8321604,8321604,8321580,24,1494,utRho16
stpA,5597156,5597156,5596990,166,60,utRho16
sucA,3034344,3034824,3034344,480,5172,utRho16
sufA,3528836,3528836,3528772,64,88,utRho16
sufE,3518962,3518962,3518580,382,250,utRho16
sugE,8753588,8753750,8753588,162,1096,utRho16
sulA,2041894,2041894,2041838,56,1810,utRho16
syd,5850738,5850738,5850560,178,228,utRho16
symE,9159834,9159834,9159680,154,378,utRho16
symR,9159670,9159670,9159670,0,0,utRho16
tabA,8949566,8949724,8949566,158,102,utRho16
talA,5157140,5157332,5157140,192,0,utRho16
talB,16382,16476,16382,94,3772,utRho16
tam,3214442,3214692,3214442,250,84,utRho16
tamA,8884540,8884764,8884540,224,438,utRho16
tar,3945432,3945432,3945382,50,70,utRho16
tas,5943138,5943194,5943138,56,1536,utRho16
tatA,16087636,16087780,16087636,144,228,utRho16
tatE,1317742,1317894,1317742,152,88,utRho16
tauA,770410,770464,770410,54,0,utRho16
tdcA,6534186,6534186,6534130,56,0,utRho16
tdcG,6519652,6519652,6519298,354,1130,utRho16
tdcR,6534380,6534760,6534380,380,114,utRho16
tdk,2586986,2587054,2586986,68,0,utRho16
tehA,3001072,3001146,3001072,74,0,utRho16
tesA,1039898,1039898,1039530,368,350,utRho16
tesB,950402,950402,950322,80,0,utRho16
tfaE,2418532,2418532,2418238,294,898,utRho16
tfaQ,3269912,3269912,3269770,142,182,utRho16
tff,379424,379256,379424,168,38,utRho16
tgt,852110,852274,852110,164,20,utRho16
thiD,4369346,4369346,4369032,314,122,utRho16
thiI,882936,883098,882936,162,254,utRho16
thiM,4370902,4370902,4370602,300,884,utRho16
thiQ,146170,146170,145854,316,2438,utRho16
thrL,592,760,592,168,188,utRho16
thrS,7210932,7210932,7210280,652,576,utRho16
thrU,8350762,8350776,8350762,14,60,utRho16
thrV,6847414,6847414,6847310,104,135762,utRho16
thrW,525682,525742,525682,60,1572,utRho16
thyA,5930696,5930696,5930310,386,1830,utRho16
tig,909986,910266,909986,280,542,utRho16
tisB,7706674,7707106,7706674,432,1260,utRho16
tktA,6163414,6163414,6163270,144,138,utRho16
tktB,5158616,5159272,5158616,656,1350,utRho16
tldD,6784368,6784368,6784056,312,154,utRho16
tmcA,5191876,5191876,5191718,158,706,utRho16
tnaC,15553644,15553740,15553644,96,724,utRho16
tolB,1555074,1555480,1555074,406,220,utRho16
tolC,6356008,6356230,6356008,222,518,utRho16
tomB,961588,961588,961416,172,1868,utRho16
tonB,2622108,2622178,2622108,70,18,utRho16
topA,2661578,2662096,2661578,518,128,utRho16
torC,2116112,2116168,2116112,56,262,utRho16
torR,2115968,2115968,2115908,60,328,utRho16
torS,2112364,2112364,2112356,8,0,utRho16
torT,2112414,2112522,2112414,108,0,utRho16
tpiA,8223138,8223138,8223014,124,376,utRho16
tppB,3425342,3425538,3425342,196,5532,utRho16
tpr,2574376,2574376,2574376,0,0,utRho16
tpx,2777688,2777688,2777622,66,378,utRho16
tqsA,3347780,3347826,3347780,46,0,utRho16
treA,2494850,2494850,2494752,98,636,utRho16
treB,8932420,8932420,8932360,60,150,utRho16
treF,7339102,7339184,7339102,82,188,utRho16
treR,8934694,8934694,8934492,202,0,utRho16
trg,2984878,2984940,2984878,62,50,utRho16
trkG,2847342,2847564,2847342,222,578,utRho16
trmA,8326590,8326590,8326540,50,72,utRho16
trpA,2634678,2634678,2634444,234,456,utRho16
trpC,2639888,2639888,2639570,318,0,utRho16
trpL,5292432,5292432,5292328,104,28,utRho16
trpR,9265408,9265520,9265408,112,150,utRho16
trpS,7027394,7027394,7027276,118,2008,utRho16
trpT,7893560,7893914,7893560,354,90996,utRho16
trxA,7931294,7931522,7931294,228,346,utRho16
trxB,1864156,1864156,1864100,56,36,utRho16
trxC,5437350,5437470,5437350,120,544,utRho16
tsaD,6421256,6421256,6421086,170,18,utRho16
tsgA,6985038,6985136,6985038,98,334,utRho16
tsr,9182824,9183314,9182824,490,4462,utRho16
tsx,864490,864490,864026,464,852,utRho16
ttcA,2823970,2823970,2823896,74,3844,utRho16
ttdA,6412848,6412926,6412848,78,176,utRho16
ttdR,6412760,6412760,6412512,248,472,utRho16
tufA,6943448,6943448,6942658,790,123096,utRho16
tus,3368346,3368518,3368346,172,202,utRho16
tusA,7218040,7218040,7217992,48,208,utRho16
tusB,6950218,6950218,6949930,288,86,utRho16
tynA,2902996,2902996,2902698,298,0,utRho16
typA,8116460,8116814,8116460,354,4242,utRho16
tyrB,8534164,8534228,8534164,64,2446,utRho16
tyrP,3979004,3979362,3979004,358,1372,utRho16
tyrR,2773384,2773440,2773384,56,174,utRho16
tyrS,3434566,3434566,3434444,122,0,utRho16
tyrT,2575330,2575330,2575244,86,62,utRho16
uacT,6062378,6062734,6062378,356,728,utRho16
ubiC,8504886,8505012,8504886,126,226,utRho16
ubiD,8049618,8049976,8049618,358,2434,utRho16
ubiE,8037494,8037710,8037494,216,178,utRho16
ubiG,4679078,4679134,4679078,56,6,utRho16
ucpA,5089342,5089342,5089246,96,106,utRho16
udp,8032782,8032862,8032782,80,170,utRho16
ugd,4199470,4199470,4199226,244,0,utRho16
ugpB,7184852,7184852,7184650,202,1956,utRho16
ugpQ,7176600,7176600,7176226,374,58,utRho16
uhpT,7694396,7694396,7694334,62,410,utRho16
uidA,3392304,3392304,3392142,162,114,utRho16
uidC,3386012,3386012,3385702,310,0,utRho16
uidR,3394150,3394150,3394104,46,0,utRho16
ulaA,8839854,8839960,8839854,106,314,utRho16
ulaG,8839350,8839350,8839250,100,180,utRho16
ulaR,8837124,8837124,8836906,218,94,utRho16
umpG,5741372,5741372,5740548,824,490,utRho16
umpH,1400704,1400704,1400652,52,0,utRho16
umuD,2461476,2461534,2461476,58,0,utRho16
ung,5433476,5433508,5433476,32,268,utRho16
uof,2843316,2843316,2842900,416,3288,utRho16
upp,5241818,5241818,5241744,74,176,utRho16
usg,4873780,4873780,4873298,482,74,utRho16
ushA,1009772,1009828,1009772,56,104,utRho16
uspA,7279966,7280222,7279966,256,410,utRho16
uspB,7279696,7279696,7279440,256,384,utRho16
uspC,3959172,3959506,3959172,334,24,utRho16
uspE,2797318,2797318,2797244,74,0,utRho16
uspF,2871282,2871282,2871238,44,70,utRho16
uspG,1283806,1283806,1283734,72,1550,utRho16
uvrA,8547872,8547872,8547742,130,394,utRho16
uvrB,1626304,1627052,1626304,748,1798,utRho16
uvrC,3989758,3989758,3989412,346,176,utRho16
uvrD,7995814,7995966,7995814,152,584,utRho16
uvrY,3990812,3990812,3990718,94,192,utRho16
uxaB,3221474,3221474,3221360,114,0,utRho16
uxaC,6489714,6489714,6489482,232,124,utRho16
uxuA,9103036,9103272,9103036,236,2778,utRho16
uxuR,9108916,9109152,9108916,236,748,utRho16
valS,8967854,8967854,8967674,180,324,utRho16
valU,5041848,5041862,5041848,14,22,utRho16
valV,3492830,3492870,3492830,40,140,utRho16
ves,3649968,3649968,3649874,94,84,utRho16
waaA,7616512,7617080,7616512,568,892,utRho16
waaH,7580298,7580298,7580162,136,216,utRho16
waaQ,7616476,7616476,7616196,280,312,utRho16
waaU,7598996,7598996,7598624,372,188,utRho16
waaY,7602272,7602272,7601930,342,3592,utRho16
wbbH,4214888,4214888,4214452,436,570,utRho16
wbbK,4209212,4209212,4209018,194,322,utRho16
wcaM,4231868,4231868,4231792,76,0,utRho16
wrbA,2135516,2135516,2135416,100,84,utRho16
wza,4275166,4275166,4274486,680,120,utRho16
wzxC,4240674,4240674,4240316,358,116,utRho16
wzzB,4196950,4196950,4196602,348,0,utRho16
xanP,7657642,7657890,7657642,248,320,utRho16
xanQ,6048520,6048702,6048520,182,176,utRho16
xapA,5049820,5049820,5049756,64,2,utRho16
xapR,10090252,10090252,10089908,344,0,utRho16
xdhA,6000514,6000690,6000514,176,896,utRho16
xerD,6079702,6079702,6079486,216,232,utRho16
xseA,5268394,5268464,5268394,70,92,utRho16
xseB,882746,882746,882686,60,190,utRho16
xthA,3664798,3664856,3664798,58,0,utRho16
xylA,7461614,7461614,7461530,84,10890,utRho16
xylE,8484540,8484540,8484508,32,0,utRho16
xylF,7462138,7462262,7462138,124,338,utRho16
xylR,7469812,7469958,7469812,146,166,utRho16
yaaA,13230,13230,12918,312,142,utRho16
yaaI,23876,23876,23572,304,606,utRho16
yaaJ,16034,16034,15918,116,100,utRho16
yaaU,91184,91614,91184,430,856,utRho16
yaaW,23084,23084,22712,372,514,utRho16
yaaX,10060,10468,10060,408,134,utRho16
yabI,142542,142702,142542,160,1022,utRho16
yacC,273880,273880,273834,46,1110,utRho16
yacH,262932,262932,262520,412,92,utRho16
yacL,268678,268776,268678,98,550,utRho16
yadD,293796,293936,293796,140,216,utRho16
yadE,289930,290162,289930,232,614,utRho16
yadN,314110,314110,313766,344,770,utRho16
yadS,355572,355572,355248,324,5382,utRho16
yadV,312470,312470,312402,68,354,utRho16
yaeF,434270,434270,434006,264,40,utRho16
yaeP,428374,428374,428250,124,868,utRho16
yaeQ,428176,428582,428176,406,1474,utRho16
yaeR,423716,423754,423716,38,0,utRho16
yafC,462166,462166,461762,404,76,utRho16
yafD,462128,462244,462128,116,220,utRho16
yafK,491986,491986,491610,376,842,utRho16
yafL,493282,493424,493282,142,50,utRho16
yafN,503938,504010,503938,72,138,utRho16
yafS,469568,469632,469568,64,510,utRho16
yafT,474470,474670,474470,200,26,utRho16
yafV,480432,480432,480378,54,252,utRho16
yafZ,536052,536052,536010,42,440,utRho16
yagE,564446,564556,564446,110,2262,utRho16
yagG,570414,570790,570414,376,972,utRho16
yagI,578384,578384,578324,60,432,utRho16
yagK,586236,586236,585896,340,3170,utRho16
yagL,588062,588062,587836,226,1204,utRho16
yagN,591342,591342,591158,184,378,utRho16
yahA,663746,664742,663746,996,2594,utRho16
yahC,670136,670136,670044,92,2722,utRho16
yahE,671478,671850,671478,372,1152,utRho16
yahM,690504,690808,690504,304,232,utRho16
yahN,692872,692872,692674,198,1210,utRho16
yahO,692864,692968,692864,104,196,utRho16
yaiE,816296,816354,816296,58,44,utRho16
yaiI,811396,811528,811396,132,66,utRho16
yaiO,761946,761946,761684,262,402,utRho16
yaiP,767970,767970,767870,100,80,utRho16
yaiS,769660,769660,769232,428,370,utRho16
yaiV,788922,788922,788922,0,0,utRho16
yaiY,799094,799094,798666,428,94,utRho16
yaiZ,798888,799186,798888,298,726,utRho16
yajC,854410,854574,854410,164,598,utRho16
yajD,860938,861210,860938,272,468,utRho16
yajI,866068,866068,865702,366,62,utRho16
yajL,887496,887496,887282,214,492,utRho16
yajQ,889316,889366,889316,50,42,utRho16
yajR,893374,893374,893332,42,218,utRho16
ybaB,987418,988152,987418,734,2560,utRho16
ybaL,1006590,1006590,1006476,114,344,utRho16
ybaM,980648,980648,980542,106,338,utRho16
ybaN,981436,981764,981436,328,324,utRho16
ybaO,936704,936766,936704,62,0,utRho16
ybaP,1016568,1016568,1016160,408,800,utRho16
ybaQ,1016348,1016436,1016348,88,96,utRho16
ybaS,1023146,1023282,1023146,136,436,utRho16
ybaV,927504,927874,927504,370,0,utRho16
ybaY,950490,950758,950490,268,540,utRho16
ybbB,1062724,1062724,1062452,272,246,utRho16
ybbJ,1030154,1030154,1029718,436,1502,utRho16
ybbL,1031784,1031838,1031784,54,0,utRho16
ybbN,1037136,1037136,1036558,578,2164,utRho16
ybbO,1038658,1038658,1038298,360,530,utRho16
ybbY,1080718,1081130,1080718,412,330,utRho16
ybcH,1176140,1176140,1175962,178,640,utRho16
ybcI,1113264,1113264,1113106,158,1688,utRho16
ybcJ,1114050,1114050,1113746,304,120,utRho16
ybcK,1137502,1137804,1137502,302,884,utRho16
ybcL,1141690,1141786,1141690,96,28,utRho16
ybcN,1144628,1144932,1144628,304,290,utRho16
ybcQ,1147548,1147912,1147548,364,1880,utRho16
ybcW,1159610,1159760,1159610,150,0,utRho16
ybdD,1263982,1264364,1263982,382,1246,utRho16
ybdF,1212106,1212106,1211772,334,438,utRho16
ybdH,1267048,1267048,1266954,94,122,utRho16
ybdJ,1212822,1212822,1212398,424,230,utRho16
ybdK,1215122,1215122,1214766,356,1950,utRho16
ybdL,1267114,1267172,1267114,58,98,utRho16
ybdM,1271110,1271110,1270752,358,510,utRho16
ybdN,1273372,1273372,1273138,234,166,utRho16
ybdR,1283844,1284176,1283844,332,1634,utRho16
ybeD,1325412,1325412,1325284,128,258,utRho16
ybeF,1323090,1323090,1322756,334,1020,utRho16
ybeL,1349986,1350036,1349986,50,460,utRho16
ybeQ,1353412,1353412,1353094,318,44,utRho16
ybeR,1353120,1353422,1353120,302,30,utRho16
ybeT,1358832,1358832,1358812,20,0,utRho16
ybeU,1358924,1359016,1358924,92,0,utRho16
ybeZ,1386938,1386938,1386834,104,2532,utRho16
ybfA,1458074,1458268,1458074,194,406,utRho16
ybfE,1423878,1423878,1423796,82,428,utRho16
ybfF,1425692,1425692,1425604,88,50,utRho16
ybfH,1433282,1433282,1433194,88,44,utRho16
ybgA,1477840,1478002,1477840,162,48,utRho16
ybgC,1549288,1549504,1549288,216,182,utRho16
ybgD,1505916,1505916,1505590,326,6988,utRho16
ybgI,1485238,1485654,1485238,416,2,utRho16
ybgO,1498370,1498370,1497964,406,294,utRho16
ybgS,1570992,1570992,1570634,358,0,utRho16
ybhA,1597184,1597184,1596862,322,0,utRho16
ybhB,1616070,1616070,1615818,252,230,utRho16
ybhC,1614642,1614642,1614562,80,798,utRho16
ybhD,1601418,1601418,1601276,142,0,utRho16
ybhH,1601104,1601518,1601104,414,26,utRho16
ybhK,1633384,1633384,1633294,90,170,utRho16
ybhM,1641556,1641586,1641556,30,0,utRho16
ybhN,1645296,1645296,1644996,300,320,utRho16
ybhQ,1649202,1649260,1649202,58,892,utRho16
ybiA,1665920,1665920,1665900,20,0,utRho16
ybiI,1676968,1676968,1676912,56,460,utRho16
ybiO,1691328,1691328,1690960,368,1590,utRho16
ybiP,1705252,1705252,1705194,58,990,utRho16
ybiS,1711572,1711572,1711488,84,166,utRho16
ybiT,1711894,1711926,1711894,32,0,utRho16
ybiU,1718212,1718212,1718122,90,106,utRho16
ybiV,1720176,1720176,1720056,120,0,utRho16
ybiW,1725566,1725566,1725212,354,4136,utRho16
ybiX,1678548,1678548,1678414,134,66,utRho16
ybjC,1781784,1781826,1781784,42,40,utRho16
ybjE,1830154,1830154,1829714,440,942,utRho16
ybjG,1767016,1767016,1766776,240,1860,utRho16
ybjL,1779882,1779882,1779638,244,196,utRho16
ybjM,1779770,1780178,1779770,408,548,utRho16
ybjO,1795704,1795978,1795704,274,56,utRho16
ybjP,1809046,1809046,1808934,112,94,utRho16
ybjQ,1809034,1809186,1809034,152,0,utRho16
ybjS,1813796,1813796,1813506,290,378,utRho16
ybjX,1838206,1838206,1838168,38,0,utRho16
ycaD,1891438,1891742,1891438,304,34,utRho16
ycaI,1928210,1928640,1928210,430,64,utRho16
ycaK,1899094,1899336,1899094,242,288,utRho16
ycaL,1920264,1920528,1920264,264,34,utRho16
ycaM,1894240,1894458,1894240,218,168,utRho16
ycaR,1941284,1941346,1941284,62,1332,utRho16
ycbB,1961862,1962094,1961862,232,254,utRho16
ycbJ,1943344,1943504,1943344,160,0,utRho16
ycbK,1966046,1966150,1966046,104,492,utRho16
ycbZ,2036920,2036920,2036598,322,80,utRho16
yccA,2062886,2062886,2062836,50,24,utRho16
yccF,2048730,2048730,2048696,34,66,utRho16
yccS,2047988,2047988,2047766,222,164,utRho16
yccT,2055674,2055674,2055546,128,36,utRho16
yccX,2059960,2060128,2059960,168,364,utRho16
ycdT,2185682,2185752,2185682,70,0,utRho16
ycdU,2191266,2191686,2191266,420,478,utRho16
ycdZ,2200504,2200592,2200504,88,114,utRho16
yceA,2233544,2233614,2233544,70,18,utRho16
yceD,2293298,2293588,2293298,290,3388,utRho16
yceF,2293522,2293522,2293190,332,2730,utRho16
yceH,2252154,2252314,2252154,160,608,utRho16
yceI,2237282,2237282,2236952,330,328,utRho16
yceJ,2238142,2238142,2238092,50,310,utRho16
yceM,2253208,2253612,2253208,404,1104,utRho16
yceO,2239264,2239264,2238894,370,408,utRho16
yceQ,2288760,2289004,2288760,244,2712,utRho16
ycfD,2376540,2376540,2376480,60,184,utRho16
ycfJ,2334814,2335198,2334814,384,326,utRho16
ycfS,2340834,2340834,2340748,86,0,utRho16
ycfT,2350658,2350658,2350330,328,230,utRho16
ycfZ,2362760,2362760,2362534,226,740,utRho16
ycgB,2474570,2474570,2474482,88,0,utRho16
ycgG,2434614,2434656,2434614,42,326,utRho16
ycgJ,2452956,2453200,2452956,244,144,utRho16
ycgL,2455218,2455362,2455218,144,104,utRho16
ycgN,2457366,2457660,2457366,294,74,utRho16
ycgR,2489112,2489112,2489054,58,0,utRho16
ycgV,2512222,2512222,2511904,318,794,utRho16
ycgX,2426568,2426568,2426214,354,9244,utRho16
ycgY,2490166,2490320,2490166,154,490,utRho16
ycgZ,2431504,2431578,2431504,74,222,utRho16
ychE,2596904,2597196,2596904,292,0,utRho16
ychF,2515764,2515764,2515624,140,0,utRho16
ychH,2517476,2517582,2517476,106,928,utRho16
ychJ,2578354,2578354,2578264,90,110,utRho16
ychN,2547310,2547310,2547198,112,38,utRho16
ychO,2547520,2547850,2547520,330,148,utRho16
ychQ,2533798,2533848,2533798,50,0,utRho16
yciA,2624828,2624828,2624492,336,98,utRho16
yciB,2626110,2626110,2625780,330,758,utRho16
yciC,2627396,2627396,2627326,70,0,utRho16
yciE,2630794,2630794,2630448,346,378,utRho16
yciG,5264368,5264368,5264140,228,44,utRho16
yciI,2621784,2621784,2621730,54,120,utRho16
yciN,2661606,2661606,2661336,270,54,utRho16
yciS,2680270,2680486,2680270,216,202,utRho16
yciT,2689088,2689088,2688692,396,2250,utRho16
yciU,2614718,2614718,2614300,418,1226,utRho16
yciV,2646376,2646440,2646376,64,10,utRho16
yciW,2700472,2700472,2700214,258,4708,utRho16
yciZ,2689276,2689276,2689218,58,1340,utRho16
ycjD,2703792,2703792,2703520,272,18,utRho16
ycjG,2777748,2777860,2777748,112,228,utRho16
ycjM,2740006,2740432,2740006,426,326,utRho16
ycjW,2767982,2767982,2767922,60,72,utRho16
ycjX,2768138,2768234,2768138,96,0,utRho16
ycjY,5568288,5568288,5567460,828,692,utRho16
ydaE,2836438,2836438,2836016,422,760,utRho16
ydaN,2816048,2816100,2816048,52,198,utRho16
ydaS,2840340,2840730,2840340,390,22,utRho16
ydbC,2948376,2948442,2948376,66,0,utRho16
ydbD,2950132,2950288,2950132,156,72,utRho16
ydbH,2885800,2886102,2885800,302,92,utRho16
ydbJ,2881712,2882116,2881712,404,414,utRho16
ydbK,2881692,2881692,2881568,124,180,utRho16
ydcA,2983294,2983354,2983294,60,162,utRho16
ydcF,2974404,2974470,2974404,66,0,utRho16
ydcI,2990268,2990268,2990142,126,0,utRho16
ydcJ,2990266,2990576,2990266,310,0,utRho16
ydcK,3001280,3001280,3000898,382,88,utRho16
ydcL,3004646,3004914,3004646,268,0,utRho16
ydcN,3012308,3012344,3012308,36,408,utRho16
ydcP,3013508,3013562,3013508,54,202,utRho16
ydcR,3019956,3020006,3019956,50,34,utRho16
ydcS,3022906,3023308,3022906,402,196,utRho16
ydcX,3034442,3034778,3034442,336,342,utRho16
ydcY,3035220,3035296,3035220,76,132,utRho16
ydcZ,3036750,3036750,3036662,88,1402,utRho16
yddB,3155332,3155332,3155238,94,418,utRho16
yddE,3071738,3071738,3071716,22,0,utRho16
yddG,3094410,3094410,3094338,72,0,utRho16
yddJ,3089732,3089732,3089438,294,260,utRho16
yddW,3137704,3137704,3137646,58,0,utRho16
ydeA,3233910,3234056,3233910,146,330,utRho16
ydeE,3242528,3242664,3242528,136,218,utRho16
ydeI,3249118,3249118,3248994,124,20,utRho16
ydeJ,3249376,3249546,3249376,170,36,utRho16
ydeN,3165458,3165458,3165048,410,52,utRho16
ydeP,3173328,3173328,3172972,356,334,utRho16
ydeR,3176596,3176596,3176592,4,312,utRho16
ydfA,3296872,3297016,3296872,144,0,utRho16
ydfG,3254982,3255034,3254982,52,42,utRho16
ydfH,3256652,3256704,3256652,52,94,utRho16
ydfK,3265446,3266144,3265446,698,2848,utRho16
ydgA,3379588,3379704,3379588,116,60,utRho16
ydgC,3364124,3364124,3364060,64,112,utRho16
ydgD,3343906,3343920,3343906,14,34,utRho16
ydgH,3356754,3356854,3356754,100,28,utRho16
ydgJ,3408798,3408798,3408616,182,548,utRho16
ydgK,3410414,3410500,3410414,86,370,utRho16
ydhB,3479618,3479618,3479596,22,0,utRho16
ydhC,3479698,3479822,3479698,124,0,utRho16
ydhF,3451310,3451310,3451264,46,0,utRho16
ydhI,3441996,3442050,3441996,54,0,utRho16
ydhL,3451864,3451864,3451840,24,572,utRho16
ydhQ,3492404,3492404,3492254,150,132,utRho16
ydhS,3494136,3494262,3494136,126,1210,utRho16
ydhT,3499138,3499138,3499118,20,178,utRho16
ydhY,3509284,3509284,3508954,330,624,utRho16
ydhZ,3510418,3510418,3510282,136,646,utRho16
ydiE,3579206,3579226,3579206,20,0,utRho16
ydiH,3530582,3530582,3530406,176,6,utRho16
ydiM,3541852,3542142,3541852,290,0,utRho16
ydiN,3544818,3545024,3544818,206,0,utRho16
ydiP,3558656,3558656,3558602,54,98,utRho16
ydiU,3582508,3582508,3582488,20,1022,utRho16
ydiV,3584174,3584174,3584040,134,306,utRho16
ydiY,3612500,3612500,3612166,334,104,utRho16
ydjA,3697400,3697400,3697352,48,46,utRho16
ydjE,3708082,3708082,3707958,124,78,utRho16
ydjF,3709848,3709848,3709708,140,100,utRho16
ydjM,3620340,3620422,3620340,82,0,utRho16
ydjO,3626696,3626696,3626288,408,524,utRho16
ydjX,3666434,3666802,3666434,368,2040,utRho16
yeaE,3731448,3731448,3731272,176,142,utRho16
yeaG,3733530,3733816,3733530,286,2,utRho16
yeaI,3740486,3740770,3740486,284,0,utRho16
yeaJ,3743874,3744082,3743874,208,344,utRho16
yeaL,3748646,3748704,3748646,58,494,utRho16
yeaM,3751296,3751296,3751152,144,0,utRho16
yeaN,3750926,3751346,3750926,420,242,utRho16
yeaO,3753554,3753818,3753554,264,164,utRho16
yeaP,3755314,3755430,3755314,116,808,utRho16
yeaQ,3758780,3758780,3758510,270,602,utRho16
yeaR,3759988,3759988,3759896,92,196,utRho16
yeaY,3781122,3781122,3781064,58,0,utRho16
yebB,3892220,3892502,3892220,282,190,utRho16
yebC,3896370,3896370,3896302,68,112,utRho16
yebE,3859464,3859464,3859414,50,186,utRho16
yebG,3861530,3861530,3861494,36,198,utRho16
yebK,3873180,3873304,3873180,124,0,utRho16
yebQ,3820314,3820552,3820314,238,66,utRho16
yebS,3832238,3832516,3832238,278,0,utRho16
yebV,3843430,3843560,3843430,130,0,utRho16
yebW,3843914,3844242,3843914,328,950,utRho16
yecC,3995646,3995646,3995628,18,0,utRho16
yecD,3901272,3901664,3901272,392,292,utRho16
yecF,3991434,3991636,3991434,202,264,utRho16
yecH,3979304,3979304,3978980,324,1882,utRho16
yecJ,3975604,3975604,3975516,88,0,utRho16
yecM,3919968,3919968,3919692,276,756,utRho16
yecR,3976400,3976444,3976400,44,36,utRho16
yecT,3923862,3923944,3923862,82,192,utRho16
yedD,4016522,4016522,4016180,342,268,utRho16
yedE,4016310,4016554,4016310,244,208,utRho16
yedI,4058922,4058922,4058732,190,536,utRho16
yedJ,4066446,4066446,4066158,288,482,utRho16
yedV,4076404,4076404,4076304,100,334,utRho16
yedX,4077680,4077912,4077680,232,54,utRho16
yedY,4078572,4078956,4078572,384,286,utRho16
yeeA,4161322,4161322,4161182,140,198,utRho16
yeeE,4171104,4171104,4171050,54,0,utRho16
yeeJ,4089526,4089822,4089526,296,370,utRho16
yeeN,4113508,4113716,4113508,208,654,utRho16
yeeO,4119444,4119444,4119692,248,0,utRho16
yeeX,4158834,4158834,4158722,112,538,utRho16
yeeZ,4178422,4178422,4178256,166,0,utRho16
yefM,4179466,4179466,4179426,40,0,utRho16
yegD,4295288,4295348,4295288,60,12,utRho16
yegH,4275726,4275804,4275726,78,140,utRho16
yegI,4302154,4302154,4301970,184,0,utRho16
yegJ,4302032,4302370,4302032,338,22,utRho16
yegQ,4331182,4331336,4331182,154,1478,utRho16
yegR,4336698,4336698,4336612,86,298,utRho16
yegS,4337086,4337424,4337086,338,276,utRho16
yegT,4357562,4357642,4357562,80,1208,utRho16
yegX,4367640,4367640,4367302,338,182,utRho16
yehA,4376944,4376944,4376828,116,172,utRho16
yehE,4385818,4385818,4385592,226,2,utRho16
yehK,4407568,4407944,4407568,376,56,utRho16
yehL,4408804,4409192,4408804,388,0,utRho16
yeiB,4486146,4486146,4485934,212,48,utRho16
yeiE,4499422,4499422,4499236,186,0,utRho16
yeiG,4487776,4487820,4487776,44,222,utRho16
yeiH,4499332,4499434,4499332,102,0,utRho16
yeiI,4503306,4503400,4503306,94,190,utRho16
yeiL,4510580,4510710,4510580,130,56,utRho16
yeiP,4530834,4530900,4530834,66,246,utRho16
yeiQ,4532328,4532490,4532328,162,238,utRho16
yeiR,4535484,4535658,4535484,174,746,utRho16
yeiW,4530840,4530840,4530590,250,292,utRho16
yejA,4544624,4544728,4544624,104,0,utRho16
yejG,4556892,4556892,4556474,418,3802,utRho16
yejH,4561244,4561264,4561244,20,0,utRho16
yejK,4568218,4568218,4567894,324,46,utRho16
yejO,4578352,4578352,4577800,552,2998,utRho16
yfaD,4713380,4713808,4713380,428,1218,utRho16
yfaE,4696676,4697028,4696676,352,2378,utRho16
yfaL,4688568,4688568,4688338,230,24,utRho16
yfaP,4656398,4656398,4656286,112,66,utRho16
yfaU,4717892,4717892,4717690,202,136,utRho16
yfaY,4727310,4727310,4727266,44,140,utRho16
yfaZ,4728744,4728744,4728550,194,356,utRho16
yfbK,4771810,4771810,4771444,366,414,utRho16
yfbL,4771500,4771720,4771500,220,332,utRho16
yfbN,4777174,4777174,4776852,322,402,utRho16
yfbO,4776916,4777162,4776916,246,348,utRho16
yfbP,4777990,4778232,4777990,242,9916,utRho16
yfbR,4817662,4817724,4817662,62,116,utRho16
yfcI,4847424,4847424,4847078,346,1734,utRho16
yfcJ,4880482,4880482,4880240,242,1500,utRho16
yfcL,4888502,4888502,4888338,164,272,utRho16
yfcV,4911642,4911642,4911292,350,610,utRho16
yfcZ,4921958,4921958,4921868,90,92,utRho16
yfdF,4925604,4926024,4925604,420,7602,utRho16
yfdG,4935474,4935710,4935474,236,0,utRho16
yfdP,4946844,4947040,4946844,196,402,utRho16
yfdX,4988866,4988866,4988804,62,36,utRho16
yfdY,4990672,4990672,4990584,88,234,utRho16
yfeA,5035784,5035784,5035664,120,14886,utRho16
yfeC,5036668,5036934,5036668,266,364,utRho16
yfeH,5053818,5053892,5053818,74,0,utRho16
yfeK,5074630,5074684,5074630,54,146,utRho16
yfeO,5018906,5019260,5018906,354,478,utRho16
yfeR,5054078,5054078,5053712,366,0,utRho16
yfeX,5101356,5101356,5101090,266,112,utRho16
yfeY,5102486,5102486,5102432,54,0,utRho16
yfeZ,5103842,5103842,5103452,390,0,utRho16
yffO,5123804,5124222,5123804,418,136,utRho16
yffQ,5126778,5127154,5126778,376,564,utRho16
yffS,5128800,5128986,5128800,186,0,utRho16
yfgC,5232052,5232188,5232052,136,164,utRho16
yfgF,5258062,5258062,5257876,186,1056,utRho16
yfgG,5258170,5258580,5258170,410,1328,utRho16
yfgH,5259344,5259584,5259344,240,316,utRho16
yfgM,5278866,5278866,5278566,300,204,utRho16
yfhH,5397414,5397518,5397414,104,240,utRho16
yfhM,5304648,5304648,5304574,74,74,utRho16
yfhR,5328408,5328726,5328408,318,15088,utRho16
yfiC,5425610,5425610,5425528,82,0,utRho16
yfiE,5430688,5430688,5430640,48,696,utRho16
yfiL,5482630,5482720,5482630,90,0,utRho16
yfiM,5448066,5448358,5448066,292,9306,utRho16
yfiR,5483354,5483750,5483354,396,402,utRho16
yfjH,5517326,5517326,5517200,126,140,utRho16
yfjI,5517710,5517970,5517710,260,72,utRho16
yfjJ,5521014,5521094,5521014,80,276,utRho16
yfjM,5531970,5531970,5531552,418,4480,utRho16
yfjP,5535080,5535420,5535080,340,1004,utRho16
yfjW,5546570,5546636,5546570,66,102,utRho16
yfjX,5551776,5551838,5551776,62,0,utRho16
ygaC,5601180,5601180,5599988,1192,6238,utRho16
ygaM,5600242,5600292,5600242,50,1626,utRho16
ygaU,5593628,5593628,5593572,56,246,utRho16
ygaZ,5619190,5619234,5619190,44,422,utRho16
ygbA,5713656,5713656,5713612,44,98,utRho16
ygbE,5746784,5746784,5746674,110,1344,utRho16
ygbI,5722882,5722882,5722528,354,352,utRho16
ygbK,5724394,5724670,5724394,276,1074,utRho16
ygbL,5727074,5727186,5727074,112,2,utRho16
ygbN,5729814,5730202,5729814,388,928,utRho16
ygcG,5811210,5811422,5811210,212,302,utRho16
ygcN,5785144,5785314,5785144,170,158,utRho16
ygcU,5799214,5799214,5798836,378,198,utRho16
ygcW,5800942,5800942,5800546,396,20,utRho16
ygdD,5883442,5883442,5883262,180,376,utRho16
ygdG,5861746,5861930,5861746,184,1720,utRho16
ygdI,5886526,5886526,5886290,236,464,utRho16
ygdQ,5940784,5940840,5940784,56,40,utRho16
ygdR,5942494,5942542,5942494,48,16,utRho16
ygeA,5961606,5961606,5961270,336,142,utRho16
ygeH,5983758,5984188,5983758,430,846,utRho16
ygeI,5987162,5987276,5987162,114,6132,utRho16
ygeR,6000078,6000078,5999782,296,252,utRho16
ygeV,6011694,6011694,6011572,122,140,utRho16
ygeW,6012234,6012524,6012234,290,558,utRho16
ygfB,6110946,6110946,6110888,58,0,utRho16
ygfK,6031984,6032120,6031984,136,42,utRho16
ygfS,6058328,6058328,6058024,304,94,utRho16
ygfZ,6082564,6082626,6082564,62,342,utRho16
yggC,6149512,6149512,6149378,134,198,utRho16
yggE,6136370,6136370,6136160,210,1184,utRho16
yggI,6179176,6179510,6179176,334,1100,utRho16
yggL,6204508,6204508,6204266,242,328,utRho16
yggM,6199514,6199514,6199130,384,220,utRho16
yggN,6203596,6203596,6203246,350,188,utRho16
yggX,18623958,18624558,18623958,600,690,utRho16
yghA,6298966,6299324,6298966,358,112,utRho16
yghB,6307058,6307126,6307058,68,376,utRho16
yghD,6222614,6222614,6222252,362,758,utRho16
yghF,6225798,6225798,6225840,42,532,utRho16
yghJ,6238640,6238640,6238224,416,190,utRho16
yghQ,6265186,6265186,6264816,370,558,utRho16
yghT,6267830,6268262,6267830,432,242,utRho16
yghU,6277400,6277454,6277400,54,154,utRho16
yghW,6293506,6293506,6293474,32,0,utRho16
yghZ,6295562,6295794,6295562,232,440,utRho16
ygiD,6365122,6365122,6364868,254,1466,utRho16
ygiH,6409066,6409388,6409066,322,102,utRho16
ygiL,6370622,6370828,6370622,206,172,utRho16
ygiM,6402084,6402414,6402084,330,276,utRho16
ygiN,6346156,6346284,6346156,128,832,utRho16
ygiQ,6322620,6322620,6322292,328,1324,utRho16
ygiS,6335462,6335462,6335436,26,166,utRho16
ygiV,6338582,6338582,6338462,120,138,utRho16
ygiW,6339774,6339774,6339352,422,2750,utRho16
ygiZ,6344506,6344506,6344422,84,44,utRho16
ygjH,6442528,6442528,6442494,34,280,utRho16
ygjI,6452140,6452468,6452140,328,20,utRho16
ygjQ,6472730,6473080,6472730,350,1192,utRho16
ygjR,6474564,6474586,6474564,22,84,utRho16
ygjV,6483638,6483638,6483488,150,116,utRho16
yhaB,6535632,6535708,6535632,76,16,utRho16
yhaH,6504498,6504608,6504498,110,240,utRho16
yhaI,6505400,6505822,6505400,422,338,utRho16
yhaJ,6508560,6508560,6508428,132,214,utRho16
yhaK,6508538,6508638,6508538,100,294,utRho16
yhbQ,6599878,6599932,6599878,54,500,utRho16
yhbT,6602736,6602736,6602552,184,724,utRho16
yhbU,6602558,6602970,6602558,412,924,utRho16
yhbX,6643302,6643302,6643226,76,54,utRho16
yhbY,6655518,6655580,6655518,62,746,utRho16
yhcA,6723956,6724224,6723956,268,814,utRho16
yhcB,6760364,6760382,6760364,18,2,utRho16
yhcC,6708470,6708470,6708100,370,1330,utRho16
yhcF,6733440,6733852,6733440,412,2034,utRho16
yhcH,6739124,6739124,6738956,168,2076,utRho16
yhcM,6760312,6760312,6759994,318,258,utRho16
yhcN,6770812,6771076,6770812,264,284,utRho16
yhcO,6772606,6772606,6772258,348,50,utRho16
yhdH,6806560,6806968,6806560,408,576,utRho16
yhdJ,6823234,6823306,6823234,72,0,utRho16
yhdN,6879092,6879092,6879018,74,470,utRho16
yhdT,6814702,6814750,6814702,48,98,utRho16
yhdU,6824994,6825242,6824994,248,498,utRho16
yhdV,6836392,6836780,6836392,388,914,utRho16
yhdW,6837944,6838298,6837944,354,116,utRho16
yheO,6953082,6953082,6952880,202,370,utRho16
yheV,6957970,6957970,6957584,386,102,utRho16
yhfA,6971902,6971902,6971636,266,1118,utRho16
yhfG,6983294,6983294,6983240,54,1082,utRho16
yhfL,6998622,6998896,6998622,274,332,utRho16
yhfY,7023244,7023244,7022844,400,48,utRho16
yhgA,7086294,7086334,7086294,40,0,utRho16
yhgE,7065176,7065176,7064878,298,748,utRho16
yhgF,7074352,7074770,7074352,418,8448,utRho16
yhhA,7173458,7173886,7173458,428,936,utRho16
yhhI,7248346,7248756,7248346,410,32,utRho16
yhhJ,7253696,7253696,7253606,90,346,utRho16
yhhM,7211588,7211588,7211220,368,598,utRho16
yhhN,7211150,7211502,7211150,352,574,utRho16
yhhQ,7218238,7218434,7218238,196,834,utRho16
yhhT,7223682,7223730,7223682,48,72,utRho16
yhhX,7162032,7162032,7161610,422,160,utRho16
yhhY,7162222,7162276,7162222,54,44,utRho16
yhhZ,7163516,7163726,7163516,210,346,utRho16
yhiD,7312220,7312220,7311804,416,73338,utRho16
yhiJ,7265190,7265190,7265180,10,0,utRho16
yhiM,7269270,7269682,7269270,412,1268,utRho16
yhiN,7275000,7275000,7274820,180,484,utRho16
yhjA,7338522,7338522,7338376,146,188,utRho16
yhjB,7344090,7344090,7343788,302,1192,utRho16
yhjC,7344272,7344684,7344272,412,286,utRho16
yhjD,7346660,7346724,7346660,64,284,utRho16
yhjE,7349274,7349572,7349274,298,2240,utRho16
yhjG,7356824,7356824,7356730,94,142,utRho16
yhjH,7358458,7358458,7358374,84,600,utRho16
yhjJ,7364032,7364032,7363880,152,182,utRho16
yhjK,7371296,7371296,7371158,138,84,utRho16
yhjR,7392750,7392750,7392370,380,50,utRho16
yhjV,7400796,7401126,7400796,330,2078,utRho16
yhjX,7424194,7424194,7424014,180,76,utRho16
yhjY,7425966,7425966,7425868,98,58,utRho16
yiaB,7455654,7455654,7455496,158,28,utRho16
yiaD,7432712,7433094,7432712,382,996,utRho16
yiaF,7438194,7438194,7438088,106,542,utRho16
yiaG,7438862,7438956,7438862,94,374,utRho16
yiaJ,7485236,7485236,7485064,172,1112,utRho16
yiaK,7485348,7485466,7485348,118,118,utRho16
yiaT,7503924,7503924,7503736,188,0,utRho16
yiaU,7503792,7503984,7503792,192,0,utRho16
yiaY,7515856,7515856,7515654,202,510,utRho16
yibF,7523950,7523950,7523910,40,56,utRho16
yibG,7536128,7536354,7536128,226,54,utRho16
yibL,7553194,7553330,7553194,136,216,utRho16
yibN,7570112,7570112,7570030,82,254,utRho16
yibT,7552848,7552848,7552760,88,856,utRho16
yicC,7633290,7633352,7633290,62,4,utRho16
yicH,7660862,7660914,7660862,52,190,utRho16
yicJ,7673328,7673328,7671858,1470,8308,utRho16
yicN,7685018,7685018,7684804,214,1798,utRho16
yicO,7687914,7687914,7687578,336,374,utRho16
yicR,15250308,15250308,15250236,72,72,utRho16
yidB,7755230,7755230,7754930,300,90,utRho16
yidE,7732780,7732780,7732546,234,150,utRho16
yidF,7711580,7711580,7711222,358,306,utRho16
yidQ,7735088,7735456,7735088,368,798,utRho16
yidR,7738824,7738824,7738618,206,48,utRho16
yieE,7787658,7787738,7787658,80,524,utRho16
yieH,7793314,7793548,7793314,234,94,utRho16
yieK,7798928,7798928,7798786,142,76,utRho16
yifB,7900350,7900350,7899998,352,436,utRho16
yifL,7988984,7989044,7988984,60,2606,utRho16
yigF,8005750,8005750,8005598,152,18944,utRho16
yigI,8009448,8009448,8009394,54,728,utRho16
yigM,8022100,8022152,8022100,52,28,utRho16
yihA,8101970,8101970,8101458,512,228,utRho16
yihD,8084098,8084138,8084098,40,90,utRho16
yihF,8088110,8088398,8088110,288,344,utRho16
yihG,8093304,8093304,8093204,100,46,utRho16
yihI,8102616,8102694,8102616,78,2,utRho16
yihL,8120506,8120894,8120506,388,116,utRho16
yihN,8124332,8124494,8124332,162,300,utRho16
yihO,8131942,8131942,8131532,410,384,utRho16
yihQ,8138892,8138892,8138552,340,140,utRho16
yihV,8147064,8147478,8147064,414,208,utRho16
yihX,8151096,8151106,8151096,10,260,utRho16
yiiE,8158192,8158582,8158192,390,1240,utRho16
yiiF,8159124,8159502,8159124,378,1268,utRho16
yiiG,8173762,8174004,8173762,242,44,utRho16
yiiM,8205506,8205644,8205506,138,3252,utRho16
yiiQ,8224624,8224624,8224428,196,142,utRho16
yiiS,8225738,8225934,8225738,196,484,utRho16
yijE,8272178,8272216,8272178,38,176,utRho16
yijF,8275728,8275728,8275314,414,1220,utRho16
yijO,8296858,8296858,8296634,224,306,utRho16
yjaA,8426240,8426468,8426240,228,89610,utRho16
yjaB,8428312,8428312,8428246,66,1028,utRho16
yjaG,8398746,8399008,8398746,262,1060,utRho16
yjaH,8401022,8401132,8401022,110,272,utRho16
yjaZ,8379506,8379572,8379506,66,90,utRho16
yjbB,8455204,8455462,8455204,258,118,utRho16
yjbE,16943432,16943624,16943432,192,452,utRho16
yjbL,8520318,8520642,8520318,324,218,utRho16
yjbQ,8540428,8540476,8540428,48,90,utRho16
yjcB,8550328,8550328,8550082,246,454,utRho16
yjcC,8550836,8550942,8550836,106,276,utRho16
yjcD,8556628,8556958,8556628,330,248,utRho16
yjcE,8559658,8559960,8559658,302,138,utRho16
yjcF,8566212,8566212,8566150,62,0,utRho16
yjcO,8594660,8594660,8594250,410,420,utRho16
yjdA,8654128,8654270,8654128,142,0,utRho16
yjdC,8726660,8726660,8726616,44,0,utRho16
yjdK,8704780,8705168,8704780,388,4092,utRho16
yjdL,8713034,8713034,8712822,212,36,utRho16
yjdM,8653672,8653672,8653468,204,602,utRho16
yjeF,8787354,8788132,8787354,778,106518,utRho16
yjeI,8745522,8745618,8745522,96,0,utRho16
yjeJ,8748806,8748806,8748468,338,638,utRho16
yjeV,8785472,8785784,8785472,312,3436,utRho16
yjfP,8833512,8833904,8833512,392,190,utRho16
yjfY,8849656,8849656,8849582,74,152,utRho16
yjfZ,8855052,8855052,8854844,208,518,utRho16
yjgA,8916162,8916162,8915730,432,428,utRho16
yjgL,8950802,8950874,8950802,72,0,utRho16
yjgM,8959342,8959342,8959074,268,118,utRho16
yjgN,8959132,8959460,8959132,328,150,utRho16
yjgR,8980170,8980170,8980126,44,200,utRho16
yjgZ,9002116,9002520,9002116,404,9610,utRho16
yjhB,9007764,9008116,9007764,352,668,utRho16
yjhG,9048452,9048452,9048188,264,10714,utRho16
yjhU,9041080,9041080,9040648,432,1166,utRho16
yjiA,9178096,9178096,9177730,366,3164,utRho16
yjiJ,9125364,9125364,9125350,14,0,utRho16
yjiK,9127270,9127270,9127422,152,390,utRho16
yjiL,9129604,9129604,9129378,226,138,utRho16
yjiS,9143410,9143502,9143410,92,288,utRho16
yjiY,9182734,9182734,9182558,176,5242,utRho16
yjjA,9200674,9200674,9200378,296,2434,utRho16
yjjB,18408708,18408708,18407800,908,2672,utRho16
yjjJ,9243314,9243538,9243314,224,36,utRho16
yjjK,9261132,9261132,9261044,88,268,utRho16
yjjL,9189764,9189764,9189444,320,1718,utRho16
yjjM,9191894,9191894,9191702,192,416,utRho16
yjjP,9206068,9206068,9205716,352,17458,utRho16
yjjQ,9206638,9206954,9206638,316,10460,utRho16
yjjX,9267798,9267798,9267490,308,1666,utRho16
yjjY,9280716,9280804,9280716,88,322,utRho16
yjjZ,9211554,9211608,9211554,54,51876,utRho16
yjtD,9281676,9281884,9281676,208,210,utRho16
ykfB,532454,532454,532174,280,13014,utRho16
ykfI,527636,527636,527338,298,1558,utRho16
ykgB,637050,637050,636638,412,698,utRho16
ykgC,640430,640430,640002,428,208,utRho16
ykgD,640232,640454,640232,222,138,utRho16
ykgE,642962,643216,642962,254,334,utRho16
ykgJ,608524,608524,608364,160,274,utRho16
ykgL,623878,624224,623878,346,632,utRho16
ykgM,625610,625610,625554,56,66,utRho16
ykgR,626570,626570,626484,86,0,utRho16
ylaC,958576,958576,958502,74,3334,utRho16
yliE,1745938,1745958,1745938,20,0,utRho16
ymcE,2103660,2103694,2103660,34,0,utRho16
ymdA,2210450,2210828,2210450,378,316,utRho16
ymdB,2211428,2211640,2211428,212,112,utRho16
ymfD,2395322,2395322,2395064,258,946,utRho16
ymfI,2402880,2402994,2402880,114,56,utRho16
ymfJ,2404518,2404518,2404168,350,770,utRho16
ymfK,2406176,2406176,2405866,310,124,utRho16
ymfT,2405766,2406048,2405766,282,176,utRho16
ymgE,2489110,2489456,2489110,346,834,utRho16
ymgF,2437628,2437966,2437628,338,48,utRho16
ymiA,2670112,2670320,2670112,208,528,utRho16
ymjA,2715620,2715620,2715336,284,554,utRho16
ynaI,2791946,2791946,2791844,102,30,utRho16
ynaK,2850438,2850754,2850438,316,168,utRho16
ynbA,2954924,2955242,2954924,318,50,utRho16
yncD,3046552,3046552,3046130,422,150,utRho16
yncE,3046454,3046614,3046454,160,68,utRho16
yncG,3052456,3052494,3052456,38,660,utRho16
yncL,3034492,3034492,3034388,104,334,utRho16
yneE,3218364,3218364,3218044,320,2,utRho16
yneF,3223748,3223748,3223708,40,0,utRho16
yneJ,3229560,3229608,3229560,48,308,utRho16
yneK,3231100,3231526,3231100,426,1018,utRho16
yneM,3245176,3245292,3245176,116,208,utRho16
ynfA,3311398,3311398,3311346,52,0,utRho16
ynfB,3311418,3311616,3311418,198,308,utRho16
ynfC,3315094,3315094,3314914,180,26,utRho16
ynfD,3314828,3315130,3314828,302,52,utRho16
ynfE,3316006,3316138,3316006,132,112,utRho16
ynfK,3334670,3334670,3334438,232,210,utRho16
ynfL,3339304,3339304,3339184,120,0,utRho16
ynfM,3339260,3339398,3339260,138,0,utRho16
ynfN,3276598,3276598,3276218,380,32,utRho16
ynfO,3273454,3273512,3273454,58,288,utRho16
ynhG,3517890,3517890,3517450,440,70,utRho16
yniA,3615158,3615592,3615158,434,780,utRho16
yniB,3618526,3618526,3618466,60,0,utRho16
yniC,3618652,3618760,3618652,108,42,utRho16
yniD,3610202,3610330,3610202,128,36,utRho16
ynjE,3678880,3678934,3678880,54,16,utRho16
ynjF,3683222,3683222,3682806,416,316,utRho16
ynjH,3684376,3684376,3684270,106,22,utRho16
ynjI,3690022,3690022,3689742,280,410,utRho16
yoaB,3786642,3786734,3786642,92,66,utRho16
yoaC,3787932,3788146,3787932,214,254,utRho16
yoaE,3803544,3803544,3803170,374,604,utRho16
yoaF,3755444,3755444,3755064,380,1292,utRho16
yoaH,3789866,3789866,3789462,404,1062,utRho16
yobB,3850418,3850880,3850418,462,632,utRho16
yobF,3815586,3815586,3815182,404,490,utRho16
yobH,3817800,3817850,3817800,50,246,utRho16
yodB,4084352,4084736,4084352,384,728,utRho16
yodC,4057008,4057008,4056740,268,204,utRho16
yohC,4451358,4451358,4451262,96,100,utRho16
yohD,4451526,4451602,4451526,76,166,utRho16
yohJ,4460986,4461248,4460986,262,56,utRho16
yohO,4431172,4431314,4431172,142,176,utRho16
yojI,4617282,4617282,4617230,52,0,utRho16
ypdI,4988988,4989396,4988988,408,236,utRho16
ypfG,5165786,5165786,5165554,232,0,utRho16
ypfM,5182140,5182140,5181732,408,744,utRho16
yphB,5349590,5349590,5349376,214,302,utRho16
ypjA,5565644,5565644,5565452,192,1640,utRho16
ypjB,5569636,5569636,5568858,778,60,utRho16
ypjD,5495860,5495774,5495860,86,0,utRho16
yqaE,5594170,5594170,5594056,114,596,utRho16
yqcA,5846100,5846100,5845968,132,576,utRho16
yqcE,5800944,5801184,5800944,240,0,utRho16
yqeC,6030468,6030468,6030114,354,1028,utRho16
yqeF,5971618,5971618,5971184,434,1730,utRho16
yqeG,5971438,5971694,5971438,256,3404,utRho16
yqeH,5975016,5975072,5975016,56,4178,utRho16
yqeI,5976688,5977004,5976688,316,70,utRho16
yqeK,5981140,5981140,5980720,420,3478,utRho16
yqfA,6086728,6086728,6086296,432,726,utRho16
yqgA,6219042,6219106,6219042,64,0,utRho16
yqgB,6172500,6172500,6172102,398,1956,utRho16
yqgE,6185768,6185874,6185768,106,610,utRho16
yqhA,6299150,6299150,6298942,208,104,utRho16
yqhC,6310768,6310768,6310436,332,436,utRho16
yqhD,6310604,6310710,6310604,106,132,utRho16
yqhH,6316842,6317254,6316842,412,1310,utRho16
yqiC,6369662,6369680,6369662,18,322,utRho16
yqiJ,6384108,6384416,6384108,308,538,utRho16
yqjA,6495096,6495546,6495096,450,6948,utRho16
yqjF,6500932,6501124,6500932,192,636,utRho16
yqjG,6501948,6502048,6501948,100,34,utRho16
yqjH,6433078,6433078,6432982,96,42,utRho16
yqjI,6433506,6433558,6433506,52,42,utRho16
yraH,6574552,6574852,6574552,300,42,utRho16
yraP,6592144,6592818,6592144,674,1006,utRho16
yraQ,6596414,6596414,6596276,138,38,utRho16
yraR,6598024,6598024,6597692,332,328,utRho16
yrbG,13360844,13361100,13360844,256,8,utRho16
yrbL,6696842,6696904,6696842,62,776,utRho16
yrbN,6616172,6616172,6615866,306,3380,utRho16
yrdB,6860176,6860176,6860046,130,78,utRho16
yrfF,7052548,7052938,7052548,390,532,utRho16
yrhB,7169440,7169518,7169440,78,0,utRho16
ysaB,7451804,7451804,7451424,380,228,utRho16
ysgA,8032686,8032686,8032338,348,990,utRho16
ytfB,8857638,8857638,8857434,204,482,utRho16
ytfE,8864018,8864018,8863966,52,94,utRho16
ytfF,8866296,8866296,8866130,166,484,utRho16
ytfH,8868164,8868226,8868164,62,628,utRho16
ytfI,8875234,8875414,8875234,180,284,utRho16
ytfJ,8878572,8878572,8878524,48,104,utRho16
ytfK,8879022,8879174,8879022,152,312,utRho16
ytfL,8882642,8882642,8882430,212,240,utRho16
ytfQ,8899634,8899924,8899634,290,212,utRho16
ytjB,9249598,9249598,9249578,20,6,utRho16
yzfA,8896588,8896588,8896490,98,120,utRho16
zapA,6111102,6111224,6111102,122,1518,utRho16
zapB,8236772,8237030,8236772,258,548,utRho16
zapC,2011700,2011904,2011700,204,84,utRho16
zinT,4082692,4082750,4082692,58,256,utRho16
zipA,5062814,5062814,5062466,348,34,utRho16
zitB,1569716,1569716,1569646,70,24,utRho16
zntA,7212844,7212902,7212844,58,120,utRho16
zntR,6878336,6878336,6878260,76,116,utRho16
znuA,3885322,3885322,3885166,156,58,utRho16
znuC,3885268,3885324,3885268,56,58,utRho16
zraP,8403424,8403424,8403376,48,0,utRho16
zraS,8403810,8403852,8403810,42,46,utRho16
zupT,6364866,6365100,6364866,234,1418,utRho16
zur,8520282,8520282,8520006,276,694,utRho16
zwf,3872752,3872752,3872628,124,108,utRho16
C0343,2818676,2818728,2818676,52,0,utRho17
aaeB,6776526,6776526,6776376,150,210,utRho17
aaeR,6778762,6779040,6778762,278,622,utRho17
aaeX,6778860,6778860,6778674,186,700,utRho17
aat,1854920,1854920,1854864,56,0,utRho17
accA,416822,417242,416822,420,2634,utRho17
accB,6810280,6810872,6810280,592,5086,utRho17
accD,4868030,4868030,4867852,178,358,utRho17
aceB,8430804,8430956,8430804,152,342,utRho17
aceE,245938,246034,245938,96,46,utRho17
ackA,4826918,4826940,4826918,22,278,utRho17
acnA,2670848,2671662,2670848,814,922,utRho17
acnB,263038,263230,263038,192,592,utRho17
acpP,2303148,2303230,2303148,82,916,utRho17
acpS,5402324,5402324,5401996,328,568,utRho17
acrA,971396,971396,971238,158,128,utRho17
acrB,969370,969370,968806,564,1924,utRho17
acrD,5174950,5175190,5174950,240,50,utRho17
acrE,6827404,6827728,6827404,324,436,utRho17
acrR,971398,971522,971398,124,0,utRho17
acrZ,1589502,1589546,1589502,44,52,utRho17
acs,8575190,8575190,8574742,448,958,utRho17
actP,8569870,8569870,8569804,66,142,utRho17
ada,4620854,4620854,4620810,44,0,utRho17
add,3404404,3404466,3404404,62,204,utRho17
ade,7687802,7687928,7687802,126,252,utRho17
adhE,2596826,2596826,2596242,584,0,utRho17
adhP,3107988,3107988,3107676,312,2494,utRho17
adiA,8681112,8681112,8681042,70,124,utRho17
adiC,8674404,8674404,8674062,342,198,utRho17
adiY,8676084,8676084,8675858,226,84,utRho17
adk,994278,994350,994278,72,1422,utRho17
adrA,807374,807406,807374,32,104,utRho17
aer,6438240,6438240,6438152,88,0,utRho17
aes,1000102,1000102,999946,156,2620,utRho17
agaR,6557406,6557406,6557330,76,94,utRho17
agaS,6563778,6563952,6563778,174,2,utRho17
agp,2131118,2131170,2131118,52,58,utRho17
agrA,7296126,7296126,7296126,0,0,utRho17
agrB,7296588,7296588,7296588,0,0,utRho17
ahpC,1277386,1277890,1277386,504,694,utRho17
ahpF,1278004,1279506,1278004,1502,60604,utRho17
ahr,8992698,8992698,8992418,280,524,utRho17
aidB,8828494,8828550,8828494,56,0,utRho17
ais,4731512,4731512,4731240,272,88,utRho17
alaA,4814816,4815122,4814816,306,224,utRho17
alaC,4996798,4996798,4996590,208,30,utRho17
alaE,5598140,5598328,5598140,188,220,utRho17
alaS,5644180,5644180,5644022,158,3168,utRho17
alaW,5036612,5036612,5036462,150,38,utRho17
aldA,2976380,2976464,2976380,84,430,utRho17
aldB,7513070,7513070,7513022,48,372,utRho17
alkA,4295118,4295118,4295080,38,178,utRho17
alkB,4618890,4618890,4618682,208,76,utRho17
allA,1064780,1064902,1064780,122,24,utRho17
allD,1092822,1092822,1092726,96,6,utRho17
allE,1088112,1088112,1088092,20,152,utRho17
allS,1064600,1064600,1064442,158,182,utRho17
alr,8531178,8531564,8531178,386,2948,utRho17
alsE,8617334,8617334,8616956,378,502,utRho17
alsK,8615990,8615990,8615598,392,1398,utRho17
alx,6476740,6477160,6476740,420,32,utRho17
amiA,5104482,5104704,5104482,222,80,utRho17
amiC,5898378,5898378,5898020,358,264,utRho17
amn,4110062,4110122,4110062,60,0,utRho17
ampC,8758006,8758006,8757888,118,70,utRho17
ampD,237362,237466,237362,104,82,utRho17
ampG,907372,907372,907090,282,422,utRho17
ampH,792726,792726,792574,152,176,utRho17
amyA,4012230,4012312,4012230,82,194,utRho17
anmK,3439346,3439346,3439204,142,0,utRho17
ansB,6201580,6201580,6201456,124,444,utRho17
ansP,3052040,3052040,3051960,80,100,utRho17
apaG,104068,104068,103212,856,3598,utRho17
apaH,102586,102586,102444,142,4316,utRho17
apbE,4623188,4623188,4623068,120,58,utRho17
appA,2081198,2081234,2081198,36,78,utRho17
appC,2075420,2075480,2075420,60,0,utRho17
appY,1167134,1167362,1167134,228,0,utRho17
apt,982620,982824,982620,204,124,utRho17
aqpZ,1832424,1832424,1832094,330,220,utRho17
araB,140150,140150,140096,54,0,utRho17
araC,140482,140774,140482,292,938,utRho17
araE,5964416,5964416,5964364,52,0,utRho17
araF,3972476,3972476,3972256,220,44,utRho17
araH,3967120,3967120,3967086,34,234,utRho17
araJ,825058,825058,824962,96,1226,utRho17
arcA,9281602,9281602,9280612,990,5504,utRho17
arcB,6706098,6706098,6706050,48,760,utRho17
arcZ,6701154,6701154,6701154,0,0,utRho17
arfA,6877346,6877346,6877298,48,872,utRho17
argA,5898312,5898484,5898312,172,112,utRho17
argC,8309770,8310002,8309770,232,84,utRho17
argD,6980442,6980442,6980360,82,550,utRho17
argE,8310156,8310156,8309694,462,250,utRho17
argF,580680,580680,580610,70,50,utRho17
argG,6637124,6637274,6637124,150,74,utRho17
argI,8956688,8956688,8956622,66,242,utRho17
argO,6137672,6137672,6137616,56,270,utRho17
argP,6119460,6119506,6119460,46,222,utRho17
argR,6769204,6769406,6769204,202,40,utRho17
argS,3920002,3920124,3920002,122,0,utRho17
argT,4855698,4855698,4855582,116,448,utRho17
argU,1129406,1129446,1129406,40,32,utRho17
argW,4932616,4932618,4932616,2,94,utRho17
argX,7964728,7964750,7964728,22,0,utRho17
aroF,5482402,5482402,5482300,102,0,utRho17
aroG,1571182,1571266,1571182,84,586,utRho17
aroH,3576636,3576870,3576636,234,586,utRho17
aroK,7038760,7038760,7038128,632,1636,utRho17
aroL,812560,812810,812560,250,1126,utRho17
aroP,243342,243342,243102,240,88,utRho17
arpA,8445382,8445382,8444974,408,494,utRho17
arrS,7316108,7316108,7316108,0,0,utRho17
arsR,7297024,7297056,7297024,32,256,utRho17
artJ,1801252,1801252,1801150,102,0,utRho17
artP,1807686,1807686,1807468,218,2308,utRho17
ascF,5678858,5679048,5678858,190,0,utRho17
ascG,5678574,5678574,5678528,46,4,utRho17
aslB,7965562,7965916,7965562,354,3528,utRho17
asnA,7854258,7854310,7854258,52,472,utRho17
asnB,1398444,1398444,1398354,90,2062,utRho17
asnC,23562186,23562186,23562018,168,0,utRho17
asnS,1978088,1978088,1977970,118,7930,utRho17
asnT,4089082,4089098,4089082,16,106,utRho17
asnU,4119690,4119702,4119690,12,14,utRho17
asnV,4124504,4124520,4124504,16,124,utRho17
aspA,17473728,17473728,17473308,420,144,utRho17
aspC,1971486,1971486,1971418,68,664,utRho17
aspS,3901402,3901402,3901044,358,152,utRho17
aspT,7893560,7893744,7893560,184,181422,utRho17
aspV,473826,473862,473826,36,356,utRho17
asr,3342654,3342752,3342654,98,94,utRho17
astC,3664088,3664088,3663964,124,0,utRho17
astE,3654138,3654138,3653846,292,84,utRho17
atoD,4646824,4646894,4646824,70,1020,utRho17
atpB,7844540,7844540,7844102,438,280,utRho17
atpC,7832118,7832118,7831944,174,1864,utRho17
atpI,7845050,7845050,7844880,170,92,utRho17
avtA,7479348,7479410,7479348,62,844,utRho17
azoR,2965982,2965982,2965720,262,282,utRho17
azuC,3976002,3976002,3975918,84,0,utRho17
bacA,6408350,6408350,6408262,88,590,utRho17
bamA,394052,395856,394052,1804,1332,utRho17
bamB,5277950,5277950,5277304,646,1030,utRho17
bamC,5198028,5198028,5197730,298,474,utRho17
bamD,5471922,5472292,5471922,370,5148,utRho17
bamE,5506972,5507210,5506972,238,492,utRho17
basS,8666954,8666954,8666544,410,1304,utRho17
bax,7474468,7474468,7474354,114,100,utRho17
bcp,5200874,5200956,5200874,82,1208,utRho17
bcsB,7385346,7385346,7385214,132,172,utRho17
bcsE,7392644,7392916,7392644,272,164,utRho17
bdcA,8948128,8948128,8948106,22,1508,utRho17
bdcR,8948192,8948248,8948192,56,1288,utRho17
bdm,3112680,3112680,3112560,120,42,utRho17
betA,654522,654522,654494,28,84,utRho17
betI,658722,658722,658668,54,242,utRho17
betT,658842,658926,658842,84,312,utRho17
bfr,6933498,6933498,6933450,48,318,utRho17
bglG,23440182,23440182,23439402,780,456,utRho17
bglX,4444240,4444240,4443978,262,172,utRho17
bhsA,2337962,2338146,2337962,184,234,utRho17
bioA,1618584,1618584,1618514,70,0,utRho17
bioB,1618604,1618688,1618604,84,0,utRho17
bioH,7089716,7089716,7089688,28,0,utRho17
bisC,7433026,7433026,7432788,238,420,utRho17
blc,8755490,8755490,8755444,46,0,utRho17
blr,3409024,3409102,3409024,78,138,utRho17
bluF,2431226,2431226,2430950,276,172,utRho17
bluR,2428226,2428226,2428118,108,28,utRho17
bolA,908698,908944,908698,246,0,utRho17
borD,1157842,1157842,1157786,56,256,utRho17
brnQ,838976,839182,838976,206,532,utRho17
bssR,1756492,1756496,1756492,4,0,utRho17
bssS,2242116,2242116,2241910,206,282,utRho17
btuB,8326798,8327278,8326798,480,3720,utRho17
cadB,8720212,8720212,8720062,150,76,utRho17
cadC,8723926,8723926,8723868,58,0,utRho17
caiE,70998,70998,70742,256,406,utRho17
caiF,68436,68600,68436,164,242,utRho17
caiT,84074,84074,83862,212,2,utRho17
can,285406,285406,285340,66,174,utRho17
carA,59102,59302,59102,200,142,utRho17
carB,61550,61634,61550,84,496,utRho17
cas2,5757830,5757830,5757706,124,310,utRho17
casA,5768638,5768638,5768276,362,70,utRho17
cbl,4121882,4121882,4121828,54,1330,utRho17
cbpA,2128074,2128074,2127550,524,346,utRho17
cbrA,7738628,7738754,7738628,126,56,utRho17
cbrB,7794958,7795012,7794958,54,246,utRho17
ccmH,4585242,4585242,4584820,422,228,utRho17
cdaR,364894,364926,364894,32,232,utRho17
cdd,4463638,4463688,4463638,50,72,utRho17
cdh,8219814,8219860,8219814,46,886,utRho17
cdsA,391110,391354,391110,244,458,utRho17
cedA,3627484,3627484,3627326,158,944,utRho17
cfa,3482402,3482826,3482402,424,506,utRho17
chaC,2544844,2544972,2544844,128,516,utRho17
chbB,3643452,3643452,3643238,214,0,utRho17
chbG,3634624,3634624,3634270,354,274,utRho17
cheW,3946924,3946924,3946678,246,804,utRho17
chiA,6939792,6939792,6939706,86,2,utRho17
chiP,1416472,1416668,1416472,196,80,utRho17
cho,3646984,3647030,3646984,46,98,utRho17
chpS,8896804,8896894,8896804,90,286,utRho17
cirA,4493884,4493884,4493538,346,332,utRho17
citC,1304078,1304078,1303712,366,60,utRho17
citT,1293264,1293264,1293160,104,70,utRho17
clcA,350104,350214,350104,110,64,utRho17
clpA,1846160,1846528,1846160,368,424,utRho17
clpB,5468410,5468410,5468346,64,320,utRho17
clpP,913154,913354,913154,200,556,utRho17
clpS,1845500,1845826,1845500,326,40,utRho17
clpX,914404,914852,914404,448,1944,utRho17
clsA,2617346,2617346,2617290,56,182,utRho17
clsC,2212584,2212710,2212584,126,214,utRho17
cmk,1922330,1922402,1922330,72,0,utRho17
cnu,3409522,3409898,3409522,376,1246,utRho17
coaA,8350214,8350214,8350052,162,754,utRho17
cobC,1340092,1340092,1339814,278,564,utRho17
cobT,4129202,4129202,4128934,268,466,utRho17
cobU,4131944,4131944,4131528,416,548,utRho17
codB,709768,709844,709768,76,476,utRho17
comR,2337726,2337726,2337664,62,0,utRho17
copA,1022822,1022822,1022758,64,74,utRho17
corA,8002388,8002852,8002388,464,19360,utRho17
cpdB,8873258,8873258,8873130,128,812,utRho17
cptB,6082198,6082198,6082140,58,100,utRho17
cpxA,8210202,8210202,8209950,252,268,utRho17
cpxP,8211570,8211640,8211570,70,224,utRho17
cpxR,8211372,8211372,8211340,32,0,utRho17
cra,175894,176056,175894,162,0,utRho17
crcB,1316016,1316016,1315876,140,474,utRho17
creA,9270486,9271042,9270486,556,322,utRho17
creD,9276320,9276356,9276320,36,348,utRho17
crl,515620,515658,515620,38,1164,utRho17
crp,6971906,6972240,6971906,334,3718,utRho17
crr,5070960,5071668,5070960,708,2028,utRho17
csdA,5886414,5886674,5886414,260,224,utRho17
csgB,2207718,2207902,2207718,184,30,utRho17
csgD,2206688,2206688,2206392,296,286,utRho17
csgG,2203510,2203510,2203368,142,278,utRho17
csiD,5577854,5577970,5577854,116,240,utRho17
csiE,5330802,5330870,5330802,68,156,utRho17
csiR,5590942,5591348,5590942,406,154,utRho17
cspA,7439778,7440098,7439778,320,11124,utRho17
cspB,3283430,3283430,3283108,322,0,utRho17
cspC,3815018,3815018,3814870,148,678,utRho17
cspD,1845352,1845352,1845180,172,6318,utRho17
cspE,1314294,1314584,1314294,290,94,utRho17
cspF,3283380,3283710,3283380,330,60,utRho17
cspG,2102610,2102922,2102610,312,1252,utRho17
cspH,2102746,2102746,2102350,396,56,utRho17
cspI,3277624,3277624,3277334,290,14,utRho17
csrA,5638746,5638746,5638292,454,1244,utRho17
csrB,5849048,5849048,5849048,0,0,utRho17
csrC,8102072,8102072,8102072,0,0,utRho17
csrD,6806850,6806850,6806664,186,198,utRho17
cstA,1259710,1259788,1259710,78,0,utRho17
cueO,274090,274166,274090,76,0,utRho17
cueR,1027948,1027986,1027948,38,14,utRho17
curA,3037784,3038054,3037784,270,838,utRho17
cusC,1191146,1191200,1191146,54,208,utRho17
cusR,1190924,1190924,1190886,38,324,utRho17
cutA,8730784,8730784,8730712,72,1262,utRho17
cutC,3918534,3918534,3917920,614,354,utRho17
cvpA,4861600,4861600,4861526,74,40,utRho17
cvrA,2484328,2484328,2484142,186,88,utRho17
cyaA,7981548,7982306,7981548,758,1092,utRho17
cyaR,4334228,4334224,4334228,4,0,utRho17
cyaY,7988166,7988166,7988118,48,180,utRho17
cybB,2981522,2981804,2981522,282,160,utRho17
cycA,8859560,8859728,8859560,168,1690,utRho17
cydA,1542340,1542916,1542340,576,184,utRho17
cydC,1858800,1858800,1858390,410,580,utRho17
cydD,1862062,1862062,1861924,138,98,utRho17
cydX,1548300,1548392,1548300,92,326,utRho17
cynR,717418,717418,717380,38,70,utRho17
cynT,1435092,1435196,1435092,104,0,utRho17
cyoA,903306,903306,903220,86,3176,utRho17
cyoE,895540,895540,895410,130,186,utRho17
cysB,2667576,2667710,2667576,134,326,utRho17
cysC,5748056,5748056,5747984,72,106,utRho17
cysD,5752736,5752736,5752658,78,66,utRho17
cysE,7565362,7565362,7565124,238,2232,utRho17
cysG,6995508,6995656,6995508,148,830,utRho17
cysJ,5783928,5783928,5783796,132,2796,utRho17
cysK,5064688,5064818,5064688,130,478,utRho17
cysP,5087114,5087114,5087056,58,800,utRho17
cysS,1109154,1109222,1109154,68,0,utRho17
cysT,3984100,3984100,3983974,126,614,utRho17
cysZ,5062766,5062926,5062766,160,198,utRho17
cytR,8249018,8249018,8248912,106,24,utRho17
dacA,1328002,1328002,1327926,76,230,utRho17
dacB,6657714,6657926,6657714,212,254,utRho17
dacC,1761306,1761454,1761306,148,510,utRho17
dadA,2475018,2475142,2475018,124,26,utRho17
dam,7032504,7032504,7031826,678,1128,utRho17
damX,7035200,7035200,7034612,588,392,utRho17
dapA,5199568,5199568,5199520,48,0,utRho17
dapB,56576,56748,56576,172,414,utRho17
dapD,371954,371954,371894,60,328,utRho17
dapE,5183120,5183214,5183120,94,1840,utRho17
dcp,3254844,3254844,3254760,84,90,utRho17
dcrB,7219534,7219910,7219534,376,664,utRho17
dctA,7366996,7366996,7366894,102,592,utRho17
dcuA,8733686,8733686,8733546,140,48,utRho17
dcuB,8698182,8698182,8697488,694,3128,utRho17
dcuC,1312166,1312166,1311936,230,520,utRho17
dcuD,6749166,6749738,6749166,572,232,utRho17
dcuR,8701130,8701130,8700068,1062,1830,utRho17
dcuS,8703370,8703370,8703324,46,684,utRho17
dcyD,3999016,3999016,3998960,56,0,utRho17
ddpX,3126498,3126498,3126152,346,334,utRho17
deaD,6615818,6615818,6615720,98,1162,utRho17
dedA,4869880,4869880,4869482,398,5650,utRho17
dedD,4863750,4863750,4863368,382,16,utRho17
def,6867300,6867380,6867300,80,230,utRho17
degP,361690,361768,361690,78,44,utRho17
degQ,6761308,6761486,6761308,178,4150,utRho17
deoB,9239134,9239206,9239134,72,158,utRho17
deoC,9233358,9234646,9233358,1288,470,utRho17
dfp,7625406,7625462,7625406,56,0,utRho17
dgcZ,3247758,3247758,3247700,58,116,utRho17
dgkA,8512914,8513274,8512914,360,300,utRho17
dgt,358392,358474,358392,82,628,utRho17
dhaK,2501888,2501888,2501676,212,310,utRho17
dhaR,2502006,2502132,2502006,126,254,utRho17
dicB,3299194,3299218,3299194,24,0,utRho17
dicC,3295752,3295752,3295700,52,0,utRho17
dinB,501760,501796,501760,36,38,utRho17
dinD,7635398,7635520,7635398,122,172,utRho17
dinG,1666146,1666140,1666146,6,0,utRho17
dinI,2243018,2243018,2242974,44,470,utRho17
dinJ,493230,493230,493004,226,190,utRho17
dinQ,7295964,7295964,7295576,388,1198,utRho17
djlA,114536,114728,114536,192,24,utRho17
dkgA,6313142,6313246,6313142,104,504,utRho17
dkgB,458196,458334,458196,138,26,utRho17
dksA,321502,321502,321208,294,1602,utRho17
dld,4444164,4444370,4444164,206,122,utRho17
dmlA,3763424,3763824,3763424,400,722,utRho17
dmlR,3763710,3763710,3763618,92,206,utRho17
dmsA,1881646,1881918,1881646,272,2,utRho17
dnaA,7767922,7767922,7767458,464,1632,utRho17
dnaB,8528566,8528628,8528566,62,322,utRho17
dnaK,24096,24326,24096,230,4394,utRho17
dnaN,7765466,7765466,7764642,824,798,utRho17
dnaQ,471868,472134,471868,266,1652,utRho17
dnaT,18406460,18406460,18406068,392,7764,utRho17
dnaX,984112,984184,984112,72,1062,utRho17
dosP,3131486,3131486,3131466,20,36,utRho17
dpiB,1303968,1304470,1303968,502,68,utRho17
dppA,7415740,7415740,7415410,330,2500,utRho17
dps,1697900,1697900,1697822,78,38,utRho17
dsbA,8086754,8086836,8086754,82,1438,utRho17
dsbB,2466294,2466294,2466060,234,110,utRho17
dsbC,6079266,6079266,6077644,1622,1768,utRho17
dsbG,1277600,1277600,1277146,454,232,utRho17
dsdA,4958242,4958404,4958242,162,258,utRho17
dsdC,4955492,4955492,4955258,234,0,utRho17
dsdX,4955642,4955694,4955642,52,242,utRho17
dsrA,4050626,4050626,4050626,0,0,utRho17
dsrB,4049686,4049686,4049646,40,608,utRho17
dtpD,1485340,1485340,1485112,228,140,utRho17
dusA,8523200,8523338,8523200,138,1474,utRho17
dusB,6820492,6820560,6820492,68,74,utRho17
dusC,4460790,4460790,4460770,20,0,utRho17
dut,7627704,7627864,7627704,160,854,utRho17
dxr,386670,387042,386670,372,402,utRho17
ebgA,6445102,6445266,6445102,164,450,utRho17
ebgR,6442874,6442932,6442874,58,24,utRho17
ecnB,8753018,8753106,8753018,88,546,utRho17
eco,4607594,4607810,4607594,216,12,utRho17
ecpA,621594,621594,621342,252,112,utRho17
ecpB,620238,620238,620052,186,74,utRho17
ecpR,622964,622964,622672,292,0,utRho17
eda,3866218,3866218,3865512,706,0,utRho17
edd,3869426,3869426,3869208,218,54,utRho17
efeO,2164308,2164486,2164308,178,4,utRho17
efeU_1,2162614,2162712,2162614,98,66,utRho17
efp,8751134,8751398,8751134,264,2258,utRho17
elaA,4763372,4763372,4763086,286,0,utRho17
elaD,4765308,4765426,4765308,118,38,utRho17
elfA,1995530,1995736,1995530,206,0,utRho17
elfD,1996642,1996980,1996642,338,128,utRho17
emrD,7707690,7707844,7707690,154,0,utRho17
emrK,4966896,4966896,4966678,218,50,utRho17
emrY,4964668,4964668,4964352,316,72,utRho17
emtA,2486250,2486360,2486250,110,40,utRho17
endA,12361100,12361388,12361100,288,152,utRho17
eno,5817692,5817692,5815882,1810,4324,utRho17
entC,1249662,1249770,1249662,108,0,utRho17
entD,1220508,1220508,1220158,350,20,utRho17
entH,1258584,1258600,1258584,16,50,utRho17
entS,1244506,1244600,1244506,94,0,utRho17
envR,6827266,6827266,6826930,336,146,utRho17
epd,12295292,12295292,12294764,528,176,utRho17
epmA,8765236,8765286,8765236,50,26,utRho17
epmB,8751406,8751406,8751314,92,886,utRho17
eptB,7421162,7421162,7420950,212,146,utRho17
eptC,8300622,8300622,8300530,92,502,utRho17
erfK,4126708,4126708,4126646,62,598,utRho17
erpA,353122,353220,353122,98,140,utRho17
esrE,8039956,8039956,8039956,0,0,utRho17
essD,1153746,1154796,1153746,1050,2764,utRho17
etk,2088606,2088606,2088420,186,740,utRho17
evgA,4967262,4967510,4967262,248,108,utRho17
exbB,6304028,6304028,6303968,60,54,utRho17
exbD,6302780,6302780,6302486,294,372,utRho17
exuR,6493016,6493304,6493016,288,472,utRho17
exuT,6490004,6490208,6490004,204,0,utRho17
fabA,2032996,2032996,2032940,56,66,utRho17
fabB,4883282,4883282,4883210,72,0,utRho17
fabH,2297032,2297518,2297032,486,2774,utRho17
fabI,2702236,2702236,2702078,158,210,utRho17
fadB,8062026,8062026,8061942,84,0,utRho17
fadD,3779614,3779614,3779492,122,0,utRho17
fadE,486812,486812,486606,206,6,utRho17
fadH,6463248,6463330,6463248,82,194,utRho17
fadI,4921022,4921022,4920938,84,92,utRho17
fadL,4922410,4922600,4922410,190,272,utRho17
fadM,928720,928804,928720,84,0,utRho17
fadR,2469810,2469876,2469810,66,0,utRho17
fbaB,4357334,4357334,4357128,206,106,utRho17
fdhE,8162722,8162722,8162456,266,1304,utRho17
fdhF,8598814,8598814,8598732,82,384,utRho17
fdnG,3094744,3094802,3094744,58,50,utRho17
fdrA,1093012,1093360,1093012,348,114,utRho17
feaB,2894994,2895038,2894994,44,0,utRho17
feaR,2894734,2894734,2894566,168,44,utRho17
fecA,9033454,9033454,9033354,100,0,utRho17
fecE,9023288,9023288,9022914,374,2134,utRho17
fecI,9036564,9036564,9036470,94,344,utRho17
feoA,7080114,7080326,7080114,212,334,utRho17
fepA,1225334,1225334,1224988,346,266,utRho17
fepB,1249454,1249454,1249020,434,72,utRho17
fepD,1244468,1244468,1244378,90,0,utRho17
fes,1225374,1225630,1225374,256,158,utRho17
ffh,5495706,5495706,5495590,116,248,utRho17
ffs,952576,952848,952576,272,1882,utRho17
fhuA,334884,334968,334884,84,530,utRho17
fhuE,2323294,2323294,2323102,192,88,utRho17
fhuF,9211504,9211504,9211326,178,74750,utRho17
fic,6983296,6983296,6982926,370,1960,utRho17
fieF,8212864,8212938,8212864,74,184,utRho17
fimA,9085388,9086230,9085388,842,2120,utRho17
fimB,9081334,9081914,9081334,580,4118,utRho17
fimE,9083742,9084074,9083742,332,2310,utRho17
fimZ,1129214,1129214,1128960,254,0,utRho17
fiu,1683296,1683296,1683062,234,56,utRho17
fixA,84650,84806,84650,156,0,utRho17
fkpA,6955050,6955050,6954838,212,3978,utRho17
fldA,2846084,2846084,2845860,224,2428,utRho17
fldB,6079644,6079710,6079644,66,156,utRho17
flgA,2261770,2261770,2261726,44,1184,utRho17
flgB,2261986,2262036,2261986,50,152,utRho17
flgK,2276702,2276756,2276702,54,1114,utRho17
flgM,2260330,2260330,2260256,74,58,utRho17
flgN,2259828,2259828,2259660,168,198,utRho17
flhB,3932432,3932432,3932382,50,480,utRho17
flhC,3955864,3955864,3955688,176,98,utRho17
flhD,3957154,3957154,3956394,760,2330,utRho17
fliA,4003638,4003638,4003578,60,142,utRho17
fliC,4007352,4007352,4007212,140,224,utRho17
fliD,4007634,4007744,4007634,110,966,utRho17
fliE,4026186,4026186,4026028,158,524,utRho17
fliF,4026292,4026458,4026292,166,358,utRho17
fliL,4039168,4039236,4039168,68,62,utRho17
flk,4875824,4875900,4875824,76,156,utRho17
flu,4142634,4143078,4142634,444,338,utRho17
flxA,3292776,3292810,3292776,34,110,utRho17
fnr,2799104,2799104,2799052,52,80,utRho17
fnrS,2818258,2818258,2818258,0,0,utRho17
focA,1909628,1909628,1908932,696,1690,utRho17
folA,99598,99646,99598,48,256,utRho17
folB,6409296,6409296,6409178,118,98,utRho17
folD,1115562,1115562,1115482,80,382,utRho17
folE,4487696,4487696,4487304,392,2152,utRho17
fpr,8228998,8228998,8228944,54,32,utRho17
frc,4986878,4986878,4986508,370,44,utRho17
frdA,8764824,8764824,8764636,188,564,utRho17
frdD,8758948,8758948,8758732,216,5024,utRho17
fre,8052886,8053054,8052886,168,1334,utRho17
frlA,6999518,6999820,6999518,302,578,utRho17
frr,385624,385744,385624,120,836,utRho17
frsA,513004,513054,513004,50,188,utRho17
fruB,4527194,4527194,4526990,204,0,utRho17
frvR,8179804,8179804,8179710,94,0,utRho17
fryA,5008986,5008986,5008970,16,364,utRho17
fsaA,1727060,1727284,1727060,224,660,utRho17
fsr,1009710,1009710,1009392,318,96,utRho17
ftnA,3977364,3977432,3977364,68,0,utRho17
ftnB,3973550,3973850,3973550,300,276,utRho17
ftsA,207122,207964,207122,842,946,utRho17
ftsB,5745802,5745802,5745640,162,1220,utRho17
ftsH,6654204,6654204,6653870,334,646,utRho17
ftsK,1865858,1866448,1865858,590,828,utRho17
ftsL,181376,182064,181376,688,2798,utRho17
ftsP,6325732,6325732,6325338,394,262,utRho17
ftsQ,205484,206310,205484,826,510,utRho17
ftsX,7204512,7204512,7204172,340,580,utRho17
ftsZ,209272,210610,209272,1338,472,utRho17
fucA,5867708,5867708,5867376,332,4248,utRho17
fucP,5868238,5868470,5868238,232,894,utRho17
fumA,6753760,6753760,6753508,252,3164,utRho17
fumB,8694696,8694696,8694652,44,160,utRho17
fumC,3373418,3373418,3373176,242,28,utRho17
fur,2842892,2842892,2842584,308,2960,utRho17
fusA,6947370,6947370,6947028,342,15794,utRho17
fxsA,8737206,8737328,8737206,122,556,utRho17
gabD,5581824,5582546,5581824,722,2628,utRho17
gadA,7335214,7335214,7335160,54,0,utRho17
gadB,3144144,3144144,3144090,54,224,utRho17
gadC,3141168,3141168,3140978,190,68,utRho17
gadE,7315600,7316732,7315600,1132,756,utRho17
gadW,7329562,7329562,7329236,326,278,utRho17
gadX,14663356,14663356,14663240,116,672,utRho17
gadY,7329728,7329728,7329728,0,0,utRho17
galE,1584354,1584354,1584110,244,132,utRho17
galF,4228702,4228702,4228654,48,142,utRho17
galM,1577796,1577796,1577674,122,212,utRho17
galP,6176510,6176568,6176510,58,42,utRho17
galR,5953138,5953198,5953138,60,58,utRho17
galS,4483420,4483420,4483336,84,0,utRho17
galU,2582810,2582914,2582810,104,340,utRho17
gapA,3724480,3725542,3724480,1062,5310,utRho17
garP,6549868,6549868,6549814,54,236,utRho17
gatY,4354468,4354468,4354408,60,58,utRho17
gatZ,4352864,4352864,4352642,222,16678,utRho17
gcd,282558,282558,282450,108,0,utRho17
gcl,1067814,1067832,1067814,18,0,utRho17
gcvA,5885278,5885278,5885134,144,72,utRho17
gcvB,5885392,5885392,5885392,0,0,utRho17
gcvR,5199758,5199812,5199758,54,152,utRho17
gcvT,6101544,6101544,6101334,210,1774,utRho17
gdhA,3684616,3684742,3684616,126,82,utRho17
gfcA,2099668,2099668,2099488,180,1424,utRho17
gfcD,2096236,2096236,2095890,346,2530,utRho17
ghrA,2195648,2195772,2195648,124,0,utRho17
ghrB,7434378,7434620,7434378,242,4174,utRho17
glcA,6242728,6242728,6242558,170,1020,utRho17
glcC,6256412,6256544,6256412,132,0,utRho17
glcD,6256152,6256152,6256042,110,340,utRho17
gldA,8278092,8278092,8278070,22,32,utRho17
glgA,7136784,7136784,7136066,718,5596,utRho17
glgB,7147314,7147314,7147004,310,728,utRho17
glgC,7139142,7139142,7138656,486,756,utRho17
glgP,7133546,7133546,7133162,384,1470,utRho17
glgS,6384024,6384024,6383878,146,274,utRho17
glgX,7142838,7142838,7142638,200,172,utRho17
glk,5018922,5018922,5018852,70,238,utRho17
glmS,7827622,7827622,7827336,286,1354,utRho17
glmU,7830652,7830652,7830400,252,370,utRho17
glmY,10765360,10765360,10765360,0,0,utRho17
glmZ,7972864,7972864,7972864,0,0,utRho17
glnA,16232888,16232888,16232136,752,504,utRho17
glnB,5375052,5375052,5374816,236,1114,utRho17
glnD,377310,377310,377300,10,2,utRho17
glnE,6399602,6399602,6399282,320,50,utRho17
glnH,1696396,1696396,1696008,388,698,utRho17
glnK,945112,945196,945112,84,100,utRho17
glnL,8112742,8112742,8112678,64,84,utRho17
glnQ,1693262,1693262,1692926,336,488,utRho17
glnS,1411998,1412186,1411998,188,2108,utRho17
gloA,3455602,3455674,3455602,72,58,utRho17
gloB,469852,469852,469564,288,1070,utRho17
glpA,4705166,4705294,4705166,128,28,utRho17
glpD,7123942,7124026,7123942,84,0,utRho17
glpE,7123698,7123698,7123646,52,46,utRho17
glpF,8236322,8236322,8236180,142,478,utRho17
glpG,7122960,7122960,7122904,56,426,utRho17
glpR,7121782,7121782,7121210,572,900,utRho17
glpT,4704902,4704902,4704748,154,490,utRho17
glpX,8231212,8231212,8231158,54,12244,utRho17
glrK,5382246,5382246,5382196,50,734,utRho17
gltA,1509534,1509534,1508936,598,5936,utRho17
gltB,6709018,6709264,6709018,246,1130,utRho17
gltI,1375792,1375792,1375494,298,3310,utRho17
gltP,8588536,8588962,8588536,426,2908,utRho17
gltS,7657382,7657382,7657330,52,1324,utRho17
gltX,5041568,5041568,5041344,224,760,utRho17
gluQ,320286,320286,320224,62,152,utRho17
glyA,5371148,5371148,5371014,134,2,utRho17
glyQ,7450708,7450708,7450636,72,548,utRho17
glyS,7448990,7448990,7448794,196,1306,utRho17
glyU,5998128,5998128,5998114,14,86,utRho17
glyV,8784626,8784720,8784626,94,512,utRho17
glyW,3984360,3984360,3984234,126,34,utRho17
gmhB,445612,445666,445612,54,0,utRho17
gmk,7642776,7642856,7642776,80,112,utRho17
gmr,2693686,2693686,2693484,202,458,utRho17
gnd,4202648,4202648,4202536,112,516,utRho17
gnsB,3275692,3275692,3275564,128,50,utRho17
gntK,14310580,14310580,14310368,212,816,utRho17
gntP,9102668,9102668,9102592,76,408,utRho17
gntR,7157760,7157760,7157452,308,454,utRho17
gntT,7092810,7093118,7092810,308,2830,utRho17
gntU,7154170,7154170,7154122,48,452,utRho17
gntX,7089334,7089764,7089334,430,256,utRho17
gor,7292224,7292598,7292224,374,138,utRho17
gpmA,1575340,1575340,1575190,150,0,utRho17
gpmM,7570374,7570520,7570374,146,44,utRho17
gpsA,7567620,7567620,7567322,298,8044,utRho17
gpt,511828,511954,511828,126,400,utRho17
grcA,5433046,5433046,5432898,148,1092,utRho17
greA,6657728,6657728,6657430,298,754,utRho17
greB,7073488,7073624,7073488,136,138,utRho17
groL,8741566,8742050,8741566,484,7258,utRho17
groS,8741232,8741376,8741232,144,11080,utRho17
grpE,5501494,5501494,5501416,78,424,utRho17
grxA,1781552,1781552,1781506,46,48,utRho17
grxB,2248206,2248206,2248108,98,798,utRho17
grxC,7569152,7569152,7568884,268,3196,utRho17
grxD,3468324,3468324,3468202,122,584,utRho17
gspA,6911268,6911268,6910796,472,328,utRho17
gspC,6910964,6911156,6910964,192,88,utRho17
gss,6277220,6277220,6277044,176,190,utRho17
gstA,3428654,3428754,3428654,100,0,utRho17
gstB,1761038,1761038,1760960,78,308,utRho17
guaB,5268214,5268214,5268140,74,152,utRho17
gudD,5839026,5839026,5838770,256,136,utRho17
gyrA,4678914,4678914,4678840,74,14,utRho17
gyrB,7760300,7760300,7760238,62,298,utRho17
hcaE,5337964,5338064,5337964,100,3174,utRho17
hcaR,5337928,5337928,5337792,136,3604,utRho17
hcaT,5336106,5336106,5335692,414,1714,utRho17
hchA,4071260,4071670,4071260,410,86,utRho17
hcp,1828258,1828258,1827628,630,1166,utRho17
hcr,1824400,1824400,1824300,100,0,utRho17
hdeA,7313582,7313582,7313480,102,66,utRho17
hdeD,7313920,7313990,7313920,70,178,utRho17
hdfR,7896320,7896320,7895934,386,726,utRho17
hdhA,3396244,3396244,3396080,164,104,utRho17
helD,2048876,2048942,2048876,66,0,utRho17
hemA,2527166,2527428,2527166,262,324,utRho17
hemB,779722,779722,779454,268,1934,utRho17
hemF,5106410,5106450,5106410,40,0,utRho17
hemH,996062,996110,996062,48,1044,utRho17
hemL,349882,349882,349764,118,68,utRho17
hemN,8103886,8104090,8103886,204,158,utRho17
hepA,127176,127176,126528,648,2860,utRho17
hflD,2385372,2385372,2385262,110,40,utRho17
hfq,8799602,8800576,8799602,974,15684,utRho17
hha,961006,961006,960616,390,356,utRho17
hicA,3018442,3018572,3018442,130,20,utRho17
higA,6468682,6468682,6468288,394,1072,utRho17
higB,6468960,6468960,6468910,50,96,utRho17
hinT,2323642,2323770,2323642,128,0,utRho17
hipB,3184964,3184964,3184884,80,134,utRho17
hisB,4186720,4186936,4186720,216,508,utRho17
hisJ,4853674,4853674,4853576,98,0,utRho17
hisL,8359856,8359984,8359856,128,732,utRho17
hisS,5281284,5281284,5281150,134,212,utRho17
hlpA,400910,400964,400910,54,400,utRho17
hlyE,2460932,2460932,2460788,144,782,utRho17
hmp,5371594,5371670,5371594,76,34,utRho17
hns,2585916,2585916,2585844,72,642,utRho17
hofM,7045856,7045856,7045502,354,124,utRho17
hokA,7441620,7441620,7441200,420,3046,utRho17
hokC,33902,33902,33806,96,444,utRho17
hokE,1215462,1215672,1215462,210,0,utRho17
holC,8968546,8968546,8968560,14,680,utRho17
holD,9215562,9215606,9215562,44,44,utRho17
holE,3850040,3850216,3850040,176,2120,utRho17
hpt,282720,282862,282720,142,1032,utRho17
hrpB,324150,324210,324150,60,8,utRho17
hscB,5319048,5319048,5318934,114,5246,utRho17
hscC,1367188,1367188,1366786,402,850,utRho17
hsdS,9163004,9163004,9162924,80,290,utRho17
hslJ,2883560,2883560,2883486,74,322,utRho17
hslO,7059344,7059548,7059344,204,10450,utRho17
hslR,7058220,7058696,7058220,476,2548,utRho17
hslV,8244708,8244708,8244574,134,1238,utRho17
hsrA,7881412,7881412,7881224,188,350,utRho17
htgA,21286,21660,21286,374,17334,utRho17
htpG,989634,990240,989634,606,22000,utRho17
htpX,3825236,3825236,3825152,84,170,utRho17
htrE,311036,311036,310852,184,1104,utRho17
htrL,7587668,7587668,7587366,302,206,utRho17
hupA,8400352,8400562,8400352,210,256,utRho17
hupB,1845220,1845804,1845220,584,972,utRho17
hyaA,2063968,2064278,2063968,310,108,utRho17
hybO,6292726,6292726,6292522,204,11034,utRho17
hycA,5700922,5700922,5700870,52,164,utRho17
hycI,5686204,5686204,5686086,118,536,utRho17
hydN,5676264,5676264,5676210,54,0,utRho17
hyfA,5202342,5202402,5202342,60,112,utRho17
hypA,11402508,11402588,11402508,80,296,utRho17
hypB,11403356,11404004,11403356,648,116,utRho17
hypF,5676210,5676210,5674850,1360,3600,utRho17
hypT,9116634,9116634,9116578,56,88,utRho17
hyuA,6019660,6020056,6019660,396,762,utRho17
iaaA,1733074,1733136,1733074,62,54,utRho17
iadA,9119074,9119074,9119052,22,526,utRho17
iap,5753072,5753162,5753072,90,144,utRho17
ibaG,6673966,6673966,6673606,360,240,utRho17
ibpA,7735036,7735036,7734844,192,5270,utRho17
ibpB,7733962,7733962,7733794,168,22968,utRho17
icd,2389922,2390246,2389922,324,604,utRho17
iclR,8447304,8447304,8447256,48,10,utRho17
idi,6065876,6066130,6065876,254,0,utRho17
idnD,8988870,8988870,8988812,58,0,utRho17
idnK,8989194,8989246,8989194,52,122,utRho17
ihfA,3591442,3591442,3591104,338,516,utRho17
ihfB,1927498,1927656,1927498,158,696,utRho17
ileS,43666,44782,43666,1116,3644,utRho17
ileX,6431194,6431196,6431194,2,0,utRho17
ilvA,15820940,15821324,15820940,384,2320,utRho17
ilvC,7915824,7915940,7915824,116,164,utRho17
ilvE,15809552,15809936,15809552,384,1744,utRho17
ilvI,170840,171260,170840,420,588,utRho17
ilvL,23701308,23701932,23701308,624,456,utRho17
ilvY,7915734,7915734,7915640,94,70,utRho17
inaA,4698998,4698998,4698944,54,174,utRho17
infA,1853370,1853370,1852886,484,1182,utRho17
infC,3602692,3602692,3601276,1416,2872,utRho17
insA-5,3958452,3958452,3958430,22,52,utRho17
insA-7,9036758,9037054,9036758,296,1786,utRho17
insC-5,6372080,6372284,6372080,204,9000,utRho17
insEF-2,785238,785238,785820,582,2976,utRho17
insEF-4,2190310,2190310,2190892,582,2828,utRho17
insG,9007098,9007098,9006862,236,0,utRho17
insH-1,550596,550596,550234,362,13888,utRho17
insH-11,7306538,7306538,7306396,142,234,utRho17
insH-2,1151548,1151548,1151506,42,210,utRho17
insH-3,1378444,1378444,1378026,418,544,utRho17
insH-4,2791942,2792152,2791942,210,466,utRho17
insH-5,2857852,2857852,2857452,400,512,utRho17
insH-6,4135022,4135022,4134642,380,852,utRho17
insH-7,4206186,4206186,4205822,364,1792,utRho17
insH-9,6260050,6260356,6260050,306,1172,utRho17
insI-3,9017372,9017372,9017234,138,1076,utRho17
insJ,7441188,7441360,7441188,172,1116,utRho17
insK,7442130,7442308,7442130,178,56,utRho17
insL-1,30760,30890,30760,130,5906,utRho17
insL-2,1216112,1216130,1216112,18,312,utRho17
insL-3,5028644,5028662,5028644,18,254,utRho17
insN-1,540452,540484,540452,32,66,utRho17
intD,1132202,1132202,1131956,246,9894,utRho17
intR,2826520,2826520,2826470,50,8,utRho17
intS,4933026,4933090,4933026,64,3708,utRho17
intZ,5117386,5117542,5117386,156,2902,utRho17
iraD,9113152,9113986,9113152,834,502,utRho17
iraM,2424246,2424246,2424006,240,16,utRho17
iraP,802638,802772,802638,134,0,utRho17
iscA,5319924,5319924,5319772,152,1060,utRho17
iscR,5324398,5324398,5324262,136,11366,utRho17
iscX,5313834,5313834,5313472,362,2832,utRho17
ispF,5743968,5743968,5743560,408,2878,utRho17
ispG,5283908,5283908,5283608,300,196,utRho17
ispU,389568,389806,389568,238,14,utRho17
isrA,2811502,2811502,2811618,116,0,utRho17
istr-1,7706384,7706384,7706384,0,0,utRho17
istr-2,7706514,7706514,7706514,0,0,utRho17
ivbL,15412092,15412092,15411952,140,308,utRho17
ivy,480638,480686,480638,48,214,utRho17
katE,3627628,3627734,3627628,106,618,utRho17
katG,8267624,8267670,8267624,46,130,utRho17
kbaZ,6557732,6557828,6557732,96,22,utRho17
kbl,7585154,7585154,7585102,52,1466,utRho17
kch,2621046,2621046,2620538,508,392,utRho17
kdgR,3820506,3820506,3820198,308,162,utRho17
kdpE,1443788,1443788,1443466,322,166,utRho17
kdpF,1457698,1457698,1457642,56,150,utRho17
kdsA,2535708,2536330,2535708,622,1594,utRho17
kdsC,6683438,6684546,6683438,1108,2986,utRho17
kduI,5968388,5968388,5968248,140,6904,utRho17
kefF,94160,94492,94160,332,690,utRho17
kgtP,5451624,5451624,5451492,132,290,utRho17
kup,7862206,7862632,7862206,426,290,utRho17
lacI,735076,735076,735020,56,154,utRho17
lacZ,1465508,1465508,1465220,288,104,utRho17
ldcA,2486394,2486394,2486160,234,288,utRho17
ldhA,2885830,2885830,2885686,144,54,utRho17
ldrA,2538954,2538954,2538550,404,2900,utRho17
ldrB,2540024,2540024,2539620,404,954,utRho17
ldrC,2541092,2541092,2540690,402,502,utRho17
ldrD,7400544,7400544,7400174,370,1860,utRho17
lepA,5414392,5414392,5414248,144,36,utRho17
lepB,5410928,5410928,5410618,310,506,utRho17
leuD,159188,159188,158906,282,576,utRho17
leuE,3761600,3761600,3761518,82,68,utRho17
leuL,168048,168048,167416,632,268,utRho17
leuO,168308,168736,168308,428,208,utRho17
leuQ,9212864,9212864,9212802,62,0,utRho17
leuU,6644556,6644556,6644316,240,2064,utRho17
leuV,9212546,9212546,9212330,216,1528,utRho17
leuX,8992772,8992810,8992772,38,126,utRho17
lexA,8514174,8514230,8514174,56,642,utRho17
lhr,3456706,3458174,3456706,1468,4266,utRho17
ligA,5060402,5060402,5060352,50,0,utRho17
ligB,7642576,7642576,7642340,236,746,utRho17
lipA,1320602,1320602,1320432,170,176,utRho17
lipB,1324802,1324802,1324556,246,7352,utRho17
lit,2397032,2397390,2397032,358,710,utRho17
livJ,7199524,7199524,7199316,208,990,utRho17
livK,7195510,7195510,7195120,390,494,utRho17
lldP,7554578,7554798,7554578,220,4938,utRho17
lnt,1381968,1381968,1381762,206,436,utRho17
loiP,6163784,6163826,6163784,42,110,utRho17
lolA,1874656,1874738,1874656,82,0,utRho17
lolB,2527112,2527112,2527000,112,216,utRho17
lolC,2350748,2350854,2350748,106,40,utRho17
lon,917630,917776,917630,146,408,utRho17
lpcA,486936,487086,486936,150,14,utRho17
lpd,255434,255824,255434,390,2446,utRho17
lplA,9248476,9248476,9248234,242,786,utRho17
lplT,5947878,5947878,5947724,154,140,utRho17
lpoA,6586422,6586800,6586422,378,500,utRho17
lpp,3514592,3514842,3514592,250,236,utRho17
lptA,6686598,6686760,6686598,162,518,utRho17
lptB,6686792,6687888,6686792,1096,1710,utRho17
lptD,114672,114672,114218,454,652,utRho17
lptF,8972244,8972436,8972244,192,294,utRho17
lpxC,213016,213114,213016,98,4978,utRho17
lpxD,401920,401942,401920,22,46,utRho17
lpxL,2233418,2233418,2233164,254,0,utRho17
lpxM,3880456,3880456,3880386,70,0,utRho17
lpxP,4991156,4991290,4991156,134,254,utRho17
lrhA,4813312,4813312,4813282,30,68,utRho17
lrp,1864656,1865190,1864656,534,956,utRho17
lspA,50028,50414,50028,386,430,utRho17
lsrA,3202920,3202980,3202920,60,0,utRho17
lsrR,3202514,3202514,3202482,32,0,utRho17
ltaE,1818640,1818640,1818588,52,0,utRho17
luxS,5630130,5630130,5629466,664,14630,utRho17
lysA,5957902,5957902,5957798,104,64,utRho17
lysC,8467232,8467232,8466466,766,1548,utRho17
lysP,4497120,4497120,4497064,56,90,utRho17
lysR,5957900,5958042,5957900,142,254,utRho17
lysT,1561028,1561108,1561028,80,0,utRho17
lysU,8709610,8709610,8709434,176,866,utRho17
macB,1840188,1840694,1840188,506,824,utRho17
maeA,3111484,3111484,3111338,146,5838,utRho17
mak,820236,820288,820236,52,14,utRho17
malE,8492928,8492928,8492838,90,46,utRho17
malI,3398456,3398456,3398360,96,0,utRho17
malK,8493472,8493568,8493472,96,94,utRho17
malP,7105020,7105020,7104946,74,898,utRho17
malQ,7100798,7100798,7100140,658,236,utRho17
malS,14949880,14949988,14949880,108,0,utRho17
malT,7106048,7106170,7106048,122,162,utRho17
malX,3398626,3398710,3398626,84,0,utRho17
malZ,1689980,1690072,1689980,92,1324,utRho17
manA,3377102,3377152,3377102,50,0,utRho17
manX,3803866,3804096,3803866,230,104,utRho17
marC,3237882,3237882,3237816,66,370,utRho17
marR,3238186,3238240,3238186,54,406,utRho17
matP,2036918,2036970,2036918,52,84,utRho17
mazE,5822736,5822736,5822678,58,92,utRho17
mazG,5821720,5821720,5821370,350,1624,utRho17
mcbA,1684306,1684306,1684112,194,0,utRho17
mcbR,3040192,3040524,3040192,332,0,utRho17
mcrA,2420278,2420692,2420278,414,192,utRho17
mcrC,9156124,9156124,9155916,208,632,utRho17
mdaB,6344814,6345060,6344814,246,160,utRho17
mdfA,1767138,1767346,1767138,208,0,utRho17
mdh,6768940,6768940,6768536,404,8,utRho17
mdoB,9198988,9198988,9198882,106,6148,utRho17
mdoD,2993290,2993712,2993290,422,30,utRho17
mdoG,2218514,2218670,2218514,156,6,utRho17
mdtA,4307958,4308032,4307958,74,448,utRho17
mdtE,7318168,7318464,7318168,296,12448,utRho17
mdtK,3486538,3486914,3486538,376,2390,utRho17
mdtP,8602472,8602472,8602060,412,1328,utRho17
melA,8683774,8683822,8683774,48,0,utRho17
melR,8683300,8683300,8683256,44,654,utRho17
menA,8240812,8240812,8240698,114,4,utRho17
menB,4753774,4753774,4753638,136,866,utRho17
mepH,3468714,3468870,3468714,156,0,utRho17
mepM,3883666,3883666,3883270,396,264,utRho17
mepS,4539840,4539958,4539840,118,494,utRho17
metA,8428318,8428560,8428318,242,234,utRho17
metB,8257272,8257344,8257272,72,596,utRho17
metC,6304150,6304472,6304150,322,506,utRho17
metE,8025768,8026106,8025768,338,1286,utRho17
metF,8265092,8265232,8265092,140,156,utRho17
metG,4388538,4388600,4388538,62,96,utRho17
metH,8447010,8447656,8447010,646,3282,utRho17
metJ,8257116,8257116,8256790,326,334,utRho17
metK,6173154,6173412,6173154,258,52,utRho17
metN,445428,445428,445290,138,10,utRho17
metR,8025710,8025710,8025632,78,0,utRho17
metT,1394326,1394326,1394266,60,246,utRho17
metY,19910250,19910250,19909734,516,1722,utRho17
metZ,11789528,11789548,11789528,20,80,utRho17
mfd,2348056,2348056,2347928,128,202,utRho17
mglA,4478782,4478782,4478578,204,1302,utRho17
mglB,4481132,4481132,4480696,436,14030,utRho17
mglC,4475918,4475918,4475506,412,484,utRho17
mgrB,3817584,3817584,3817532,52,14,utRho17
mgrR,3245828,3245828,3245828,0,0,utRho17
mgsA,2054082,2054082,2054030,52,76,utRho17
mgtL,8934560,8934862,8934560,302,218,utRho17
mhpA,737038,737222,737038,184,2,utRho17
mhpR,737072,737072,736840,232,8,utRho17
mhpT,750772,750918,750772,146,72,utRho17
miaA,8797964,8798504,8797964,540,5930,utRho17
micA,5629604,5629604,5629604,0,0,utRho17
micC,2874242,2874238,2874242,4,0,utRho17
micF,4626168,4626168,4626168,0,0,utRho17
micM,1014408,1014408,1014408,0,0,utRho17
minE,2449422,2449422,2449090,332,882,utRho17
mioC,7852950,7852950,7852910,40,78,utRho17
mipA,3733012,3733012,3732944,68,1364,utRho17
mlaA,4930270,4930270,4930014,256,0,utRho17
mlc,3337206,3337206,3337128,78,120,utRho17
mlrA,4429498,4429732,4429498,234,200,utRho17
mltA,5894546,5894546,5894356,190,392,utRho17
mltD,468050,468050,467910,140,194,utRho17
mltF,5391534,5391602,5391534,68,0,utRho17
mmuP,550238,550650,550238,412,16492,utRho17
mngA,1531622,1531968,1531622,346,170,utRho17
mngR,1531852,1531852,1531750,102,92,utRho17
mnmG,7851348,7851348,7851266,82,4184,utRho17
mntH,5025470,5025470,5025412,58,0,utRho17
mntP,3810918,3811376,3810918,458,3190,utRho17
mntR,1706160,1706366,1706160,206,0,utRho17
mntS,1706128,1706128,1705994,134,62,utRho17
moaA,1633654,1634088,1633654,434,1228,utRho17
moaB,1635954,1636110,1635954,156,1108,utRho17
mobA,8084242,8084242,8083998,244,216,utRho17
mocA,6030112,6030320,6030112,208,672,utRho17
modA,1589990,1590178,1589990,188,124,utRho17
moeA,1732788,1732788,1732728,60,60,utRho17
mokB,2984610,2984610,2984258,352,1020,utRho17
molR_1,4392888,4392948,4392888,60,130,utRho17
motA,3954604,3954604,3954278,326,4,utRho17
mpaA,2781278,2781278,2781196,82,466,utRho17
mpl,8911456,8911570,8911456,114,114,utRho17
mppA,2786108,2786454,2786108,346,186,utRho17
mprA,5621494,5621540,5621494,46,956,utRho17
mqo,4613848,4613848,4613508,340,396,utRho17
mqsA,6336742,6336742,6336492,250,648,utRho17
mqsR,6337306,6337306,6337088,218,760,utRho17
mraZ,179192,179268,179192,76,0,utRho17
mrcA,7045652,7045742,7045652,90,0,utRho17
mrcB,329442,329460,329442,18,0,utRho17
mreB,13605424,13605424,13604348,1076,1152,utRho17
mreD,6798166,6798166,6797750,416,330,utRho17
mrp,4388360,4388360,4388336,24,0,utRho17
mscK,972984,973072,972984,88,44,utRho17
mscL,6876002,6876048,6876002,46,462,utRho17
mscS,6139742,6139742,6139614,128,152,utRho17
msrA,8884522,8884522,8884352,170,382,utRho17
msrB,3725168,3725168,3724858,310,14,utRho17
msyB,2228426,2228426,2228362,64,182,utRho17
mtfA,4087236,4087302,4087236,66,1132,utRho17
mtgA,6699662,6699662,6699618,44,2040,utRho17
mtlA,30177504,30178248,30177504,744,3664,utRho17
mtn,358366,358366,358306,60,810,utRho17
mtr,6611864,6611864,6611634,230,354,utRho17
mug,6430992,6430992,6430946,46,128,utRho17
murQ,5091466,5091546,5091466,80,90,utRho17
murR,5091586,5091586,5091218,368,142,utRho17
mutH,5939164,5939324,5939164,160,124,utRho17
mutL,8794092,8794824,8794092,732,8708,utRho17
mutM,7622554,7622554,7622304,250,300,utRho17
mutS,5714038,5714186,5714038,148,840,utRho17
mutY,18617466,18618078,18617466,612,894,utRho17
nac,4123956,4123956,4123866,90,768,utRho17
nadA,1564122,1564170,1564122,48,0,utRho17
nadB,5420714,5420840,5420714,126,6,utRho17
nadC,237326,237326,237290,36,106,utRho17
nadE,3644604,3644916,3644604,312,192,utRho17
nadK,5501526,5501662,5501526,136,356,utRho17
nagA,1406350,1406350,1405502,848,7340,utRho17
nagB,1407416,1407416,1407222,194,194,utRho17
nagC,1404016,1404016,1403188,828,596,utRho17
nagE,1407680,1407888,1407680,208,4,utRho17
nagK,2357080,2357186,2357080,106,0,utRho17
nanA,6747240,6747240,6747152,88,64,utRho17
nanC,9079856,9079856,9079002,854,1720,utRho17
nanR,6749406,6749406,6748978,428,654,utRho17
nanS,9075406,9075406,9075188,218,722,utRho17
napF,4607390,4607390,4606994,396,298,utRho17
narG,2559614,2559728,2559614,114,418,utRho17
narK,2555642,2555914,2555642,272,442,utRho17
narP,4580844,4581000,4580844,156,358,utRho17
narQ,5171154,5171462,5171154,308,158,utRho17
narU,3088326,3088326,3088120,206,94,utRho17
narW,3077374,3077374,3074618,2756,1086,utRho17
narX,2555554,2555554,2555236,318,296,utRho17
narZ,3085380,3085380,3085180,200,76,utRho17
ndh,2331984,2332170,2331984,186,412,utRho17
ndk,5289920,5289920,5289728,192,214,utRho17
nemR,6904084,6904092,6904084,8,668,utRho17
nepI,7683542,7683542,7683478,64,54,utRho17
nfo,4501612,4501680,4501612,68,174,utRho17
nfsB,1210906,1210906,1210848,58,20,utRho17
nfuA,7090916,7091248,7090916,332,698,utRho17
nhaA,34634,34978,34634,344,688,utRho17
nhaB,2469534,2469534,2469434,100,150,utRho17
nhoA,3067926,3068048,3067926,122,134,utRho17
nikA,7226878,7227334,7226878,456,7234,utRho17
nikR,7237074,7237176,7237074,102,682,utRho17
nirB,6987974,6988022,6987974,48,106,utRho17
nlpA,7680034,7680034,7679986,48,0,utRho17
nlpC,3585654,3585654,3585462,192,60,utRho17
nlpD,5737658,5737658,5737506,152,262,utRho17
nlpI,6618080,6618080,6617848,232,64,utRho17
nmpC,1153740,1153740,1153650,90,84,utRho17
nohA,3273206,3273206,3272734,472,468,utRho17
norR,5664614,5664614,5664578,36,0,utRho17
norV,5664878,5664952,5664878,74,2,utRho17
nrdA,4689510,4689730,4689510,220,4588,utRho17
nrdD,8925676,8925676,8925320,356,11460,utRho17
nrdH,5601312,5601446,5601312,134,334,utRho17
nrdR,865954,866004,865954,50,38,utRho17
nrfA,8575342,8575528,8575342,186,68,utRho17
nsrR,8812088,8812380,8812088,292,6688,utRho17
nudB,3897348,3897348,3897264,84,16,utRho17
nudC,8393428,8393806,8393428,378,182,utRho17
nudE,7052658,7052658,7052298,360,1056,utRho17
nudG,3682876,3682980,3682876,104,134,utRho17
nudI,4729050,4729108,4729050,58,34,utRho17
nudJ,2388874,2388874,2388576,298,748,utRho17
nuoA,4810670,4810670,4810144,526,7034,utRho17
nuoN,4783434,4783434,4783010,424,1216,utRho17
nupC,5026018,5026084,5026018,66,0,utRho17
nupG,6211302,6211428,6211302,126,68,utRho17
ogrK,4335096,4335096,4335040,56,14,utRho17
ogt,2800568,2800568,2800472,96,274,utRho17
ohsC,5401036,5401040,5401036,4,78,utRho17
ompA,2040382,2040382,2040106,276,19338,utRho17
ompC,4625774,4625774,4625498,276,218,utRho17
ompF,1974184,1974184,1973964,220,256,utRho17
ompL,8128958,8128958,8128590,368,616,utRho17
ompN,2874158,2874158,2873786,372,0,utRho17
ompR,7073510,7073510,7073168,342,128,utRho17
ompT,1171330,1171330,1171266,64,106,utRho17
ompW,2627982,2628040,2627982,58,0,utRho17
ompX,1700418,1700900,1700418,482,2816,utRho17
omrA,5952378,5952378,5952378,0,0,utRho17
omrB,5952770,5952770,5952770,0,0,utRho17
oppA,2602170,2602364,2602170,194,5678,utRho17
orn,8783168,8783208,8783168,40,2,utRho17
osmB,2686952,2686952,2686656,296,1882,utRho17
osmC,3113192,3113250,3113192,58,486,utRho17
osmE,3644566,3644566,3644512,54,110,utRho17
osmF,4439046,4439046,4438962,84,2308,utRho17
osmY,9222306,9222792,9222306,486,1288,utRho17
otsA,3963302,3963302,3963224,78,296,utRho17
otsB,3964930,3964930,3964774,156,690,utRho17
oxc,4984288,4984288,4983900,388,690,utRho17
oxyR,8316914,8316980,8316914,66,1548,utRho17
oxyS,8316788,8316788,8316788,0,0,utRho17
paaA,2907730,2907854,2907730,124,36,utRho17
paaX,2927018,2927078,2927018,60,0,utRho17
paaZ,2907340,2907340,2907284,56,0,utRho17
pabA,6981702,6981702,6981658,44,122,utRho17
pabB,3789256,3789610,3789256,354,294,utRho17
pabC,2306186,2306600,2306186,414,1410,utRho17
pagP,1313052,1313114,1313052,62,0,utRho17
panB,299260,299260,299202,58,6454,utRho17
panC,297840,297840,297590,250,222,utRho17
panD,293490,293490,293388,102,282,utRho17
panZ,7195656,7195968,7195656,312,564,utRho17
parC,6332060,6332060,6331946,114,762,utRho17
patA,6438916,6438988,6438916,72,46,utRho17
patD,3030830,3031156,3030830,326,116,utRho17
pbpC,5294986,5294986,5294650,336,2,utRho17
pbpG,4450132,4450132,4449740,392,84,utRho17
pck,7065358,7065636,7065358,278,3158,utRho17
pcnB,318782,318782,318252,530,1104,utRho17
pdhR,244068,244184,244068,116,68,utRho17
pdxB,4875768,4875768,4875702,66,10,utRho17
pdxH,3436068,3436068,3436014,54,308,utRho17
pdxJ,5403626,5403626,5403458,168,506,utRho17
pdxK,5074638,5074638,5074474,164,32,utRho17
pepA,8972278,8972278,8971902,376,204,utRho17
pepD,511618,511618,511432,186,3100,utRho17
pepN,1981182,1981244,1981182,62,288,utRho17
pepQ,8062294,8062322,8062294,28,56,utRho17
pepT,2371646,2371688,2371646,42,122,utRho17
pfkA,8214948,8215104,8214948,156,232,utRho17
pfkB,3612646,3612740,3612646,94,0,utRho17
pflA,1902456,1902456,1902160,296,198,utRho17
pflB,1907850,1907850,1907108,742,1710,utRho17
pflD,8287716,8287990,8287716,274,2,utRho17
pgaA,2185046,2185046,2184578,468,220,utRho17
pgi,8467444,8467516,8467444,72,0,utRho17
pgk,12291428,12291428,12290488,940,2576,utRho17
pgl,1597078,1597172,1597078,94,0,utRho17
pgpB,2678324,2678660,2678324,336,476,utRho17
pgpC,5397276,5397276,5397100,176,138,utRho17
pgrR,2783744,2783982,2783744,238,222,utRho17
pheL,5475158,5475198,5475158,40,0,utRho17
pheM,7197204,7197204,7197080,124,20,utRho17
pheP,1203858,1203918,1203858,60,132,utRho17
pheU,8725254,8725254,8725252,2,4,utRho17
pheV,6220730,6220732,6220730,2,22,utRho17
phnC,8650412,8650412,8650330,82,90,utRho17
phoA,803414,803494,803414,80,258,utRho17
phoB,834202,834284,834202,82,92,utRho17
phoE,520316,520316,520200,116,476,utRho17
phoH,2169730,2169984,2169730,254,326,utRho17
phoP,2381016,2381016,2380894,122,1776,utRho17
phoQ,2379880,2379880,2379552,328,872,utRho17
phoU,7815330,7815330,7815156,174,168,utRho17
phr,1478842,1479014,1478842,172,10,utRho17
pinE,2419054,2419370,2419054,316,606,utRho17
pinQ,3267168,3267244,3267168,76,390,utRho17
pinR,2867424,2867424,2867348,76,240,utRho17
pitA,7275224,7275284,7275224,60,44,utRho17
pitB,6272806,6272806,6272742,64,224,utRho17
pka,5439862,5439906,5439862,44,270,utRho17
plaP,4174476,4174476,4174124,352,202,utRho17
pldA,8009628,8009724,8009628,96,1108,utRho17
pldB,8018028,8018340,8018028,312,2860,utRho17
plsB,8513196,8513196,8512932,264,218,utRho17
pmbA,8915890,8915918,8915890,28,40,utRho17
pmrD,4747148,4747148,4747076,72,34,utRho17
pncB,1980828,1980828,1980712,116,0,utRho17
pncC,5648788,5648788,5648692,96,0,utRho17
pnp,6622652,6622652,6622336,316,54,utRho17
pntA,3355950,3355950,3355806,144,0,utRho17
pntB,3353096,3353096,3352720,376,400,utRho17
polA,8093880,8093932,8093880,52,474,utRho17
polB,131606,131606,131560,46,0,utRho17
potD,2365700,2365700,2365658,42,76,utRho17
potE,1436688,1436688,1436530,158,72,utRho17
potF,1787268,1787568,1787268,300,548,utRho17
poxB,1822152,1822152,1822098,54,434,utRho17
ppa,8899372,8899372,8899304,68,124,utRho17
ppc,8306380,8306380,8306196,184,660,utRho17
ppdA,5928440,5928440,5928354,86,3056,utRho17
ppdD,235410,235410,235098,312,740,utRho17
pphA,3846770,3846770,3845938,832,5048,utRho17
pphB,5719474,5719520,5719474,46,228,utRho17
ppiA,6984898,6984898,6984594,304,176,utRho17
ppiC,7919682,7919682,7919626,56,46,utRho17
ppiD,923638,923830,923638,192,36,utRho17
ppk,5245748,5246088,5245748,340,466,utRho17
pppA,6228958,6228958,6228704,254,48,utRho17
ppsA,3574322,3574322,3574224,98,98,utRho17
ppsR,3574678,3574890,3574678,212,38,utRho17
pptA,3065716,3066104,3065716,388,564,utRho17
pqiA,2023318,2024002,2023318,684,62,utRho17
prc,3830054,3830054,3829632,422,9322,utRho17
preT,4467978,4468066,4467978,88,1554,utRho17
prfC,9218688,9218828,9218688,140,1580,utRho17
prkB,6968622,6968980,6968622,358,2240,utRho17
prlC,7290476,7290476,7290364,112,306,utRho17
prlF,6553944,6554004,6553944,60,718,utRho17
proB,520432,520776,520432,344,1338,utRho17
proC,811372,811372,811288,84,66,utRho17
proK,7417388,7417388,7417384,4,62,utRho17
proL,4572414,4572422,4572414,8,44,utRho17
proP,8660640,8661004,8660640,364,324,utRho17
proS,437674,437674,437550,124,1148,utRho17
proV,5609126,5609630,5609126,504,1214,utRho17
prpB,697292,697364,697292,72,42,utRho17
prpR,696942,696942,696886,56,10,utRho17
prs,2524354,2524354,2523750,604,35616,utRho17
psd,8781276,8781276,8780720,556,848,utRho17
psiE,8480600,8480650,8480600,50,0,utRho17
pspA,2736076,2736158,2736076,82,0,utRho17
pspF,2736080,2736080,2735824,256,0,utRho17
pspG,8525632,8525680,8525632,48,0,utRho17
pssA,5445156,5445454,5445156,298,4504,utRho17
pstB,7817112,7817112,7816732,380,166,utRho17
pstC,7821084,7821084,7820796,288,158,utRho17
pstS,23469408,23469408,23469150,258,390,utRho17
psuG,4517114,4517114,4516734,380,6614,utRho17
psuT,4514992,4514992,4514670,322,196,utRho17
pth,2517084,2517084,2517026,58,40,utRho17
ptrA,5918022,5918022,5917768,254,0,utRho17
ptrB,3857730,3857730,3857678,52,2816,utRho17
ptsG,2315252,2315738,2315252,486,2872,utRho17
ptsH,5066996,5067528,5066996,532,3274,utRho17
purA,8809328,8809374,8809328,46,0,utRho17
purC,5195562,5195562,5195236,326,32,utRho17
purD,8411972,8411972,8411862,110,420,utRho17
purE,1106284,1106284,1106200,84,802,utRho17
purH,8415254,8415254,8415064,190,166,utRho17
purL,5391178,5391178,5391086,92,492,utRho17
purM,5242306,5242394,5242306,88,134,utRho17
purR,3475378,3475688,3475378,310,260,utRho17
purT,3861438,3861762,3861438,324,54,utRho17
purU,2577512,2577512,2577248,264,302,utRho17
putA,2157850,2157850,2157764,86,0,utRho17
putP,2158336,2158610,2158336,274,646,utRho17
puuA,2721936,2721936,2721816,120,0,utRho17
puuC,2725456,2725486,2725456,30,0,utRho17
puuD,2722104,2722240,2722104,136,82,utRho17
puuP,2718746,2718746,2718374,372,1278,utRho17
pykA,3874988,3875298,3874988,310,286,utRho17
pykF,3510934,3511396,3510934,462,984,utRho17
pyrC,2245286,2245286,2245214,72,58,utRho17
pyrD,2009464,2009536,2009464,72,336,utRho17
pyrE,7631970,7631970,7631536,434,602,utRho17
pyrF,2683740,2683842,2683740,102,140,utRho17
pyrG,5819594,5819594,5819332,262,1690,utRho17
pyrH,383624,383710,383624,86,952,utRho17
pyrL,8945490,8945490,8945066,424,882,utRho17
qmcA,1031646,1031646,1031546,100,266,utRho17
qor,8528608,8528608,8528462,146,554,utRho17
qseB,6339502,6339656,6339502,154,410,utRho17
queA,849970,850022,849970,52,302,utRho17
queE,5811212,5811212,5810836,376,362,utRho17
queF,5850642,5850696,5850642,54,14,utRho17
queG,8788184,8788184,8788134,50,50836,utRho17
racC,2835630,2835630,2835526,104,30,utRho17
racR,2840898,2840898,2840482,416,318,utRho17
raiA,5474208,5474308,5474208,100,98,utRho17
rarD,8008594,8008594,8008356,238,366,utRho17
ravA,7862256,7862256,7862186,70,42,utRho17
rayT,495088,495274,495088,186,624,utRho17
rbn,4763162,4763216,4763162,54,0,utRho17
rbsD,7866644,7866702,7866644,58,0,utRho17
rcnA,4371654,4371834,4371654,180,226,utRho17
rcnB,4373768,4373920,4373768,152,208,utRho17
rcnR,4371806,4371806,4371592,214,342,utRho17
rcsA,4047672,4047936,4047672,264,2632,utRho17
rcsB,4631390,4632354,4631390,964,704,utRho17
rcsC,4640162,4640162,4639656,506,186,utRho17
rcsD,4626904,4626976,4626904,72,420,utRho17
rdgB,6193240,6193362,6193240,122,494,utRho17
rdlA,2538646,2538646,2538646,0,0,utRho17
rdlB,2539712,2539716,2539712,4,20,utRho17
rdlC,2540782,2540786,2540782,4,0,utRho17
rdlD,7400272,7400272,7400272,0,0,utRho17
rdoA,8084782,8084830,8084782,48,18,utRho17
recA,11295276,11295276,11295076,200,620,utRho17
recC,5925014,5925014,5924856,158,0,utRho17
recF,7763722,7763722,7762442,1280,8146,utRho17
recN,5503518,5503590,5503518,72,0,utRho17
recQ,8011666,8011728,8011666,62,104,utRho17
relA,5828554,5828554,5827302,1252,1228,utRho17
relB,3291806,3291806,3291744,62,82,utRho17
rem,3289950,3289950,3289804,146,66,utRho17
rep,7921294,7921354,7921294,60,108,utRho17
rfaD,7587730,7587974,7587730,244,366,utRho17
rfaE,6393852,6393852,6393506,346,184,utRho17
rfaH,8049930,8049930,8049642,288,2298,utRho17
rfbX,4219436,4219436,4219168,268,770,utRho17
rfe,7935600,7935832,7935600,232,60,utRho17
rhaB,8194944,8194944,8194896,48,0,utRho17
rhaD,8188770,8188770,8188544,226,0,utRho17
rhaS,8195422,8195472,8195422,50,0,utRho17
rhaT,8201132,8201132,8201050,82,168,utRho17
rhlE,1661566,1661744,1661566,178,258,utRho17
rhoL,47593944,47594772,47593944,828,74772,utRho17
rhsB,7238006,7238384,7238006,378,1694,utRho17
rhsC,1458758,1459166,1458758,408,0,utRho17
rhsD,1046132,1046522,1046132,390,0,utRho17
rhtA,1700608,1700608,1700194,414,256,utRho17
rhtC,8015478,8015514,8015478,36,1148,utRho17
ribA,2678468,2678468,2678320,148,462,utRho17
ribC,3486916,3486916,3486484,432,3552,utRho17
ribE,869008,869294,869008,286,3720,utRho17
ribF,42766,42814,42766,48,0,utRho17
ridA,8941892,8941892,8941826,66,252,utRho17
rihA,1369204,1369204,1368824,380,5316,utRho17
rihB,4510504,4510504,4510372,132,274,utRho17
rimJ,2251044,2251124,2251044,80,92,utRho17
rimK,1783752,1783934,1783752,182,622,utRho17
rimL,2997486,2997876,2997486,390,290,utRho17
rimO,1756140,1756140,1756070,70,98,utRho17
rimP,6636350,6636350,6636012,338,474,utRho17
rlmA,3814172,3814172,3814120,52,1290,utRho17
rlmD,5830086,5830086,5830000,86,74,utRho17
rlmE,6655520,6655520,6655328,192,1124,utRho17
rlmF,1684384,1684664,1684384,280,296,utRho17
rlmG,6471784,6471784,6471750,34,48,utRho17
rlmI,2060002,2060002,2059938,64,350,utRho17
rlmJ,7290700,7290770,7290700,70,0,utRho17
rlmL,2015344,2015688,2015344,344,1488,utRho17
rlpA,1330444,1330444,1330380,64,178,utRho17
rluA,120900,120900,120692,208,744,utRho17
rluF,8460324,8460708,8460324,384,210,utRho17
rmf,2031006,2031430,2031006,424,1216,utRho17
rna,1290068,1290068,1290006,62,6,utRho17
rnb,2698258,2698258,2697824,434,4840,utRho17
rnc,10816892,10816892,10816252,640,6576,utRho17
rnd,3776122,3776122,3775982,140,72,utRho17
rne,2289746,2289746,2288734,1012,4794,utRho17
rnhA,472082,472082,472004,78,648,utRho17
rnk,1288360,1288360,1287934,426,0,utRho17
rnlA,5531788,5531836,5531788,48,1084,utRho17
rnlB,5533414,5533968,5533414,554,1176,utRho17
rnpB,19623552,19623552,19623552,0,0,utRho17
rob,9270706,9270706,9270620,86,12,utRho17
rodZ,5285868,5285868,5285688,180,72,utRho17
rpe,7030306,7030306,7030118,188,300,utRho17
rph,15266320,15266320,15266196,124,192,utRho17
rpiA,6118706,6118706,6118650,56,1464,utRho17
rpiB,8626514,8626700,8626514,186,366,utRho17
rpiR,8626274,8626274,8625982,292,0,utRho17
rplJ,8359246,8359992,8359246,746,6730,utRho17
rplK,8356708,8356894,8356708,186,492,utRho17
rplM,6757344,6757344,6757302,42,6786,utRho17
rplN,6896444,6896444,6896298,146,9506,utRho17
rplS,5489284,5489284,5489060,224,5386,utRho17
rplT,7199052,7199052,7198996,56,596,utRho17
rplU,6667036,6667036,6666902,134,214,utRho17
rplY,4564866,4565034,4564866,168,252,utRho17
rpmA,6666450,6666450,6666238,212,1352,utRho17
rpmB,15247980,15247980,15246696,1284,42296,utRho17
rpmE,8253816,8254026,8253816,210,950,utRho17
rpmF,2294676,2294734,2294676,58,12308,utRho17
rpmH,7768130,7768672,7768130,542,3526,utRho17
rpmI,3600854,3600854,3599998,856,11952,utRho17
rpoB,8362126,8362490,8362126,364,342,utRho17
rpoD,6424946,6426094,6424946,1148,28604,utRho17
rpoE,5420372,5420372,5420024,348,174,utRho17
rpoH,7202006,7202006,7201566,440,3720,utRho17
rpoN,6689324,6689434,6689324,110,62,utRho17
rpoS,5736236,5736236,5735102,1134,2944,utRho17
rpoZ,7644154,7644212,7644154,58,238,utRho17
rppH,5937986,5937986,5937954,32,0,utRho17
rprA,3540744,3540744,3540744,0,0,utRho17
rpsA,1923434,1923990,1923434,556,96734,utRho17
rpsF,8850050,8850236,8850050,186,19820,utRho17
rpsI,6756580,6756580,6756414,166,6960,utRho17
rpsJ,6906884,6906884,6906540,344,7162,utRho17
rpsL,6949242,6949242,6949104,138,1182,utRho17
rpsM,6885130,6885130,6884942,188,1106,utRho17
rpsO,13247144,13247144,13246736,408,1596,utRho17
rpsP,5492508,5492508,5492370,138,192,utRho17
rpsT,42420,42420,42156,264,270,utRho17
rpsU,12842584,12843124,12842584,540,3276,utRho17
rraA,8238716,8238716,8238660,56,112,utRho17
rraB,8956768,8956946,8956768,178,254,utRho17
rrsA,8070478,8071062,8070478,584,7482,utRho17
rrsB,16665468,16666636,16665468,1168,15352,utRho17
rrsC,7883032,7883616,7883032,584,8660,utRho17
rrsD,6858094,6858094,6857524,570,964,utRho17
rrsE,8415726,8416294,8415726,568,1018,utRho17
rrsG,5462896,5462896,5462314,582,6640,utRho17
rrsH,446970,447542,446970,572,1350,utRho17
rsd,8393908,8393908,8393616,292,312,utRho17
rseA,5419264,5419264,5418808,456,720,utRho17
rseP,392940,393092,392940,152,0,utRho17
rseX,4067298,4067298,4067298,0,0,utRho17
rsfS,1338144,1338144,1338072,72,366,utRho17
rsgA,8783132,8783132,8783018,114,48,utRho17
rsmA,105176,105176,104860,316,1480,utRho17
rsmB,6869982,6870414,6869982,432,192,utRho17
rsmC,9215736,9215736,9215400,336,268,utRho17
rsmD,7208594,7208786,7208594,192,156,utRho17
rsmE,6182036,6182268,6182036,232,572,utRho17
rsmG,7847512,7847512,7847360,152,2874,utRho17
rsmH,180020,180188,180020,168,430,utRho17
rsmI,6587106,6587106,6586670,436,870,utRho17
rssA,2578212,2578412,2578212,200,540,utRho17
rssB,2580440,2580484,2580440,44,174,utRho17
rstA,3364276,3364300,3364276,24,0,utRho17
rsuA,4561096,4561096,4560966,130,286,utRho17
rsxA,3411510,3411534,3411510,24,0,utRho17
rtcA,7114004,7114004,7113698,306,1242,utRho17
rtcB,7116214,7116214,7116158,56,190,utRho17
rtn,4541356,4541452,4541356,96,72,utRho17
rutA,2148052,2148052,2148022,30,98,utRho17
rutG,2140090,2140090,2139678,412,72,utRho17
rutR,2148226,2148484,2148226,258,866,utRho17
ruvA,7784096,7784096,7783904,192,112,utRho17
ruvB,7782176,7782176,7781424,752,844,utRho17
ruvC,3894878,3894878,3894752,126,0,utRho17
rybB,1776114,1776114,1776114,0,0,utRho17
rydB,3529860,3529860,3529322,538,250,utRho17
rydC,2983012,2983012,2983012,0,0,utRho17
ryfA,5307398,5307710,5307398,312,28,utRho17
ryfD,5468590,5468590,5468590,0,0,utRho17
ryhB,7162032,7162032,7162032,0,0,utRho17
ryjA,8556132,8556132,8556132,0,0,utRho17
ryjB,9055954,9055954,9055954,0,0,utRho17
sad,3229598,3229598,3229406,192,424,utRho17
safA,3168056,3168056,3167918,138,882,utRho17
sanA,4465368,4465756,4465368,388,30,utRho17
sapF,2705314,2705314,2705268,46,252,utRho17
sbcB,4165456,4165512,4165456,56,0,utRho17
sbcC,831694,831694,831506,188,84,utRho17
sbcD,833954,833954,833904,50,92,utRho17
sbmA,793106,793278,793106,172,1274,utRho17
sbmC,4162650,4162650,4162524,126,0,utRho17
sdaA,3793618,3793864,3793618,246,46,utRho17
sdaC,5856070,5856458,5856070,388,2852,utRho17
sdhC,1509916,1510354,1509916,438,37598,utRho17
sdhD,1510808,1511120,1510808,312,7706,utRho17
sdiA,3993834,3993834,3993664,170,180,utRho17
secE,8354354,8354716,8354354,362,186,utRho17
secG,6645180,6645180,6645010,170,1422,utRho17
selA,7522594,7522594,7522498,96,1254,utRho17
selB,7519850,7519850,7519722,128,564,utRho17
selC,7672396,7672444,7672396,48,652,utRho17
selD,3696058,3696058,3696016,42,1274,utRho17
seqA,1425884,1425974,1425884,90,348,utRho17
serA,6117098,6117098,6116820,278,760,utRho17
serB,9249712,9249790,9249712,78,292,utRho17
serC,3830380,3830612,3830380,232,0,utRho17
serS,1878730,1878856,1878730,126,1294,utRho17
serT,2063438,2063438,2063424,14,0,utRho17
serU,4087124,4087124,4087114,10,86,utRho17
serV,5637394,5637394,5637290,104,150,utRho17
serW,1852014,1852014,1851942,72,178,utRho17
serX,2195352,2195352,2195304,48,26,utRho17
setB,4527426,4527726,4527426,300,100,utRho17
setC,7673488,7673906,7673488,418,2110,utRho17
sfmA,1116124,1116424,1116124,300,46,utRho17
sfmC,1117606,1117948,1117606,342,154,utRho17
sfsA,323030,323030,322972,58,286,utRho17
sfsB,6669592,6669818,6669592,226,998,utRho17
sgrR,154676,154676,154598,78,94,utRho17
sgrS,154734,154734,154734,0,0,utRho17
shiA,4107068,4107286,4107068,218,340,utRho17
sibA,4306622,4306622,4306622,0,0,utRho17
sibB,4307292,4307292,4307292,0,0,utRho17
sibC,6113702,6113702,6113702,0,0,utRho17
sibD,6389730,6389730,6389730,0,0,utRho17
sibE,6390480,6390480,6390480,0,0,utRho17
sixA,4913998,4913998,4913624,374,50,utRho17
slp,7307872,7307922,7307872,50,238,utRho17
slt,9261400,9261466,9261400,66,110,utRho17
slyA,3442028,3442028,3441648,380,258,utRho17
slyB,3439496,3439752,3439496,256,6,utRho17
slyD,6957398,6957398,6956994,404,804,utRho17
slyX,6954862,6955280,6954862,418,4120,utRho17
smf,6867372,6867372,6867120,252,416,utRho17
smpB,5509534,5509792,5509534,258,650,utRho17
smrA,2811872,2811958,2811872,86,684,utRho17
smrB,4896872,4897212,4896872,340,1098,utRho17
smtA,1946808,1947074,1946808,266,76,utRho17
sodA,8201518,8201620,8201518,102,2360,utRho17
sodB,3470646,3470756,3470646,110,1298,utRho17
sodC,3449358,3449358,3449310,48,188,utRho17
sohB,2658568,2658664,2658568,96,458,utRho17
sokB,2984232,2984238,2984232,6,106,utRho17
solA,2241218,2241218,2241172,46,0,utRho17
soxR,8554894,8554938,8554894,44,54,utRho17
soxS,8554846,8554846,8554766,80,0,utRho17
speA,6172096,6172096,6171822,274,378,utRho17
speB,6167892,6167892,6167594,298,778,utRho17
speC,6218350,6218350,6218310,40,124,utRho17
spf,8099798,8099798,8099798,0,0,utRho17
sppA,3697422,3697674,3697422,252,506,utRho17
spy,3651376,3651376,3651250,126,0,utRho17
sra,3112092,3112092,3111926,166,0,utRho17
sraB,2293178,2293178,2293178,0,0,utRho17
sraC,3846132,3846132,3846132,0,0,utRho17
srlA,5651582,5651664,5651582,82,28,utRho17
srlR,5657720,5658094,5657720,374,1778,utRho17
srmB,5425752,5425792,5425752,40,108,utRho17
sroA,151216,151216,151216,0,0,utRho17
sroG,6369436,6369436,6369436,0,0,utRho17
sroH,8380974,8380974,8380974,0,0,utRho17
ssb,8548022,8548250,8548022,228,144,utRho17
sseA,5304782,5304988,5304782,206,5418,utRho17
sspA,6755138,6755138,6754840,298,316,utRho17
ssrA,5511014,5511186,5511014,172,324,utRho17
ssrS,12223036,12223932,12223036,896,8012,utRho17
sstT,6479726,6479888,6479726,162,76,utRho17
ssuB,1988282,1988282,1988088,194,134,utRho17
ssuE,1995126,1995126,1995024,102,2,utRho17
sthA,8321604,8321604,8321580,24,1182,utRho17
stpA,5597156,5597156,5596990,166,72,utRho17
sucA,3034344,3034824,3034344,480,5536,utRho17
sufA,3528836,3528836,3528772,64,98,utRho17
sufE,3518962,3518962,3518580,382,18,utRho17
sugE,8753588,8753750,8753588,162,1778,utRho17
sulA,2041894,2041894,2041838,56,1694,utRho17
syd,5850738,5850738,5850560,178,14,utRho17
symE,9159834,9159834,9159680,154,770,utRho17
symR,9159670,9159670,9159670,0,0,utRho17
tabA,8949566,8949724,8949566,158,0,utRho17
talA,5157140,5157332,5157140,192,4,utRho17
talB,16382,16476,16382,94,5094,utRho17
tam,3214442,3214692,3214442,250,78,utRho17
tamA,8884540,8884764,8884540,224,502,utRho17
tar,3945432,3945432,3945382,50,32,utRho17
tas,5943138,5943194,5943138,56,2852,utRho17
tatA,16087636,16087780,16087636,144,136,utRho17
tatE,1317742,1317894,1317742,152,46,utRho17
tauA,770410,770464,770410,54,8,utRho17
tdcA,6534186,6534186,6534130,56,54,utRho17
tdcG,6519652,6519652,6519298,354,1268,utRho17
tdcR,6534380,6534760,6534380,380,220,utRho17
tdk,2586986,2587054,2586986,68,30,utRho17
tehA,3001072,3001146,3001072,74,0,utRho17
tesA,1039898,1039898,1039530,368,236,utRho17
tesB,950402,950402,950322,80,0,utRho17
tfaE,2418532,2418532,2418238,294,812,utRho17
tfaQ,3269912,3269912,3269770,142,822,utRho17
tff,379424,379256,379424,168,140,utRho17
tgt,852110,852274,852110,164,8,utRho17
thiD,4369346,4369346,4369032,314,140,utRho17
thiI,882936,883098,882936,162,0,utRho17
thiM,4370902,4370902,4370602,300,700,utRho17
thiQ,146170,146170,145854,316,2736,utRho17
thrL,592,760,592,168,4,utRho17
thrS,7210932,7210932,7210280,652,532,utRho17
thrU,8350762,8350776,8350762,14,0,utRho17
thrV,6847414,6847414,6847310,104,276378,utRho17
thrW,525682,525742,525682,60,1810,utRho17
thyA,5930696,5930696,5930310,386,2402,utRho17
tig,909986,910266,909986,280,856,utRho17
tisB,7706674,7707106,7706674,432,1182,utRho17
tktA,6163414,6163414,6163270,144,58,utRho17
tktB,5158616,5159272,5158616,656,3068,utRho17
tldD,6784368,6784368,6784056,312,88,utRho17
tmcA,5191876,5191876,5191718,158,186,utRho17
tnaC,15553644,15553740,15553644,96,3272,utRho17
tolB,1555074,1555480,1555074,406,200,utRho17
tolC,6356008,6356230,6356008,222,614,utRho17
tomB,961588,961588,961416,172,2152,utRho17
tonB,2622108,2622178,2622108,70,14,utRho17
topA,2661578,2662096,2661578,518,174,utRho17
torC,2116112,2116168,2116112,56,404,utRho17
torR,2115968,2115968,2115908,60,258,utRho17
torS,2112364,2112364,2112356,8,0,utRho17
torT,2112414,2112522,2112414,108,64,utRho17
tpiA,8223138,8223138,8223014,124,412,utRho17
tppB,3425342,3425538,3425342,196,4540,utRho17
tpr,2574376,2574376,2574376,0,0,utRho17
tpx,2777688,2777688,2777622,66,388,utRho17
tqsA,3347780,3347826,3347780,46,142,utRho17
treA,2494850,2494850,2494752,98,1164,utRho17
treB,8932420,8932420,8932360,60,96,utRho17
treF,7339102,7339184,7339102,82,230,utRho17
treR,8934694,8934694,8934492,202,0,utRho17
trg,2984878,2984940,2984878,62,32,utRho17
trkG,2847342,2847564,2847342,222,460,utRho17
trmA,8326590,8326590,8326540,50,128,utRho17
trpA,2634678,2634678,2634444,234,454,utRho17
trpC,2639888,2639888,2639570,318,108,utRho17
trpL,5292432,5292432,5292328,104,0,utRho17
trpR,9265408,9265520,9265408,112,276,utRho17
trpS,7027394,7027394,7027276,118,1708,utRho17
trpT,7893560,7893914,7893560,354,183832,utRho17
trxA,7931294,7931522,7931294,228,708,utRho17
trxB,1864156,1864156,1864100,56,200,utRho17
trxC,5437350,5437470,5437350,120,222,utRho17
tsaD,6421256,6421256,6421086,170,28,utRho17
tsgA,6985038,6985136,6985038,98,152,utRho17
tsr,9182824,9183314,9182824,490,2984,utRho17
tsx,864490,864490,864026,464,620,utRho17
ttcA,2823970,2823970,2823896,74,3658,utRho17
ttdA,6412848,6412926,6412848,78,230,utRho17
ttdR,6412760,6412760,6412512,248,482,utRho17
tufA,6943448,6943448,6942658,790,169760,utRho17
tus,3368346,3368518,3368346,172,152,utRho17
tusA,7218040,7218040,7217992,48,282,utRho17
tusB,6950218,6950218,6949930,288,652,utRho17
tynA,2902996,2902996,2902698,298,0,utRho17
typA,8116460,8116814,8116460,354,6242,utRho17
tyrB,8534164,8534228,8534164,64,2620,utRho17
tyrP,3979004,3979362,3979004,358,760,utRho17
tyrR,2773384,2773440,2773384,56,54,utRho17
tyrS,3434566,3434566,3434444,122,0,utRho17
tyrT,2575330,2575330,2575244,86,378,utRho17
uacT,6062378,6062734,6062378,356,842,utRho17
ubiC,8504886,8505012,8504886,126,120,utRho17
ubiD,8049618,8049976,8049618,358,2532,utRho17
ubiE,8037494,8037710,8037494,216,258,utRho17
ubiG,4679078,4679134,4679078,56,14,utRho17
ucpA,5089342,5089342,5089246,96,0,utRho17
udp,8032782,8032862,8032782,80,34,utRho17
ugd,4199470,4199470,4199226,244,4,utRho17
ugpB,7184852,7184852,7184650,202,1964,utRho17
ugpQ,7176600,7176600,7176226,374,396,utRho17
uhpT,7694396,7694396,7694334,62,270,utRho17
uidA,3392304,3392304,3392142,162,68,utRho17
uidC,3386012,3386012,3385702,310,42,utRho17
uidR,3394150,3394150,3394104,46,88,utRho17
ulaA,8839854,8839960,8839854,106,178,utRho17
ulaG,8839350,8839350,8839250,100,114,utRho17
ulaR,8837124,8837124,8836906,218,0,utRho17
umpG,5741372,5741372,5740548,824,138,utRho17
umpH,1400704,1400704,1400652,52,168,utRho17
umuD,2461476,2461534,2461476,58,0,utRho17
ung,5433476,5433508,5433476,32,32,utRho17
uof,2843316,2843316,2842900,416,4156,utRho17
upp,5241818,5241818,5241744,74,578,utRho17
usg,4873780,4873780,4873298,482,456,utRho17
ushA,1009772,1009828,1009772,56,148,utRho17
uspA,7279966,7280222,7279966,256,600,utRho17
uspB,7279696,7279696,7279440,256,334,utRho17
uspC,3959172,3959506,3959172,334,40,utRho17
uspE,2797318,2797318,2797244,74,52,utRho17
uspF,2871282,2871282,2871238,44,6,utRho17
uspG,1283806,1283806,1283734,72,1200,utRho17
uvrA,8547872,8547872,8547742,130,514,utRho17
uvrB,1626304,1627052,1626304,748,2168,utRho17
uvrC,3989758,3989758,3989412,346,120,utRho17
uvrD,7995814,7995966,7995814,152,610,utRho17
uvrY,3990812,3990812,3990718,94,32,utRho17
uxaB,3221474,3221474,3221360,114,0,utRho17
uxaC,6489714,6489714,6489482,232,148,utRho17
uxuA,9103036,9103272,9103036,236,1456,utRho17
uxuR,9108916,9109152,9108916,236,682,utRho17
valS,8967854,8967854,8967674,180,378,utRho17
valU,5041848,5041862,5041848,14,6,utRho17
valV,3492830,3492870,3492830,40,82,utRho17
ves,3649968,3649968,3649874,94,0,utRho17
waaA,7616512,7617080,7616512,568,1086,utRho17
waaH,7580298,7580298,7580162,136,112,utRho17
waaQ,7616476,7616476,7616196,280,182,utRho17
waaU,7598996,7598996,7598624,372,298,utRho17
waaY,7602272,7602272,7601930,342,3898,utRho17
wbbH,4214888,4214888,4214452,436,826,utRho17
wbbK,4209212,4209212,4209018,194,0,utRho17
wcaM,4231868,4231868,4231792,76,138,utRho17
wrbA,2135516,2135516,2135416,100,232,utRho17
wza,4275166,4275166,4274486,680,16,utRho17
wzxC,4240674,4240674,4240316,358,12,utRho17
wzzB,4196950,4196950,4196602,348,100,utRho17
xanP,7657642,7657890,7657642,248,262,utRho17
xanQ,6048520,6048702,6048520,182,14,utRho17
xapA,5049820,5049820,5049756,64,146,utRho17
xapR,10090252,10090252,10089908,344,180,utRho17
xdhA,6000514,6000690,6000514,176,818,utRho17
xerD,6079702,6079702,6079486,216,88,utRho17
xseA,5268394,5268464,5268394,70,78,utRho17
xseB,882746,882746,882686,60,188,utRho17
xthA,3664798,3664856,3664798,58,92,utRho17
xylA,7461614,7461614,7461530,84,8678,utRho17
xylE,8484540,8484540,8484508,32,0,utRho17
xylF,7462138,7462262,7462138,124,416,utRho17
xylR,7469812,7469958,7469812,146,164,utRho17
yaaA,13230,13230,12918,312,202,utRho17
yaaI,23876,23876,23572,304,540,utRho17
yaaJ,16034,16034,15918,116,174,utRho17
yaaU,91184,91614,91184,430,342,utRho17
yaaW,23084,23084,22712,372,644,utRho17
yaaX,10060,10468,10060,408,216,utRho17
yabI,142542,142702,142542,160,798,utRho17
yacC,273880,273880,273834,46,1898,utRho17
yacH,262932,262932,262520,412,84,utRho17
yacL,268678,268776,268678,98,746,utRho17
yadD,293796,293936,293796,140,290,utRho17
yadE,289930,290162,289930,232,166,utRho17
yadN,314110,314110,313766,344,352,utRho17
yadS,355572,355572,355248,324,4486,utRho17
yadV,312470,312470,312402,68,732,utRho17
yaeF,434270,434270,434006,264,166,utRho17
yaeP,428374,428374,428250,124,686,utRho17
yaeQ,428176,428582,428176,406,1180,utRho17
yaeR,423716,423754,423716,38,70,utRho17
yafC,462166,462166,461762,404,274,utRho17
yafD,462128,462244,462128,116,204,utRho17
yafK,491986,491986,491610,376,1814,utRho17
yafL,493282,493424,493282,142,86,utRho17
yafN,503938,504010,503938,72,158,utRho17
yafS,469568,469632,469568,64,384,utRho17
yafT,474470,474670,474470,200,160,utRho17
yafV,480432,480432,480378,54,128,utRho17
yafZ,536052,536052,536010,42,612,utRho17
yagE,564446,564556,564446,110,540,utRho17
yagG,570414,570790,570414,376,628,utRho17
yagI,578384,578384,578324,60,236,utRho17
yagK,586236,586236,585896,340,3710,utRho17
yagL,588062,588062,587836,226,1134,utRho17
yagN,591342,591342,591158,184,262,utRho17
yahA,663746,664742,663746,996,3934,utRho17
yahC,670136,670136,670044,92,1928,utRho17
yahE,671478,671850,671478,372,512,utRho17
yahM,690504,690808,690504,304,432,utRho17
yahN,692872,692872,692674,198,1558,utRho17
yahO,692864,692968,692864,104,458,utRho17
yaiE,816296,816354,816296,58,98,utRho17
yaiI,811396,811528,811396,132,28,utRho17
yaiO,761946,761946,761684,262,270,utRho17
yaiP,767970,767970,767870,100,62,utRho17
yaiS,769660,769660,769232,428,286,utRho17
yaiV,788922,788922,788922,0,0,utRho17
yaiY,799094,799094,798666,428,390,utRho17
yaiZ,798888,799186,798888,298,642,utRho17
yajC,854410,854574,854410,164,726,utRho17
yajD,860938,861210,860938,272,566,utRho17
yajI,866068,866068,865702,366,126,utRho17
yajL,887496,887496,887282,214,516,utRho17
yajQ,889316,889366,889316,50,14,utRho17
yajR,893374,893374,893332,42,572,utRho17
ybaB,987418,988152,987418,734,3074,utRho17
ybaL,1006590,1006590,1006476,114,238,utRho17
ybaM,980648,980648,980542,106,996,utRho17
ybaN,981436,981764,981436,328,428,utRho17
ybaO,936704,936766,936704,62,0,utRho17
ybaP,1016568,1016568,1016160,408,1106,utRho17
ybaQ,1016348,1016436,1016348,88,212,utRho17
ybaS,1023146,1023282,1023146,136,632,utRho17
ybaV,927504,927874,927504,370,0,utRho17
ybaY,950490,950758,950490,268,182,utRho17
ybbB,1062724,1062724,1062452,272,26,utRho17
ybbJ,1030154,1030154,1029718,436,2236,utRho17
ybbL,1031784,1031838,1031784,54,66,utRho17
ybbN,1037136,1037136,1036558,578,1180,utRho17
ybbO,1038658,1038658,1038298,360,698,utRho17
ybbY,1080718,1081130,1080718,412,384,utRho17
ybcH,1176140,1176140,1175962,178,252,utRho17
ybcI,1113264,1113264,1113106,158,2372,utRho17
ybcJ,1114050,1114050,1113746,304,460,utRho17
ybcK,1137502,1137804,1137502,302,632,utRho17
ybcL,1141690,1141786,1141690,96,148,utRho17
ybcN,1144628,1144932,1144628,304,516,utRho17
ybcQ,1147548,1147912,1147548,364,2388,utRho17
ybcW,1159610,1159760,1159610,150,20,utRho17
ybdD,1263982,1264364,1263982,382,506,utRho17
ybdF,1212106,1212106,1211772,334,322,utRho17
ybdH,1267048,1267048,1266954,94,230,utRho17
ybdJ,1212822,1212822,1212398,424,502,utRho17
ybdK,1215122,1215122,1214766,356,2112,utRho17
ybdL,1267114,1267172,1267114,58,176,utRho17
ybdM,1271110,1271110,1270752,358,626,utRho17
ybdN,1273372,1273372,1273138,234,26,utRho17
ybdR,1283844,1284176,1283844,332,1306,utRho17
ybeD,1325412,1325412,1325284,128,248,utRho17
ybeF,1323090,1323090,1322756,334,384,utRho17
ybeL,1349986,1350036,1349986,50,100,utRho17
ybeQ,1353412,1353412,1353094,318,94,utRho17
ybeR,1353120,1353422,1353120,302,88,utRho17
ybeT,1358832,1358832,1358812,20,2,utRho17
ybeU,1358924,1359016,1358924,92,64,utRho17
ybeZ,1386938,1386938,1386834,104,4076,utRho17
ybfA,1458074,1458268,1458074,194,190,utRho17
ybfE,1423878,1423878,1423796,82,384,utRho17
ybfF,1425692,1425692,1425604,88,248,utRho17
ybfH,1433282,1433282,1433194,88,138,utRho17
ybgA,1477840,1478002,1477840,162,42,utRho17
ybgC,1549288,1549504,1549288,216,60,utRho17
ybgD,1505916,1505916,1505590,326,8010,utRho17
ybgI,1485238,1485654,1485238,416,68,utRho17
ybgO,1498370,1498370,1497964,406,556,utRho17
ybgS,1570992,1570992,1570634,358,0,utRho17
ybhA,1597184,1597184,1596862,322,40,utRho17
ybhB,1616070,1616070,1615818,252,478,utRho17
ybhC,1614642,1614642,1614562,80,1002,utRho17
ybhD,1601418,1601418,1601276,142,84,utRho17
ybhH,1601104,1601518,1601104,414,248,utRho17
ybhK,1633384,1633384,1633294,90,430,utRho17
ybhM,1641556,1641586,1641556,30,52,utRho17
ybhN,1645296,1645296,1644996,300,304,utRho17
ybhQ,1649202,1649260,1649202,58,652,utRho17
ybiA,1665920,1665920,1665900,20,0,utRho17
ybiI,1676968,1676968,1676912,56,152,utRho17
ybiO,1691328,1691328,1690960,368,2592,utRho17
ybiP,1705252,1705252,1705194,58,442,utRho17
ybiS,1711572,1711572,1711488,84,136,utRho17
ybiT,1711894,1711926,1711894,32,0,utRho17
ybiU,1718212,1718212,1718122,90,182,utRho17
ybiV,1720176,1720176,1720056,120,58,utRho17
ybiW,1725566,1725566,1725212,354,3714,utRho17
ybiX,1678548,1678548,1678414,134,108,utRho17
ybjC,1781784,1781826,1781784,42,0,utRho17
ybjE,1830154,1830154,1829714,440,458,utRho17
ybjG,1767016,1767016,1766776,240,1236,utRho17
ybjL,1779882,1779882,1779638,244,84,utRho17
ybjM,1779770,1780178,1779770,408,676,utRho17
ybjO,1795704,1795978,1795704,274,88,utRho17
ybjP,1809046,1809046,1808934,112,0,utRho17
ybjQ,1809034,1809186,1809034,152,0,utRho17
ybjS,1813796,1813796,1813506,290,374,utRho17
ybjX,1838206,1838206,1838168,38,2,utRho17
ycaD,1891438,1891742,1891438,304,0,utRho17
ycaI,1928210,1928640,1928210,430,96,utRho17
ycaK,1899094,1899336,1899094,242,268,utRho17
ycaL,1920264,1920528,1920264,264,28,utRho17
ycaM,1894240,1894458,1894240,218,146,utRho17
ycaR,1941284,1941346,1941284,62,1976,utRho17
ycbB,1961862,1962094,1961862,232,270,utRho17
ycbJ,1943344,1943504,1943344,160,56,utRho17
ycbK,1966046,1966150,1966046,104,392,utRho17
ycbZ,2036920,2036920,2036598,322,84,utRho17
yccA,2062886,2062886,2062836,50,52,utRho17
yccF,2048730,2048730,2048696,34,0,utRho17
yccS,2047988,2047988,2047766,222,318,utRho17
yccT,2055674,2055674,2055546,128,130,utRho17
yccX,2059960,2060128,2059960,168,578,utRho17
ycdT,2185682,2185752,2185682,70,2,utRho17
ycdU,2191266,2191686,2191266,420,336,utRho17
ycdZ,2200504,2200592,2200504,88,76,utRho17
yceA,2233544,2233614,2233544,70,34,utRho17
yceD,2293298,2293588,2293298,290,3296,utRho17
yceF,2293522,2293522,2293190,332,2308,utRho17
yceH,2252154,2252314,2252154,160,1056,utRho17
yceI,2237282,2237282,2236952,330,986,utRho17
yceJ,2238142,2238142,2238092,50,426,utRho17
yceM,2253208,2253612,2253208,404,180,utRho17
yceO,2239264,2239264,2238894,370,1190,utRho17
yceQ,2288760,2289004,2288760,244,3124,utRho17
ycfD,2376540,2376540,2376480,60,180,utRho17
ycfJ,2334814,2335198,2334814,384,536,utRho17
ycfS,2340834,2340834,2340748,86,0,utRho17
ycfT,2350658,2350658,2350330,328,0,utRho17
ycfZ,2362760,2362760,2362534,226,890,utRho17
ycgB,2474570,2474570,2474482,88,20,utRho17
ycgG,2434614,2434656,2434614,42,488,utRho17
ycgJ,2452956,2453200,2452956,244,0,utRho17
ycgL,2455218,2455362,2455218,144,92,utRho17
ycgN,2457366,2457660,2457366,294,314,utRho17
ycgR,2489112,2489112,2489054,58,0,utRho17
ycgV,2512222,2512222,2511904,318,1238,utRho17
ycgX,2426568,2426568,2426214,354,8082,utRho17
ycgY,2490166,2490320,2490166,154,376,utRho17
ycgZ,2431504,2431578,2431504,74,40,utRho17
ychE,2596904,2597196,2596904,292,2,utRho17
ychF,2515764,2515764,2515624,140,66,utRho17
ychH,2517476,2517582,2517476,106,572,utRho17
ychJ,2578354,2578354,2578264,90,184,utRho17
ychN,2547310,2547310,2547198,112,0,utRho17
ychO,2547520,2547850,2547520,330,228,utRho17
ychQ,2533798,2533848,2533798,50,2,utRho17
yciA,2624828,2624828,2624492,336,172,utRho17
yciB,2626110,2626110,2625780,330,940,utRho17
yciC,2627396,2627396,2627326,70,0,utRho17
yciE,2630794,2630794,2630448,346,198,utRho17
yciG,5264368,5264368,5264140,228,228,utRho17
yciI,2621784,2621784,2621730,54,170,utRho17
yciN,2661606,2661606,2661336,270,54,utRho17
yciS,2680270,2680486,2680270,216,118,utRho17
yciT,2689088,2689088,2688692,396,2454,utRho17
yciU,2614718,2614718,2614300,418,1638,utRho17
yciV,2646376,2646440,2646376,64,26,utRho17
yciW,2700472,2700472,2700214,258,3506,utRho17
yciZ,2689276,2689276,2689218,58,1370,utRho17
ycjD,2703792,2703792,2703520,272,78,utRho17
ycjG,2777748,2777860,2777748,112,298,utRho17
ycjM,2740006,2740432,2740006,426,178,utRho17
ycjW,2767982,2767982,2767922,60,90,utRho17
ycjX,2768138,2768234,2768138,96,90,utRho17
ycjY,5568288,5568288,5567460,828,648,utRho17
ydaE,2836438,2836438,2836016,422,458,utRho17
ydaN,2816048,2816100,2816048,52,158,utRho17
ydaS,2840340,2840730,2840340,390,212,utRho17
ydbC,2948376,2948442,2948376,66,0,utRho17
ydbD,2950132,2950288,2950132,156,0,utRho17
ydbH,2885800,2886102,2885800,302,282,utRho17
ydbJ,2881712,2882116,2881712,404,1396,utRho17
ydbK,2881692,2881692,2881568,124,122,utRho17
ydcA,2983294,2983354,2983294,60,254,utRho17
ydcF,2974404,2974470,2974404,66,0,utRho17
ydcI,2990268,2990268,2990142,126,28,utRho17
ydcJ,2990266,2990576,2990266,310,0,utRho17
ydcK,3001280,3001280,3000898,382,186,utRho17
ydcL,3004646,3004914,3004646,268,70,utRho17
ydcN,3012308,3012344,3012308,36,1004,utRho17
ydcP,3013508,3013562,3013508,54,32,utRho17
ydcR,3019956,3020006,3019956,50,0,utRho17
ydcS,3022906,3023308,3022906,402,222,utRho17
ydcX,3034442,3034778,3034442,336,312,utRho17
ydcY,3035220,3035296,3035220,76,138,utRho17
ydcZ,3036750,3036750,3036662,88,1626,utRho17
yddB,3155332,3155332,3155238,94,184,utRho17
yddE,3071738,3071738,3071716,22,42,utRho17
yddG,3094410,3094410,3094338,72,40,utRho17
yddJ,3089732,3089732,3089438,294,708,utRho17
yddW,3137704,3137704,3137646,58,0,utRho17
ydeA,3233910,3234056,3233910,146,540,utRho17
ydeE,3242528,3242664,3242528,136,76,utRho17
ydeI,3249118,3249118,3248994,124,82,utRho17
ydeJ,3249376,3249546,3249376,170,4,utRho17
ydeN,3165458,3165458,3165048,410,144,utRho17
ydeP,3173328,3173328,3172972,356,776,utRho17
ydeR,3176596,3176596,3176592,4,56,utRho17
ydfA,3296872,3297016,3296872,144,14,utRho17
ydfG,3254982,3255034,3254982,52,242,utRho17
ydfH,3256652,3256704,3256652,52,172,utRho17
ydfK,3265446,3266144,3265446,698,4182,utRho17
ydgA,3379588,3379704,3379588,116,152,utRho17
ydgC,3364124,3364124,3364060,64,212,utRho17
ydgD,3343906,3343920,3343906,14,2,utRho17
ydgH,3356754,3356854,3356754,100,20,utRho17
ydgJ,3408798,3408798,3408616,182,690,utRho17
ydgK,3410414,3410500,3410414,86,430,utRho17
ydhB,3479618,3479618,3479596,22,0,utRho17
ydhC,3479698,3479822,3479698,124,28,utRho17
ydhF,3451310,3451310,3451264,46,18,utRho17
ydhI,3441996,3442050,3441996,54,0,utRho17
ydhL,3451864,3451864,3451840,24,396,utRho17
ydhQ,3492404,3492404,3492254,150,0,utRho17
ydhS,3494136,3494262,3494136,126,806,utRho17
ydhT,3499138,3499138,3499118,20,206,utRho17
ydhY,3509284,3509284,3508954,330,336,utRho17
ydhZ,3510418,3510418,3510282,136,312,utRho17
ydiE,3579206,3579226,3579206,20,0,utRho17
ydiH,3530582,3530582,3530406,176,0,utRho17
ydiM,3541852,3542142,3541852,290,142,utRho17
ydiN,3544818,3545024,3544818,206,68,utRho17
ydiP,3558656,3558656,3558602,54,66,utRho17
ydiU,3582508,3582508,3582488,20,634,utRho17
ydiV,3584174,3584174,3584040,134,510,utRho17
ydiY,3612500,3612500,3612166,334,104,utRho17
ydjA,3697400,3697400,3697352,48,152,utRho17
ydjE,3708082,3708082,3707958,124,0,utRho17
ydjF,3709848,3709848,3709708,140,170,utRho17
ydjM,3620340,3620422,3620340,82,0,utRho17
ydjO,3626696,3626696,3626288,408,734,utRho17
ydjX,3666434,3666802,3666434,368,1964,utRho17
yeaE,3731448,3731448,3731272,176,274,utRho17
yeaG,3733530,3733816,3733530,286,0,utRho17
yeaI,3740486,3740770,3740486,284,42,utRho17
yeaJ,3743874,3744082,3743874,208,94,utRho17
yeaL,3748646,3748704,3748646,58,184,utRho17
yeaM,3751296,3751296,3751152,144,80,utRho17
yeaN,3750926,3751346,3750926,420,120,utRho17
yeaO,3753554,3753818,3753554,264,176,utRho17
yeaP,3755314,3755430,3755314,116,610,utRho17
yeaQ,3758780,3758780,3758510,270,368,utRho17
yeaR,3759988,3759988,3759896,92,42,utRho17
yeaY,3781122,3781122,3781064,58,4,utRho17
yebB,3892220,3892502,3892220,282,214,utRho17
yebC,3896370,3896370,3896302,68,40,utRho17
yebE,3859464,3859464,3859414,50,400,utRho17
yebG,3861530,3861530,3861494,36,0,utRho17
yebK,3873180,3873304,3873180,124,144,utRho17
yebQ,3820314,3820552,3820314,238,162,utRho17
yebS,3832238,3832516,3832238,278,10,utRho17
yebV,3843430,3843560,3843430,130,54,utRho17
yebW,3843914,3844242,3843914,328,1162,utRho17
yecC,3995646,3995646,3995628,18,0,utRho17
yecD,3901272,3901664,3901272,392,98,utRho17
yecF,3991434,3991636,3991434,202,246,utRho17
yecH,3979304,3979304,3978980,324,1510,utRho17
yecJ,3975604,3975604,3975516,88,0,utRho17
yecM,3919968,3919968,3919692,276,242,utRho17
yecR,3976400,3976444,3976400,44,0,utRho17
yecT,3923862,3923944,3923862,82,174,utRho17
yedD,4016522,4016522,4016180,342,198,utRho17
yedE,4016310,4016554,4016310,244,190,utRho17
yedI,4058922,4058922,4058732,190,0,utRho17
yedJ,4066446,4066446,4066158,288,478,utRho17
yedV,4076404,4076404,4076304,100,372,utRho17
yedX,4077680,4077912,4077680,232,0,utRho17
yedY,4078572,4078956,4078572,384,676,utRho17
yeeA,4161322,4161322,4161182,140,2,utRho17
yeeE,4171104,4171104,4171050,54,2,utRho17
yeeJ,4089526,4089822,4089526,296,546,utRho17
yeeN,4113508,4113716,4113508,208,390,utRho17
yeeO,4119444,4119444,4119692,248,194,utRho17
yeeX,4158834,4158834,4158722,112,570,utRho17
yeeZ,4178422,4178422,4178256,166,36,utRho17
yefM,4179466,4179466,4179426,40,0,utRho17
yegD,4295288,4295348,4295288,60,2,utRho17
yegH,4275726,4275804,4275726,78,376,utRho17
yegI,4302154,4302154,4301970,184,0,utRho17
yegJ,4302032,4302370,4302032,338,146,utRho17
yegQ,4331182,4331336,4331182,154,1834,utRho17
yegR,4336698,4336698,4336612,86,376,utRho17
yegS,4337086,4337424,4337086,338,482,utRho17
yegT,4357562,4357642,4357562,80,636,utRho17
yegX,4367640,4367640,4367302,338,600,utRho17
yehA,4376944,4376944,4376828,116,324,utRho17
yehE,4385818,4385818,4385592,226,0,utRho17
yehK,4407568,4407944,4407568,376,204,utRho17
yehL,4408804,4409192,4408804,388,76,utRho17
yeiB,4486146,4486146,4485934,212,106,utRho17
yeiE,4499422,4499422,4499236,186,26,utRho17
yeiG,4487776,4487820,4487776,44,150,utRho17
yeiH,4499332,4499434,4499332,102,60,utRho17
yeiI,4503306,4503400,4503306,94,134,utRho17
yeiL,4510580,4510710,4510580,130,6,utRho17
yeiP,4530834,4530900,4530834,66,226,utRho17
yeiQ,4532328,4532490,4532328,162,138,utRho17
yeiR,4535484,4535658,4535484,174,380,utRho17
yeiW,4530840,4530840,4530590,250,274,utRho17
yejA,4544624,4544728,4544624,104,0,utRho17
yejG,4556892,4556892,4556474,418,3746,utRho17
yejH,4561244,4561264,4561244,20,0,utRho17
yejK,4568218,4568218,4567894,324,62,utRho17
yejO,4578352,4578352,4577800,552,1934,utRho17
yfaD,4713380,4713808,4713380,428,1590,utRho17
yfaE,4696676,4697028,4696676,352,2046,utRho17
yfaL,4688568,4688568,4688338,230,14,utRho17
yfaP,4656398,4656398,4656286,112,38,utRho17
yfaU,4717892,4717892,4717690,202,114,utRho17
yfaY,4727310,4727310,4727266,44,22,utRho17
yfaZ,4728744,4728744,4728550,194,36,utRho17
yfbK,4771810,4771810,4771444,366,984,utRho17
yfbL,4771500,4771720,4771500,220,716,utRho17
yfbN,4777174,4777174,4776852,322,130,utRho17
yfbO,4776916,4777162,4776916,246,130,utRho17
yfbP,4777990,4778232,4777990,242,10206,utRho17
yfbR,4817662,4817724,4817662,62,16,utRho17
yfcI,4847424,4847424,4847078,346,1328,utRho17
yfcJ,4880482,4880482,4880240,242,756,utRho17
yfcL,4888502,4888502,4888338,164,250,utRho17
yfcV,4911642,4911642,4911292,350,520,utRho17
yfcZ,4921958,4921958,4921868,90,40,utRho17
yfdF,4925604,4926024,4925604,420,5856,utRho17
yfdG,4935474,4935710,4935474,236,0,utRho17
yfdP,4946844,4947040,4946844,196,152,utRho17
yfdX,4988866,4988866,4988804,62,0,utRho17
yfdY,4990672,4990672,4990584,88,44,utRho17
yfeA,5035784,5035784,5035664,120,15036,utRho17
yfeC,5036668,5036934,5036668,266,112,utRho17
yfeH,5053818,5053892,5053818,74,132,utRho17
yfeK,5074630,5074684,5074630,54,0,utRho17
yfeO,5018906,5019260,5018906,354,762,utRho17
yfeR,5054078,5054078,5053712,366,172,utRho17
yfeX,5101356,5101356,5101090,266,56,utRho17
yfeY,5102486,5102486,5102432,54,0,utRho17
yfeZ,5103842,5103842,5103452,390,132,utRho17
yffO,5123804,5124222,5123804,418,74,utRho17
yffQ,5126778,5127154,5126778,376,762,utRho17
yffS,5128800,5128986,5128800,186,0,utRho17
yfgC,5232052,5232188,5232052,136,164,utRho17
yfgF,5258062,5258062,5257876,186,978,utRho17
yfgG,5258170,5258580,5258170,410,1612,utRho17
yfgH,5259344,5259584,5259344,240,478,utRho17
yfgM,5278866,5278866,5278566,300,644,utRho17
yfhH,5397414,5397518,5397414,104,86,utRho17
yfhM,5304648,5304648,5304574,74,74,utRho17
yfhR,5328408,5328726,5328408,318,13442,utRho17
yfiC,5425610,5425610,5425528,82,30,utRho17
yfiE,5430688,5430688,5430640,48,996,utRho17
yfiL,5482630,5482720,5482630,90,208,utRho17
yfiM,5448066,5448358,5448066,292,11628,utRho17
yfiR,5483354,5483750,5483354,396,486,utRho17
yfjH,5517326,5517326,5517200,126,20,utRho17
yfjI,5517710,5517970,5517710,260,168,utRho17
yfjJ,5521014,5521094,5521014,80,266,utRho17
yfjM,5531970,5531970,5531552,418,6866,utRho17
yfjP,5535080,5535420,5535080,340,826,utRho17
yfjW,5546570,5546636,5546570,66,0,utRho17
yfjX,5551776,5551838,5551776,62,0,utRho17
ygaC,5601180,5601180,5599988,1192,2466,utRho17
ygaM,5600242,5600292,5600242,50,562,utRho17
ygaU,5593628,5593628,5593572,56,196,utRho17
ygaZ,5619190,5619234,5619190,44,466,utRho17
ygbA,5713656,5713656,5713612,44,74,utRho17
ygbE,5746784,5746784,5746674,110,2312,utRho17
ygbI,5722882,5722882,5722528,354,312,utRho17
ygbK,5724394,5724670,5724394,276,532,utRho17
ygbL,5727074,5727186,5727074,112,104,utRho17
ygbN,5729814,5730202,5729814,388,710,utRho17
ygcG,5811210,5811422,5811210,212,40,utRho17
ygcN,5785144,5785314,5785144,170,292,utRho17
ygcU,5799214,5799214,5798836,378,198,utRho17
ygcW,5800942,5800942,5800546,396,0,utRho17
ygdD,5883442,5883442,5883262,180,494,utRho17
ygdG,5861746,5861930,5861746,184,1802,utRho17
ygdI,5886526,5886526,5886290,236,126,utRho17
ygdQ,5940784,5940840,5940784,56,184,utRho17
ygdR,5942494,5942542,5942494,48,100,utRho17
ygeA,5961606,5961606,5961270,336,200,utRho17
ygeH,5983758,5984188,5983758,430,988,utRho17
ygeI,5987162,5987276,5987162,114,4696,utRho17
ygeR,6000078,6000078,5999782,296,544,utRho17
ygeV,6011694,6011694,6011572,122,68,utRho17
ygeW,6012234,6012524,6012234,290,532,utRho17
ygfB,6110946,6110946,6110888,58,216,utRho17
ygfK,6031984,6032120,6031984,136,118,utRho17
ygfS,6058328,6058328,6058024,304,152,utRho17
ygfZ,6082564,6082626,6082564,62,236,utRho17
yggC,6149512,6149512,6149378,134,84,utRho17
yggE,6136370,6136370,6136160,210,426,utRho17
yggI,6179176,6179510,6179176,334,1560,utRho17
yggL,6204508,6204508,6204266,242,92,utRho17
yggM,6199514,6199514,6199130,384,92,utRho17
yggN,6203596,6203596,6203246,350,848,utRho17
yggX,18623958,18624558,18623958,600,270,utRho17
yghA,6298966,6299324,6298966,358,84,utRho17
yghB,6307058,6307126,6307058,68,338,utRho17
yghD,6222614,6222614,6222252,362,684,utRho17
yghF,6225798,6225798,6225840,42,146,utRho17
yghJ,6238640,6238640,6238224,416,44,utRho17
yghQ,6265186,6265186,6264816,370,356,utRho17
yghT,6267830,6268262,6267830,432,494,utRho17
yghU,6277400,6277454,6277400,54,100,utRho17
yghW,6293506,6293506,6293474,32,0,utRho17
yghZ,6295562,6295794,6295562,232,528,utRho17
ygiD,6365122,6365122,6364868,254,2968,utRho17
ygiH,6409066,6409388,6409066,322,582,utRho17
ygiL,6370622,6370828,6370622,206,378,utRho17
ygiM,6402084,6402414,6402084,330,560,utRho17
ygiN,6346156,6346284,6346156,128,1148,utRho17
ygiQ,6322620,6322620,6322292,328,1586,utRho17
ygiS,6335462,6335462,6335436,26,94,utRho17
ygiV,6338582,6338582,6338462,120,212,utRho17
ygiW,6339774,6339774,6339352,422,1562,utRho17
ygiZ,6344506,6344506,6344422,84,16,utRho17
ygjH,6442528,6442528,6442494,34,16,utRho17
ygjI,6452140,6452468,6452140,328,118,utRho17
ygjQ,6472730,6473080,6472730,350,1216,utRho17
ygjR,6474564,6474586,6474564,22,0,utRho17
ygjV,6483638,6483638,6483488,150,72,utRho17
yhaB,6535632,6535708,6535632,76,0,utRho17
yhaH,6504498,6504608,6504498,110,370,utRho17
yhaI,6505400,6505822,6505400,422,526,utRho17
yhaJ,6508560,6508560,6508428,132,214,utRho17
yhaK,6508538,6508638,6508538,100,146,utRho17
yhbQ,6599878,6599932,6599878,54,772,utRho17
yhbT,6602736,6602736,6602552,184,506,utRho17
yhbU,6602558,6602970,6602558,412,608,utRho17
yhbX,6643302,6643302,6643226,76,0,utRho17
yhbY,6655518,6655580,6655518,62,586,utRho17
yhcA,6723956,6724224,6723956,268,744,utRho17
yhcB,6760364,6760382,6760364,18,42,utRho17
yhcC,6708470,6708470,6708100,370,2460,utRho17
yhcF,6733440,6733852,6733440,412,2672,utRho17
yhcH,6739124,6739124,6738956,168,896,utRho17
yhcM,6760312,6760312,6759994,318,68,utRho17
yhcN,6770812,6771076,6770812,264,278,utRho17
yhcO,6772606,6772606,6772258,348,152,utRho17
yhdH,6806560,6806968,6806560,408,550,utRho17
yhdJ,6823234,6823306,6823234,72,0,utRho17
yhdN,6879092,6879092,6879018,74,810,utRho17
yhdT,6814702,6814750,6814702,48,120,utRho17
yhdU,6824994,6825242,6824994,248,354,utRho17
yhdV,6836392,6836780,6836392,388,1492,utRho17
yhdW,6837944,6838298,6837944,354,124,utRho17
yheO,6953082,6953082,6952880,202,438,utRho17
yheV,6957970,6957970,6957584,386,348,utRho17
yhfA,6971902,6971902,6971636,266,606,utRho17
yhfG,6983294,6983294,6983240,54,1026,utRho17
yhfL,6998622,6998896,6998622,274,568,utRho17
yhfY,7023244,7023244,7022844,400,0,utRho17
yhgA,7086294,7086334,7086294,40,6,utRho17
yhgE,7065176,7065176,7064878,298,816,utRho17
yhgF,7074352,7074770,7074352,418,7864,utRho17
yhhA,7173458,7173886,7173458,428,640,utRho17
yhhI,7248346,7248756,7248346,410,40,utRho17
yhhJ,7253696,7253696,7253606,90,328,utRho17
yhhM,7211588,7211588,7211220,368,874,utRho17
yhhN,7211150,7211502,7211150,352,624,utRho17
yhhQ,7218238,7218434,7218238,196,290,utRho17
yhhT,7223682,7223730,7223682,48,50,utRho17
yhhX,7162032,7162032,7161610,422,2,utRho17
yhhY,7162222,7162276,7162222,54,38,utRho17
yhhZ,7163516,7163726,7163516,210,344,utRho17
yhiD,7312220,7312220,7311804,416,101984,utRho17
yhiJ,7265190,7265190,7265180,10,90,utRho17
yhiM,7269270,7269682,7269270,412,2026,utRho17
yhiN,7275000,7275000,7274820,180,780,utRho17
yhjA,7338522,7338522,7338376,146,78,utRho17
yhjB,7344090,7344090,7343788,302,1040,utRho17
yhjC,7344272,7344684,7344272,412,208,utRho17
yhjD,7346660,7346724,7346660,64,160,utRho17
yhjE,7349274,7349572,7349274,298,1200,utRho17
yhjG,7356824,7356824,7356730,94,120,utRho17
yhjH,7358458,7358458,7358374,84,786,utRho17
yhjJ,7364032,7364032,7363880,152,328,utRho17
yhjK,7371296,7371296,7371158,138,140,utRho17
yhjR,7392750,7392750,7392370,380,52,utRho17
yhjV,7400796,7401126,7400796,330,2656,utRho17
yhjX,7424194,7424194,7424014,180,260,utRho17
yhjY,7425966,7425966,7425868,98,100,utRho17
yiaB,7455654,7455654,7455496,158,410,utRho17
yiaD,7432712,7433094,7432712,382,1242,utRho17
yiaF,7438194,7438194,7438088,106,962,utRho17
yiaG,7438862,7438956,7438862,94,434,utRho17
yiaJ,7485236,7485236,7485064,172,946,utRho17
yiaK,7485348,7485466,7485348,118,182,utRho17
yiaT,7503924,7503924,7503736,188,0,utRho17
yiaU,7503792,7503984,7503792,192,76,utRho17
yiaY,7515856,7515856,7515654,202,432,utRho17
yibF,7523950,7523950,7523910,40,38,utRho17
yibG,7536128,7536354,7536128,226,64,utRho17
yibL,7553194,7553330,7553194,136,180,utRho17
yibN,7570112,7570112,7570030,82,86,utRho17
yibT,7552848,7552848,7552760,88,1062,utRho17
yicC,7633290,7633352,7633290,62,94,utRho17
yicH,7660862,7660914,7660862,52,18,utRho17
yicJ,7673328,7673328,7671858,1470,12662,utRho17
yicN,7685018,7685018,7684804,214,1228,utRho17
yicO,7687914,7687914,7687578,336,370,utRho17
yicR,15250308,15250308,15250236,72,0,utRho17
yidB,7755230,7755230,7754930,300,130,utRho17
yidE,7732780,7732780,7732546,234,572,utRho17
yidF,7711580,7711580,7711222,358,428,utRho17
yidQ,7735088,7735456,7735088,368,1212,utRho17
yidR,7738824,7738824,7738618,206,158,utRho17
yieE,7787658,7787738,7787658,80,912,utRho17
yieH,7793314,7793548,7793314,234,314,utRho17
yieK,7798928,7798928,7798786,142,14,utRho17
yifB,7900350,7900350,7899998,352,194,utRho17
yifL,7988984,7989044,7988984,60,2068,utRho17
yigF,8005750,8005750,8005598,152,17424,utRho17
yigI,8009448,8009448,8009394,54,488,utRho17
yigM,8022100,8022152,8022100,52,212,utRho17
yihA,8101970,8101970,8101458,512,202,utRho17
yihD,8084098,8084138,8084098,40,36,utRho17
yihF,8088110,8088398,8088110,288,326,utRho17
yihG,8093304,8093304,8093204,100,84,utRho17
yihI,8102616,8102694,8102616,78,4,utRho17
yihL,8120506,8120894,8120506,388,238,utRho17
yihN,8124332,8124494,8124332,162,534,utRho17
yihO,8131942,8131942,8131532,410,322,utRho17
yihQ,8138892,8138892,8138552,340,102,utRho17
yihV,8147064,8147478,8147064,414,412,utRho17
yihX,8151096,8151106,8151096,10,140,utRho17
yiiE,8158192,8158582,8158192,390,718,utRho17
yiiF,8159124,8159502,8159124,378,1308,utRho17
yiiG,8173762,8174004,8173762,242,32,utRho17
yiiM,8205506,8205644,8205506,138,2424,utRho17
yiiQ,8224624,8224624,8224428,196,206,utRho17
yiiS,8225738,8225934,8225738,196,380,utRho17
yijE,8272178,8272216,8272178,38,214,utRho17
yijF,8275728,8275728,8275314,414,1348,utRho17
yijO,8296858,8296858,8296634,224,750,utRho17
yjaA,8426240,8426468,8426240,228,182740,utRho17
yjaB,8428312,8428312,8428246,66,672,utRho17
yjaG,8398746,8399008,8398746,262,802,utRho17
yjaH,8401022,8401132,8401022,110,324,utRho17
yjaZ,8379506,8379572,8379506,66,62,utRho17
yjbB,8455204,8455462,8455204,258,0,utRho17
yjbE,16943432,16943624,16943432,192,508,utRho17
yjbL,8520318,8520642,8520318,324,424,utRho17
yjbQ,8540428,8540476,8540428,48,72,utRho17
yjcB,8550328,8550328,8550082,246,378,utRho17
yjcC,8550836,8550942,8550836,106,306,utRho17
yjcD,8556628,8556958,8556628,330,168,utRho17
yjcE,8559658,8559960,8559658,302,420,utRho17
yjcF,8566212,8566212,8566150,62,30,utRho17
yjcO,8594660,8594660,8594250,410,222,utRho17
yjdA,8654128,8654270,8654128,142,0,utRho17
yjdC,8726660,8726660,8726616,44,16,utRho17
yjdK,8704780,8705168,8704780,388,3446,utRho17
yjdL,8713034,8713034,8712822,212,36,utRho17
yjdM,8653672,8653672,8653468,204,996,utRho17
yjeF,8787354,8788132,8787354,778,92936,utRho17
yjeI,8745522,8745618,8745522,96,0,utRho17
yjeJ,8748806,8748806,8748468,338,646,utRho17
yjeV,8785472,8785784,8785472,312,3070,utRho17
yjfP,8833512,8833904,8833512,392,198,utRho17
yjfY,8849656,8849656,8849582,74,218,utRho17
yjfZ,8855052,8855052,8854844,208,138,utRho17
yjgA,8916162,8916162,8915730,432,470,utRho17
yjgL,8950802,8950874,8950802,72,60,utRho17
yjgM,8959342,8959342,8959074,268,42,utRho17
yjgN,8959132,8959460,8959132,328,42,utRho17
yjgR,8980170,8980170,8980126,44,732,utRho17
yjgZ,9002116,9002520,9002116,404,7240,utRho17
yjhB,9007764,9008116,9007764,352,666,utRho17
yjhG,9048452,9048452,9048188,264,12716,utRho17
yjhU,9041080,9041080,9040648,432,1064,utRho17
yjiA,9178096,9178096,9177730,366,3710,utRho17
yjiJ,9125364,9125364,9125350,14,124,utRho17
yjiK,9127270,9127270,9127422,152,316,utRho17
yjiL,9129604,9129604,9129378,226,20,utRho17
yjiS,9143410,9143502,9143410,92,322,utRho17
yjiY,9182734,9182734,9182558,176,4926,utRho17
yjjA,9200674,9200674,9200378,296,2438,utRho17
yjjB,18408708,18408708,18407800,908,2100,utRho17
yjjJ,9243314,9243538,9243314,224,44,utRho17
yjjK,9261132,9261132,9261044,88,1122,utRho17
yjjL,9189764,9189764,9189444,320,1296,utRho17
yjjM,9191894,9191894,9191702,192,178,utRho17
yjjP,9206068,9206068,9205716,352,16424,utRho17
yjjQ,9206638,9206954,9206638,316,9708,utRho17
yjjX,9267798,9267798,9267490,308,1666,utRho17
yjjY,9280716,9280804,9280716,88,488,utRho17
yjjZ,9211554,9211608,9211554,54,55996,utRho17
yjtD,9281676,9281884,9281676,208,144,utRho17
ykfB,532454,532454,532174,280,13948,utRho17
ykfI,527636,527636,527338,298,2776,utRho17
ykgB,637050,637050,636638,412,378,utRho17
ykgC,640430,640430,640002,428,98,utRho17
ykgD,640232,640454,640232,222,0,utRho17
ykgE,642962,643216,642962,254,514,utRho17
ykgJ,608524,608524,608364,160,568,utRho17
ykgL,623878,624224,623878,346,996,utRho17
ykgM,625610,625610,625554,56,200,utRho17
ykgR,626570,626570,626484,86,2,utRho17
ylaC,958576,958576,958502,74,2500,utRho17
yliE,1745938,1745958,1745938,20,52,utRho17
ymcE,2103660,2103694,2103660,34,0,utRho17
ymdA,2210450,2210828,2210450,378,132,utRho17
ymdB,2211428,2211640,2211428,212,0,utRho17
ymfD,2395322,2395322,2395064,258,832,utRho17
ymfI,2402880,2402994,2402880,114,0,utRho17
ymfJ,2404518,2404518,2404168,350,276,utRho17
ymfK,2406176,2406176,2405866,310,34,utRho17
ymfT,2405766,2406048,2405766,282,64,utRho17
ymgE,2489110,2489456,2489110,346,1068,utRho17
ymgF,2437628,2437966,2437628,338,158,utRho17
ymiA,2670112,2670320,2670112,208,482,utRho17
ymjA,2715620,2715620,2715336,284,1030,utRho17
ynaI,2791946,2791946,2791844,102,334,utRho17
ynaK,2850438,2850754,2850438,316,114,utRho17
ynbA,2954924,2955242,2954924,318,492,utRho17
yncD,3046552,3046552,3046130,422,60,utRho17
yncE,3046454,3046614,3046454,160,8,utRho17
yncG,3052456,3052494,3052456,38,772,utRho17
yncL,3034492,3034492,3034388,104,216,utRho17
yneE,3218364,3218364,3218044,320,120,utRho17
yneF,3223748,3223748,3223708,40,2,utRho17
yneJ,3229560,3229608,3229560,48,172,utRho17
yneK,3231100,3231526,3231100,426,442,utRho17
yneM,3245176,3245292,3245176,116,288,utRho17
ynfA,3311398,3311398,3311346,52,112,utRho17
ynfB,3311418,3311616,3311418,198,556,utRho17
ynfC,3315094,3315094,3314914,180,98,utRho17
ynfD,3314828,3315130,3314828,302,98,utRho17
ynfE,3316006,3316138,3316006,132,120,utRho17
ynfK,3334670,3334670,3334438,232,360,utRho17
ynfL,3339304,3339304,3339184,120,0,utRho17
ynfM,3339260,3339398,3339260,138,0,utRho17
ynfN,3276598,3276598,3276218,380,78,utRho17
ynfO,3273454,3273512,3273454,58,244,utRho17
ynhG,3517890,3517890,3517450,440,138,utRho17
yniA,3615158,3615592,3615158,434,336,utRho17
yniB,3618526,3618526,3618466,60,52,utRho17
yniC,3618652,3618760,3618652,108,34,utRho17
yniD,3610202,3610330,3610202,128,258,utRho17
ynjE,3678880,3678934,3678880,54,0,utRho17
ynjF,3683222,3683222,3682806,416,442,utRho17
ynjH,3684376,3684376,3684270,106,164,utRho17
ynjI,3690022,3690022,3689742,280,146,utRho17
yoaB,3786642,3786734,3786642,92,298,utRho17
yoaC,3787932,3788146,3787932,214,156,utRho17
yoaE,3803544,3803544,3803170,374,610,utRho17
yoaF,3755444,3755444,3755064,380,1208,utRho17
yoaH,3789866,3789866,3789462,404,964,utRho17
yobB,3850418,3850880,3850418,462,838,utRho17
yobF,3815586,3815586,3815182,404,324,utRho17
yobH,3817800,3817850,3817800,50,676,utRho17
yodB,4084352,4084736,4084352,384,974,utRho17
yodC,4057008,4057008,4056740,268,330,utRho17
yohC,4451358,4451358,4451262,96,140,utRho17
yohD,4451526,4451602,4451526,76,26,utRho17
yohJ,4460986,4461248,4460986,262,126,utRho17
yohO,4431172,4431314,4431172,142,4,utRho17
yojI,4617282,4617282,4617230,52,0,utRho17
ypdI,4988988,4989396,4988988,408,80,utRho17
ypfG,5165786,5165786,5165554,232,166,utRho17
ypfM,5182140,5182140,5181732,408,1834,utRho17
yphB,5349590,5349590,5349376,214,204,utRho17
ypjA,5565644,5565644,5565452,192,1232,utRho17
ypjB,5569636,5569636,5568858,778,16,utRho17
ypjD,5495860,5495774,5495860,86,0,utRho17
yqaE,5594170,5594170,5594056,114,802,utRho17
yqcA,5846100,5846100,5845968,132,226,utRho17
yqcE,5800944,5801184,5800944,240,90,utRho17
yqeC,6030468,6030468,6030114,354,1384,utRho17
yqeF,5971618,5971618,5971184,434,1250,utRho17
yqeG,5971438,5971694,5971438,256,2236,utRho17
yqeH,5975016,5975072,5975016,56,3574,utRho17
yqeI,5976688,5977004,5976688,316,170,utRho17
yqeK,5981140,5981140,5980720,420,2728,utRho17
yqfA,6086728,6086728,6086296,432,564,utRho17
yqgA,6219042,6219106,6219042,64,0,utRho17
yqgB,6172500,6172500,6172102,398,2460,utRho17
yqgE,6185768,6185874,6185768,106,442,utRho17
yqhA,6299150,6299150,6298942,208,56,utRho17
yqhC,6310768,6310768,6310436,332,620,utRho17
yqhD,6310604,6310710,6310604,106,364,utRho17
yqhH,6316842,6317254,6316842,412,794,utRho17
yqiC,6369662,6369680,6369662,18,158,utRho17
yqiJ,6384108,6384416,6384108,308,638,utRho17
yqjA,6495096,6495546,6495096,450,6926,utRho17
yqjF,6500932,6501124,6500932,192,886,utRho17
yqjG,6501948,6502048,6501948,100,20,utRho17
yqjH,6433078,6433078,6432982,96,0,utRho17
yqjI,6433506,6433558,6433506,52,0,utRho17
yraH,6574552,6574852,6574552,300,218,utRho17
yraP,6592144,6592818,6592144,674,462,utRho17
yraQ,6596414,6596414,6596276,138,52,utRho17
yraR,6598024,6598024,6597692,332,580,utRho17
yrbG,13360844,13361100,13360844,256,0,utRho17
yrbL,6696842,6696904,6696842,62,1314,utRho17
yrbN,6616172,6616172,6615866,306,3904,utRho17
yrdB,6860176,6860176,6860046,130,92,utRho17
yrfF,7052548,7052938,7052548,390,1156,utRho17
yrhB,7169440,7169518,7169440,78,0,utRho17
ysaB,7451804,7451804,7451424,380,604,utRho17
ysgA,8032686,8032686,8032338,348,806,utRho17
ytfB,8857638,8857638,8857434,204,502,utRho17
ytfE,8864018,8864018,8863966,52,320,utRho17
ytfF,8866296,8866296,8866130,166,402,utRho17
ytfH,8868164,8868226,8868164,62,468,utRho17
ytfI,8875234,8875414,8875234,180,130,utRho17
ytfJ,8878572,8878572,8878524,48,164,utRho17
ytfK,8879022,8879174,8879022,152,648,utRho17
ytfL,8882642,8882642,8882430,212,268,utRho17
ytfQ,8899634,8899924,8899634,290,112,utRho17
ytjB,9249598,9249598,9249578,20,136,utRho17
yzfA,8896588,8896588,8896490,98,16,utRho17
zapA,6111102,6111224,6111102,122,2326,utRho17
zapB,8236772,8237030,8236772,258,308,utRho17
zapC,2011700,2011904,2011700,204,20,utRho17
zinT,4082692,4082750,4082692,58,252,utRho17
zipA,5062814,5062814,5062466,348,70,utRho17
zitB,1569716,1569716,1569646,70,62,utRho17
zntA,7212844,7212902,7212844,58,164,utRho17
zntR,6878336,6878336,6878260,76,24,utRho17
znuA,3885322,3885322,3885166,156,216,utRho17
znuC,3885268,3885324,3885268,56,128,utRho17
zraP,8403424,8403424,8403376,48,98,utRho17
zraS,8403810,8403852,8403810,42,0,utRho17
zupT,6364866,6365100,6364866,234,2958,utRho17
zur,8520282,8520282,8520006,276,954,utRho17
zwf,3872752,3872752,3872628,124,128,utRho17
C0343,2818676,2818728,2818676,52,22,utRho18
aaeB,6776526,6776526,6776376,150,232,utRho18
aaeR,6778762,6779040,6778762,278,504,utRho18
aaeX,6778860,6778860,6778674,186,586,utRho18
aat,1854920,1854920,1854864,56,52,utRho18
accA,416822,417242,416822,420,3032,utRho18
accB,6810280,6810872,6810280,592,5976,utRho18
accD,4868030,4868030,4867852,178,56,utRho18
aceB,8430804,8430956,8430804,152,222,utRho18
aceE,245938,246034,245938,96,196,utRho18
ackA,4826918,4826940,4826918,22,426,utRho18
acnA,2670848,2671662,2670848,814,370,utRho18
acnB,263038,263230,263038,192,322,utRho18
acpP,2303148,2303230,2303148,82,1030,utRho18
acpS,5402324,5402324,5401996,328,856,utRho18
acrA,971396,971396,971238,158,206,utRho18
acrB,969370,969370,968806,564,1646,utRho18
acrD,5174950,5175190,5174950,240,64,utRho18
acrE,6827404,6827728,6827404,324,444,utRho18
acrR,971398,971522,971398,124,0,utRho18
acrZ,1589502,1589546,1589502,44,60,utRho18
acs,8575190,8575190,8574742,448,814,utRho18
actP,8569870,8569870,8569804,66,0,utRho18
ada,4620854,4620854,4620810,44,0,utRho18
add,3404404,3404466,3404404,62,164,utRho18
ade,7687802,7687928,7687802,126,390,utRho18
adhE,2596826,2596826,2596242,584,0,utRho18
adhP,3107988,3107988,3107676,312,2314,utRho18
adiA,8681112,8681112,8681042,70,150,utRho18
adiC,8674404,8674404,8674062,342,704,utRho18
adiY,8676084,8676084,8675858,226,0,utRho18
adk,994278,994350,994278,72,1432,utRho18
adrA,807374,807406,807374,32,124,utRho18
aer,6438240,6438240,6438152,88,0,utRho18
aes,1000102,1000102,999946,156,750,utRho18
agaR,6557406,6557406,6557330,76,18,utRho18
agaS,6563778,6563952,6563778,174,186,utRho18
agp,2131118,2131170,2131118,52,62,utRho18
agrA,7296126,7296126,7296126,0,0,utRho18
agrB,7296588,7296588,7296588,0,0,utRho18
ahpC,1277386,1277890,1277386,504,690,utRho18
ahpF,1278004,1279506,1278004,1502,54278,utRho18
ahr,8992698,8992698,8992418,280,220,utRho18
aidB,8828494,8828550,8828494,56,0,utRho18
ais,4731512,4731512,4731240,272,76,utRho18
alaA,4814816,4815122,4814816,306,108,utRho18
alaC,4996798,4996798,4996590,208,0,utRho18
alaE,5598140,5598328,5598140,188,88,utRho18
alaS,5644180,5644180,5644022,158,4054,utRho18
alaW,5036612,5036612,5036462,150,0,utRho18
aldA,2976380,2976464,2976380,84,430,utRho18
aldB,7513070,7513070,7513022,48,618,utRho18
alkA,4295118,4295118,4295080,38,0,utRho18
alkB,4618890,4618890,4618682,208,140,utRho18
allA,1064780,1064902,1064780,122,66,utRho18
allD,1092822,1092822,1092726,96,0,utRho18
allE,1088112,1088112,1088092,20,92,utRho18
allS,1064600,1064600,1064442,158,266,utRho18
alr,8531178,8531564,8531178,386,2308,utRho18
alsE,8617334,8617334,8616956,378,368,utRho18
alsK,8615990,8615990,8615598,392,906,utRho18
alx,6476740,6477160,6476740,420,64,utRho18
amiA,5104482,5104704,5104482,222,48,utRho18
amiC,5898378,5898378,5898020,358,380,utRho18
amn,4110062,4110122,4110062,60,0,utRho18
ampC,8758006,8758006,8757888,118,108,utRho18
ampD,237362,237466,237362,104,348,utRho18
ampG,907372,907372,907090,282,402,utRho18
ampH,792726,792726,792574,152,68,utRho18
amyA,4012230,4012312,4012230,82,72,utRho18
anmK,3439346,3439346,3439204,142,36,utRho18
ansB,6201580,6201580,6201456,124,140,utRho18
ansP,3052040,3052040,3051960,80,150,utRho18
apaG,104068,104068,103212,856,4356,utRho18
apaH,102586,102586,102444,142,3856,utRho18
apbE,4623188,4623188,4623068,120,0,utRho18
appA,2081198,2081234,2081198,36,0,utRho18
appC,2075420,2075480,2075420,60,36,utRho18
appY,1167134,1167362,1167134,228,134,utRho18
apt,982620,982824,982620,204,98,utRho18
aqpZ,1832424,1832424,1832094,330,184,utRho18
araB,140150,140150,140096,54,0,utRho18
araC,140482,140774,140482,292,782,utRho18
araE,5964416,5964416,5964364,52,56,utRho18
araF,3972476,3972476,3972256,220,60,utRho18
araH,3967120,3967120,3967086,34,286,utRho18
araJ,825058,825058,824962,96,642,utRho18
arcA,9281602,9281602,9280612,990,5238,utRho18
arcB,6706098,6706098,6706050,48,258,utRho18
arcZ,6701154,6701154,6701154,0,0,utRho18
arfA,6877346,6877346,6877298,48,712,utRho18
argA,5898312,5898484,5898312,172,190,utRho18
argC,8309770,8310002,8309770,232,36,utRho18
argD,6980442,6980442,6980360,82,284,utRho18
argE,8310156,8310156,8309694,462,112,utRho18
argF,580680,580680,580610,70,0,utRho18
argG,6637124,6637274,6637124,150,160,utRho18
argI,8956688,8956688,8956622,66,362,utRho18
argO,6137672,6137672,6137616,56,306,utRho18
argP,6119460,6119506,6119460,46,460,utRho18
argR,6769204,6769406,6769204,202,146,utRho18
argS,3920002,3920124,3920002,122,68,utRho18
argT,4855698,4855698,4855582,116,42,utRho18
argU,1129406,1129446,1129406,40,2,utRho18
argW,4932616,4932618,4932616,2,54,utRho18
argX,7964728,7964750,7964728,22,72,utRho18
aroF,5482402,5482402,5482300,102,72,utRho18
aroG,1571182,1571266,1571182,84,204,utRho18
aroH,3576636,3576870,3576636,234,450,utRho18
aroK,7038760,7038760,7038128,632,748,utRho18
aroL,812560,812810,812560,250,838,utRho18
aroP,243342,243342,243102,240,82,utRho18
arpA,8445382,8445382,8444974,408,62,utRho18
arrS,7316108,7316108,7316108,0,0,utRho18
arsR,7297024,7297056,7297024,32,98,utRho18
artJ,1801252,1801252,1801150,102,30,utRho18
artP,1807686,1807686,1807468,218,1304,utRho18
ascF,5678858,5679048,5678858,190,0,utRho18
ascG,5678574,5678574,5678528,46,132,utRho18
aslB,7965562,7965916,7965562,354,2230,utRho18
asnA,7854258,7854310,7854258,52,224,utRho18
asnB,1398444,1398444,1398354,90,1464,utRho18
asnC,23562186,23562186,23562018,168,432,utRho18
asnS,1978088,1978088,1977970,118,8322,utRho18
asnT,4089082,4089098,4089082,16,272,utRho18
asnU,4119690,4119702,4119690,12,18,utRho18
asnV,4124504,4124520,4124504,16,260,utRho18
aspA,17473728,17473728,17473308,420,508,utRho18
aspC,1971486,1971486,1971418,68,482,utRho18
aspS,3901402,3901402,3901044,358,368,utRho18
aspT,7893560,7893744,7893560,184,276396,utRho18
aspV,473826,473862,473826,36,226,utRho18
asr,3342654,3342752,3342654,98,56,utRho18
astC,3664088,3664088,3663964,124,0,utRho18
astE,3654138,3654138,3653846,292,52,utRho18
atoD,4646824,4646894,4646824,70,776,utRho18
atpB,7844540,7844540,7844102,438,134,utRho18
atpC,7832118,7832118,7831944,174,1722,utRho18
atpI,7845050,7845050,7844880,170,0,utRho18
avtA,7479348,7479410,7479348,62,764,utRho18
azoR,2965982,2965982,2965720,262,274,utRho18
azuC,3976002,3976002,3975918,84,70,utRho18
bacA,6408350,6408350,6408262,88,420,utRho18
bamA,394052,395856,394052,1804,540,utRho18
bamB,5277950,5277950,5277304,646,496,utRho18
bamC,5198028,5198028,5197730,298,508,utRho18
bamD,5471922,5472292,5471922,370,4114,utRho18
bamE,5506972,5507210,5506972,238,618,utRho18
basS,8666954,8666954,8666544,410,954,utRho18
bax,7474468,7474468,7474354,114,140,utRho18
bcp,5200874,5200956,5200874,82,968,utRho18
bcsB,7385346,7385346,7385214,132,0,utRho18
bcsE,7392644,7392916,7392644,272,52,utRho18
bdcA,8948128,8948128,8948106,22,1674,utRho18
bdcR,8948192,8948248,8948192,56,862,utRho18
bdm,3112680,3112680,3112560,120,118,utRho18
betA,654522,654522,654494,28,34,utRho18
betI,658722,658722,658668,54,30,utRho18
betT,658842,658926,658842,84,106,utRho18
bfr,6933498,6933498,6933450,48,16,utRho18
bglG,23440182,23440182,23439402,780,216,utRho18
bglX,4444240,4444240,4443978,262,52,utRho18
bhsA,2337962,2338146,2337962,184,108,utRho18
bioA,1618584,1618584,1618514,70,4,utRho18
bioB,1618604,1618688,1618604,84,0,utRho18
bioH,7089716,7089716,7089688,28,100,utRho18
bisC,7433026,7433026,7432788,238,56,utRho18
blc,8755490,8755490,8755444,46,0,utRho18
blr,3409024,3409102,3409024,78,222,utRho18
bluF,2431226,2431226,2430950,276,60,utRho18
bluR,2428226,2428226,2428118,108,112,utRho18
bolA,908698,908944,908698,246,56,utRho18
borD,1157842,1157842,1157786,56,78,utRho18
brnQ,838976,839182,838976,206,936,utRho18
bssR,1756492,1756496,1756492,4,0,utRho18
bssS,2242116,2242116,2241910,206,222,utRho18
btuB,8326798,8327278,8326798,480,2790,utRho18
cadB,8720212,8720212,8720062,150,62,utRho18
cadC,8723926,8723926,8723868,58,0,utRho18
caiE,70998,70998,70742,256,240,utRho18
caiF,68436,68600,68436,164,490,utRho18
caiT,84074,84074,83862,212,58,utRho18
can,285406,285406,285340,66,116,utRho18
carA,59102,59302,59102,200,150,utRho18
carB,61550,61634,61550,84,50,utRho18
cas2,5757830,5757830,5757706,124,248,utRho18
casA,5768638,5768638,5768276,362,0,utRho18
cbl,4121882,4121882,4121828,54,1466,utRho18
cbpA,2128074,2128074,2127550,524,640,utRho18
cbrA,7738628,7738754,7738628,126,204,utRho18
cbrB,7794958,7795012,7794958,54,250,utRho18
ccmH,4585242,4585242,4584820,422,140,utRho18
cdaR,364894,364926,364894,32,88,utRho18
cdd,4463638,4463688,4463638,50,0,utRho18
cdh,8219814,8219860,8219814,46,792,utRho18
cdsA,391110,391354,391110,244,446,utRho18
cedA,3627484,3627484,3627326,158,566,utRho18
cfa,3482402,3482826,3482402,424,734,utRho18
chaC,2544844,2544972,2544844,128,150,utRho18
chbB,3643452,3643452,3643238,214,100,utRho18
chbG,3634624,3634624,3634270,354,170,utRho18
cheW,3946924,3946924,3946678,246,584,utRho18
chiA,6939792,6939792,6939706,86,82,utRho18
chiP,1416472,1416668,1416472,196,0,utRho18
cho,3646984,3647030,3646984,46,220,utRho18
chpS,8896804,8896894,8896804,90,108,utRho18
cirA,4493884,4493884,4493538,346,124,utRho18
citC,1304078,1304078,1303712,366,76,utRho18
citT,1293264,1293264,1293160,104,0,utRho18
clcA,350104,350214,350104,110,0,utRho18
clpA,1846160,1846528,1846160,368,68,utRho18
clpB,5468410,5468410,5468346,64,622,utRho18
clpP,913154,913354,913154,200,140,utRho18
clpS,1845500,1845826,1845500,326,66,utRho18
clpX,914404,914852,914404,448,1642,utRho18
clsA,2617346,2617346,2617290,56,238,utRho18
clsC,2212584,2212710,2212584,126,166,utRho18
cmk,1922330,1922402,1922330,72,0,utRho18
cnu,3409522,3409898,3409522,376,930,utRho18
coaA,8350214,8350214,8350052,162,740,utRho18
cobC,1340092,1340092,1339814,278,204,utRho18
cobT,4129202,4129202,4128934,268,144,utRho18
cobU,4131944,4131944,4131528,416,514,utRho18
codB,709768,709844,709768,76,410,utRho18
comR,2337726,2337726,2337664,62,0,utRho18
copA,1022822,1022822,1022758,64,52,utRho18
corA,8002388,8002852,8002388,464,16836,utRho18
cpdB,8873258,8873258,8873130,128,210,utRho18
cptB,6082198,6082198,6082140,58,104,utRho18
cpxA,8210202,8210202,8209950,252,242,utRho18
cpxP,8211570,8211640,8211570,70,180,utRho18
cpxR,8211372,8211372,8211340,32,0,utRho18
cra,175894,176056,175894,162,120,utRho18
crcB,1316016,1316016,1315876,140,250,utRho18
creA,9270486,9271042,9270486,556,910,utRho18
creD,9276320,9276356,9276320,36,474,utRho18
crl,515620,515658,515620,38,1028,utRho18
crp,6971906,6972240,6971906,334,2486,utRho18
crr,5070960,5071668,5070960,708,1826,utRho18
csdA,5886414,5886674,5886414,260,160,utRho18
csgB,2207718,2207902,2207718,184,0,utRho18
csgD,2206688,2206688,2206392,296,254,utRho18
csgG,2203510,2203510,2203368,142,156,utRho18
csiD,5577854,5577970,5577854,116,120,utRho18
csiE,5330802,5330870,5330802,68,174,utRho18
csiR,5590942,5591348,5590942,406,162,utRho18
cspA,7439778,7440098,7439778,320,11066,utRho18
cspB,3283430,3283430,3283108,322,40,utRho18
cspC,3815018,3815018,3814870,148,1206,utRho18
cspD,1845352,1845352,1845180,172,6548,utRho18
cspE,1314294,1314584,1314294,290,140,utRho18
cspF,3283380,3283710,3283380,330,8,utRho18
cspG,2102610,2102922,2102610,312,602,utRho18
cspH,2102746,2102746,2102350,396,0,utRho18
cspI,3277624,3277624,3277334,290,0,utRho18
csrA,5638746,5638746,5638292,454,686,utRho18
csrB,5849048,5849048,5849048,0,0,utRho18
csrC,8102072,8102072,8102072,0,0,utRho18
csrD,6806850,6806850,6806664,186,146,utRho18
cstA,1259710,1259788,1259710,78,0,utRho18
cueO,274090,274166,274090,76,0,utRho18
cueR,1027948,1027986,1027948,38,0,utRho18
curA,3037784,3038054,3037784,270,684,utRho18
cusC,1191146,1191200,1191146,54,206,utRho18
cusR,1190924,1190924,1190886,38,248,utRho18
cutA,8730784,8730784,8730712,72,1484,utRho18
cutC,3918534,3918534,3917920,614,756,utRho18
cvpA,4861600,4861600,4861526,74,98,utRho18
cvrA,2484328,2484328,2484142,186,154,utRho18
cyaA,7981548,7982306,7981548,758,1012,utRho18
cyaR,4334228,4334224,4334228,4,52,utRho18
cyaY,7988166,7988166,7988118,48,82,utRho18
cybB,2981522,2981804,2981522,282,714,utRho18
cycA,8859560,8859728,8859560,168,1222,utRho18
cydA,1542340,1542916,1542340,576,18,utRho18
cydC,1858800,1858800,1858390,410,36,utRho18
cydD,1862062,1862062,1861924,138,32,utRho18
cydX,1548300,1548392,1548300,92,440,utRho18
cynR,717418,717418,717380,38,32,utRho18
cynT,1435092,1435196,1435092,104,0,utRho18
cyoA,903306,903306,903220,86,1966,utRho18
cyoE,895540,895540,895410,130,84,utRho18
cysB,2667576,2667710,2667576,134,182,utRho18
cysC,5748056,5748056,5747984,72,424,utRho18
cysD,5752736,5752736,5752658,78,16,utRho18
cysE,7565362,7565362,7565124,238,1870,utRho18
cysG,6995508,6995656,6995508,148,714,utRho18
cysJ,5783928,5783928,5783796,132,1604,utRho18
cysK,5064688,5064818,5064688,130,590,utRho18
cysP,5087114,5087114,5087056,58,444,utRho18
cysS,1109154,1109222,1109154,68,184,utRho18
cysT,3984100,3984100,3983974,126,608,utRho18
cysZ,5062766,5062926,5062766,160,0,utRho18
cytR,8249018,8249018,8248912,106,0,utRho18
dacA,1328002,1328002,1327926,76,244,utRho18
dacB,6657714,6657926,6657714,212,174,utRho18
dacC,1761306,1761454,1761306,148,680,utRho18
dadA,2475018,2475142,2475018,124,0,utRho18
dam,7032504,7032504,7031826,678,1404,utRho18
damX,7035200,7035200,7034612,588,140,utRho18
dapA,5199568,5199568,5199520,48,0,utRho18
dapB,56576,56748,56576,172,450,utRho18
dapD,371954,371954,371894,60,224,utRho18
dapE,5183120,5183214,5183120,94,1044,utRho18
dcp,3254844,3254844,3254760,84,42,utRho18
dcrB,7219534,7219910,7219534,376,484,utRho18
dctA,7366996,7366996,7366894,102,686,utRho18
dcuA,8733686,8733686,8733546,140,0,utRho18
dcuB,8698182,8698182,8697488,694,3526,utRho18
dcuC,1312166,1312166,1311936,230,488,utRho18
dcuD,6749166,6749738,6749166,572,254,utRho18
dcuR,8701130,8701130,8700068,1062,558,utRho18
dcuS,8703370,8703370,8703324,46,836,utRho18
dcyD,3999016,3999016,3998960,56,0,utRho18
ddpX,3126498,3126498,3126152,346,782,utRho18
deaD,6615818,6615818,6615720,98,1086,utRho18
dedA,4869880,4869880,4869482,398,4372,utRho18
dedD,4863750,4863750,4863368,382,0,utRho18
def,6867300,6867380,6867300,80,128,utRho18
degP,361690,361768,361690,78,0,utRho18
degQ,6761308,6761486,6761308,178,2292,utRho18
deoB,9239134,9239206,9239134,72,18,utRho18
deoC,9233358,9234646,9233358,1288,746,utRho18
dfp,7625406,7625462,7625406,56,0,utRho18
dgcZ,3247758,3247758,3247700,58,0,utRho18
dgkA,8512914,8513274,8512914,360,546,utRho18
dgt,358392,358474,358392,82,766,utRho18
dhaK,2501888,2501888,2501676,212,130,utRho18
dhaR,2502006,2502132,2502006,126,96,utRho18
dicB,3299194,3299218,3299194,24,0,utRho18
dicC,3295752,3295752,3295700,52,0,utRho18
dinB,501760,501796,501760,36,0,utRho18
dinD,7635398,7635520,7635398,122,272,utRho18
dinG,1666146,1666140,1666146,6,0,utRho18
dinI,2243018,2243018,2242974,44,188,utRho18
dinJ,493230,493230,493004,226,124,utRho18
dinQ,7295964,7295964,7295576,388,920,utRho18
djlA,114536,114728,114536,192,186,utRho18
dkgA,6313142,6313246,6313142,104,168,utRho18
dkgB,458196,458334,458196,138,0,utRho18
dksA,321502,321502,321208,294,1642,utRho18
dld,4444164,4444370,4444164,206,124,utRho18
dmlA,3763424,3763824,3763424,400,412,utRho18
dmlR,3763710,3763710,3763618,92,132,utRho18
dmsA,1881646,1881918,1881646,272,0,utRho18
dnaA,7767922,7767922,7767458,464,1754,utRho18
dnaB,8528566,8528628,8528566,62,138,utRho18
dnaK,24096,24326,24096,230,4584,utRho18
dnaN,7765466,7765466,7764642,824,1112,utRho18
dnaQ,471868,472134,471868,266,1820,utRho18
dnaT,18406460,18406460,18406068,392,6048,utRho18
dnaX,984112,984184,984112,72,1092,utRho18
dosP,3131486,3131486,3131466,20,178,utRho18
dpiB,1303968,1304470,1303968,502,38,utRho18
dppA,7415740,7415740,7415410,330,2450,utRho18
dps,1697900,1697900,1697822,78,18,utRho18
dsbA,8086754,8086836,8086754,82,792,utRho18
dsbB,2466294,2466294,2466060,234,188,utRho18
dsbC,6079266,6079266,6077644,1622,1168,utRho18
dsbG,1277600,1277600,1277146,454,216,utRho18
dsdA,4958242,4958404,4958242,162,194,utRho18
dsdC,4955492,4955492,4955258,234,86,utRho18
dsdX,4955642,4955694,4955642,52,46,utRho18
dsrA,4050626,4050626,4050626,0,0,utRho18
dsrB,4049686,4049686,4049646,40,346,utRho18
dtpD,1485340,1485340,1485112,228,240,utRho18
dusA,8523200,8523338,8523200,138,2360,utRho18
dusB,6820492,6820560,6820492,68,108,utRho18
dusC,4460790,4460790,4460770,20,0,utRho18
dut,7627704,7627864,7627704,160,482,utRho18
dxr,386670,387042,386670,372,456,utRho18
ebgA,6445102,6445266,6445102,164,300,utRho18
ebgR,6442874,6442932,6442874,58,146,utRho18
ecnB,8753018,8753106,8753018,88,758,utRho18
eco,4607594,4607810,4607594,216,0,utRho18
ecpA,621594,621594,621342,252,498,utRho18
ecpB,620238,620238,620052,186,242,utRho18
ecpR,622964,622964,622672,292,148,utRho18
eda,3866218,3866218,3865512,706,0,utRho18
edd,3869426,3869426,3869208,218,116,utRho18
efeO,2164308,2164486,2164308,178,0,utRho18
efeU_1,2162614,2162712,2162614,98,214,utRho18
efp,8751134,8751398,8751134,264,1820,utRho18
elaA,4763372,4763372,4763086,286,180,utRho18
elaD,4765308,4765426,4765308,118,0,utRho18
elfA,1995530,1995736,1995530,206,0,utRho18
elfD,1996642,1996980,1996642,338,110,utRho18
emrD,7707690,7707844,7707690,154,148,utRho18
emrK,4966896,4966896,4966678,218,0,utRho18
emrY,4964668,4964668,4964352,316,282,utRho18
emtA,2486250,2486360,2486250,110,26,utRho18
endA,12361100,12361388,12361100,288,172,utRho18
eno,5817692,5817692,5815882,1810,5734,utRho18
entC,1249662,1249770,1249662,108,0,utRho18
entD,1220508,1220508,1220158,350,10,utRho18
entH,1258584,1258600,1258584,16,18,utRho18
entS,1244506,1244600,1244506,94,212,utRho18
envR,6827266,6827266,6826930,336,0,utRho18
epd,12295292,12295292,12294764,528,132,utRho18
epmA,8765236,8765286,8765236,50,56,utRho18
epmB,8751406,8751406,8751314,92,970,utRho18
eptB,7421162,7421162,7420950,212,130,utRho18
eptC,8300622,8300622,8300530,92,882,utRho18
erfK,4126708,4126708,4126646,62,172,utRho18
erpA,353122,353220,353122,98,58,utRho18
esrE,8039956,8039956,8039956,0,0,utRho18
essD,1153746,1154796,1153746,1050,2188,utRho18
etk,2088606,2088606,2088420,186,2062,utRho18
evgA,4967262,4967510,4967262,248,116,utRho18
exbB,6304028,6304028,6303968,60,0,utRho18
exbD,6302780,6302780,6302486,294,296,utRho18
exuR,6493016,6493304,6493016,288,326,utRho18
exuT,6490004,6490208,6490004,204,0,utRho18
fabA,2032996,2032996,2032940,56,0,utRho18
fabB,4883282,4883282,4883210,72,4,utRho18
fabH,2297032,2297518,2297032,486,2618,utRho18
fabI,2702236,2702236,2702078,158,64,utRho18
fadB,8062026,8062026,8061942,84,0,utRho18
fadD,3779614,3779614,3779492,122,0,utRho18
fadE,486812,486812,486606,206,136,utRho18
fadH,6463248,6463330,6463248,82,502,utRho18
fadI,4921022,4921022,4920938,84,218,utRho18
fadL,4922410,4922600,4922410,190,160,utRho18
fadM,928720,928804,928720,84,0,utRho18
fadR,2469810,2469876,2469810,66,0,utRho18
fbaB,4357334,4357334,4357128,206,140,utRho18
fdhE,8162722,8162722,8162456,266,1840,utRho18
fdhF,8598814,8598814,8598732,82,378,utRho18
fdnG,3094744,3094802,3094744,58,0,utRho18
fdrA,1093012,1093360,1093012,348,184,utRho18
feaB,2894994,2895038,2894994,44,0,utRho18
feaR,2894734,2894734,2894566,168,0,utRho18
fecA,9033454,9033454,9033354,100,0,utRho18
fecE,9023288,9023288,9022914,374,1408,utRho18
fecI,9036564,9036564,9036470,94,390,utRho18
feoA,7080114,7080326,7080114,212,278,utRho18
fepA,1225334,1225334,1224988,346,6,utRho18
fepB,1249454,1249454,1249020,434,174,utRho18
fepD,1244468,1244468,1244378,90,0,utRho18
fes,1225374,1225630,1225374,256,52,utRho18
ffh,5495706,5495706,5495590,116,376,utRho18
ffs,952576,952848,952576,272,1260,utRho18
fhuA,334884,334968,334884,84,466,utRho18
fhuE,2323294,2323294,2323102,192,26,utRho18
fhuF,9211504,9211504,9211326,178,50930,utRho18
fic,6983296,6983296,6982926,370,2028,utRho18
fieF,8212864,8212938,8212864,74,0,utRho18
fimA,9085388,9086230,9085388,842,1250,utRho18
fimB,9081334,9081914,9081334,580,2940,utRho18
fimE,9083742,9084074,9083742,332,1986,utRho18
fimZ,1129214,1129214,1128960,254,0,utRho18
fiu,1683296,1683296,1683062,234,60,utRho18
fixA,84650,84806,84650,156,0,utRho18
fkpA,6955050,6955050,6954838,212,3016,utRho18
fldA,2846084,2846084,2845860,224,2436,utRho18
fldB,6079644,6079710,6079644,66,226,utRho18
flgA,2261770,2261770,2261726,44,734,utRho18
flgB,2261986,2262036,2261986,50,16,utRho18
flgK,2276702,2276756,2276702,54,306,utRho18
flgM,2260330,2260330,2260256,74,214,utRho18
flgN,2259828,2259828,2259660,168,22,utRho18
flhB,3932432,3932432,3932382,50,52,utRho18
flhC,3955864,3955864,3955688,176,132,utRho18
flhD,3957154,3957154,3956394,760,1870,utRho18
fliA,4003638,4003638,4003578,60,84,utRho18
fliC,4007352,4007352,4007212,140,76,utRho18
fliD,4007634,4007744,4007634,110,608,utRho18
fliE,4026186,4026186,4026028,158,674,utRho18
fliF,4026292,4026458,4026292,166,494,utRho18
fliL,4039168,4039236,4039168,68,84,utRho18
flk,4875824,4875900,4875824,76,366,utRho18
flu,4142634,4143078,4142634,444,144,utRho18
flxA,3292776,3292810,3292776,34,96,utRho18
fnr,2799104,2799104,2799052,52,52,utRho18
fnrS,2818258,2818258,2818258,0,0,utRho18
focA,1909628,1909628,1908932,696,1906,utRho18
folA,99598,99646,99598,48,128,utRho18
folB,6409296,6409296,6409178,118,0,utRho18
folD,1115562,1115562,1115482,80,304,utRho18
folE,4487696,4487696,4487304,392,2054,utRho18
fpr,8228998,8228998,8228944,54,118,utRho18
frc,4986878,4986878,4986508,370,324,utRho18
frdA,8764824,8764824,8764636,188,128,utRho18
frdD,8758948,8758948,8758732,216,3112,utRho18
fre,8052886,8053054,8052886,168,1074,utRho18
frlA,6999518,6999820,6999518,302,282,utRho18
frr,385624,385744,385624,120,726,utRho18
frsA,513004,513054,513004,50,150,utRho18
fruB,4527194,4527194,4526990,204,84,utRho18
frvR,8179804,8179804,8179710,94,32,utRho18
fryA,5008986,5008986,5008970,16,276,utRho18
fsaA,1727060,1727284,1727060,224,390,utRho18
fsr,1009710,1009710,1009392,318,454,utRho18
ftnA,3977364,3977432,3977364,68,0,utRho18
ftnB,3973550,3973850,3973550,300,372,utRho18
ftsA,207122,207964,207122,842,904,utRho18
ftsB,5745802,5745802,5745640,162,1064,utRho18
ftsH,6654204,6654204,6653870,334,636,utRho18
ftsK,1865858,1866448,1865858,590,942,utRho18
ftsL,181376,182064,181376,688,1420,utRho18
ftsP,6325732,6325732,6325338,394,186,utRho18
ftsQ,205484,206310,205484,826,946,utRho18
ftsX,7204512,7204512,7204172,340,404,utRho18
ftsZ,209272,210610,209272,1338,504,utRho18
fucA,5867708,5867708,5867376,332,2454,utRho18
fucP,5868238,5868470,5868238,232,390,utRho18
fumA,6753760,6753760,6753508,252,4456,utRho18
fumB,8694696,8694696,8694652,44,278,utRho18
fumC,3373418,3373418,3373176,242,0,utRho18
fur,2842892,2842892,2842584,308,2840,utRho18
fusA,6947370,6947370,6947028,342,15250,utRho18
fxsA,8737206,8737328,8737206,122,1222,utRho18
gabD,5581824,5582546,5581824,722,2408,utRho18
gadA,7335214,7335214,7335160,54,48,utRho18
gadB,3144144,3144144,3144090,54,248,utRho18
gadC,3141168,3141168,3140978,190,330,utRho18
gadE,7315600,7316732,7315600,1132,792,utRho18
gadW,7329562,7329562,7329236,326,80,utRho18
gadX,14663356,14663356,14663240,116,1260,utRho18
gadY,7329728,7329728,7329728,0,0,utRho18
galE,1584354,1584354,1584110,244,0,utRho18
galF,4228702,4228702,4228654,48,0,utRho18
galM,1577796,1577796,1577674,122,28,utRho18
galP,6176510,6176568,6176510,58,0,utRho18
galR,5953138,5953198,5953138,60,0,utRho18
galS,4483420,4483420,4483336,84,0,utRho18
galU,2582810,2582914,2582810,104,360,utRho18
gapA,3724480,3725542,3724480,1062,5120,utRho18
garP,6549868,6549868,6549814,54,156,utRho18
gatY,4354468,4354468,4354408,60,50,utRho18
gatZ,4352864,4352864,4352642,222,13866,utRho18
gcd,282558,282558,282450,108,32,utRho18
gcl,1067814,1067832,1067814,18,0,utRho18
gcvA,5885278,5885278,5885134,144,0,utRho18
gcvB,5885392,5885392,5885392,0,0,utRho18
gcvR,5199758,5199812,5199758,54,336,utRho18
gcvT,6101544,6101544,6101334,210,1738,utRho18
gdhA,3684616,3684742,3684616,126,0,utRho18
gfcA,2099668,2099668,2099488,180,1296,utRho18
gfcD,2096236,2096236,2095890,346,1710,utRho18
ghrA,2195648,2195772,2195648,124,8,utRho18
ghrB,7434378,7434620,7434378,242,2922,utRho18
glcA,6242728,6242728,6242558,170,716,utRho18
glcC,6256412,6256544,6256412,132,232,utRho18
glcD,6256152,6256152,6256042,110,212,utRho18
gldA,8278092,8278092,8278070,22,0,utRho18
glgA,7136784,7136784,7136066,718,4504,utRho18
glgB,7147314,7147314,7147004,310,234,utRho18
glgC,7139142,7139142,7138656,486,1078,utRho18
glgP,7133546,7133546,7133162,384,2266,utRho18
glgS,6384024,6384024,6383878,146,44,utRho18
glgX,7142838,7142838,7142638,200,148,utRho18
glk,5018922,5018922,5018852,70,8,utRho18
glmS,7827622,7827622,7827336,286,1314,utRho18
glmU,7830652,7830652,7830400,252,142,utRho18
glmY,10765360,10765360,10765360,0,0,utRho18
glmZ,7972864,7972864,7972864,0,0,utRho18
glnA,16232888,16232888,16232136,752,96,utRho18
glnB,5375052,5375052,5374816,236,522,utRho18
glnD,377310,377310,377300,10,10,utRho18
glnE,6399602,6399602,6399282,320,116,utRho18
glnH,1696396,1696396,1696008,388,316,utRho18
glnK,945112,945196,945112,84,84,utRho18
glnL,8112742,8112742,8112678,64,0,utRho18
glnQ,1693262,1693262,1692926,336,312,utRho18
glnS,1411998,1412186,1411998,188,982,utRho18
gloA,3455602,3455674,3455602,72,66,utRho18
gloB,469852,469852,469564,288,952,utRho18
glpA,4705166,4705294,4705166,128,0,utRho18
glpD,7123942,7124026,7123942,84,74,utRho18
glpE,7123698,7123698,7123646,52,104,utRho18
glpF,8236322,8236322,8236180,142,880,utRho18
glpG,7122960,7122960,7122904,56,94,utRho18
glpR,7121782,7121782,7121210,572,1226,utRho18
glpT,4704902,4704902,4704748,154,264,utRho18
glpX,8231212,8231212,8231158,54,9378,utRho18
glrK,5382246,5382246,5382196,50,1126,utRho18
gltA,1509534,1509534,1508936,598,5144,utRho18
gltB,6709018,6709264,6709018,246,556,utRho18
gltI,1375792,1375792,1375494,298,1888,utRho18
gltP,8588536,8588962,8588536,426,1998,utRho18
gltS,7657382,7657382,7657330,52,882,utRho18
gltX,5041568,5041568,5041344,224,162,utRho18
gluQ,320286,320286,320224,62,578,utRho18
glyA,5371148,5371148,5371014,134,0,utRho18
glyQ,7450708,7450708,7450636,72,352,utRho18
glyS,7448990,7448990,7448794,196,994,utRho18
glyU,5998128,5998128,5998114,14,62,utRho18
glyV,8784626,8784720,8784626,94,306,utRho18
glyW,3984360,3984360,3984234,126,72,utRho18
gmhB,445612,445666,445612,54,0,utRho18
gmk,7642776,7642856,7642776,80,166,utRho18
gmr,2693686,2693686,2693484,202,730,utRho18
gnd,4202648,4202648,4202536,112,348,utRho18
gnsB,3275692,3275692,3275564,128,0,utRho18
gntK,14310580,14310580,14310368,212,1092,utRho18
gntP,9102668,9102668,9102592,76,388,utRho18
gntR,7157760,7157760,7157452,308,436,utRho18
gntT,7092810,7093118,7092810,308,1372,utRho18
gntU,7154170,7154170,7154122,48,70,utRho18
gntX,7089334,7089764,7089334,430,302,utRho18
gor,7292224,7292598,7292224,374,564,utRho18
gpmA,1575340,1575340,1575190,150,0,utRho18
gpmM,7570374,7570520,7570374,146,6,utRho18
gpsA,7567620,7567620,7567322,298,8004,utRho18
gpt,511828,511954,511828,126,998,utRho18
grcA,5433046,5433046,5432898,148,752,utRho18
greA,6657728,6657728,6657430,298,1282,utRho18
greB,7073488,7073624,7073488,136,18,utRho18
groL,8741566,8742050,8741566,484,6422,utRho18
groS,8741232,8741376,8741232,144,14498,utRho18
grpE,5501494,5501494,5501416,78,198,utRho18
grxA,1781552,1781552,1781506,46,22,utRho18
grxB,2248206,2248206,2248108,98,748,utRho18
grxC,7569152,7569152,7568884,268,3172,utRho18
grxD,3468324,3468324,3468202,122,796,utRho18
gspA,6911268,6911268,6910796,472,24,utRho18
gspC,6910964,6911156,6910964,192,10,utRho18
gss,6277220,6277220,6277044,176,96,utRho18
gstA,3428654,3428754,3428654,100,0,utRho18
gstB,1761038,1761038,1760960,78,72,utRho18
guaB,5268214,5268214,5268140,74,16,utRho18
gudD,5839026,5839026,5838770,256,222,utRho18
gyrA,4678914,4678914,4678840,74,0,utRho18
gyrB,7760300,7760300,7760238,62,86,utRho18
hcaE,5337964,5338064,5337964,100,1722,utRho18
hcaR,5337928,5337928,5337792,136,2600,utRho18
hcaT,5336106,5336106,5335692,414,964,utRho18
hchA,4071260,4071670,4071260,410,0,utRho18
hcp,1828258,1828258,1827628,630,1108,utRho18
hcr,1824400,1824400,1824300,100,40,utRho18
hdeA,7313582,7313582,7313480,102,70,utRho18
hdeD,7313920,7313990,7313920,70,316,utRho18
hdfR,7896320,7896320,7895934,386,362,utRho18
hdhA,3396244,3396244,3396080,164,16,utRho18
helD,2048876,2048942,2048876,66,0,utRho18
hemA,2527166,2527428,2527166,262,0,utRho18
hemB,779722,779722,779454,268,1204,utRho18
hemF,5106410,5106450,5106410,40,44,utRho18
hemH,996062,996110,996062,48,710,utRho18
hemL,349882,349882,349764,118,24,utRho18
hemN,8103886,8104090,8103886,204,146,utRho18
hepA,127176,127176,126528,648,2398,utRho18
hflD,2385372,2385372,2385262,110,114,utRho18
hfq,8799602,8800576,8799602,974,19196,utRho18
hha,961006,961006,960616,390,242,utRho18
hicA,3018442,3018572,3018442,130,42,utRho18
higA,6468682,6468682,6468288,394,1510,utRho18
higB,6468960,6468960,6468910,50,0,utRho18
hinT,2323642,2323770,2323642,128,0,utRho18
hipB,3184964,3184964,3184884,80,68,utRho18
hisB,4186720,4186936,4186720,216,610,utRho18
hisJ,4853674,4853674,4853576,98,138,utRho18
hisL,8359856,8359984,8359856,128,168,utRho18
hisS,5281284,5281284,5281150,134,312,utRho18
hlpA,400910,400964,400910,54,312,utRho18
hlyE,2460932,2460932,2460788,144,598,utRho18
hmp,5371594,5371670,5371594,76,8,utRho18
hns,2585916,2585916,2585844,72,304,utRho18
hofM,7045856,7045856,7045502,354,206,utRho18
hokA,7441620,7441620,7441200,420,1908,utRho18
hokC,33902,33902,33806,96,264,utRho18
hokE,1215462,1215672,1215462,210,136,utRho18
holC,8968546,8968546,8968560,14,626,utRho18
holD,9215562,9215606,9215562,44,0,utRho18
holE,3850040,3850216,3850040,176,2582,utRho18
hpt,282720,282862,282720,142,326,utRho18
hrpB,324150,324210,324150,60,44,utRho18
hscB,5319048,5319048,5318934,114,4264,utRho18
hscC,1367188,1367188,1366786,402,984,utRho18
hsdS,9163004,9163004,9162924,80,222,utRho18
hslJ,2883560,2883560,2883486,74,268,utRho18
hslO,7059344,7059548,7059344,204,8070,utRho18
hslR,7058220,7058696,7058220,476,2006,utRho18
hslV,8244708,8244708,8244574,134,458,utRho18
hsrA,7881412,7881412,7881224,188,260,utRho18
htgA,21286,21660,21286,374,14798,utRho18
htpG,989634,990240,989634,606,16512,utRho18
htpX,3825236,3825236,3825152,84,0,utRho18
htrE,311036,311036,310852,184,646,utRho18
htrL,7587668,7587668,7587366,302,286,utRho18
hupA,8400352,8400562,8400352,210,116,utRho18
hupB,1845220,1845804,1845220,584,532,utRho18
hyaA,2063968,2064278,2063968,310,16,utRho18
hybO,6292726,6292726,6292522,204,8272,utRho18
hycA,5700922,5700922,5700870,52,2,utRho18
hycI,5686204,5686204,5686086,118,944,utRho18
hydN,5676264,5676264,5676210,54,0,utRho18
hyfA,5202342,5202402,5202342,60,0,utRho18
hypA,11402508,11402588,11402508,80,88,utRho18
hypB,11403356,11404004,11403356,648,180,utRho18
hypF,5676210,5676210,5674850,1360,1574,utRho18
hypT,9116634,9116634,9116578,56,22,utRho18
hyuA,6019660,6020056,6019660,396,484,utRho18
iaaA,1733074,1733136,1733074,62,58,utRho18
iadA,9119074,9119074,9119052,22,854,utRho18
iap,5753072,5753162,5753072,90,42,utRho18
ibaG,6673966,6673966,6673606,360,232,utRho18
ibpA,7735036,7735036,7734844,192,3962,utRho18
ibpB,7733962,7733962,7733794,168,13252,utRho18
icd,2389922,2390246,2389922,324,450,utRho18
iclR,8447304,8447304,8447256,48,0,utRho18
idi,6065876,6066130,6065876,254,156,utRho18
idnD,8988870,8988870,8988812,58,52,utRho18
idnK,8989194,8989246,8989194,52,40,utRho18
ihfA,3591442,3591442,3591104,338,784,utRho18
ihfB,1927498,1927656,1927498,158,622,utRho18
ileS,43666,44782,43666,1116,3034,utRho18
ileX,6431194,6431196,6431194,2,54,utRho18
ilvA,15820940,15821324,15820940,384,880,utRho18
ilvC,7915824,7915940,7915824,116,52,utRho18
ilvE,15809552,15809936,15809552,384,764,utRho18
ilvI,170840,171260,170840,420,396,utRho18
ilvL,23701308,23701932,23701308,624,0,utRho18
ilvY,7915734,7915734,7915640,94,76,utRho18
inaA,4698998,4698998,4698944,54,264,utRho18
infA,1853370,1853370,1852886,484,770,utRho18
infC,3602692,3602692,3601276,1416,3614,utRho18
insA-5,3958452,3958452,3958430,22,62,utRho18
insA-7,9036758,9037054,9036758,296,1366,utRho18
insC-5,6372080,6372284,6372080,204,6332,utRho18
insEF-2,785238,785238,785820,582,2376,utRho18
insEF-4,2190310,2190310,2190892,582,2716,utRho18
insG,9007098,9007098,9006862,236,174,utRho18
insH-1,550596,550596,550234,362,10858,utRho18
insH-11,7306538,7306538,7306396,142,70,utRho18
insH-2,1151548,1151548,1151506,42,334,utRho18
insH-3,1378444,1378444,1378026,418,926,utRho18
insH-4,2791942,2792152,2791942,210,344,utRho18
insH-5,2857852,2857852,2857452,400,146,utRho18
insH-6,4135022,4135022,4134642,380,1178,utRho18
insH-7,4206186,4206186,4205822,364,2100,utRho18
insH-9,6260050,6260356,6260050,306,396,utRho18
insI-3,9017372,9017372,9017234,138,514,utRho18
insJ,7441188,7441360,7441188,172,612,utRho18
insK,7442130,7442308,7442130,178,42,utRho18
insL-1,30760,30890,30760,130,4160,utRho18
insL-2,1216112,1216130,1216112,18,170,utRho18
insL-3,5028644,5028662,5028644,18,210,utRho18
insN-1,540452,540484,540452,32,34,utRho18
intD,1132202,1132202,1131956,246,7196,utRho18
intR,2826520,2826520,2826470,50,244,utRho18
intS,4933026,4933090,4933026,64,3128,utRho18
intZ,5117386,5117542,5117386,156,1604,utRho18
iraD,9113152,9113986,9113152,834,336,utRho18
iraM,2424246,2424246,2424006,240,260,utRho18
iraP,802638,802772,802638,134,0,utRho18
iscA,5319924,5319924,5319772,152,834,utRho18
iscR,5324398,5324398,5324262,136,10848,utRho18
iscX,5313834,5313834,5313472,362,1840,utRho18
ispF,5743968,5743968,5743560,408,2546,utRho18
ispG,5283908,5283908,5283608,300,412,utRho18
ispU,389568,389806,389568,238,104,utRho18
isrA,2811502,2811502,2811618,116,68,utRho18
istr-1,7706384,7706384,7706384,0,0,utRho18
istr-2,7706514,7706514,7706514,0,0,utRho18
ivbL,15412092,15412092,15411952,140,624,utRho18
ivy,480638,480686,480638,48,4,utRho18
katE,3627628,3627734,3627628,106,586,utRho18
katG,8267624,8267670,8267624,46,34,utRho18
kbaZ,6557732,6557828,6557732,96,94,utRho18
kbl,7585154,7585154,7585102,52,1000,utRho18
kch,2621046,2621046,2620538,508,246,utRho18
kdgR,3820506,3820506,3820198,308,0,utRho18
kdpE,1443788,1443788,1443466,322,0,utRho18
kdpF,1457698,1457698,1457642,56,32,utRho18
kdsA,2535708,2536330,2535708,622,1972,utRho18
kdsC,6683438,6684546,6683438,1108,2596,utRho18
kduI,5968388,5968388,5968248,140,5906,utRho18
kefF,94160,94492,94160,332,1538,utRho18
kgtP,5451624,5451624,5451492,132,314,utRho18
kup,7862206,7862632,7862206,426,0,utRho18
lacI,735076,735076,735020,56,52,utRho18
lacZ,1465508,1465508,1465220,288,208,utRho18
ldcA,2486394,2486394,2486160,234,174,utRho18
ldhA,2885830,2885830,2885686,144,0,utRho18
ldrA,2538954,2538954,2538550,404,2286,utRho18
ldrB,2540024,2540024,2539620,404,968,utRho18
ldrC,2541092,2541092,2540690,402,554,utRho18
ldrD,7400544,7400544,7400174,370,1588,utRho18
lepA,5414392,5414392,5414248,144,164,utRho18
lepB,5410928,5410928,5410618,310,312,utRho18
leuD,159188,159188,158906,282,64,utRho18
leuE,3761600,3761600,3761518,82,28,utRho18
leuL,168048,168048,167416,632,172,utRho18
leuO,168308,168736,168308,428,188,utRho18
leuQ,9212864,9212864,9212802,62,130,utRho18
leuU,6644556,6644556,6644316,240,2184,utRho18
leuV,9212546,9212546,9212330,216,1092,utRho18
leuX,8992772,8992810,8992772,38,106,utRho18
lexA,8514174,8514230,8514174,56,286,utRho18
lhr,3456706,3458174,3456706,1468,2320,utRho18
ligA,5060402,5060402,5060352,50,0,utRho18
ligB,7642576,7642576,7642340,236,388,utRho18
lipA,1320602,1320602,1320432,170,364,utRho18
lipB,1324802,1324802,1324556,246,5214,utRho18
lit,2397032,2397390,2397032,358,1236,utRho18
livJ,7199524,7199524,7199316,208,722,utRho18
livK,7195510,7195510,7195120,390,210,utRho18
lldP,7554578,7554798,7554578,220,3836,utRho18
lnt,1381968,1381968,1381762,206,666,utRho18
loiP,6163784,6163826,6163784,42,0,utRho18
lolA,1874656,1874738,1874656,82,194,utRho18
lolB,2527112,2527112,2527000,112,0,utRho18
lolC,2350748,2350854,2350748,106,28,utRho18
lon,917630,917776,917630,146,300,utRho18
lpcA,486936,487086,486936,150,62,utRho18
lpd,255434,255824,255434,390,3292,utRho18
lplA,9248476,9248476,9248234,242,898,utRho18
lplT,5947878,5947878,5947724,154,58,utRho18
lpoA,6586422,6586800,6586422,378,88,utRho18
lpp,3514592,3514842,3514592,250,210,utRho18
lptA,6686598,6686760,6686598,162,588,utRho18
lptB,6686792,6687888,6686792,1096,1846,utRho18
lptD,114672,114672,114218,454,520,utRho18
lptF,8972244,8972436,8972244,192,76,utRho18
lpxC,213016,213114,213016,98,4384,utRho18
lpxD,401920,401942,401920,22,22,utRho18
lpxL,2233418,2233418,2233164,254,40,utRho18
lpxM,3880456,3880456,3880386,70,0,utRho18
lpxP,4991156,4991290,4991156,134,396,utRho18
lrhA,4813312,4813312,4813282,30,16,utRho18
lrp,1864656,1865190,1864656,534,1088,utRho18
lspA,50028,50414,50028,386,1392,utRho18
lsrA,3202920,3202980,3202920,60,0,utRho18
lsrR,3202514,3202514,3202482,32,0,utRho18
ltaE,1818640,1818640,1818588,52,0,utRho18
luxS,5630130,5630130,5629466,664,15974,utRho18
lysA,5957902,5957902,5957798,104,38,utRho18
lysC,8467232,8467232,8466466,766,784,utRho18
lysP,4497120,4497120,4497064,56,88,utRho18
lysR,5957900,5958042,5957900,142,98,utRho18
lysT,1561028,1561108,1561028,80,48,utRho18
lysU,8709610,8709610,8709434,176,290,utRho18
macB,1840188,1840694,1840188,506,718,utRho18
maeA,3111484,3111484,3111338,146,7730,utRho18
mak,820236,820288,820236,52,38,utRho18
malE,8492928,8492928,8492838,90,46,utRho18
malI,3398456,3398456,3398360,96,0,utRho18
malK,8493472,8493568,8493472,96,190,utRho18
malP,7105020,7105020,7104946,74,528,utRho18
malQ,7100798,7100798,7100140,658,262,utRho18
malS,14949880,14949988,14949880,108,44,utRho18
malT,7106048,7106170,7106048,122,184,utRho18
malX,3398626,3398710,3398626,84,0,utRho18
malZ,1689980,1690072,1689980,92,2288,utRho18
manA,3377102,3377152,3377102,50,56,utRho18
manX,3803866,3804096,3803866,230,152,utRho18
marC,3237882,3237882,3237816,66,186,utRho18
marR,3238186,3238240,3238186,54,354,utRho18
matP,2036918,2036970,2036918,52,0,utRho18
mazE,5822736,5822736,5822678,58,0,utRho18
mazG,5821720,5821720,5821370,350,2120,utRho18
mcbA,1684306,1684306,1684112,194,46,utRho18
mcbR,3040192,3040524,3040192,332,0,utRho18
mcrA,2420278,2420692,2420278,414,94,utRho18
mcrC,9156124,9156124,9155916,208,566,utRho18
mdaB,6344814,6345060,6344814,246,128,utRho18
mdfA,1767138,1767346,1767138,208,0,utRho18
mdh,6768940,6768940,6768536,404,188,utRho18
mdoB,9198988,9198988,9198882,106,5388,utRho18
mdoD,2993290,2993712,2993290,422,176,utRho18
mdoG,2218514,2218670,2218514,156,36,utRho18
mdtA,4307958,4308032,4307958,74,204,utRho18
mdtE,7318168,7318464,7318168,296,6690,utRho18
mdtK,3486538,3486914,3486538,376,1340,utRho18
mdtP,8602472,8602472,8602060,412,478,utRho18
melA,8683774,8683822,8683774,48,0,utRho18
melR,8683300,8683300,8683256,44,626,utRho18
menA,8240812,8240812,8240698,114,136,utRho18
menB,4753774,4753774,4753638,136,626,utRho18
mepH,3468714,3468870,3468714,156,18,utRho18
mepM,3883666,3883666,3883270,396,12,utRho18
mepS,4539840,4539958,4539840,118,452,utRho18
metA,8428318,8428560,8428318,242,332,utRho18
metB,8257272,8257344,8257272,72,348,utRho18
metC,6304150,6304472,6304150,322,230,utRho18
metE,8025768,8026106,8025768,338,1708,utRho18
metF,8265092,8265232,8265092,140,56,utRho18
metG,4388538,4388600,4388538,62,90,utRho18
metH,8447010,8447656,8447010,646,2004,utRho18
metJ,8257116,8257116,8256790,326,114,utRho18
metK,6173154,6173412,6173154,258,278,utRho18
metN,445428,445428,445290,138,60,utRho18
metR,8025710,8025710,8025632,78,0,utRho18
metT,1394326,1394326,1394266,60,258,utRho18
metY,19910250,19910250,19909734,516,474,utRho18
metZ,11789528,11789548,11789528,20,540,utRho18
mfd,2348056,2348056,2347928,128,62,utRho18
mglA,4478782,4478782,4478578,204,804,utRho18
mglB,4481132,4481132,4480696,436,11446,utRho18
mglC,4475918,4475918,4475506,412,704,utRho18
mgrB,3817584,3817584,3817532,52,66,utRho18
mgrR,3245828,3245828,3245828,0,0,utRho18
mgsA,2054082,2054082,2054030,52,0,utRho18
mgtL,8934560,8934862,8934560,302,76,utRho18
mhpA,737038,737222,737038,184,36,utRho18
mhpR,737072,737072,736840,232,18,utRho18
mhpT,750772,750918,750772,146,0,utRho18
miaA,8797964,8798504,8797964,540,5620,utRho18
micA,5629604,5629604,5629604,0,0,utRho18
micC,2874242,2874238,2874242,4,4,utRho18
micF,4626168,4626168,4626168,0,0,utRho18
micM,1014408,1014408,1014408,0,0,utRho18
minE,2449422,2449422,2449090,332,1760,utRho18
mioC,7852950,7852950,7852910,40,0,utRho18
mipA,3733012,3733012,3732944,68,2728,utRho18
mlaA,4930270,4930270,4930014,256,128,utRho18
mlc,3337206,3337206,3337128,78,28,utRho18
mlrA,4429498,4429732,4429498,234,242,utRho18
mltA,5894546,5894546,5894356,190,88,utRho18
mltD,468050,468050,467910,140,0,utRho18
mltF,5391534,5391602,5391534,68,38,utRho18
mmuP,550238,550650,550238,412,11776,utRho18
mngA,1531622,1531968,1531622,346,350,utRho18
mngR,1531852,1531852,1531750,102,296,utRho18
mnmG,7851348,7851348,7851266,82,3592,utRho18
mntH,5025470,5025470,5025412,58,0,utRho18
mntP,3810918,3811376,3810918,458,2030,utRho18
mntR,1706160,1706366,1706160,206,0,utRho18
mntS,1706128,1706128,1705994,134,0,utRho18
moaA,1633654,1634088,1633654,434,1388,utRho18
moaB,1635954,1636110,1635954,156,614,utRho18
mobA,8084242,8084242,8083998,244,384,utRho18
mocA,6030112,6030320,6030112,208,862,utRho18
modA,1589990,1590178,1589990,188,0,utRho18
moeA,1732788,1732788,1732728,60,0,utRho18
mokB,2984610,2984610,2984258,352,456,utRho18
molR_1,4392888,4392948,4392888,60,0,utRho18
motA,3954604,3954604,3954278,326,148,utRho18
mpaA,2781278,2781278,2781196,82,26,utRho18
mpl,8911456,8911570,8911456,114,0,utRho18
mppA,2786108,2786454,2786108,346,74,utRho18
mprA,5621494,5621540,5621494,46,600,utRho18
mqo,4613848,4613848,4613508,340,648,utRho18
mqsA,6336742,6336742,6336492,250,554,utRho18
mqsR,6337306,6337306,6337088,218,680,utRho18
mraZ,179192,179268,179192,76,0,utRho18
mrcA,7045652,7045742,7045652,90,50,utRho18
mrcB,329442,329460,329442,18,0,utRho18
mreB,13605424,13605424,13604348,1076,1048,utRho18
mreD,6798166,6798166,6797750,416,192,utRho18
mrp,4388360,4388360,4388336,24,76,utRho18
mscK,972984,973072,972984,88,134,utRho18
mscL,6876002,6876048,6876002,46,714,utRho18
mscS,6139742,6139742,6139614,128,158,utRho18
msrA,8884522,8884522,8884352,170,252,utRho18
msrB,3725168,3725168,3724858,310,0,utRho18
msyB,2228426,2228426,2228362,64,100,utRho18
mtfA,4087236,4087302,4087236,66,804,utRho18
mtgA,6699662,6699662,6699618,44,1110,utRho18
mtlA,30177504,30178248,30177504,744,3736,utRho18
mtn,358366,358366,358306,60,1124,utRho18
mtr,6611864,6611864,6611634,230,114,utRho18
mug,6430992,6430992,6430946,46,388,utRho18
murQ,5091466,5091546,5091466,80,0,utRho18
murR,5091586,5091586,5091218,368,0,utRho18
mutH,5939164,5939324,5939164,160,12,utRho18
mutL,8794092,8794824,8794092,732,10284,utRho18
mutM,7622554,7622554,7622304,250,820,utRho18
mutS,5714038,5714186,5714038,148,578,utRho18
mutY,18617466,18618078,18617466,612,636,utRho18
nac,4123956,4123956,4123866,90,164,utRho18
nadA,1564122,1564170,1564122,48,130,utRho18
nadB,5420714,5420840,5420714,126,122,utRho18
nadC,237326,237326,237290,36,262,utRho18
nadE,3644604,3644916,3644604,312,350,utRho18
nadK,5501526,5501662,5501526,136,6,utRho18
nagA,1406350,1406350,1405502,848,5572,utRho18
nagB,1407416,1407416,1407222,194,64,utRho18
nagC,1404016,1404016,1403188,828,260,utRho18
nagE,1407680,1407888,1407680,208,56,utRho18
nagK,2357080,2357186,2357080,106,132,utRho18
nanA,6747240,6747240,6747152,88,108,utRho18
nanC,9079856,9079856,9079002,854,1706,utRho18
nanR,6749406,6749406,6748978,428,388,utRho18
nanS,9075406,9075406,9075188,218,426,utRho18
napF,4607390,4607390,4606994,396,208,utRho18
narG,2559614,2559728,2559614,114,338,utRho18
narK,2555642,2555914,2555642,272,366,utRho18
narP,4580844,4581000,4580844,156,324,utRho18
narQ,5171154,5171462,5171154,308,306,utRho18
narU,3088326,3088326,3088120,206,218,utRho18
narW,3077374,3077374,3074618,2756,684,utRho18
narX,2555554,2555554,2555236,318,590,utRho18
narZ,3085380,3085380,3085180,200,0,utRho18
ndh,2331984,2332170,2331984,186,254,utRho18
ndk,5289920,5289920,5289728,192,156,utRho18
nemR,6904084,6904092,6904084,8,664,utRho18
nepI,7683542,7683542,7683478,64,132,utRho18
nfo,4501612,4501680,4501612,68,130,utRho18
nfsB,1210906,1210906,1210848,58,42,utRho18
nfuA,7090916,7091248,7090916,332,624,utRho18
nhaA,34634,34978,34634,344,628,utRho18
nhaB,2469534,2469534,2469434,100,94,utRho18
nhoA,3067926,3068048,3067926,122,38,utRho18
nikA,7226878,7227334,7226878,456,3758,utRho18
nikR,7237074,7237176,7237074,102,744,utRho18
nirB,6987974,6988022,6987974,48,176,utRho18
nlpA,7680034,7680034,7679986,48,60,utRho18
nlpC,3585654,3585654,3585462,192,94,utRho18
nlpD,5737658,5737658,5737506,152,298,utRho18
nlpI,6618080,6618080,6617848,232,0,utRho18
nmpC,1153740,1153740,1153650,90,146,utRho18
nohA,3273206,3273206,3272734,472,428,utRho18
norR,5664614,5664614,5664578,36,0,utRho18
norV,5664878,5664952,5664878,74,44,utRho18
nrdA,4689510,4689730,4689510,220,3042,utRho18
nrdD,8925676,8925676,8925320,356,9052,utRho18
nrdH,5601312,5601446,5601312,134,154,utRho18
nrdR,865954,866004,865954,50,62,utRho18
nrfA,8575342,8575528,8575342,186,0,utRho18
nsrR,8812088,8812380,8812088,292,5952,utRho18
nudB,3897348,3897348,3897264,84,0,utRho18
nudC,8393428,8393806,8393428,378,130,utRho18
nudE,7052658,7052658,7052298,360,382,utRho18
nudG,3682876,3682980,3682876,104,60,utRho18
nudI,4729050,4729108,4729050,58,0,utRho18
nudJ,2388874,2388874,2388576,298,190,utRho18
nuoA,4810670,4810670,4810144,526,5768,utRho18
nuoN,4783434,4783434,4783010,424,1256,utRho18
nupC,5026018,5026084,5026018,66,0,utRho18
nupG,6211302,6211428,6211302,126,144,utRho18
ogrK,4335096,4335096,4335040,56,0,utRho18
ogt,2800568,2800568,2800472,96,104,utRho18
ohsC,5401036,5401040,5401036,4,62,utRho18
ompA,2040382,2040382,2040106,276,19358,utRho18
ompC,4625774,4625774,4625498,276,488,utRho18
ompF,1974184,1974184,1973964,220,262,utRho18
ompL,8128958,8128958,8128590,368,274,utRho18
ompN,2874158,2874158,2873786,372,4,utRho18
ompR,7073510,7073510,7073168,342,0,utRho18
ompT,1171330,1171330,1171266,64,304,utRho18
ompW,2627982,2628040,2627982,58,68,utRho18
ompX,1700418,1700900,1700418,482,1862,utRho18
omrA,5952378,5952378,5952378,0,0,utRho18
omrB,5952770,5952770,5952770,0,0,utRho18
oppA,2602170,2602364,2602170,194,3932,utRho18
orn,8783168,8783208,8783168,40,0,utRho18
osmB,2686952,2686952,2686656,296,878,utRho18
osmC,3113192,3113250,3113192,58,492,utRho18
osmE,3644566,3644566,3644512,54,58,utRho18
osmF,4439046,4439046,4438962,84,1730,utRho18
osmY,9222306,9222792,9222306,486,1744,utRho18
otsA,3963302,3963302,3963224,78,240,utRho18
otsB,3964930,3964930,3964774,156,414,utRho18
oxc,4984288,4984288,4983900,388,980,utRho18
oxyR,8316914,8316980,8316914,66,872,utRho18
oxyS,8316788,8316788,8316788,0,0,utRho18
paaA,2907730,2907854,2907730,124,16,utRho18
paaX,2927018,2927078,2927018,60,0,utRho18
paaZ,2907340,2907340,2907284,56,0,utRho18
pabA,6981702,6981702,6981658,44,118,utRho18
pabB,3789256,3789610,3789256,354,298,utRho18
pabC,2306186,2306600,2306186,414,2030,utRho18
pagP,1313052,1313114,1313052,62,22,utRho18
panB,299260,299260,299202,58,5984,utRho18
panC,297840,297840,297590,250,480,utRho18
panD,293490,293490,293388,102,66,utRho18
panZ,7195656,7195968,7195656,312,282,utRho18
parC,6332060,6332060,6331946,114,556,utRho18
patA,6438916,6438988,6438916,72,120,utRho18
patD,3030830,3031156,3030830,326,288,utRho18
pbpC,5294986,5294986,5294650,336,148,utRho18
pbpG,4450132,4450132,4449740,392,144,utRho18
pck,7065358,7065636,7065358,278,2582,utRho18
pcnB,318782,318782,318252,530,406,utRho18
pdhR,244068,244184,244068,116,0,utRho18
pdxB,4875768,4875768,4875702,66,156,utRho18
pdxH,3436068,3436068,3436014,54,272,utRho18
pdxJ,5403626,5403626,5403458,168,90,utRho18
pdxK,5074638,5074638,5074474,164,52,utRho18
pepA,8972278,8972278,8971902,376,144,utRho18
pepD,511618,511618,511432,186,2444,utRho18
pepN,1981182,1981244,1981182,62,120,utRho18
pepQ,8062294,8062322,8062294,28,56,utRho18
pepT,2371646,2371688,2371646,42,182,utRho18
pfkA,8214948,8215104,8214948,156,176,utRho18
pfkB,3612646,3612740,3612646,94,0,utRho18
pflA,1902456,1902456,1902160,296,12,utRho18
pflB,1907850,1907850,1907108,742,1066,utRho18
pflD,8287716,8287990,8287716,274,56,utRho18
pgaA,2185046,2185046,2184578,468,92,utRho18
pgi,8467444,8467516,8467444,72,10,utRho18
pgk,12291428,12291428,12290488,940,2600,utRho18
pgl,1597078,1597172,1597078,94,0,utRho18
pgpB,2678324,2678660,2678324,336,370,utRho18
pgpC,5397276,5397276,5397100,176,116,utRho18
pgrR,2783744,2783982,2783744,238,294,utRho18
pheL,5475158,5475198,5475158,40,164,utRho18
pheM,7197204,7197204,7197080,124,0,utRho18
pheP,1203858,1203918,1203858,60,238,utRho18
pheU,8725254,8725254,8725252,2,4,utRho18
pheV,6220730,6220732,6220730,2,4,utRho18
phnC,8650412,8650412,8650330,82,188,utRho18
phoA,803414,803494,803414,80,226,utRho18
phoB,834202,834284,834202,82,0,utRho18
phoE,520316,520316,520200,116,562,utRho18
phoH,2169730,2169984,2169730,254,486,utRho18
phoP,2381016,2381016,2380894,122,2046,utRho18
phoQ,2379880,2379880,2379552,328,1172,utRho18
phoU,7815330,7815330,7815156,174,298,utRho18
phr,1478842,1479014,1478842,172,54,utRho18
pinE,2419054,2419370,2419054,316,370,utRho18
pinQ,3267168,3267244,3267168,76,180,utRho18
pinR,2867424,2867424,2867348,76,202,utRho18
pitA,7275224,7275284,7275224,60,96,utRho18
pitB,6272806,6272806,6272742,64,102,utRho18
pka,5439862,5439906,5439862,44,246,utRho18
plaP,4174476,4174476,4174124,352,516,utRho18
pldA,8009628,8009724,8009628,96,1138,utRho18
pldB,8018028,8018340,8018028,312,2404,utRho18
plsB,8513196,8513196,8512932,264,456,utRho18
pmbA,8915890,8915918,8915890,28,98,utRho18
pmrD,4747148,4747148,4747076,72,32,utRho18
pncB,1980828,1980828,1980712,116,0,utRho18
pncC,5648788,5648788,5648692,96,0,utRho18
pnp,6622652,6622652,6622336,316,94,utRho18
pntA,3355950,3355950,3355806,144,40,utRho18
pntB,3353096,3353096,3352720,376,244,utRho18
polA,8093880,8093932,8093880,52,248,utRho18
polB,131606,131606,131560,46,0,utRho18
potD,2365700,2365700,2365658,42,0,utRho18
potE,1436688,1436688,1436530,158,64,utRho18
potF,1787268,1787568,1787268,300,486,utRho18
poxB,1822152,1822152,1822098,54,226,utRho18
ppa,8899372,8899372,8899304,68,132,utRho18
ppc,8306380,8306380,8306196,184,942,utRho18
ppdA,5928440,5928440,5928354,86,1800,utRho18
ppdD,235410,235410,235098,312,30,utRho18
pphA,3846770,3846770,3845938,832,5024,utRho18
pphB,5719474,5719520,5719474,46,160,utRho18
ppiA,6984898,6984898,6984594,304,332,utRho18
ppiC,7919682,7919682,7919626,56,328,utRho18
ppiD,923638,923830,923638,192,150,utRho18
ppk,5245748,5246088,5245748,340,550,utRho18
pppA,6228958,6228958,6228704,254,88,utRho18
ppsA,3574322,3574322,3574224,98,2,utRho18
ppsR,3574678,3574890,3574678,212,14,utRho18
pptA,3065716,3066104,3065716,388,374,utRho18
pqiA,2023318,2024002,2023318,684,0,utRho18
prc,3830054,3830054,3829632,422,7176,utRho18
preT,4467978,4468066,4467978,88,1674,utRho18
prfC,9218688,9218828,9218688,140,1776,utRho18
prkB,6968622,6968980,6968622,358,1592,utRho18
prlC,7290476,7290476,7290364,112,150,utRho18
prlF,6553944,6554004,6553944,60,446,utRho18
proB,520432,520776,520432,344,628,utRho18
proC,811372,811372,811288,84,0,utRho18
proK,7417388,7417388,7417384,4,0,utRho18
proL,4572414,4572422,4572414,8,14,utRho18
proP,8660640,8661004,8660640,364,520,utRho18
proS,437674,437674,437550,124,1384,utRho18
proV,5609126,5609630,5609126,504,1058,utRho18
prpB,697292,697364,697292,72,68,utRho18
prpR,696942,696942,696886,56,0,utRho18
prs,2524354,2524354,2523750,604,38682,utRho18
psd,8781276,8781276,8780720,556,290,utRho18
psiE,8480600,8480650,8480600,50,0,utRho18
pspA,2736076,2736158,2736076,82,0,utRho18
pspF,2736080,2736080,2735824,256,72,utRho18
pspG,8525632,8525680,8525632,48,32,utRho18
pssA,5445156,5445454,5445156,298,4192,utRho18
pstB,7817112,7817112,7816732,380,292,utRho18
pstC,7821084,7821084,7820796,288,44,utRho18
pstS,23469408,23469408,23469150,258,336,utRho18
psuG,4517114,4517114,4516734,380,4624,utRho18
psuT,4514992,4514992,4514670,322,92,utRho18
pth,2517084,2517084,2517026,58,0,utRho18
ptrA,5918022,5918022,5917768,254,0,utRho18
ptrB,3857730,3857730,3857678,52,2624,utRho18
ptsG,2315252,2315738,2315252,486,3208,utRho18
ptsH,5066996,5067528,5066996,532,3624,utRho18
purA,8809328,8809374,8809328,46,0,utRho18
purC,5195562,5195562,5195236,326,0,utRho18
purD,8411972,8411972,8411862,110,100,utRho18
purE,1106284,1106284,1106200,84,952,utRho18
purH,8415254,8415254,8415064,190,64,utRho18
purL,5391178,5391178,5391086,92,672,utRho18
purM,5242306,5242394,5242306,88,0,utRho18
purR,3475378,3475688,3475378,310,970,utRho18
purT,3861438,3861762,3861438,324,62,utRho18
purU,2577512,2577512,2577248,264,734,utRho18
putA,2157850,2157850,2157764,86,28,utRho18
putP,2158336,2158610,2158336,274,718,utRho18
puuA,2721936,2721936,2721816,120,0,utRho18
puuC,2725456,2725486,2725456,30,0,utRho18
puuD,2722104,2722240,2722104,136,0,utRho18
puuP,2718746,2718746,2718374,372,886,utRho18
pykA,3874988,3875298,3874988,310,532,utRho18
pykF,3510934,3511396,3510934,462,1090,utRho18
pyrC,2245286,2245286,2245214,72,0,utRho18
pyrD,2009464,2009536,2009464,72,76,utRho18
pyrE,7631970,7631970,7631536,434,408,utRho18
pyrF,2683740,2683842,2683740,102,84,utRho18
pyrG,5819594,5819594,5819332,262,2192,utRho18
pyrH,383624,383710,383624,86,1000,utRho18
pyrL,8945490,8945490,8945066,424,462,utRho18
qmcA,1031646,1031646,1031546,100,452,utRho18
qor,8528608,8528608,8528462,146,76,utRho18
qseB,6339502,6339656,6339502,154,248,utRho18
queA,849970,850022,849970,52,482,utRho18
queE,5811212,5811212,5810836,376,276,utRho18
queF,5850642,5850696,5850642,54,38,utRho18
queG,8788184,8788184,8788134,50,38484,utRho18
racC,2835630,2835630,2835526,104,0,utRho18
racR,2840898,2840898,2840482,416,96,utRho18
raiA,5474208,5474308,5474208,100,134,utRho18
rarD,8008594,8008594,8008356,238,578,utRho18
ravA,7862256,7862256,7862186,70,0,utRho18
rayT,495088,495274,495088,186,280,utRho18
rbn,4763162,4763216,4763162,54,0,utRho18
rbsD,7866644,7866702,7866644,58,0,utRho18
rcnA,4371654,4371834,4371654,180,148,utRho18
rcnB,4373768,4373920,4373768,152,152,utRho18
rcnR,4371806,4371806,4371592,214,234,utRho18
rcsA,4047672,4047936,4047672,264,1394,utRho18
rcsB,4631390,4632354,4631390,964,964,utRho18
rcsC,4640162,4640162,4639656,506,38,utRho18
rcsD,4626904,4626976,4626904,72,90,utRho18
rdgB,6193240,6193362,6193240,122,818,utRho18
rdlA,2538646,2538646,2538646,0,0,utRho18
rdlB,2539712,2539716,2539712,4,30,utRho18
rdlC,2540782,2540786,2540782,4,0,utRho18
rdlD,7400272,7400272,7400272,0,0,utRho18
rdoA,8084782,8084830,8084782,48,0,utRho18
recA,11295276,11295276,11295076,200,464,utRho18
recC,5925014,5925014,5924856,158,370,utRho18
recF,7763722,7763722,7762442,1280,6350,utRho18
recN,5503518,5503590,5503518,72,54,utRho18
recQ,8011666,8011728,8011666,62,0,utRho18
relA,5828554,5828554,5827302,1252,412,utRho18
relB,3291806,3291806,3291744,62,0,utRho18
rem,3289950,3289950,3289804,146,0,utRho18
rep,7921294,7921354,7921294,60,0,utRho18
rfaD,7587730,7587974,7587730,244,592,utRho18
rfaE,6393852,6393852,6393506,346,10,utRho18
rfaH,8049930,8049930,8049642,288,1828,utRho18
rfbX,4219436,4219436,4219168,268,800,utRho18
rfe,7935600,7935832,7935600,232,56,utRho18
rhaB,8194944,8194944,8194896,48,102,utRho18
rhaD,8188770,8188770,8188544,226,0,utRho18
rhaS,8195422,8195472,8195422,50,0,utRho18
rhaT,8201132,8201132,8201050,82,102,utRho18
rhlE,1661566,1661744,1661566,178,194,utRho18
rhoL,47593944,47594772,47593944,828,72840,utRho18
rhsB,7238006,7238384,7238006,378,1024,utRho18
rhsC,1458758,1459166,1458758,408,0,utRho18
rhsD,1046132,1046522,1046132,390,128,utRho18
rhtA,1700608,1700608,1700194,414,368,utRho18
rhtC,8015478,8015514,8015478,36,664,utRho18
ribA,2678468,2678468,2678320,148,328,utRho18
ribC,3486916,3486916,3486484,432,2428,utRho18
ribE,869008,869294,869008,286,3294,utRho18
ribF,42766,42814,42766,48,0,utRho18
ridA,8941892,8941892,8941826,66,102,utRho18
rihA,1369204,1369204,1368824,380,3486,utRho18
rihB,4510504,4510504,4510372,132,346,utRho18
rimJ,2251044,2251124,2251044,80,152,utRho18
rimK,1783752,1783934,1783752,182,614,utRho18
rimL,2997486,2997876,2997486,390,220,utRho18
rimO,1756140,1756140,1756070,70,56,utRho18
rimP,6636350,6636350,6636012,338,532,utRho18
rlmA,3814172,3814172,3814120,52,1296,utRho18
rlmD,5830086,5830086,5830000,86,176,utRho18
rlmE,6655520,6655520,6655328,192,804,utRho18
rlmF,1684384,1684664,1684384,280,62,utRho18
rlmG,6471784,6471784,6471750,34,38,utRho18
rlmI,2060002,2060002,2059938,64,172,utRho18
rlmJ,7290700,7290770,7290700,70,158,utRho18
rlmL,2015344,2015688,2015344,344,1846,utRho18
rlpA,1330444,1330444,1330380,64,32,utRho18
rluA,120900,120900,120692,208,588,utRho18
rluF,8460324,8460708,8460324,384,74,utRho18
rmf,2031006,2031430,2031006,424,1206,utRho18
rna,1290068,1290068,1290006,62,98,utRho18
rnb,2698258,2698258,2697824,434,2492,utRho18
rnc,10816892,10816892,10816252,640,5832,utRho18
rnd,3776122,3776122,3775982,140,64,utRho18
rne,2289746,2289746,2288734,1012,5200,utRho18
rnhA,472082,472082,472004,78,420,utRho18
rnk,1288360,1288360,1287934,426,116,utRho18
rnlA,5531788,5531836,5531788,48,510,utRho18
rnlB,5533414,5533968,5533414,554,838,utRho18
rnpB,19623552,19623552,19623552,0,0,utRho18
rob,9270706,9270706,9270620,86,186,utRho18
rodZ,5285868,5285868,5285688,180,0,utRho18
rpe,7030306,7030306,7030118,188,272,utRho18
rph,15266320,15266320,15266196,124,160,utRho18
rpiA,6118706,6118706,6118650,56,1098,utRho18
rpiB,8626514,8626700,8626514,186,172,utRho18
rpiR,8626274,8626274,8625982,292,130,utRho18
rplJ,8359246,8359992,8359246,746,9842,utRho18
rplK,8356708,8356894,8356708,186,1172,utRho18
rplM,6757344,6757344,6757302,42,7540,utRho18
rplN,6896444,6896444,6896298,146,15114,utRho18
rplS,5489284,5489284,5489060,224,6142,utRho18
rplT,7199052,7199052,7198996,56,1380,utRho18
rplU,6667036,6667036,6666902,134,0,utRho18
rplY,4564866,4565034,4564866,168,0,utRho18
rpmA,6666450,6666450,6666238,212,852,utRho18
rpmB,15247980,15247980,15246696,1284,46900,utRho18
rpmE,8253816,8254026,8253816,210,708,utRho18
rpmF,2294676,2294734,2294676,58,15310,utRho18
rpmH,7768130,7768672,7768130,542,4876,utRho18
rpmI,3600854,3600854,3599998,856,16430,utRho18
rpoB,8362126,8362490,8362126,364,380,utRho18
rpoD,6424946,6426094,6424946,1148,26150,utRho18
rpoE,5420372,5420372,5420024,348,0,utRho18
rpoH,7202006,7202006,7201566,440,3140,utRho18
rpoN,6689324,6689434,6689324,110,178,utRho18
rpoS,5736236,5736236,5735102,1134,3132,utRho18
rpoZ,7644154,7644212,7644154,58,168,utRho18
rppH,5937986,5937986,5937954,32,0,utRho18
rprA,3540744,3540744,3540744,0,0,utRho18
rpsA,1923434,1923990,1923434,556,115560,utRho18
rpsF,8850050,8850236,8850050,186,21822,utRho18
rpsI,6756580,6756580,6756414,166,7374,utRho18
rpsJ,6906884,6906884,6906540,344,8400,utRho18
rpsL,6949242,6949242,6949104,138,1392,utRho18
rpsM,6885130,6885130,6884942,188,2500,utRho18
rpsO,13247144,13247144,13246736,408,1752,utRho18
rpsP,5492508,5492508,5492370,138,472,utRho18
rpsT,42420,42420,42156,264,684,utRho18
rpsU,12842584,12843124,12842584,540,4912,utRho18
rraA,8238716,8238716,8238660,56,140,utRho18
rraB,8956768,8956946,8956768,178,250,utRho18
rrsA,8070478,8071062,8070478,584,11600,utRho18
rrsB,16665468,16666636,16665468,1168,24888,utRho18
rrsC,7883032,7883616,7883032,584,10388,utRho18
rrsD,6858094,6858094,6857524,570,1296,utRho18
rrsE,8415726,8416294,8415726,568,2674,utRho18
rrsG,5462896,5462896,5462314,582,8842,utRho18
rrsH,446970,447542,446970,572,3680,utRho18
rsd,8393908,8393908,8393616,292,296,utRho18
rseA,5419264,5419264,5418808,456,80,utRho18
rseP,392940,393092,392940,152,0,utRho18
rseX,4067298,4067298,4067298,0,0,utRho18
rsfS,1338144,1338144,1338072,72,190,utRho18
rsgA,8783132,8783132,8783018,114,72,utRho18
rsmA,105176,105176,104860,316,924,utRho18
rsmB,6869982,6870414,6869982,432,530,utRho18
rsmC,9215736,9215736,9215400,336,210,utRho18
rsmD,7208594,7208786,7208594,192,0,utRho18
rsmE,6182036,6182268,6182036,232,866,utRho18
rsmG,7847512,7847512,7847360,152,1932,utRho18
rsmH,180020,180188,180020,168,122,utRho18
rsmI,6587106,6587106,6586670,436,462,utRho18
rssA,2578212,2578412,2578212,200,496,utRho18
rssB,2580440,2580484,2580440,44,118,utRho18
rstA,3364276,3364300,3364276,24,0,utRho18
rsuA,4561096,4561096,4560966,130,344,utRho18
rsxA,3411510,3411534,3411510,24,88,utRho18
rtcA,7114004,7114004,7113698,306,920,utRho18
rtcB,7116214,7116214,7116158,56,62,utRho18
rtn,4541356,4541452,4541356,96,2,utRho18
rutA,2148052,2148052,2148022,30,16,utRho18
rutG,2140090,2140090,2139678,412,88,utRho18
rutR,2148226,2148484,2148226,258,396,utRho18
ruvA,7784096,7784096,7783904,192,200,utRho18
ruvB,7782176,7782176,7781424,752,1380,utRho18
ruvC,3894878,3894878,3894752,126,162,utRho18
rybB,1776114,1776114,1776114,0,0,utRho18
rydB,3529860,3529860,3529322,538,440,utRho18
rydC,2983012,2983012,2983012,0,0,utRho18
ryfA,5307398,5307710,5307398,312,224,utRho18
ryfD,5468590,5468590,5468590,0,0,utRho18
ryhB,7162032,7162032,7162032,0,0,utRho18
ryjA,8556132,8556132,8556132,0,0,utRho18
ryjB,9055954,9055954,9055954,0,0,utRho18
sad,3229598,3229598,3229406,192,254,utRho18
safA,3168056,3168056,3167918,138,336,utRho18
sanA,4465368,4465756,4465368,388,232,utRho18
sapF,2705314,2705314,2705268,46,92,utRho18
sbcB,4165456,4165512,4165456,56,0,utRho18
sbcC,831694,831694,831506,188,0,utRho18
sbcD,833954,833954,833904,50,86,utRho18
sbmA,793106,793278,793106,172,634,utRho18
sbmC,4162650,4162650,4162524,126,28,utRho18
sdaA,3793618,3793864,3793618,246,184,utRho18
sdaC,5856070,5856458,5856070,388,2388,utRho18
sdhC,1509916,1510354,1509916,438,26562,utRho18
sdhD,1510808,1511120,1510808,312,6066,utRho18
sdiA,3993834,3993834,3993664,170,16,utRho18
secE,8354354,8354716,8354354,362,144,utRho18
secG,6645180,6645180,6645010,170,1492,utRho18
selA,7522594,7522594,7522498,96,1394,utRho18
selB,7519850,7519850,7519722,128,284,utRho18
selC,7672396,7672444,7672396,48,606,utRho18
selD,3696058,3696058,3696016,42,710,utRho18
seqA,1425884,1425974,1425884,90,306,utRho18
serA,6117098,6117098,6116820,278,170,utRho18
serB,9249712,9249790,9249712,78,132,utRho18
serC,3830380,3830612,3830380,232,328,utRho18
serS,1878730,1878856,1878730,126,1050,utRho18
serT,2063438,2063438,2063424,14,0,utRho18
serU,4087124,4087124,4087114,10,162,utRho18
serV,5637394,5637394,5637290,104,314,utRho18
serW,1852014,1852014,1851942,72,326,utRho18
serX,2195352,2195352,2195304,48,98,utRho18
setB,4527426,4527726,4527426,300,54,utRho18
setC,7673488,7673906,7673488,418,1480,utRho18
sfmA,1116124,1116424,1116124,300,0,utRho18
sfmC,1117606,1117948,1117606,342,80,utRho18
sfsA,323030,323030,322972,58,312,utRho18
sfsB,6669592,6669818,6669592,226,956,utRho18
sgrR,154676,154676,154598,78,108,utRho18
sgrS,154734,154734,154734,0,0,utRho18
shiA,4107068,4107286,4107068,218,102,utRho18
sibA,4306622,4306622,4306622,0,0,utRho18
sibB,4307292,4307292,4307292,0,0,utRho18
sibC,6113702,6113702,6113702,0,0,utRho18
sibD,6389730,6389730,6389730,0,0,utRho18
sibE,6390480,6390480,6390480,0,0,utRho18
sixA,4913998,4913998,4913624,374,66,utRho18
slp,7307872,7307922,7307872,50,154,utRho18
slt,9261400,9261466,9261400,66,0,utRho18
slyA,3442028,3442028,3441648,380,254,utRho18
slyB,3439496,3439752,3439496,256,86,utRho18
slyD,6957398,6957398,6956994,404,674,utRho18
slyX,6954862,6955280,6954862,418,2884,utRho18
smf,6867372,6867372,6867120,252,194,utRho18
smpB,5509534,5509792,5509534,258,760,utRho18
smrA,2811872,2811958,2811872,86,202,utRho18
smrB,4896872,4897212,4896872,340,582,utRho18
smtA,1946808,1947074,1946808,266,26,utRho18
sodA,8201518,8201620,8201518,102,1984,utRho18
sodB,3470646,3470756,3470646,110,838,utRho18
sodC,3449358,3449358,3449310,48,26,utRho18
sohB,2658568,2658664,2658568,96,362,utRho18
sokB,2984232,2984238,2984232,6,58,utRho18
solA,2241218,2241218,2241172,46,44,utRho18
soxR,8554894,8554938,8554894,44,0,utRho18
soxS,8554846,8554846,8554766,80,0,utRho18
speA,6172096,6172096,6171822,274,170,utRho18
speB,6167892,6167892,6167594,298,500,utRho18
speC,6218350,6218350,6218310,40,18,utRho18
spf,8099798,8099798,8099798,0,0,utRho18
sppA,3697422,3697674,3697422,252,318,utRho18
spy,3651376,3651376,3651250,126,80,utRho18
sra,3112092,3112092,3111926,166,36,utRho18
sraB,2293178,2293178,2293178,0,0,utRho18
sraC,3846132,3846132,3846132,0,0,utRho18
srlA,5651582,5651664,5651582,82,60,utRho18
srlR,5657720,5658094,5657720,374,1582,utRho18
srmB,5425752,5425792,5425752,40,16,utRho18
sroA,151216,151216,151216,0,0,utRho18
sroG,6369436,6369436,6369436,0,0,utRho18
sroH,8380974,8380974,8380974,0,0,utRho18
ssb,8548022,8548250,8548022,228,326,utRho18
sseA,5304782,5304988,5304782,206,4030,utRho18
sspA,6755138,6755138,6754840,298,710,utRho18
ssrA,5511014,5511186,5511014,172,196,utRho18
ssrS,12223036,12223932,12223036,896,8680,utRho18
sstT,6479726,6479888,6479726,162,64,utRho18
ssuB,1988282,1988282,1988088,194,268,utRho18
ssuE,1995126,1995126,1995024,102,0,utRho18
sthA,8321604,8321604,8321580,24,1276,utRho18
stpA,5597156,5597156,5596990,166,104,utRho18
sucA,3034344,3034824,3034344,480,3928,utRho18
sufA,3528836,3528836,3528772,64,0,utRho18
sufE,3518962,3518962,3518580,382,374,utRho18
sugE,8753588,8753750,8753588,162,1160,utRho18
sulA,2041894,2041894,2041838,56,1904,utRho18
syd,5850738,5850738,5850560,178,128,utRho18
symE,9159834,9159834,9159680,154,520,utRho18
symR,9159670,9159670,9159670,0,0,utRho18
tabA,8949566,8949724,8949566,158,86,utRho18
talA,5157140,5157332,5157140,192,104,utRho18
talB,16382,16476,16382,94,3878,utRho18
tam,3214442,3214692,3214442,250,390,utRho18
tamA,8884540,8884764,8884540,224,292,utRho18
tar,3945432,3945432,3945382,50,12,utRho18
tas,5943138,5943194,5943138,56,1710,utRho18
tatA,16087636,16087780,16087636,144,372,utRho18
tatE,1317742,1317894,1317742,152,114,utRho18
tauA,770410,770464,770410,54,46,utRho18
tdcA,6534186,6534186,6534130,56,0,utRho18
tdcG,6519652,6519652,6519298,354,970,utRho18
tdcR,6534380,6534760,6534380,380,0,utRho18
tdk,2586986,2587054,2586986,68,42,utRho18
tehA,3001072,3001146,3001072,74,0,utRho18
tesA,1039898,1039898,1039530,368,296,utRho18
tesB,950402,950402,950322,80,46,utRho18
tfaE,2418532,2418532,2418238,294,594,utRho18
tfaQ,3269912,3269912,3269770,142,160,utRho18
tff,379424,379256,379424,168,124,utRho18
tgt,852110,852274,852110,164,0,utRho18
thiD,4369346,4369346,4369032,314,226,utRho18
thiI,882936,883098,882936,162,244,utRho18
thiM,4370902,4370902,4370602,300,918,utRho18
thiQ,146170,146170,145854,316,1692,utRho18
thrL,592,760,592,168,32,utRho18
thrS,7210932,7210932,7210280,652,292,utRho18
thrU,8350762,8350776,8350762,14,198,utRho18
thrV,6847414,6847414,6847310,104,393332,utRho18
thrW,525682,525742,525682,60,1586,utRho18
thyA,5930696,5930696,5930310,386,1762,utRho18
tig,909986,910266,909986,280,842,utRho18
tisB,7706674,7707106,7706674,432,1270,utRho18
tktA,6163414,6163414,6163270,144,172,utRho18
tktB,5158616,5159272,5158616,656,1320,utRho18
tldD,6784368,6784368,6784056,312,0,utRho18
tmcA,5191876,5191876,5191718,158,60,utRho18
tnaC,15553644,15553740,15553644,96,1520,utRho18
tolB,1555074,1555480,1555074,406,478,utRho18
tolC,6356008,6356230,6356008,222,480,utRho18
tomB,961588,961588,961416,172,1520,utRho18
tonB,2622108,2622178,2622108,70,126,utRho18
topA,2661578,2662096,2661578,518,244,utRho18
torC,2116112,2116168,2116112,56,186,utRho18
torR,2115968,2115968,2115908,60,284,utRho18
torS,2112364,2112364,2112356,8,0,utRho18
torT,2112414,2112522,2112414,108,0,utRho18
tpiA,8223138,8223138,8223014,124,804,utRho18
tppB,3425342,3425538,3425342,196,4908,utRho18
tpr,2574376,2574376,2574376,0,0,utRho18
tpx,2777688,2777688,2777622,66,312,utRho18
tqsA,3347780,3347826,3347780,46,248,utRho18
treA,2494850,2494850,2494752,98,766,utRho18
treB,8932420,8932420,8932360,60,160,utRho18
treF,7339102,7339184,7339102,82,140,utRho18
treR,8934694,8934694,8934492,202,50,utRho18
trg,2984878,2984940,2984878,62,0,utRho18
trkG,2847342,2847564,2847342,222,172,utRho18
trmA,8326590,8326590,8326540,50,30,utRho18
trpA,2634678,2634678,2634444,234,406,utRho18
trpC,2639888,2639888,2639570,318,204,utRho18
trpL,5292432,5292432,5292328,104,88,utRho18
trpR,9265408,9265520,9265408,112,516,utRho18
trpS,7027394,7027394,7027276,118,2162,utRho18
trpT,7893560,7893914,7893560,354,278408,utRho18
trxA,7931294,7931522,7931294,228,570,utRho18
trxB,1864156,1864156,1864100,56,0,utRho18
trxC,5437350,5437470,5437350,120,152,utRho18
tsaD,6421256,6421256,6421086,170,134,utRho18
tsgA,6985038,6985136,6985038,98,268,utRho18
tsr,9182824,9183314,9182824,490,2060,utRho18
tsx,864490,864490,864026,464,948,utRho18
ttcA,2823970,2823970,2823896,74,2364,utRho18
ttdA,6412848,6412926,6412848,78,0,utRho18
ttdR,6412760,6412760,6412512,248,300,utRho18
tufA,6943448,6943448,6942658,790,169020,utRho18
tus,3368346,3368518,3368346,172,378,utRho18
tusA,7218040,7218040,7217992,48,204,utRho18
tusB,6950218,6950218,6949930,288,158,utRho18
tynA,2902996,2902996,2902698,298,0,utRho18
typA,8116460,8116814,8116460,354,4196,utRho18
tyrB,8534164,8534228,8534164,64,1806,utRho18
tyrP,3979004,3979362,3979004,358,542,utRho18
tyrR,2773384,2773440,2773384,56,50,utRho18
tyrS,3434566,3434566,3434444,122,0,utRho18
tyrT,2575330,2575330,2575244,86,652,utRho18
uacT,6062378,6062734,6062378,356,620,utRho18
ubiC,8504886,8505012,8504886,126,0,utRho18
ubiD,8049618,8049976,8049618,358,1856,utRho18
ubiE,8037494,8037710,8037494,216,122,utRho18
ubiG,4679078,4679134,4679078,56,0,utRho18
ucpA,5089342,5089342,5089246,96,0,utRho18
udp,8032782,8032862,8032782,80,0,utRho18
ugd,4199470,4199470,4199226,244,0,utRho18
ugpB,7184852,7184852,7184650,202,1372,utRho18
ugpQ,7176600,7176600,7176226,374,194,utRho18
uhpT,7694396,7694396,7694334,62,172,utRho18
uidA,3392304,3392304,3392142,162,38,utRho18
uidC,3386012,3386012,3385702,310,62,utRho18
uidR,3394150,3394150,3394104,46,0,utRho18
ulaA,8839854,8839960,8839854,106,456,utRho18
ulaG,8839350,8839350,8839250,100,20,utRho18
ulaR,8837124,8837124,8836906,218,86,utRho18
umpG,5741372,5741372,5740548,824,640,utRho18
umpH,1400704,1400704,1400652,52,200,utRho18
umuD,2461476,2461534,2461476,58,0,utRho18
ung,5433476,5433508,5433476,32,114,utRho18
uof,2843316,2843316,2842900,416,3204,utRho18
upp,5241818,5241818,5241744,74,292,utRho18
usg,4873780,4873780,4873298,482,480,utRho18
ushA,1009772,1009828,1009772,56,28,utRho18
uspA,7279966,7280222,7279966,256,524,utRho18
uspB,7279696,7279696,7279440,256,354,utRho18
uspC,3959172,3959506,3959172,334,58,utRho18
uspE,2797318,2797318,2797244,74,0,utRho18
uspF,2871282,2871282,2871238,44,60,utRho18
uspG,1283806,1283806,1283734,72,744,utRho18
uvrA,8547872,8547872,8547742,130,376,utRho18
uvrB,1626304,1627052,1626304,748,1188,utRho18
uvrC,3989758,3989758,3989412,346,472,utRho18
uvrD,7995814,7995966,7995814,152,954,utRho18
uvrY,3990812,3990812,3990718,94,60,utRho18
uxaB,3221474,3221474,3221360,114,0,utRho18
uxaC,6489714,6489714,6489482,232,148,utRho18
uxuA,9103036,9103272,9103036,236,1098,utRho18
uxuR,9108916,9109152,9108916,236,512,utRho18
valS,8967854,8967854,8967674,180,304,utRho18
valU,5041848,5041862,5041848,14,0,utRho18
valV,3492830,3492870,3492830,40,448,utRho18
ves,3649968,3649968,3649874,94,10,utRho18
waaA,7616512,7617080,7616512,568,838,utRho18
waaH,7580298,7580298,7580162,136,284,utRho18
waaQ,7616476,7616476,7616196,280,188,utRho18
waaU,7598996,7598996,7598624,372,312,utRho18
waaY,7602272,7602272,7601930,342,3492,utRho18
wbbH,4214888,4214888,4214452,436,326,utRho18
wbbK,4209212,4209212,4209018,194,132,utRho18
wcaM,4231868,4231868,4231792,76,70,utRho18
wrbA,2135516,2135516,2135416,100,148,utRho18
wza,4275166,4275166,4274486,680,432,utRho18
wzxC,4240674,4240674,4240316,358,58,utRho18
wzzB,4196950,4196950,4196602,348,128,utRho18
xanP,7657642,7657890,7657642,248,552,utRho18
xanQ,6048520,6048702,6048520,182,0,utRho18
xapA,5049820,5049820,5049756,64,44,utRho18
xapR,10090252,10090252,10089908,344,128,utRho18
xdhA,6000514,6000690,6000514,176,572,utRho18
xerD,6079702,6079702,6079486,216,496,utRho18
xseA,5268394,5268464,5268394,70,4,utRho18
xseB,882746,882746,882686,60,124,utRho18
xthA,3664798,3664856,3664798,58,0,utRho18
xylA,7461614,7461614,7461530,84,6744,utRho18
xylE,8484540,8484540,8484508,32,0,utRho18
xylF,7462138,7462262,7462138,124,370,utRho18
xylR,7469812,7469958,7469812,146,0,utRho18
yaaA,13230,13230,12918,312,238,utRho18
yaaI,23876,23876,23572,304,322,utRho18
yaaJ,16034,16034,15918,116,214,utRho18
yaaU,91184,91614,91184,430,168,utRho18
yaaW,23084,23084,22712,372,684,utRho18
yaaX,10060,10468,10060,408,70,utRho18
yabI,142542,142702,142542,160,310,utRho18
yacC,273880,273880,273834,46,1248,utRho18
yacH,262932,262932,262520,412,98,utRho18
yacL,268678,268776,268678,98,356,utRho18
yadD,293796,293936,293796,140,274,utRho18
yadE,289930,290162,289930,232,380,utRho18
yadN,314110,314110,313766,344,582,utRho18
yadS,355572,355572,355248,324,3442,utRho18
yadV,312470,312470,312402,68,310,utRho18
yaeF,434270,434270,434006,264,188,utRho18
yaeP,428374,428374,428250,124,558,utRho18
yaeQ,428176,428582,428176,406,1194,utRho18
yaeR,423716,423754,423716,38,0,utRho18
yafC,462166,462166,461762,404,406,utRho18
yafD,462128,462244,462128,116,450,utRho18
yafK,491986,491986,491610,376,1096,utRho18
yafL,493282,493424,493282,142,122,utRho18
yafN,503938,504010,503938,72,156,utRho18
yafS,469568,469632,469568,64,390,utRho18
yafT,474470,474670,474470,200,92,utRho18
yafV,480432,480432,480378,54,392,utRho18
yafZ,536052,536052,536010,42,146,utRho18
yagE,564446,564556,564446,110,138,utRho18
yagG,570414,570790,570414,376,332,utRho18
yagI,578384,578384,578324,60,198,utRho18
yagK,586236,586236,585896,340,3870,utRho18
yagL,588062,588062,587836,226,876,utRho18
yagN,591342,591342,591158,184,190,utRho18
yahA,663746,664742,663746,996,2500,utRho18
yahC,670136,670136,670044,92,1742,utRho18
yahE,671478,671850,671478,372,612,utRho18
yahM,690504,690808,690504,304,396,utRho18
yahN,692872,692872,692674,198,1032,utRho18
yahO,692864,692968,692864,104,448,utRho18
yaiE,816296,816354,816296,58,210,utRho18
yaiI,811396,811528,811396,132,36,utRho18
yaiO,761946,761946,761684,262,228,utRho18
yaiP,767970,767970,767870,100,4,utRho18
yaiS,769660,769660,769232,428,308,utRho18
yaiV,788922,788922,788922,0,0,utRho18
yaiY,799094,799094,798666,428,118,utRho18
yaiZ,798888,799186,798888,298,422,utRho18
yajC,854410,854574,854410,164,322,utRho18
yajD,860938,861210,860938,272,520,utRho18
yajI,866068,866068,865702,366,282,utRho18
yajL,887496,887496,887282,214,420,utRho18
yajQ,889316,889366,889316,50,72,utRho18
yajR,893374,893374,893332,42,256,utRho18
ybaB,987418,988152,987418,734,2608,utRho18
ybaL,1006590,1006590,1006476,114,278,utRho18
ybaM,980648,980648,980542,106,162,utRho18
ybaN,981436,981764,981436,328,492,utRho18
ybaO,936704,936766,936704,62,0,utRho18
ybaP,1016568,1016568,1016160,408,748,utRho18
ybaQ,1016348,1016436,1016348,88,74,utRho18
ybaS,1023146,1023282,1023146,136,360,utRho18
ybaV,927504,927874,927504,370,52,utRho18
ybaY,950490,950758,950490,268,274,utRho18
ybbB,1062724,1062724,1062452,272,130,utRho18
ybbJ,1030154,1030154,1029718,436,1038,utRho18
ybbL,1031784,1031838,1031784,54,82,utRho18
ybbN,1037136,1037136,1036558,578,1130,utRho18
ybbO,1038658,1038658,1038298,360,472,utRho18
ybbY,1080718,1081130,1080718,412,352,utRho18
ybcH,1176140,1176140,1175962,178,256,utRho18
ybcI,1113264,1113264,1113106,158,1754,utRho18
ybcJ,1114050,1114050,1113746,304,660,utRho18
ybcK,1137502,1137804,1137502,302,324,utRho18
ybcL,1141690,1141786,1141690,96,2,utRho18
ybcN,1144628,1144932,1144628,304,256,utRho18
ybcQ,1147548,1147912,1147548,364,2262,utRho18
ybcW,1159610,1159760,1159610,150,60,utRho18
ybdD,1263982,1264364,1263982,382,396,utRho18
ybdF,1212106,1212106,1211772,334,362,utRho18
ybdH,1267048,1267048,1266954,94,168,utRho18
ybdJ,1212822,1212822,1212398,424,236,utRho18
ybdK,1215122,1215122,1214766,356,1858,utRho18
ybdL,1267114,1267172,1267114,58,172,utRho18
ybdM,1271110,1271110,1270752,358,88,utRho18
ybdN,1273372,1273372,1273138,234,130,utRho18
ybdR,1283844,1284176,1283844,332,1000,utRho18
ybeD,1325412,1325412,1325284,128,208,utRho18
ybeF,1323090,1323090,1322756,334,1324,utRho18
ybeL,1349986,1350036,1349986,50,196,utRho18
ybeQ,1353412,1353412,1353094,318,224,utRho18
ybeR,1353120,1353422,1353120,302,224,utRho18
ybeT,1358832,1358832,1358812,20,0,utRho18
ybeU,1358924,1359016,1358924,92,0,utRho18
ybeZ,1386938,1386938,1386834,104,3182,utRho18
ybfA,1458074,1458268,1458074,194,24,utRho18
ybfE,1423878,1423878,1423796,82,350,utRho18
ybfF,1425692,1425692,1425604,88,74,utRho18
ybfH,1433282,1433282,1433194,88,60,utRho18
ybgA,1477840,1478002,1477840,162,58,utRho18
ybgC,1549288,1549504,1549288,216,28,utRho18
ybgD,1505916,1505916,1505590,326,5668,utRho18
ybgI,1485238,1485654,1485238,416,0,utRho18
ybgO,1498370,1498370,1497964,406,0,utRho18
ybgS,1570992,1570992,1570634,358,120,utRho18
ybhA,1597184,1597184,1596862,322,0,utRho18
ybhB,1616070,1616070,1615818,252,80,utRho18
ybhC,1614642,1614642,1614562,80,1288,utRho18
ybhD,1601418,1601418,1601276,142,80,utRho18
ybhH,1601104,1601518,1601104,414,180,utRho18
ybhK,1633384,1633384,1633294,90,170,utRho18
ybhM,1641556,1641586,1641556,30,56,utRho18
ybhN,1645296,1645296,1644996,300,232,utRho18
ybhQ,1649202,1649260,1649202,58,412,utRho18
ybiA,1665920,1665920,1665900,20,0,utRho18
ybiI,1676968,1676968,1676912,56,434,utRho18
ybiO,1691328,1691328,1690960,368,2216,utRho18
ybiP,1705252,1705252,1705194,58,364,utRho18
ybiS,1711572,1711572,1711488,84,130,utRho18
ybiT,1711894,1711926,1711894,32,0,utRho18
ybiU,1718212,1718212,1718122,90,94,utRho18
ybiV,1720176,1720176,1720056,120,48,utRho18
ybiW,1725566,1725566,1725212,354,2750,utRho18
ybiX,1678548,1678548,1678414,134,162,utRho18
ybjC,1781784,1781826,1781784,42,22,utRho18
ybjE,1830154,1830154,1829714,440,506,utRho18
ybjG,1767016,1767016,1766776,240,2324,utRho18
ybjL,1779882,1779882,1779638,244,172,utRho18
ybjM,1779770,1780178,1779770,408,790,utRho18
ybjO,1795704,1795978,1795704,274,146,utRho18
ybjP,1809046,1809046,1808934,112,0,utRho18
ybjQ,1809034,1809186,1809034,152,30,utRho18
ybjS,1813796,1813796,1813506,290,70,utRho18
ybjX,1838206,1838206,1838168,38,0,utRho18
ycaD,1891438,1891742,1891438,304,52,utRho18
ycaI,1928210,1928640,1928210,430,168,utRho18
ycaK,1899094,1899336,1899094,242,346,utRho18
ycaL,1920264,1920528,1920264,264,0,utRho18
ycaM,1894240,1894458,1894240,218,34,utRho18
ycaR,1941284,1941346,1941284,62,1632,utRho18
ycbB,1961862,1962094,1961862,232,312,utRho18
ycbJ,1943344,1943504,1943344,160,0,utRho18
ycbK,1966046,1966150,1966046,104,568,utRho18
ycbZ,2036920,2036920,2036598,322,66,utRho18
yccA,2062886,2062886,2062836,50,140,utRho18
yccF,2048730,2048730,2048696,34,0,utRho18
yccS,2047988,2047988,2047766,222,276,utRho18
yccT,2055674,2055674,2055546,128,184,utRho18
yccX,2059960,2060128,2059960,168,526,utRho18
ycdT,2185682,2185752,2185682,70,0,utRho18
ycdU,2191266,2191686,2191266,420,172,utRho18
ycdZ,2200504,2200592,2200504,88,198,utRho18
yceA,2233544,2233614,2233544,70,84,utRho18
yceD,2293298,2293588,2293298,290,3450,utRho18
yceF,2293522,2293522,2293190,332,2466,utRho18
yceH,2252154,2252314,2252154,160,452,utRho18
yceI,2237282,2237282,2236952,330,1074,utRho18
yceJ,2238142,2238142,2238092,50,84,utRho18
yceM,2253208,2253612,2253208,404,372,utRho18
yceO,2239264,2239264,2238894,370,812,utRho18
yceQ,2288760,2289004,2288760,244,2650,utRho18
ycfD,2376540,2376540,2376480,60,54,utRho18
ycfJ,2334814,2335198,2334814,384,284,utRho18
ycfS,2340834,2340834,2340748,86,34,utRho18
ycfT,2350658,2350658,2350330,328,4,utRho18
ycfZ,2362760,2362760,2362534,226,296,utRho18
ycgB,2474570,2474570,2474482,88,50,utRho18
ycgG,2434614,2434656,2434614,42,122,utRho18
ycgJ,2452956,2453200,2452956,244,32,utRho18
ycgL,2455218,2455362,2455218,144,0,utRho18
ycgN,2457366,2457660,2457366,294,80,utRho18
ycgR,2489112,2489112,2489054,58,66,utRho18
ycgV,2512222,2512222,2511904,318,882,utRho18
ycgX,2426568,2426568,2426214,354,7476,utRho18
ycgY,2490166,2490320,2490166,154,170,utRho18
ycgZ,2431504,2431578,2431504,74,58,utRho18
ychE,2596904,2597196,2596904,292,122,utRho18
ychF,2515764,2515764,2515624,140,136,utRho18
ychH,2517476,2517582,2517476,106,576,utRho18
ychJ,2578354,2578354,2578264,90,192,utRho18
ychN,2547310,2547310,2547198,112,0,utRho18
ychO,2547520,2547850,2547520,330,128,utRho18
ychQ,2533798,2533848,2533798,50,84,utRho18
yciA,2624828,2624828,2624492,336,208,utRho18
yciB,2626110,2626110,2625780,330,1004,utRho18
yciC,2627396,2627396,2627326,70,0,utRho18
yciE,2630794,2630794,2630448,346,148,utRho18
yciG,5264368,5264368,5264140,228,0,utRho18
yciI,2621784,2621784,2621730,54,114,utRho18
yciN,2661606,2661606,2661336,270,0,utRho18
yciS,2680270,2680486,2680270,216,108,utRho18
yciT,2689088,2689088,2688692,396,1334,utRho18
yciU,2614718,2614718,2614300,418,1470,utRho18
yciV,2646376,2646440,2646376,64,44,utRho18
yciW,2700472,2700472,2700214,258,2804,utRho18
yciZ,2689276,2689276,2689218,58,1138,utRho18
ycjD,2703792,2703792,2703520,272,26,utRho18
ycjG,2777748,2777860,2777748,112,64,utRho18
ycjM,2740006,2740432,2740006,426,132,utRho18
ycjW,2767982,2767982,2767922,60,0,utRho18
ycjX,2768138,2768234,2768138,96,62,utRho18
ycjY,5568288,5568288,5567460,828,588,utRho18
ydaE,2836438,2836438,2836016,422,596,utRho18
ydaN,2816048,2816100,2816048,52,70,utRho18
ydaS,2840340,2840730,2840340,390,62,utRho18
ydbC,2948376,2948442,2948376,66,0,utRho18
ydbD,2950132,2950288,2950132,156,0,utRho18
ydbH,2885800,2886102,2885800,302,170,utRho18
ydbJ,2881712,2882116,2881712,404,662,utRho18
ydbK,2881692,2881692,2881568,124,198,utRho18
ydcA,2983294,2983354,2983294,60,180,utRho18
ydcF,2974404,2974470,2974404,66,66,utRho18
ydcI,2990268,2990268,2990142,126,58,utRho18
ydcJ,2990266,2990576,2990266,310,0,utRho18
ydcK,3001280,3001280,3000898,382,100,utRho18
ydcL,3004646,3004914,3004646,268,82,utRho18
ydcN,3012308,3012344,3012308,36,546,utRho18
ydcP,3013508,3013562,3013508,54,80,utRho18
ydcR,3019956,3020006,3019956,50,58,utRho18
ydcS,3022906,3023308,3022906,402,404,utRho18
ydcX,3034442,3034778,3034442,336,640,utRho18
ydcY,3035220,3035296,3035220,76,0,utRho18
ydcZ,3036750,3036750,3036662,88,742,utRho18
yddB,3155332,3155332,3155238,94,186,utRho18
yddE,3071738,3071738,3071716,22,0,utRho18
yddG,3094410,3094410,3094338,72,40,utRho18
yddJ,3089732,3089732,3089438,294,282,utRho18
yddW,3137704,3137704,3137646,58,44,utRho18
ydeA,3233910,3234056,3233910,146,346,utRho18
ydeE,3242528,3242664,3242528,136,202,utRho18
ydeI,3249118,3249118,3248994,124,158,utRho18
ydeJ,3249376,3249546,3249376,170,0,utRho18
ydeN,3165458,3165458,3165048,410,408,utRho18
ydeP,3173328,3173328,3172972,356,378,utRho18
ydeR,3176596,3176596,3176592,4,378,utRho18
ydfA,3296872,3297016,3296872,144,0,utRho18
ydfG,3254982,3255034,3254982,52,0,utRho18
ydfH,3256652,3256704,3256652,52,78,utRho18
ydfK,3265446,3266144,3265446,698,4060,utRho18
ydgA,3379588,3379704,3379588,116,0,utRho18
ydgC,3364124,3364124,3364060,64,16,utRho18
ydgD,3343906,3343920,3343906,14,0,utRho18
ydgH,3356754,3356854,3356754,100,0,utRho18
ydgJ,3408798,3408798,3408616,182,358,utRho18
ydgK,3410414,3410500,3410414,86,692,utRho18
ydhB,3479618,3479618,3479596,22,56,utRho18
ydhC,3479698,3479822,3479698,124,22,utRho18
ydhF,3451310,3451310,3451264,46,0,utRho18
ydhI,3441996,3442050,3441996,54,0,utRho18
ydhL,3451864,3451864,3451840,24,258,utRho18
ydhQ,3492404,3492404,3492254,150,0,utRho18
ydhS,3494136,3494262,3494136,126,1552,utRho18
ydhT,3499138,3499138,3499118,20,76,utRho18
ydhY,3509284,3509284,3508954,330,176,utRho18
ydhZ,3510418,3510418,3510282,136,248,utRho18
ydiE,3579206,3579226,3579206,20,0,utRho18
ydiH,3530582,3530582,3530406,176,48,utRho18
ydiM,3541852,3542142,3541852,290,132,utRho18
ydiN,3544818,3545024,3544818,206,0,utRho18
ydiP,3558656,3558656,3558602,54,224,utRho18
ydiU,3582508,3582508,3582488,20,636,utRho18
ydiV,3584174,3584174,3584040,134,328,utRho18
ydiY,3612500,3612500,3612166,334,206,utRho18
ydjA,3697400,3697400,3697352,48,242,utRho18
ydjE,3708082,3708082,3707958,124,54,utRho18
ydjF,3709848,3709848,3709708,140,0,utRho18
ydjM,3620340,3620422,3620340,82,0,utRho18
ydjO,3626696,3626696,3626288,408,454,utRho18
ydjX,3666434,3666802,3666434,368,1300,utRho18
yeaE,3731448,3731448,3731272,176,80,utRho18
yeaG,3733530,3733816,3733530,286,24,utRho18
yeaI,3740486,3740770,3740486,284,108,utRho18
yeaJ,3743874,3744082,3743874,208,36,utRho18
yeaL,3748646,3748704,3748646,58,432,utRho18
yeaM,3751296,3751296,3751152,144,96,utRho18
yeaN,3750926,3751346,3750926,420,100,utRho18
yeaO,3753554,3753818,3753554,264,434,utRho18
yeaP,3755314,3755430,3755314,116,456,utRho18
yeaQ,3758780,3758780,3758510,270,486,utRho18
yeaR,3759988,3759988,3759896,92,10,utRho18
yeaY,3781122,3781122,3781064,58,24,utRho18
yebB,3892220,3892502,3892220,282,418,utRho18
yebC,3896370,3896370,3896302,68,160,utRho18
yebE,3859464,3859464,3859414,50,172,utRho18
yebG,3861530,3861530,3861494,36,2,utRho18
yebK,3873180,3873304,3873180,124,168,utRho18
yebQ,3820314,3820552,3820314,238,0,utRho18
yebS,3832238,3832516,3832238,278,4,utRho18
yebV,3843430,3843560,3843430,130,0,utRho18
yebW,3843914,3844242,3843914,328,962,utRho18
yecC,3995646,3995646,3995628,18,0,utRho18
yecD,3901272,3901664,3901272,392,202,utRho18
yecF,3991434,3991636,3991434,202,228,utRho18
yecH,3979304,3979304,3978980,324,604,utRho18
yecJ,3975604,3975604,3975516,88,0,utRho18
yecM,3919968,3919968,3919692,276,248,utRho18
yecR,3976400,3976444,3976400,44,24,utRho18
yecT,3923862,3923944,3923862,82,54,utRho18
yedD,4016522,4016522,4016180,342,394,utRho18
yedE,4016310,4016554,4016310,244,224,utRho18
yedI,4058922,4058922,4058732,190,136,utRho18
yedJ,4066446,4066446,4066158,288,400,utRho18
yedV,4076404,4076404,4076304,100,340,utRho18
yedX,4077680,4077912,4077680,232,0,utRho18
yedY,4078572,4078956,4078572,384,558,utRho18
yeeA,4161322,4161322,4161182,140,64,utRho18
yeeE,4171104,4171104,4171050,54,0,utRho18
yeeJ,4089526,4089822,4089526,296,602,utRho18
yeeN,4113508,4113716,4113508,208,234,utRho18
yeeO,4119444,4119444,4119692,248,106,utRho18
yeeX,4158834,4158834,4158722,112,430,utRho18
yeeZ,4178422,4178422,4178256,166,48,utRho18
yefM,4179466,4179466,4179426,40,0,utRho18
yegD,4295288,4295348,4295288,60,44,utRho18
yegH,4275726,4275804,4275726,78,344,utRho18
yegI,4302154,4302154,4301970,184,0,utRho18
yegJ,4302032,4302370,4302032,338,12,utRho18
yegQ,4331182,4331336,4331182,154,1368,utRho18
yegR,4336698,4336698,4336612,86,268,utRho18
yegS,4337086,4337424,4337086,338,110,utRho18
yegT,4357562,4357642,4357562,80,614,utRho18
yegX,4367640,4367640,4367302,338,734,utRho18
yehA,4376944,4376944,4376828,116,232,utRho18
yehE,4385818,4385818,4385592,226,0,utRho18
yehK,4407568,4407944,4407568,376,76,utRho18
yehL,4408804,4409192,4408804,388,0,utRho18
yeiB,4486146,4486146,4485934,212,100,utRho18
yeiE,4499422,4499422,4499236,186,84,utRho18
yeiG,4487776,4487820,4487776,44,0,utRho18
yeiH,4499332,4499434,4499332,102,100,utRho18
yeiI,4503306,4503400,4503306,94,48,utRho18
yeiL,4510580,4510710,4510580,130,46,utRho18
yeiP,4530834,4530900,4530834,66,468,utRho18
yeiQ,4532328,4532490,4532328,162,296,utRho18
yeiR,4535484,4535658,4535484,174,138,utRho18
yeiW,4530840,4530840,4530590,250,766,utRho18
yejA,4544624,4544728,4544624,104,10,utRho18
yejG,4556892,4556892,4556474,418,3788,utRho18
yejH,4561244,4561264,4561244,20,0,utRho18
yejK,4568218,4568218,4567894,324,0,utRho18
yejO,4578352,4578352,4577800,552,1578,utRho18
yfaD,4713380,4713808,4713380,428,1144,utRho18
yfaE,4696676,4697028,4696676,352,2026,utRho18
yfaL,4688568,4688568,4688338,230,66,utRho18
yfaP,4656398,4656398,4656286,112,0,utRho18
yfaU,4717892,4717892,4717690,202,98,utRho18
yfaY,4727310,4727310,4727266,44,250,utRho18
yfaZ,4728744,4728744,4728550,194,0,utRho18
yfbK,4771810,4771810,4771444,366,326,utRho18
yfbL,4771500,4771720,4771500,220,198,utRho18
yfbN,4777174,4777174,4776852,322,254,utRho18
yfbO,4776916,4777162,4776916,246,222,utRho18
yfbP,4777990,4778232,4777990,242,7236,utRho18
yfbR,4817662,4817724,4817662,62,114,utRho18
yfcI,4847424,4847424,4847078,346,848,utRho18
yfcJ,4880482,4880482,4880240,242,766,utRho18
yfcL,4888502,4888502,4888338,164,92,utRho18
yfcV,4911642,4911642,4911292,350,868,utRho18
yfcZ,4921958,4921958,4921868,90,52,utRho18
yfdF,4925604,4926024,4925604,420,5980,utRho18
yfdG,4935474,4935710,4935474,236,0,utRho18
yfdP,4946844,4947040,4946844,196,282,utRho18
yfdX,4988866,4988866,4988804,62,0,utRho18
yfdY,4990672,4990672,4990584,88,372,utRho18
yfeA,5035784,5035784,5035664,120,11130,utRho18
yfeC,5036668,5036934,5036668,266,328,utRho18
yfeH,5053818,5053892,5053818,74,78,utRho18
yfeK,5074630,5074684,5074630,54,74,utRho18
yfeO,5018906,5019260,5018906,354,326,utRho18
yfeR,5054078,5054078,5053712,366,78,utRho18
yfeX,5101356,5101356,5101090,266,378,utRho18
yfeY,5102486,5102486,5102432,54,38,utRho18
yfeZ,5103842,5103842,5103452,390,82,utRho18
yffO,5123804,5124222,5123804,418,268,utRho18
yffQ,5126778,5127154,5126778,376,140,utRho18
yffS,5128800,5128986,5128800,186,18,utRho18
yfgC,5232052,5232188,5232052,136,222,utRho18
yfgF,5258062,5258062,5257876,186,492,utRho18
yfgG,5258170,5258580,5258170,410,652,utRho18
yfgH,5259344,5259584,5259344,240,160,utRho18
yfgM,5278866,5278866,5278566,300,728,utRho18
yfhH,5397414,5397518,5397414,104,14,utRho18
yfhM,5304648,5304648,5304574,74,158,utRho18
yfhR,5328408,5328726,5328408,318,10822,utRho18
yfiC,5425610,5425610,5425528,82,0,utRho18
yfiE,5430688,5430688,5430640,48,446,utRho18
yfiL,5482630,5482720,5482630,90,0,utRho18
yfiM,5448066,5448358,5448066,292,7716,utRho18
yfiR,5483354,5483750,5483354,396,296,utRho18
yfjH,5517326,5517326,5517200,126,100,utRho18
yfjI,5517710,5517970,5517710,260,202,utRho18
yfjJ,5521014,5521094,5521014,80,84,utRho18
yfjM,5531970,5531970,5531552,418,5636,utRho18
yfjP,5535080,5535420,5535080,340,728,utRho18
yfjW,5546570,5546636,5546570,66,0,utRho18
yfjX,5551776,5551838,5551776,62,0,utRho18
ygaC,5601180,5601180,5599988,1192,1572,utRho18
ygaM,5600242,5600292,5600242,50,470,utRho18
ygaU,5593628,5593628,5593572,56,94,utRho18
ygaZ,5619190,5619234,5619190,44,132,utRho18
ygbA,5713656,5713656,5713612,44,52,utRho18
ygbE,5746784,5746784,5746674,110,1482,utRho18
ygbI,5722882,5722882,5722528,354,16,utRho18
ygbK,5724394,5724670,5724394,276,1000,utRho18
ygbL,5727074,5727186,5727074,112,0,utRho18
ygbN,5729814,5730202,5729814,388,944,utRho18
ygcG,5811210,5811422,5811210,212,0,utRho18
ygcN,5785144,5785314,5785144,170,202,utRho18
ygcU,5799214,5799214,5798836,378,120,utRho18
ygcW,5800942,5800942,5800546,396,0,utRho18
ygdD,5883442,5883442,5883262,180,66,utRho18
ygdG,5861746,5861930,5861746,184,2504,utRho18
ygdI,5886526,5886526,5886290,236,58,utRho18
ygdQ,5940784,5940840,5940784,56,146,utRho18
ygdR,5942494,5942542,5942494,48,0,utRho18
ygeA,5961606,5961606,5961270,336,0,utRho18
ygeH,5983758,5984188,5983758,430,1292,utRho18
ygeI,5987162,5987276,5987162,114,4554,utRho18
ygeR,6000078,6000078,5999782,296,976,utRho18
ygeV,6011694,6011694,6011572,122,0,utRho18
ygeW,6012234,6012524,6012234,290,706,utRho18
ygfB,6110946,6110946,6110888,58,306,utRho18
ygfK,6031984,6032120,6031984,136,276,utRho18
ygfS,6058328,6058328,6058024,304,26,utRho18
ygfZ,6082564,6082626,6082564,62,562,utRho18
yggC,6149512,6149512,6149378,134,120,utRho18
yggE,6136370,6136370,6136160,210,758,utRho18
yggI,6179176,6179510,6179176,334,608,utRho18
yggL,6204508,6204508,6204266,242,168,utRho18
yggM,6199514,6199514,6199130,384,624,utRho18
yggN,6203596,6203596,6203246,350,142,utRho18
yggX,18623958,18624558,18623958,600,630,utRho18
yghA,6298966,6299324,6298966,358,204,utRho18
yghB,6307058,6307126,6307058,68,248,utRho18
yghD,6222614,6222614,6222252,362,336,utRho18
yghF,6225798,6225798,6225840,42,318,utRho18
yghJ,6238640,6238640,6238224,416,204,utRho18
yghQ,6265186,6265186,6264816,370,248,utRho18
yghT,6267830,6268262,6267830,432,344,utRho18
yghU,6277400,6277454,6277400,54,52,utRho18
yghW,6293506,6293506,6293474,32,0,utRho18
yghZ,6295562,6295794,6295562,232,600,utRho18
ygiD,6365122,6365122,6364868,254,1970,utRho18
ygiH,6409066,6409388,6409066,322,342,utRho18
ygiL,6370622,6370828,6370622,206,142,utRho18
ygiM,6402084,6402414,6402084,330,244,utRho18
ygiN,6346156,6346284,6346156,128,1092,utRho18
ygiQ,6322620,6322620,6322292,328,1272,utRho18
ygiS,6335462,6335462,6335436,26,124,utRho18
ygiV,6338582,6338582,6338462,120,30,utRho18
ygiW,6339774,6339774,6339352,422,816,utRho18
ygiZ,6344506,6344506,6344422,84,146,utRho18
ygjH,6442528,6442528,6442494,34,0,utRho18
ygjI,6452140,6452468,6452140,328,0,utRho18
ygjQ,6472730,6473080,6472730,350,898,utRho18
ygjR,6474564,6474586,6474564,22,64,utRho18
ygjV,6483638,6483638,6483488,150,8,utRho18
yhaB,6535632,6535708,6535632,76,14,utRho18
yhaH,6504498,6504608,6504498,110,672,utRho18
yhaI,6505400,6505822,6505400,422,220,utRho18
yhaJ,6508560,6508560,6508428,132,122,utRho18
yhaK,6508538,6508638,6508538,100,70,utRho18
yhbQ,6599878,6599932,6599878,54,212,utRho18
yhbT,6602736,6602736,6602552,184,576,utRho18
yhbU,6602558,6602970,6602558,412,678,utRho18
yhbX,6643302,6643302,6643226,76,0,utRho18
yhbY,6655518,6655580,6655518,62,532,utRho18
yhcA,6723956,6724224,6723956,268,868,utRho18
yhcB,6760364,6760382,6760364,18,92,utRho18
yhcC,6708470,6708470,6708100,370,1032,utRho18
yhcF,6733440,6733852,6733440,412,1698,utRho18
yhcH,6739124,6739124,6738956,168,542,utRho18
yhcM,6760312,6760312,6759994,318,196,utRho18
yhcN,6770812,6771076,6770812,264,88,utRho18
yhcO,6772606,6772606,6772258,348,60,utRho18
yhdH,6806560,6806968,6806560,408,258,utRho18
yhdJ,6823234,6823306,6823234,72,0,utRho18
yhdN,6879092,6879092,6879018,74,610,utRho18
yhdT,6814702,6814750,6814702,48,26,utRho18
yhdU,6824994,6825242,6824994,248,124,utRho18
yhdV,6836392,6836780,6836392,388,1242,utRho18
yhdW,6837944,6838298,6837944,354,132,utRho18
yheO,6953082,6953082,6952880,202,788,utRho18
yheV,6957970,6957970,6957584,386,190,utRho18
yhfA,6971902,6971902,6971636,266,968,utRho18
yhfG,6983294,6983294,6983240,54,1180,utRho18
yhfL,6998622,6998896,6998622,274,24,utRho18
yhfY,7023244,7023244,7022844,400,0,utRho18
yhgA,7086294,7086334,7086294,40,134,utRho18
yhgE,7065176,7065176,7064878,298,210,utRho18
yhgF,7074352,7074770,7074352,418,6728,utRho18
yhhA,7173458,7173886,7173458,428,344,utRho18
yhhI,7248346,7248756,7248346,410,0,utRho18
yhhJ,7253696,7253696,7253606,90,170,utRho18
yhhM,7211588,7211588,7211220,368,1152,utRho18
yhhN,7211150,7211502,7211150,352,800,utRho18
yhhQ,7218238,7218434,7218238,196,484,utRho18
yhhT,7223682,7223730,7223682,48,44,utRho18
yhhX,7162032,7162032,7161610,422,112,utRho18
yhhY,7162222,7162276,7162222,54,0,utRho18
yhhZ,7163516,7163726,7163516,210,238,utRho18
yhiD,7312220,7312220,7311804,416,71060,utRho18
yhiJ,7265190,7265190,7265180,10,40,utRho18
yhiM,7269270,7269682,7269270,412,1396,utRho18
yhiN,7275000,7275000,7274820,180,306,utRho18
yhjA,7338522,7338522,7338376,146,150,utRho18
yhjB,7344090,7344090,7343788,302,750,utRho18
yhjC,7344272,7344684,7344272,412,340,utRho18
yhjD,7346660,7346724,7346660,64,62,utRho18
yhjE,7349274,7349572,7349274,298,1042,utRho18
yhjG,7356824,7356824,7356730,94,54,utRho18
yhjH,7358458,7358458,7358374,84,336,utRho18
yhjJ,7364032,7364032,7363880,152,418,utRho18
yhjK,7371296,7371296,7371158,138,6,utRho18
yhjR,7392750,7392750,7392370,380,388,utRho18
yhjV,7400796,7401126,7400796,330,2458,utRho18
yhjX,7424194,7424194,7424014,180,170,utRho18
yhjY,7425966,7425966,7425868,98,34,utRho18
yiaB,7455654,7455654,7455496,158,30,utRho18
yiaD,7432712,7433094,7432712,382,668,utRho18
yiaF,7438194,7438194,7438088,106,454,utRho18
yiaG,7438862,7438956,7438862,94,392,utRho18
yiaJ,7485236,7485236,7485064,172,204,utRho18
yiaK,7485348,7485466,7485348,118,136,utRho18
yiaT,7503924,7503924,7503736,188,0,utRho18
yiaU,7503792,7503984,7503792,192,88,utRho18
yiaY,7515856,7515856,7515654,202,488,utRho18
yibF,7523950,7523950,7523910,40,104,utRho18
yibG,7536128,7536354,7536128,226,196,utRho18
yibL,7553194,7553330,7553194,136,338,utRho18
yibN,7570112,7570112,7570030,82,392,utRho18
yibT,7552848,7552848,7552760,88,636,utRho18
yicC,7633290,7633352,7633290,62,34,utRho18
yicH,7660862,7660914,7660862,52,96,utRho18
yicJ,7673328,7673328,7671858,1470,10206,utRho18
yicN,7685018,7685018,7684804,214,750,utRho18
yicO,7687914,7687914,7687578,336,562,utRho18
yicR,15250308,15250308,15250236,72,0,utRho18
yidB,7755230,7755230,7754930,300,112,utRho18
yidE,7732780,7732780,7732546,234,436,utRho18
yidF,7711580,7711580,7711222,358,364,utRho18
yidQ,7735088,7735456,7735088,368,1146,utRho18
yidR,7738824,7738824,7738618,206,204,utRho18
yieE,7787658,7787738,7787658,80,256,utRho18
yieH,7793314,7793548,7793314,234,78,utRho18
yieK,7798928,7798928,7798786,142,70,utRho18
yifB,7900350,7900350,7899998,352,178,utRho18
yifL,7988984,7989044,7988984,60,1718,utRho18
yigF,8005750,8005750,8005598,152,13186,utRho18
yigI,8009448,8009448,8009394,54,450,utRho18
yigM,8022100,8022152,8022100,52,126,utRho18
yihA,8101970,8101970,8101458,512,54,utRho18
yihD,8084098,8084138,8084098,40,142,utRho18
yihF,8088110,8088398,8088110,288,38,utRho18
yihG,8093304,8093304,8093204,100,206,utRho18
yihI,8102616,8102694,8102616,78,0,utRho18
yihL,8120506,8120894,8120506,388,206,utRho18
yihN,8124332,8124494,8124332,162,200,utRho18
yihO,8131942,8131942,8131532,410,574,utRho18
yihQ,8138892,8138892,8138552,340,102,utRho18
yihV,8147064,8147478,8147064,414,266,utRho18
yihX,8151096,8151106,8151096,10,120,utRho18
yiiE,8158192,8158582,8158192,390,1084,utRho18
yiiF,8159124,8159502,8159124,378,762,utRho18
yiiG,8173762,8174004,8173762,242,0,utRho18
yiiM,8205506,8205644,8205506,138,1176,utRho18
yiiQ,8224624,8224624,8224428,196,224,utRho18
yiiS,8225738,8225934,8225738,196,478,utRho18
yijE,8272178,8272216,8272178,38,194,utRho18
yijF,8275728,8275728,8275314,414,790,utRho18
yijO,8296858,8296858,8296634,224,322,utRho18
yjaA,8426240,8426468,8426240,228,286552,utRho18
yjaB,8428312,8428312,8428246,66,350,utRho18
yjaG,8398746,8399008,8398746,262,150,utRho18
yjaH,8401022,8401132,8401022,110,470,utRho18
yjaZ,8379506,8379572,8379506,66,100,utRho18
yjbB,8455204,8455462,8455204,258,70,utRho18
yjbE,16943432,16943624,16943432,192,236,utRho18
yjbL,8520318,8520642,8520318,324,208,utRho18
yjbQ,8540428,8540476,8540428,48,42,utRho18
yjcB,8550328,8550328,8550082,246,310,utRho18
yjcC,8550836,8550942,8550836,106,178,utRho18
yjcD,8556628,8556958,8556628,330,340,utRho18
yjcE,8559658,8559960,8559658,302,50,utRho18
yjcF,8566212,8566212,8566150,62,60,utRho18
yjcO,8594660,8594660,8594250,410,428,utRho18
yjdA,8654128,8654270,8654128,142,0,utRho18
yjdC,8726660,8726660,8726616,44,52,utRho18
yjdK,8704780,8705168,8704780,388,3312,utRho18
yjdL,8713034,8713034,8712822,212,0,utRho18
yjdM,8653672,8653672,8653468,204,496,utRho18
yjeF,8787354,8788132,8787354,778,76078,utRho18
yjeI,8745522,8745618,8745522,96,192,utRho18
yjeJ,8748806,8748806,8748468,338,496,utRho18
yjeV,8785472,8785784,8785472,312,3546,utRho18
yjfP,8833512,8833904,8833512,392,120,utRho18
yjfY,8849656,8849656,8849582,74,422,utRho18
yjfZ,8855052,8855052,8854844,208,264,utRho18
yjgA,8916162,8916162,8915730,432,362,utRho18
yjgL,8950802,8950874,8950802,72,108,utRho18
yjgM,8959342,8959342,8959074,268,0,utRho18
yjgN,8959132,8959460,8959132,328,0,utRho18
yjgR,8980170,8980170,8980126,44,278,utRho18
yjgZ,9002116,9002520,9002116,404,6524,utRho18
yjhB,9007764,9008116,9007764,352,1552,utRho18
yjhG,9048452,9048452,9048188,264,7818,utRho18
yjhU,9041080,9041080,9040648,432,846,utRho18
yjiA,9178096,9178096,9177730,366,2460,utRho18
yjiJ,9125364,9125364,9125350,14,0,utRho18
yjiK,9127270,9127270,9127422,152,316,utRho18
yjiL,9129604,9129604,9129378,226,152,utRho18
yjiS,9143410,9143502,9143410,92,262,utRho18
yjiY,9182734,9182734,9182558,176,5088,utRho18
yjjA,9200674,9200674,9200378,296,2250,utRho18
yjjB,18408708,18408708,18407800,908,2724,utRho18
yjjJ,9243314,9243538,9243314,224,0,utRho18
yjjK,9261132,9261132,9261044,88,1440,utRho18
yjjL,9189764,9189764,9189444,320,1112,utRho18
yjjM,9191894,9191894,9191702,192,120,utRho18
yjjP,9206068,9206068,9205716,352,12614,utRho18
yjjQ,9206638,9206954,9206638,316,6394,utRho18
yjjX,9267798,9267798,9267490,308,1004,utRho18
yjjY,9280716,9280804,9280716,88,420,utRho18
yjjZ,9211554,9211608,9211554,54,38454,utRho18
yjtD,9281676,9281884,9281676,208,138,utRho18
ykfB,532454,532454,532174,280,10184,utRho18
ykfI,527636,527636,527338,298,1706,utRho18
ykgB,637050,637050,636638,412,300,utRho18
ykgC,640430,640430,640002,428,122,utRho18
ykgD,640232,640454,640232,222,118,utRho18
ykgE,642962,643216,642962,254,320,utRho18
ykgJ,608524,608524,608364,160,364,utRho18
ykgL,623878,624224,623878,346,1252,utRho18
ykgM,625610,625610,625554,56,60,utRho18
ykgR,626570,626570,626484,86,132,utRho18
ylaC,958576,958576,958502,74,2146,utRho18
yliE,1745938,1745958,1745938,20,0,utRho18
ymcE,2103660,2103694,2103660,34,56,utRho18
ymdA,2210450,2210828,2210450,378,282,utRho18
ymdB,2211428,2211640,2211428,212,188,utRho18
ymfD,2395322,2395322,2395064,258,950,utRho18
ymfI,2402880,2402994,2402880,114,0,utRho18
ymfJ,2404518,2404518,2404168,350,440,utRho18
ymfK,2406176,2406176,2405866,310,0,utRho18
ymfT,2405766,2406048,2405766,282,0,utRho18
ymgE,2489110,2489456,2489110,346,1116,utRho18
ymgF,2437628,2437966,2437628,338,48,utRho18
ymiA,2670112,2670320,2670112,208,308,utRho18
ymjA,2715620,2715620,2715336,284,278,utRho18
ynaI,2791946,2791946,2791844,102,234,utRho18
ynaK,2850438,2850754,2850438,316,38,utRho18
ynbA,2954924,2955242,2954924,318,160,utRho18
yncD,3046552,3046552,3046130,422,196,utRho18
yncE,3046454,3046614,3046454,160,58,utRho18
yncG,3052456,3052494,3052456,38,338,utRho18
yncL,3034492,3034492,3034388,104,452,utRho18
yneE,3218364,3218364,3218044,320,0,utRho18
yneF,3223748,3223748,3223708,40,0,utRho18
yneJ,3229560,3229608,3229560,48,106,utRho18
yneK,3231100,3231526,3231100,426,214,utRho18
yneM,3245176,3245292,3245176,116,252,utRho18
ynfA,3311398,3311398,3311346,52,2,utRho18
ynfB,3311418,3311616,3311418,198,390,utRho18
ynfC,3315094,3315094,3314914,180,0,utRho18
ynfD,3314828,3315130,3314828,302,0,utRho18
ynfE,3316006,3316138,3316006,132,74,utRho18
ynfK,3334670,3334670,3334438,232,408,utRho18
ynfL,3339304,3339304,3339184,120,0,utRho18
ynfM,3339260,3339398,3339260,138,0,utRho18
ynfN,3276598,3276598,3276218,380,4,utRho18
ynfO,3273454,3273512,3273454,58,112,utRho18
ynhG,3517890,3517890,3517450,440,200,utRho18
yniA,3615158,3615592,3615158,434,314,utRho18
yniB,3618526,3618526,3618466,60,142,utRho18
yniC,3618652,3618760,3618652,108,66,utRho18
yniD,3610202,3610330,3610202,128,112,utRho18
ynjE,3678880,3678934,3678880,54,144,utRho18
ynjF,3683222,3683222,3682806,416,230,utRho18
ynjH,3684376,3684376,3684270,106,26,utRho18
ynjI,3690022,3690022,3689742,280,340,utRho18
yoaB,3786642,3786734,3786642,92,212,utRho18
yoaC,3787932,3788146,3787932,214,446,utRho18
yoaE,3803544,3803544,3803170,374,886,utRho18
yoaF,3755444,3755444,3755064,380,824,utRho18
yoaH,3789866,3789866,3789462,404,502,utRho18
yobB,3850418,3850880,3850418,462,600,utRho18
yobF,3815586,3815586,3815182,404,382,utRho18
yobH,3817800,3817850,3817800,50,388,utRho18
yodB,4084352,4084736,4084352,384,780,utRho18
yodC,4057008,4057008,4056740,268,368,utRho18
yohC,4451358,4451358,4451262,96,82,utRho18
yohD,4451526,4451602,4451526,76,134,utRho18
yohJ,4460986,4461248,4460986,262,418,utRho18
yohO,4431172,4431314,4431172,142,200,utRho18
yojI,4617282,4617282,4617230,52,112,utRho18
ypdI,4988988,4989396,4988988,408,106,utRho18
ypfG,5165786,5165786,5165554,232,52,utRho18
ypfM,5182140,5182140,5181732,408,1610,utRho18
yphB,5349590,5349590,5349376,214,394,utRho18
ypjA,5565644,5565644,5565452,192,576,utRho18
ypjB,5569636,5569636,5568858,778,110,utRho18
ypjD,5495860,5495774,5495860,86,92,utRho18
yqaE,5594170,5594170,5594056,114,466,utRho18
yqcA,5846100,5846100,5845968,132,168,utRho18
yqcE,5800944,5801184,5800944,240,0,utRho18
yqeC,6030468,6030468,6030114,354,1490,utRho18
yqeF,5971618,5971618,5971184,434,1722,utRho18
yqeG,5971438,5971694,5971438,256,2358,utRho18
yqeH,5975016,5975072,5975016,56,2868,utRho18
yqeI,5976688,5977004,5976688,316,160,utRho18
yqeK,5981140,5981140,5980720,420,2402,utRho18
yqfA,6086728,6086728,6086296,432,884,utRho18
yqgA,6219042,6219106,6219042,64,48,utRho18
yqgB,6172500,6172500,6172102,398,2634,utRho18
yqgE,6185768,6185874,6185768,106,624,utRho18
yqhA,6299150,6299150,6298942,208,102,utRho18
yqhC,6310768,6310768,6310436,332,630,utRho18
yqhD,6310604,6310710,6310604,106,234,utRho18
yqhH,6316842,6317254,6316842,412,1112,utRho18
yqiC,6369662,6369680,6369662,18,52,utRho18
yqiJ,6384108,6384416,6384108,308,1268,utRho18
yqjA,6495096,6495546,6495096,450,4554,utRho18
yqjF,6500932,6501124,6500932,192,816,utRho18
yqjG,6501948,6502048,6501948,100,86,utRho18
yqjH,6433078,6433078,6432982,96,0,utRho18
yqjI,6433506,6433558,6433506,52,0,utRho18
yraH,6574552,6574852,6574552,300,134,utRho18
yraP,6592144,6592818,6592144,674,938,utRho18
yraQ,6596414,6596414,6596276,138,0,utRho18
yraR,6598024,6598024,6597692,332,142,utRho18
yrbG,13360844,13361100,13360844,256,0,utRho18
yrbL,6696842,6696904,6696842,62,768,utRho18
yrbN,6616172,6616172,6615866,306,3442,utRho18
yrdB,6860176,6860176,6860046,130,30,utRho18
yrfF,7052548,7052938,7052548,390,484,utRho18
yrhB,7169440,7169518,7169440,78,0,utRho18
ysaB,7451804,7451804,7451424,380,288,utRho18
ysgA,8032686,8032686,8032338,348,864,utRho18
ytfB,8857638,8857638,8857434,204,408,utRho18
ytfE,8864018,8864018,8863966,52,232,utRho18
ytfF,8866296,8866296,8866130,166,188,utRho18
ytfH,8868164,8868226,8868164,62,490,utRho18
ytfI,8875234,8875414,8875234,180,240,utRho18
ytfJ,8878572,8878572,8878524,48,112,utRho18
ytfK,8879022,8879174,8879022,152,270,utRho18
ytfL,8882642,8882642,8882430,212,200,utRho18
ytfQ,8899634,8899924,8899634,290,194,utRho18
ytjB,9249598,9249598,9249578,20,130,utRho18
yzfA,8896588,8896588,8896490,98,314,utRho18
zapA,6111102,6111224,6111102,122,2716,utRho18
zapB,8236772,8237030,8236772,258,316,utRho18
zapC,2011700,2011904,2011700,204,4,utRho18
zinT,4082692,4082750,4082692,58,328,utRho18
zipA,5062814,5062814,5062466,348,0,utRho18
zitB,1569716,1569716,1569646,70,94,utRho18
zntA,7212844,7212902,7212844,58,0,utRho18
zntR,6878336,6878336,6878260,76,128,utRho18
znuA,3885322,3885322,3885166,156,212,utRho18
znuC,3885268,3885324,3885268,56,196,utRho18
zraP,8403424,8403424,8403376,48,0,utRho18
zraS,8403810,8403852,8403810,42,0,utRho18
zupT,6364866,6365100,6364866,234,1928,utRho18
zur,8520282,8520282,8520006,276,742,utRho18
zwf,3872752,3872752,3872628,124,420,utRho18
C0343,2818676,2818728,2818676,52,56,utRho19
aaeB,6776526,6776526,6776376,150,2,utRho19
aaeR,6778762,6779040,6778762,278,6,utRho19
aaeX,6778860,6778860,6778674,186,76,utRho19
aat,1854920,1854920,1854864,56,0,utRho19
accA,416822,417242,416822,420,964,utRho19
accB,6810280,6810872,6810280,592,4068,utRho19
accD,4868030,4868030,4867852,178,682,utRho19
aceB,8430804,8430956,8430804,152,170,utRho19
aceE,245938,246034,245938,96,248,utRho19
ackA,4826918,4826940,4826918,22,86,utRho19
acnA,2670848,2671662,2670848,814,3790,utRho19
acnB,263038,263230,263038,192,1272,utRho19
acpP,2303148,2303230,2303148,82,472,utRho19
acpS,5402324,5402324,5401996,328,512,utRho19
acrA,971396,971396,971238,158,116,utRho19
acrB,969370,969370,968806,564,3496,utRho19
acrD,5174950,5175190,5174950,240,20,utRho19
acrE,6827404,6827728,6827404,324,0,utRho19
acrR,971398,971522,971398,124,138,utRho19
acrZ,1589502,1589546,1589502,44,124,utRho19
acs,8575190,8575190,8574742,448,194,utRho19
actP,8569870,8569870,8569804,66,184,utRho19
ada,4620854,4620854,4620810,44,0,utRho19
add,3404404,3404466,3404404,62,0,utRho19
ade,7687802,7687928,7687802,126,0,utRho19
adhE,2596826,2596826,2596242,584,56,utRho19
adhP,3107988,3107988,3107676,312,2278,utRho19
adiA,8681112,8681112,8681042,70,0,utRho19
adiC,8674404,8674404,8674062,342,122,utRho19
adiY,8676084,8676084,8675858,226,12,utRho19
adk,994278,994350,994278,72,12,utRho19
adrA,807374,807406,807374,32,2,utRho19
aer,6438240,6438240,6438152,88,0,utRho19
aes,1000102,1000102,999946,156,30,utRho19
agaR,6557406,6557406,6557330,76,0,utRho19
agaS,6563778,6563952,6563778,174,0,utRho19
agp,2131118,2131170,2131118,52,0,utRho19
agrA,7296126,7296126,7296126,0,0,utRho19
agrB,7296588,7296588,7296588,0,0,utRho19
ahpC,1277386,1277890,1277386,504,4488,utRho19
ahpF,1278004,1279506,1278004,1502,364288,utRho19
ahr,8992698,8992698,8992418,280,8,utRho19
aidB,8828494,8828550,8828494,56,0,utRho19
ais,4731512,4731512,4731240,272,0,utRho19
alaA,4814816,4815122,4814816,306,2,utRho19
alaC,4996798,4996798,4996590,208,0,utRho19
alaE,5598140,5598328,5598140,188,858,utRho19
alaS,5644180,5644180,5644022,158,3860,utRho19
alaW,5036612,5036612,5036462,150,12,utRho19
aldA,2976380,2976464,2976380,84,924,utRho19
aldB,7513070,7513070,7513022,48,24,utRho19
alkA,4295118,4295118,4295080,38,106,utRho19
alkB,4618890,4618890,4618682,208,0,utRho19
allA,1064780,1064902,1064780,122,0,utRho19
allD,1092822,1092822,1092726,96,0,utRho19
allE,1088112,1088112,1088092,20,60,utRho19
allS,1064600,1064600,1064442,158,4,utRho19
alr,8531178,8531564,8531178,386,1692,utRho19
alsE,8617334,8617334,8616956,378,466,utRho19
alsK,8615990,8615990,8615598,392,122,utRho19
alx,6476740,6477160,6476740,420,24,utRho19
amiA,5104482,5104704,5104482,222,0,utRho19
amiC,5898378,5898378,5898020,358,0,utRho19
amn,4110062,4110122,4110062,60,0,utRho19
ampC,8758006,8758006,8757888,118,0,utRho19
ampD,237362,237466,237362,104,98,utRho19
ampG,907372,907372,907090,282,556,utRho19
ampH,792726,792726,792574,152,28,utRho19
amyA,4012230,4012312,4012230,82,0,utRho19
anmK,3439346,3439346,3439204,142,2,utRho19
ansB,6201580,6201580,6201456,124,4,utRho19
ansP,3052040,3052040,3051960,80,86,utRho19
apaG,104068,104068,103212,856,4304,utRho19
apaH,102586,102586,102444,142,5720,utRho19
apbE,4623188,4623188,4623068,120,72,utRho19
appA,2081198,2081234,2081198,36,62,utRho19
appC,2075420,2075480,2075420,60,0,utRho19
appY,1167134,1167362,1167134,228,0,utRho19
apt,982620,982824,982620,204,156,utRho19
aqpZ,1832424,1832424,1832094,330,80,utRho19
araB,140150,140150,140096,54,0,utRho19
araC,140482,140774,140482,292,1526,utRho19
araE,5964416,5964416,5964364,52,0,utRho19
araF,3972476,3972476,3972256,220,112,utRho19
araH,3967120,3967120,3967086,34,10,utRho19
araJ,825058,825058,824962,96,28,utRho19
arcA,9281602,9281602,9280612,990,13462,utRho19
arcB,6706098,6706098,6706050,48,0,utRho19
arcZ,6701154,6701154,6701154,0,0,utRho19
arfA,6877346,6877346,6877298,48,128,utRho19
argA,5898312,5898484,5898312,172,0,utRho19
argC,8309770,8310002,8309770,232,166,utRho19
argD,6980442,6980442,6980360,82,2,utRho19
argE,8310156,8310156,8309694,462,368,utRho19
argF,580680,580680,580610,70,0,utRho19
argG,6637124,6637274,6637124,150,40,utRho19
argI,8956688,8956688,8956622,66,2,utRho19
argO,6137672,6137672,6137616,56,68,utRho19
argP,6119460,6119506,6119460,46,2,utRho19
argR,6769204,6769406,6769204,202,52,utRho19
argS,3920002,3920124,3920002,122,66,utRho19
argT,4855698,4855698,4855582,116,22,utRho19
argU,1129406,1129446,1129406,40,0,utRho19
argW,4932616,4932618,4932616,2,0,utRho19
argX,7964728,7964750,7964728,22,34,utRho19
aroF,5482402,5482402,5482300,102,0,utRho19
aroG,1571182,1571266,1571182,84,166,utRho19
aroH,3576636,3576870,3576636,234,630,utRho19
aroK,7038760,7038760,7038128,632,1034,utRho19
aroL,812560,812810,812560,250,28,utRho19
aroP,243342,243342,243102,240,0,utRho19
arpA,8445382,8445382,8444974,408,106,utRho19
arrS,7316108,7316108,7316108,0,0,utRho19
arsR,7297024,7297056,7297024,32,0,utRho19
artJ,1801252,1801252,1801150,102,0,utRho19
artP,1807686,1807686,1807468,218,1978,utRho19
ascF,5678858,5679048,5678858,190,0,utRho19
ascG,5678574,5678574,5678528,46,0,utRho19
aslB,7965562,7965916,7965562,354,242,utRho19
asnA,7854258,7854310,7854258,52,12,utRho19
asnB,1398444,1398444,1398354,90,112,utRho19
asnC,23562186,23562186,23562018,168,12,utRho19
asnS,1978088,1978088,1977970,118,11646,utRho19
asnT,4089082,4089098,4089082,16,610,utRho19
asnU,4119690,4119702,4119690,12,4,utRho19
asnV,4124504,4124520,4124504,16,42,utRho19
aspA,17473728,17473728,17473308,420,328,utRho19
aspC,1971486,1971486,1971418,68,210,utRho19
aspS,3901402,3901402,3901044,358,98,utRho19
aspT,7893560,7893744,7893560,184,120474,utRho19
aspV,473826,473862,473826,36,10,utRho19
asr,3342654,3342752,3342654,98,210,utRho19
astC,3664088,3664088,3663964,124,46,utRho19
astE,3654138,3654138,3653846,292,6,utRho19
atoD,4646824,4646894,4646824,70,38,utRho19
atpB,7844540,7844540,7844102,438,130,utRho19
atpC,7832118,7832118,7831944,174,398,utRho19
atpI,7845050,7845050,7844880,170,0,utRho19
avtA,7479348,7479410,7479348,62,26,utRho19
azoR,2965982,2965982,2965720,262,406,utRho19
azuC,3976002,3976002,3975918,84,0,utRho19
bacA,6408350,6408350,6408262,88,60,utRho19
bamA,394052,395856,394052,1804,1176,utRho19
bamB,5277950,5277950,5277304,646,1778,utRho19
bamC,5198028,5198028,5197730,298,2974,utRho19
bamD,5471922,5472292,5471922,370,1288,utRho19
bamE,5506972,5507210,5506972,238,396,utRho19
basS,8666954,8666954,8666544,410,730,utRho19
bax,7474468,7474468,7474354,114,12,utRho19
bcp,5200874,5200956,5200874,82,4062,utRho19
bcsB,7385346,7385346,7385214,132,32,utRho19
bcsE,7392644,7392916,7392644,272,0,utRho19
bdcA,8948128,8948128,8948106,22,20,utRho19
bdcR,8948192,8948248,8948192,56,4,utRho19
bdm,3112680,3112680,3112560,120,90,utRho19
betA,654522,654522,654494,28,286,utRho19
betI,658722,658722,658668,54,4,utRho19
betT,658842,658926,658842,84,42,utRho19
bfr,6933498,6933498,6933450,48,172,utRho19
bglG,23440182,23440182,23439402,780,6,utRho19
bglX,4444240,4444240,4443978,262,0,utRho19
bhsA,2337962,2338146,2337962,184,2,utRho19
bioA,1618584,1618584,1618514,70,0,utRho19
bioB,1618604,1618688,1618604,84,4,utRho19
bioH,7089716,7089716,7089688,28,0,utRho19
bisC,7433026,7433026,7432788,238,4,utRho19
blc,8755490,8755490,8755444,46,4,utRho19
blr,3409024,3409102,3409024,78,202,utRho19
bluF,2431226,2431226,2430950,276,30,utRho19
bluR,2428226,2428226,2428118,108,0,utRho19
bolA,908698,908944,908698,246,0,utRho19
borD,1157842,1157842,1157786,56,58,utRho19
brnQ,838976,839182,838976,206,600,utRho19
bssR,1756492,1756496,1756492,4,0,utRho19
bssS,2242116,2242116,2241910,206,174,utRho19
btuB,8326798,8327278,8326798,480,2800,utRho19
cadB,8720212,8720212,8720062,150,2,utRho19
cadC,8723926,8723926,8723868,58,0,utRho19
caiE,70998,70998,70742,256,10,utRho19
caiF,68436,68600,68436,164,14,utRho19
caiT,84074,84074,83862,212,0,utRho19
can,285406,285406,285340,66,144,utRho19
carA,59102,59302,59102,200,14,utRho19
carB,61550,61634,61550,84,284,utRho19
cas2,5757830,5757830,5757706,124,118,utRho19
casA,5768638,5768638,5768276,362,0,utRho19
cbl,4121882,4121882,4121828,54,148,utRho19
cbpA,2128074,2128074,2127550,524,92,utRho19
cbrA,7738628,7738754,7738628,126,0,utRho19
cbrB,7794958,7795012,7794958,54,2,utRho19
ccmH,4585242,4585242,4584820,422,2,utRho19
cdaR,364894,364926,364894,32,0,utRho19
cdd,4463638,4463688,4463638,50,28,utRho19
cdh,8219814,8219860,8219814,46,8,utRho19
cdsA,391110,391354,391110,244,432,utRho19
cedA,3627484,3627484,3627326,158,52,utRho19
cfa,3482402,3482826,3482402,424,580,utRho19
chaC,2544844,2544972,2544844,128,14,utRho19
chbB,3643452,3643452,3643238,214,2,utRho19
chbG,3634624,3634624,3634270,354,0,utRho19
cheW,3946924,3946924,3946678,246,170,utRho19
chiA,6939792,6939792,6939706,86,0,utRho19
chiP,1416472,1416668,1416472,196,2,utRho19
cho,3646984,3647030,3646984,46,162,utRho19
chpS,8896804,8896894,8896804,90,4,utRho19
cirA,4493884,4493884,4493538,346,4,utRho19
citC,1304078,1304078,1303712,366,0,utRho19
citT,1293264,1293264,1293160,104,2,utRho19
clcA,350104,350214,350104,110,220,utRho19
clpA,1846160,1846528,1846160,368,140,utRho19
clpB,5468410,5468410,5468346,64,190,utRho19
clpP,913154,913354,913154,200,614,utRho19
clpS,1845500,1845826,1845500,326,0,utRho19
clpX,914404,914852,914404,448,3248,utRho19
clsA,2617346,2617346,2617290,56,118,utRho19
clsC,2212584,2212710,2212584,126,942,utRho19
cmk,1922330,1922402,1922330,72,112,utRho19
cnu,3409522,3409898,3409522,376,854,utRho19
coaA,8350214,8350214,8350052,162,42,utRho19
cobC,1340092,1340092,1339814,278,358,utRho19
cobT,4129202,4129202,4128934,268,0,utRho19
cobU,4131944,4131944,4131528,416,28,utRho19
codB,709768,709844,709768,76,8,utRho19
comR,2337726,2337726,2337664,62,0,utRho19
copA,1022822,1022822,1022758,64,0,utRho19
corA,8002388,8002852,8002388,464,5304,utRho19
cpdB,8873258,8873258,8873130,128,440,utRho19
cptB,6082198,6082198,6082140,58,0,utRho19
cpxA,8210202,8210202,8209950,252,1680,utRho19
cpxP,8211570,8211640,8211570,70,302,utRho19
cpxR,8211372,8211372,8211340,32,246,utRho19
cra,175894,176056,175894,162,40,utRho19
crcB,1316016,1316016,1315876,140,2,utRho19
creA,9270486,9271042,9270486,556,884,utRho19
creD,9276320,9276356,9276320,36,2,utRho19
crl,515620,515658,515620,38,3742,utRho19
crp,6971906,6972240,6971906,334,3846,utRho19
crr,5070960,5071668,5070960,708,13692,utRho19
csdA,5886414,5886674,5886414,260,2,utRho19
csgB,2207718,2207902,2207718,184,2,utRho19
csgD,2206688,2206688,2206392,296,4,utRho19
csgG,2203510,2203510,2203368,142,66,utRho19
csiD,5577854,5577970,5577854,116,1550,utRho19
csiE,5330802,5330870,5330802,68,162,utRho19
csiR,5590942,5591348,5590942,406,492,utRho19
cspA,7439778,7440098,7439778,320,620,utRho19
cspB,3283430,3283430,3283108,322,0,utRho19
cspC,3815018,3815018,3814870,148,434,utRho19
cspD,1845352,1845352,1845180,172,20648,utRho19
cspE,1314294,1314584,1314294,290,0,utRho19
cspF,3283380,3283710,3283380,330,0,utRho19
cspG,2102610,2102922,2102610,312,136,utRho19
cspH,2102746,2102746,2102350,396,0,utRho19
cspI,3277624,3277624,3277334,290,0,utRho19
csrA,5638746,5638746,5638292,454,2434,utRho19
csrB,5849048,5849048,5849048,0,0,utRho19
csrC,8102072,8102072,8102072,0,0,utRho19
csrD,6806850,6806850,6806664,186,430,utRho19
cstA,1259710,1259788,1259710,78,0,utRho19
cueO,274090,274166,274090,76,100,utRho19
cueR,1027948,1027986,1027948,38,78,utRho19
curA,3037784,3038054,3037784,270,10,utRho19
cusC,1191146,1191200,1191146,54,0,utRho19
cusR,1190924,1190924,1190886,38,36,utRho19
cutA,8730784,8730784,8730712,72,72,utRho19
cutC,3918534,3918534,3917920,614,234,utRho19
cvpA,4861600,4861600,4861526,74,0,utRho19
cvrA,2484328,2484328,2484142,186,58,utRho19
cyaA,7981548,7982306,7981548,758,1070,utRho19
cyaR,4334228,4334224,4334228,4,0,utRho19
cyaY,7988166,7988166,7988118,48,58,utRho19
cybB,2981522,2981804,2981522,282,50,utRho19
cycA,8859560,8859728,8859560,168,76,utRho19
cydA,1542340,1542916,1542340,576,558,utRho19
cydC,1858800,1858800,1858390,410,326,utRho19
cydD,1862062,1862062,1861924,138,2,utRho19
cydX,1548300,1548392,1548300,92,546,utRho19
cynR,717418,717418,717380,38,2,utRho19
cynT,1435092,1435196,1435092,104,0,utRho19
cyoA,903306,903306,903220,86,1104,utRho19
cyoE,895540,895540,895410,130,396,utRho19
cysB,2667576,2667710,2667576,134,606,utRho19
cysC,5748056,5748056,5747984,72,44,utRho19
cysD,5752736,5752736,5752658,78,0,utRho19
cysE,7565362,7565362,7565124,238,1796,utRho19
cysG,6995508,6995656,6995508,148,48,utRho19
cysJ,5783928,5783928,5783796,132,92,utRho19
cysK,5064688,5064818,5064688,130,156,utRho19
cysP,5087114,5087114,5087056,58,8,utRho19
cysS,1109154,1109222,1109154,68,44,utRho19
cysT,3984100,3984100,3983974,126,136,utRho19
cysZ,5062766,5062926,5062766,160,270,utRho19
cytR,8249018,8249018,8248912,106,60,utRho19
dacA,1328002,1328002,1327926,76,202,utRho19
dacB,6657714,6657926,6657714,212,0,utRho19
dacC,1761306,1761454,1761306,148,2,utRho19
dadA,2475018,2475142,2475018,124,114,utRho19
dam,7032504,7032504,7031826,678,1452,utRho19
damX,7035200,7035200,7034612,588,372,utRho19
dapA,5199568,5199568,5199520,48,0,utRho19
dapB,56576,56748,56576,172,30,utRho19
dapD,371954,371954,371894,60,554,utRho19
dapE,5183120,5183214,5183120,94,688,utRho19
dcp,3254844,3254844,3254760,84,134,utRho19
dcrB,7219534,7219910,7219534,376,8,utRho19
dctA,7366996,7366996,7366894,102,280,utRho19
dcuA,8733686,8733686,8733546,140,4,utRho19
dcuB,8698182,8698182,8697488,694,48,utRho19
dcuC,1312166,1312166,1311936,230,6,utRho19
dcuD,6749166,6749738,6749166,572,8,utRho19
dcuR,8701130,8701130,8700068,1062,656,utRho19
dcuS,8703370,8703370,8703324,46,6,utRho19
dcyD,3999016,3999016,3998960,56,0,utRho19
ddpX,3126498,3126498,3126152,346,6,utRho19
deaD,6615818,6615818,6615720,98,122,utRho19
dedA,4869880,4869880,4869482,398,8444,utRho19
dedD,4863750,4863750,4863368,382,40,utRho19
def,6867300,6867380,6867300,80,0,utRho19
degP,361690,361768,361690,78,0,utRho19
degQ,6761308,6761486,6761308,178,216,utRho19
deoB,9239134,9239206,9239134,72,4,utRho19
deoC,9233358,9234646,9233358,1288,394,utRho19
dfp,7625406,7625462,7625406,56,0,utRho19
dgcZ,3247758,3247758,3247700,58,0,utRho19
dgkA,8512914,8513274,8512914,360,676,utRho19
dgt,358392,358474,358392,82,10,utRho19
dhaK,2501888,2501888,2501676,212,236,utRho19
dhaR,2502006,2502132,2502006,126,0,utRho19
dicB,3299194,3299218,3299194,24,0,utRho19
dicC,3295752,3295752,3295700,52,0,utRho19
dinB,501760,501796,501760,36,0,utRho19
dinD,7635398,7635520,7635398,122,0,utRho19
dinG,1666146,1666140,1666146,6,0,utRho19
dinI,2243018,2243018,2242974,44,4,utRho19
dinJ,493230,493230,493004,226,2,utRho19
dinQ,7295964,7295964,7295576,388,358,utRho19
djlA,114536,114728,114536,192,4,utRho19
dkgA,6313142,6313246,6313142,104,1632,utRho19
dkgB,458196,458334,458196,138,0,utRho19
dksA,321502,321502,321208,294,676,utRho19
dld,4444164,4444370,4444164,206,22,utRho19
dmlA,3763424,3763824,3763424,400,162,utRho19
dmlR,3763710,3763710,3763618,92,4,utRho19
dmsA,1881646,1881918,1881646,272,0,utRho19
dnaA,7767922,7767922,7767458,464,1314,utRho19
dnaB,8528566,8528628,8528566,62,152,utRho19
dnaK,24096,24326,24096,230,2250,utRho19
dnaN,7765466,7765466,7764642,824,68,utRho19
dnaQ,471868,472134,471868,266,2340,utRho19
dnaT,18406460,18406460,18406068,392,384,utRho19
dnaX,984112,984184,984112,72,320,utRho19
dosP,3131486,3131486,3131466,20,110,utRho19
dpiB,1303968,1304470,1303968,502,0,utRho19
dppA,7415740,7415740,7415410,330,4258,utRho19
dps,1697900,1697900,1697822,78,478,utRho19
dsbA,8086754,8086836,8086754,82,2158,utRho19
dsbB,2466294,2466294,2466060,234,0,utRho19
dsbC,6079266,6079266,6077644,1622,1948,utRho19
dsbG,1277600,1277600,1277146,454,716,utRho19
dsdA,4958242,4958404,4958242,162,118,utRho19
dsdC,4955492,4955492,4955258,234,2,utRho19
dsdX,4955642,4955694,4955642,52,4,utRho19
dsrA,4050626,4050626,4050626,0,0,utRho19
dsrB,4049686,4049686,4049646,40,6,utRho19
dtpD,1485340,1485340,1485112,228,4,utRho19
dusA,8523200,8523338,8523200,138,516,utRho19
dusB,6820492,6820560,6820492,68,0,utRho19
dusC,4460790,4460790,4460770,20,0,utRho19
dut,7627704,7627864,7627704,160,1690,utRho19
dxr,386670,387042,386670,372,1912,utRho19
ebgA,6445102,6445266,6445102,164,0,utRho19
ebgR,6442874,6442932,6442874,58,54,utRho19
ecnB,8753018,8753106,8753018,88,52,utRho19
eco,4607594,4607810,4607594,216,4,utRho19
ecpA,621594,621594,621342,252,0,utRho19
ecpB,620238,620238,620052,186,0,utRho19
ecpR,622964,622964,622672,292,0,utRho19
eda,3866218,3866218,3865512,706,498,utRho19
edd,3869426,3869426,3869208,218,0,utRho19
efeO,2164308,2164486,2164308,178,132,utRho19
efeU_1,2162614,2162712,2162614,98,60,utRho19
efp,8751134,8751398,8751134,264,3154,utRho19
elaA,4763372,4763372,4763086,286,126,utRho19
elaD,4765308,4765426,4765308,118,0,utRho19
elfA,1995530,1995736,1995530,206,0,utRho19
elfD,1996642,1996980,1996642,338,0,utRho19
emrD,7707690,7707844,7707690,154,12,utRho19
emrK,4966896,4966896,4966678,218,2,utRho19
emrY,4964668,4964668,4964352,316,268,utRho19
emtA,2486250,2486360,2486250,110,0,utRho19
endA,12361100,12361388,12361100,288,0,utRho19
eno,5817692,5817692,5815882,1810,4574,utRho19
entC,1249662,1249770,1249662,108,2,utRho19
entD,1220508,1220508,1220158,350,52,utRho19
entH,1258584,1258600,1258584,16,0,utRho19
entS,1244506,1244600,1244506,94,40,utRho19
envR,6827266,6827266,6826930,336,0,utRho19
epd,12295292,12295292,12294764,528,312,utRho19
epmA,8765236,8765286,8765236,50,4,utRho19
epmB,8751406,8751406,8751314,92,976,utRho19
eptB,7421162,7421162,7420950,212,80,utRho19
eptC,8300622,8300622,8300530,92,46,utRho19
erfK,4126708,4126708,4126646,62,4,utRho19
erpA,353122,353220,353122,98,8,utRho19
esrE,8039956,8039956,8039956,0,0,utRho19
essD,1153746,1154796,1153746,1050,124,utRho19
etk,2088606,2088606,2088420,186,16,utRho19
evgA,4967262,4967510,4967262,248,0,utRho19
exbB,6304028,6304028,6303968,60,0,utRho19
exbD,6302780,6302780,6302486,294,200,utRho19
exuR,6493016,6493304,6493016,288,96,utRho19
exuT,6490004,6490208,6490004,204,0,utRho19
fabA,2032996,2032996,2032940,56,132,utRho19
fabB,4883282,4883282,4883210,72,64,utRho19
fabH,2297032,2297518,2297032,486,656,utRho19
fabI,2702236,2702236,2702078,158,2,utRho19
fadB,8062026,8062026,8061942,84,0,utRho19
fadD,3779614,3779614,3779492,122,0,utRho19
fadE,486812,486812,486606,206,0,utRho19
fadH,6463248,6463330,6463248,82,4,utRho19
fadI,4921022,4921022,4920938,84,6,utRho19
fadL,4922410,4922600,4922410,190,452,utRho19
fadM,928720,928804,928720,84,0,utRho19
fadR,2469810,2469876,2469810,66,0,utRho19
fbaB,4357334,4357334,4357128,206,882,utRho19
fdhE,8162722,8162722,8162456,266,1708,utRho19
fdhF,8598814,8598814,8598732,82,46,utRho19
fdnG,3094744,3094802,3094744,58,0,utRho19
fdrA,1093012,1093360,1093012,348,0,utRho19
feaB,2894994,2895038,2894994,44,0,utRho19
feaR,2894734,2894734,2894566,168,22,utRho19
fecA,9033454,9033454,9033354,100,80,utRho19
fecE,9023288,9023288,9022914,374,1268,utRho19
fecI,9036564,9036564,9036470,94,16,utRho19
feoA,7080114,7080326,7080114,212,570,utRho19
fepA,1225334,1225334,1224988,346,6,utRho19
fepB,1249454,1249454,1249020,434,2,utRho19
fepD,1244468,1244468,1244378,90,0,utRho19
fes,1225374,1225630,1225374,256,44,utRho19
ffh,5495706,5495706,5495590,116,1432,utRho19
ffs,952576,952848,952576,272,96,utRho19
fhuA,334884,334968,334884,84,42,utRho19
fhuE,2323294,2323294,2323102,192,290,utRho19
fhuF,9211504,9211504,9211326,178,734,utRho19
fic,6983296,6983296,6982926,370,464,utRho19
fieF,8212864,8212938,8212864,74,2,utRho19
fimA,9085388,9086230,9085388,842,504,utRho19
fimB,9081334,9081914,9081334,580,2130,utRho19
fimE,9083742,9084074,9083742,332,24,utRho19
fimZ,1129214,1129214,1128960,254,0,utRho19
fiu,1683296,1683296,1683062,234,2,utRho19
fixA,84650,84806,84650,156,56,utRho19
fkpA,6955050,6955050,6954838,212,3604,utRho19
fldA,2846084,2846084,2845860,224,4172,utRho19
fldB,6079644,6079710,6079644,66,0,utRho19
flgA,2261770,2261770,2261726,44,12,utRho19
flgB,2261986,2262036,2261986,50,2,utRho19
flgK,2276702,2276756,2276702,54,2,utRho19
flgM,2260330,2260330,2260256,74,42,utRho19
flgN,2259828,2259828,2259660,168,0,utRho19
flhB,3932432,3932432,3932382,50,246,utRho19
flhC,3955864,3955864,3955688,176,2,utRho19
flhD,3957154,3957154,3956394,760,354,utRho19
fliA,4003638,4003638,4003578,60,0,utRho19
fliC,4007352,4007352,4007212,140,0,utRho19
fliD,4007634,4007744,4007634,110,114,utRho19
fliE,4026186,4026186,4026028,158,6,utRho19
fliF,4026292,4026458,4026292,166,2,utRho19
fliL,4039168,4039236,4039168,68,0,utRho19
flk,4875824,4875900,4875824,76,0,utRho19
flu,4142634,4143078,4142634,444,2,utRho19
flxA,3292776,3292810,3292776,34,66,utRho19
fnr,2799104,2799104,2799052,52,0,utRho19
fnrS,2818258,2818258,2818258,0,0,utRho19
focA,1909628,1909628,1908932,696,186,utRho19
folA,99598,99646,99598,48,2,utRho19
folB,6409296,6409296,6409178,118,2,utRho19
folD,1115562,1115562,1115482,80,84,utRho19
folE,4487696,4487696,4487304,392,2990,utRho19
fpr,8228998,8228998,8228944,54,0,utRho19
frc,4986878,4986878,4986508,370,0,utRho19
frdA,8764824,8764824,8764636,188,4,utRho19
frdD,8758948,8758948,8758732,216,762,utRho19
fre,8052886,8053054,8052886,168,1788,utRho19
frlA,6999518,6999820,6999518,302,6,utRho19
frr,385624,385744,385624,120,1550,utRho19
frsA,513004,513054,513004,50,8,utRho19
fruB,4527194,4527194,4526990,204,18,utRho19
frvR,8179804,8179804,8179710,94,0,utRho19
fryA,5008986,5008986,5008970,16,4,utRho19
fsaA,1727060,1727284,1727060,224,4,utRho19
fsr,1009710,1009710,1009392,318,176,utRho19
ftnA,3977364,3977432,3977364,68,2,utRho19
ftnB,3973550,3973850,3973550,300,228,utRho19
ftsA,207122,207964,207122,842,1254,utRho19
ftsB,5745802,5745802,5745640,162,328,utRho19
ftsH,6654204,6654204,6653870,334,300,utRho19
ftsK,1865858,1866448,1865858,590,3164,utRho19
ftsL,181376,182064,181376,688,3550,utRho19
ftsP,6325732,6325732,6325338,394,406,utRho19
ftsQ,205484,206310,205484,826,1214,utRho19
ftsX,7204512,7204512,7204172,340,1116,utRho19
ftsZ,209272,210610,209272,1338,268,utRho19
fucA,5867708,5867708,5867376,332,28,utRho19
fucP,5868238,5868470,5868238,232,0,utRho19
fumA,6753760,6753760,6753508,252,10604,utRho19
fumB,8694696,8694696,8694652,44,0,utRho19
fumC,3373418,3373418,3373176,242,74,utRho19
fur,2842892,2842892,2842584,308,7380,utRho19
fusA,6947370,6947370,6947028,342,15168,utRho19
fxsA,8737206,8737328,8737206,122,256,utRho19
gabD,5581824,5582546,5581824,722,46384,utRho19
gadA,7335214,7335214,7335160,54,0,utRho19
gadB,3144144,3144144,3144090,54,8,utRho19
gadC,3141168,3141168,3140978,190,120,utRho19
gadE,7315600,7316732,7315600,1132,14,utRho19
gadW,7329562,7329562,7329236,326,126,utRho19
gadX,14663356,14663356,14663240,116,192,utRho19
gadY,7329728,7329728,7329728,0,0,utRho19
galE,1584354,1584354,1584110,244,40,utRho19
galF,4228702,4228702,4228654,48,164,utRho19
galM,1577796,1577796,1577674,122,3252,utRho19
galP,6176510,6176568,6176510,58,0,utRho19
galR,5953138,5953198,5953138,60,16,utRho19
galS,4483420,4483420,4483336,84,0,utRho19
galU,2582810,2582914,2582810,104,602,utRho19
gapA,3724480,3725542,3724480,1062,13820,utRho19
garP,6549868,6549868,6549814,54,230,utRho19
gatY,4354468,4354468,4354408,60,0,utRho19
gatZ,4352864,4352864,4352642,222,43642,utRho19
gcd,282558,282558,282450,108,0,utRho19
gcl,1067814,1067832,1067814,18,0,utRho19
gcvA,5885278,5885278,5885134,144,0,utRho19
gcvB,5885392,5885392,5885392,0,0,utRho19
gcvR,5199758,5199812,5199758,54,72,utRho19
gcvT,6101544,6101544,6101334,210,4046,utRho19
gdhA,3684616,3684742,3684616,126,0,utRho19
gfcA,2099668,2099668,2099488,180,16,utRho19
gfcD,2096236,2096236,2095890,346,184,utRho19
ghrA,2195648,2195772,2195648,124,0,utRho19
ghrB,7434378,7434620,7434378,242,1694,utRho19
glcA,6242728,6242728,6242558,170,462,utRho19
glcC,6256412,6256544,6256412,132,0,utRho19
glcD,6256152,6256152,6256042,110,2,utRho19
gldA,8278092,8278092,8278070,22,224,utRho19
glgA,7136784,7136784,7136066,718,3770,utRho19
glgB,7147314,7147314,7147004,310,722,utRho19
glgC,7139142,7139142,7138656,486,914,utRho19
glgP,7133546,7133546,7133162,384,1000,utRho19
glgS,6384024,6384024,6383878,146,64,utRho19
glgX,7142838,7142838,7142638,200,154,utRho19
glk,5018922,5018922,5018852,70,220,utRho19
glmS,7827622,7827622,7827336,286,5692,utRho19
glmU,7830652,7830652,7830400,252,0,utRho19
glmY,10765360,10765360,10765360,0,0,utRho19
glmZ,7972864,7972864,7972864,0,0,utRho19
glnA,16232888,16232888,16232136,752,1236,utRho19
glnB,5375052,5375052,5374816,236,152,utRho19
glnD,377310,377310,377300,10,0,utRho19
glnE,6399602,6399602,6399282,320,292,utRho19
glnH,1696396,1696396,1696008,388,670,utRho19
glnK,945112,945196,945112,84,2,utRho19
glnL,8112742,8112742,8112678,64,0,utRho19
glnQ,1693262,1693262,1692926,336,1530,utRho19
glnS,1411998,1412186,1411998,188,792,utRho19
gloA,3455602,3455674,3455602,72,66,utRho19
gloB,469852,469852,469564,288,3486,utRho19
glpA,4705166,4705294,4705166,128,0,utRho19
glpD,7123942,7124026,7123942,84,0,utRho19
glpE,7123698,7123698,7123646,52,0,utRho19
glpF,8236322,8236322,8236180,142,8,utRho19
glpG,7122960,7122960,7122904,56,244,utRho19
glpR,7121782,7121782,7121210,572,510,utRho19
glpT,4704902,4704902,4704748,154,6,utRho19
glpX,8231212,8231212,8231158,54,26,utRho19
glrK,5382246,5382246,5382196,50,6,utRho19
gltA,1509534,1509534,1508936,598,53062,utRho19
gltB,6709018,6709264,6709018,246,42,utRho19
gltI,1375792,1375792,1375494,298,2738,utRho19
gltP,8588536,8588962,8588536,426,1370,utRho19
gltS,7657382,7657382,7657330,52,130,utRho19
gltX,5041568,5041568,5041344,224,514,utRho19
gluQ,320286,320286,320224,62,142,utRho19
glyA,5371148,5371148,5371014,134,290,utRho19
glyQ,7450708,7450708,7450636,72,8,utRho19
glyS,7448990,7448990,7448794,196,2748,utRho19
glyU,5998128,5998128,5998114,14,0,utRho19
glyV,8784626,8784720,8784626,94,202,utRho19
glyW,3984360,3984360,3984234,126,78,utRho19
gmhB,445612,445666,445612,54,2,utRho19
gmk,7642776,7642856,7642776,80,48,utRho19
gmr,2693686,2693686,2693484,202,204,utRho19
gnd,4202648,4202648,4202536,112,314,utRho19
gnsB,3275692,3275692,3275564,128,0,utRho19
gntK,14310580,14310580,14310368,212,132,utRho19
gntP,9102668,9102668,9102592,76,20,utRho19
gntR,7157760,7157760,7157452,308,710,utRho19
gntT,7092810,7093118,7092810,308,22,utRho19
gntU,7154170,7154170,7154122,48,2,utRho19
gntX,7089334,7089764,7089334,430,6,utRho19
gor,7292224,7292598,7292224,374,692,utRho19
gpmA,1575340,1575340,1575190,150,0,utRho19
gpmM,7570374,7570520,7570374,146,0,utRho19
gpsA,7567620,7567620,7567322,298,16634,utRho19
gpt,511828,511954,511828,126,178,utRho19
grcA,5433046,5433046,5432898,148,20,utRho19
greA,6657728,6657728,6657430,298,788,utRho19
greB,7073488,7073624,7073488,136,184,utRho19
groL,8741566,8742050,8741566,484,34800,utRho19
groS,8741232,8741376,8741232,144,18338,utRho19
grpE,5501494,5501494,5501416,78,674,utRho19
grxA,1781552,1781552,1781506,46,0,utRho19
grxB,2248206,2248206,2248108,98,70,utRho19
grxC,7569152,7569152,7568884,268,6946,utRho19
grxD,3468324,3468324,3468202,122,5192,utRho19
gspA,6911268,6911268,6910796,472,94,utRho19
gspC,6910964,6911156,6910964,192,90,utRho19
gss,6277220,6277220,6277044,176,138,utRho19
gstA,3428654,3428754,3428654,100,0,utRho19
gstB,1761038,1761038,1760960,78,188,utRho19
guaB,5268214,5268214,5268140,74,106,utRho19
gudD,5839026,5839026,5838770,256,212,utRho19
gyrA,4678914,4678914,4678840,74,6,utRho19
gyrB,7760300,7760300,7760238,62,192,utRho19
hcaE,5337964,5338064,5337964,100,100,utRho19
hcaR,5337928,5337928,5337792,136,68,utRho19
hcaT,5336106,5336106,5335692,414,290,utRho19
hchA,4071260,4071670,4071260,410,1246,utRho19
hcp,1828258,1828258,1827628,630,4,utRho19
hcr,1824400,1824400,1824300,100,56,utRho19
hdeA,7313582,7313582,7313480,102,0,utRho19
hdeD,7313920,7313990,7313920,70,20,utRho19
hdfR,7896320,7896320,7895934,386,138,utRho19
hdhA,3396244,3396244,3396080,164,70,utRho19
helD,2048876,2048942,2048876,66,0,utRho19
hemA,2527166,2527428,2527166,262,346,utRho19
hemB,779722,779722,779454,268,108,utRho19
hemF,5106410,5106450,5106410,40,54,utRho19
hemH,996062,996110,996062,48,144,utRho19
hemL,349882,349882,349764,118,184,utRho19
hemN,8103886,8104090,8103886,204,8,utRho19
hepA,127176,127176,126528,648,1312,utRho19
hflD,2385372,2385372,2385262,110,494,utRho19
hfq,8799602,8800576,8799602,974,7124,utRho19
hha,961006,961006,960616,390,14,utRho19
hicA,3018442,3018572,3018442,130,0,utRho19
higA,6468682,6468682,6468288,394,184,utRho19
higB,6468960,6468960,6468910,50,2,utRho19
hinT,2323642,2323770,2323642,128,92,utRho19
hipB,3184964,3184964,3184884,80,8,utRho19
hisB,4186720,4186936,4186720,216,938,utRho19
hisJ,4853674,4853674,4853576,98,284,utRho19
hisL,8359856,8359984,8359856,128,668,utRho19
hisS,5281284,5281284,5281150,134,124,utRho19
hlpA,400910,400964,400910,54,80,utRho19
hlyE,2460932,2460932,2460788,144,6,utRho19
hmp,5371594,5371670,5371594,76,28,utRho19
hns,2585916,2585916,2585844,72,764,utRho19
hofM,7045856,7045856,7045502,354,2,utRho19
hokA,7441620,7441620,7441200,420,8,utRho19
hokC,33902,33902,33806,96,116,utRho19
hokE,1215462,1215672,1215462,210,2,utRho19
holC,8968546,8968546,8968560,14,1922,utRho19
holD,9215562,9215606,9215562,44,0,utRho19
holE,3850040,3850216,3850040,176,290,utRho19
hpt,282720,282862,282720,142,66,utRho19
hrpB,324150,324210,324150,60,14,utRho19
hscB,5319048,5319048,5318934,114,1110,utRho19
hscC,1367188,1367188,1366786,402,1180,utRho19
hsdS,9163004,9163004,9162924,80,22,utRho19
hslJ,2883560,2883560,2883486,74,186,utRho19
hslO,7059344,7059548,7059344,204,11334,utRho19
hslR,7058220,7058696,7058220,476,1588,utRho19
hslV,8244708,8244708,8244574,134,164,utRho19
hsrA,7881412,7881412,7881224,188,0,utRho19
htgA,21286,21660,21286,374,316,utRho19
htpG,989634,990240,989634,606,2684,utRho19
htpX,3825236,3825236,3825152,84,0,utRho19
htrE,311036,311036,310852,184,0,utRho19
htrL,7587668,7587668,7587366,302,0,utRho19
hupA,8400352,8400562,8400352,210,346,utRho19
hupB,1845220,1845804,1845220,584,1008,utRho19
hyaA,2063968,2064278,2063968,310,2,utRho19
hybO,6292726,6292726,6292522,204,2288,utRho19
hycA,5700922,5700922,5700870,52,22,utRho19
hycI,5686204,5686204,5686086,118,498,utRho19
hydN,5676264,5676264,5676210,54,14,utRho19
hyfA,5202342,5202402,5202342,60,2,utRho19
hypA,11402508,11402588,11402508,80,4,utRho19
hypB,11403356,11404004,11403356,648,676,utRho19
hypF,5676210,5676210,5674850,1360,512,utRho19
hypT,9116634,9116634,9116578,56,0,utRho19
hyuA,6019660,6020056,6019660,396,8,utRho19
iaaA,1733074,1733136,1733074,62,24,utRho19
iadA,9119074,9119074,9119052,22,36,utRho19
iap,5753072,5753162,5753072,90,2,utRho19
ibaG,6673966,6673966,6673606,360,0,utRho19
ibpA,7735036,7735036,7734844,192,414,utRho19
ibpB,7733962,7733962,7733794,168,622,utRho19
icd,2389922,2390246,2389922,324,738,utRho19
iclR,8447304,8447304,8447256,48,132,utRho19
idi,6065876,6066130,6065876,254,0,utRho19
idnD,8988870,8988870,8988812,58,0,utRho19
idnK,8989194,8989246,8989194,52,4,utRho19
ihfA,3591442,3591442,3591104,338,1492,utRho19
ihfB,1927498,1927656,1927498,158,1870,utRho19
ileS,43666,44782,43666,1116,8204,utRho19
ileX,6431194,6431196,6431194,2,0,utRho19
ilvA,15820940,15821324,15820940,384,92,utRho19
ilvC,7915824,7915940,7915824,116,4,utRho19
ilvE,15809552,15809936,15809552,384,544,utRho19
ilvI,170840,171260,170840,420,4,utRho19
ilvL,23701308,23701932,23701308,624,6,utRho19
ilvY,7915734,7915734,7915640,94,2,utRho19
inaA,4698998,4698998,4698944,54,4,utRho19
infA,1853370,1853370,1852886,484,192,utRho19
infC,3602692,3602692,3601276,1416,5100,utRho19
insA-5,3958452,3958452,3958430,22,36,utRho19
insA-7,9036758,9037054,9036758,296,10,utRho19
insC-5,6372080,6372284,6372080,204,248,utRho19
insEF-2,785238,785238,785820,582,486,utRho19
insEF-4,2190310,2190310,2190892,582,418,utRho19
insG,9007098,9007098,9006862,236,18,utRho19
insH-1,550596,550596,550234,362,660,utRho19
insH-11,7306538,7306538,7306396,142,178,utRho19
insH-2,1151548,1151548,1151506,42,604,utRho19
insH-3,1378444,1378444,1378026,418,256,utRho19
insH-4,2791942,2792152,2791942,210,152,utRho19
insH-5,2857852,2857852,2857452,400,54,utRho19
insH-6,4135022,4135022,4134642,380,410,utRho19
insH-7,4206186,4206186,4205822,364,3710,utRho19
insH-9,6260050,6260356,6260050,306,288,utRho19
insI-3,9017372,9017372,9017234,138,10,utRho19
insJ,7441188,7441360,7441188,172,2,utRho19
insK,7442130,7442308,7442130,178,0,utRho19
insL-1,30760,30890,30760,130,3644,utRho19
insL-2,1216112,1216130,1216112,18,70,utRho19
insL-3,5028644,5028662,5028644,18,86,utRho19
insN-1,540452,540484,540452,32,2,utRho19
intD,1132202,1132202,1131956,246,138,utRho19
intR,2826520,2826520,2826470,50,2,utRho19
intS,4933026,4933090,4933026,64,64,utRho19
intZ,5117386,5117542,5117386,156,150,utRho19
iraD,9113152,9113986,9113152,834,112,utRho19
iraM,2424246,2424246,2424006,240,0,utRho19
iraP,802638,802772,802638,134,52,utRho19
iscA,5319924,5319924,5319772,152,2190,utRho19
iscR,5324398,5324398,5324262,136,10260,utRho19
iscX,5313834,5313834,5313472,362,1436,utRho19
ispF,5743968,5743968,5743560,408,1532,utRho19
ispG,5283908,5283908,5283608,300,648,utRho19
ispU,389568,389806,389568,238,184,utRho19
isrA,2811502,2811502,2811618,116,0,utRho19
istr-1,7706384,7706384,7706384,0,0,utRho19
istr-2,7706514,7706514,7706514,0,0,utRho19
ivbL,15412092,15412092,15411952,140,1404,utRho19
ivy,480638,480686,480638,48,0,utRho19
katE,3627628,3627734,3627628,106,308,utRho19
katG,8267624,8267670,8267624,46,102,utRho19
kbaZ,6557732,6557828,6557732,96,0,utRho19
kbl,7585154,7585154,7585102,52,338,utRho19
kch,2621046,2621046,2620538,508,80,utRho19
kdgR,3820506,3820506,3820198,308,90,utRho19
kdpE,1443788,1443788,1443466,322,2,utRho19
kdpF,1457698,1457698,1457642,56,0,utRho19
kdsA,2535708,2536330,2535708,622,2858,utRho19
kdsC,6683438,6684546,6683438,1108,4118,utRho19
kduI,5968388,5968388,5968248,140,192,utRho19
kefF,94160,94492,94160,332,18,utRho19
kgtP,5451624,5451624,5451492,132,72,utRho19
kup,7862206,7862632,7862206,426,118,utRho19
lacI,735076,735076,735020,56,0,utRho19
lacZ,1465508,1465508,1465220,288,556,utRho19
ldcA,2486394,2486394,2486160,234,6,utRho19
ldhA,2885830,2885830,2885686,144,62,utRho19
ldrA,2538954,2538954,2538550,404,236,utRho19
ldrB,2540024,2540024,2539620,404,64,utRho19
ldrC,2541092,2541092,2540690,402,42,utRho19
ldrD,7400544,7400544,7400174,370,8,utRho19
lepA,5414392,5414392,5414248,144,280,utRho19
lepB,5410928,5410928,5410618,310,1086,utRho19
leuD,159188,159188,158906,282,134,utRho19
leuE,3761600,3761600,3761518,82,2,utRho19
leuL,168048,168048,167416,632,4,utRho19
leuO,168308,168736,168308,428,0,utRho19
leuQ,9212864,9212864,9212802,62,0,utRho19
leuU,6644556,6644556,6644316,240,1584,utRho19
leuV,9212546,9212546,9212330,216,420,utRho19
leuX,8992772,8992810,8992772,38,44,utRho19
lexA,8514174,8514230,8514174,56,178,utRho19
lhr,3456706,3458174,3456706,1468,2244,utRho19
ligA,5060402,5060402,5060352,50,36,utRho19
ligB,7642576,7642576,7642340,236,6,utRho19
lipA,1320602,1320602,1320432,170,6,utRho19
lipB,1324802,1324802,1324556,246,1984,utRho19
lit,2397032,2397390,2397032,358,56,utRho19
livJ,7199524,7199524,7199316,208,114,utRho19
livK,7195510,7195510,7195120,390,88,utRho19
lldP,7554578,7554798,7554578,220,5366,utRho19
lnt,1381968,1381968,1381762,206,1538,utRho19
loiP,6163784,6163826,6163784,42,0,utRho19
lolA,1874656,1874738,1874656,82,282,utRho19
lolB,2527112,2527112,2527000,112,314,utRho19
lolC,2350748,2350854,2350748,106,0,utRho19
lon,917630,917776,917630,146,306,utRho19
lpcA,486936,487086,486936,150,26,utRho19
lpd,255434,255824,255434,390,2786,utRho19
lplA,9248476,9248476,9248234,242,3668,utRho19
lplT,5947878,5947878,5947724,154,0,utRho19
lpoA,6586422,6586800,6586422,378,636,utRho19
lpp,3514592,3514842,3514592,250,130,utRho19
lptA,6686598,6686760,6686598,162,1720,utRho19
lptB,6686792,6687888,6686792,1096,2308,utRho19
lptD,114672,114672,114218,454,2642,utRho19
lptF,8972244,8972436,8972244,192,2,utRho19
lpxC,213016,213114,213016,98,4558,utRho19
lpxD,401920,401942,401920,22,58,utRho19
lpxL,2233418,2233418,2233164,254,0,utRho19
lpxM,3880456,3880456,3880386,70,24,utRho19
lpxP,4991156,4991290,4991156,134,142,utRho19
lrhA,4813312,4813312,4813282,30,52,utRho19
lrp,1864656,1865190,1864656,534,982,utRho19
lspA,50028,50414,50028,386,1998,utRho19
lsrA,3202920,3202980,3202920,60,0,utRho19
lsrR,3202514,3202514,3202482,32,0,utRho19
ltaE,1818640,1818640,1818588,52,88,utRho19
luxS,5630130,5630130,5629466,664,1028,utRho19
lysA,5957902,5957902,5957798,104,2,utRho19
lysC,8467232,8467232,8466466,766,3004,utRho19
lysP,4497120,4497120,4497064,56,64,utRho19
lysR,5957900,5958042,5957900,142,0,utRho19
lysT,1561028,1561108,1561028,80,264,utRho19
lysU,8709610,8709610,8709434,176,80,utRho19
macB,1840188,1840694,1840188,506,1362,utRho19
maeA,3111484,3111484,3111338,146,6496,utRho19
mak,820236,820288,820236,52,64,utRho19
malE,8492928,8492928,8492838,90,4,utRho19
malI,3398456,3398456,3398360,96,124,utRho19
malK,8493472,8493568,8493472,96,0,utRho19
malP,7105020,7105020,7104946,74,2654,utRho19
malQ,7100798,7100798,7100140,658,582,utRho19
malS,14949880,14949988,14949880,108,0,utRho19
malT,7106048,7106170,7106048,122,148,utRho19
malX,3398626,3398710,3398626,84,252,utRho19
malZ,1689980,1690072,1689980,92,12,utRho19
manA,3377102,3377152,3377102,50,0,utRho19
manX,3803866,3804096,3803866,230,14,utRho19
marC,3237882,3237882,3237816,66,0,utRho19
marR,3238186,3238240,3238186,54,12,utRho19
matP,2036918,2036970,2036918,52,110,utRho19
mazE,5822736,5822736,5822678,58,90,utRho19
mazG,5821720,5821720,5821370,350,4412,utRho19
mcbA,1684306,1684306,1684112,194,0,utRho19
mcbR,3040192,3040524,3040192,332,0,utRho19
mcrA,2420278,2420692,2420278,414,0,utRho19
mcrC,9156124,9156124,9155916,208,198,utRho19
mdaB,6344814,6345060,6344814,246,2,utRho19
mdfA,1767138,1767346,1767138,208,2,utRho19
mdh,6768940,6768940,6768536,404,420,utRho19
mdoB,9198988,9198988,9198882,106,1918,utRho19
mdoD,2993290,2993712,2993290,422,0,utRho19
mdoG,2218514,2218670,2218514,156,82,utRho19
mdtA,4307958,4308032,4307958,74,0,utRho19
mdtE,7318168,7318464,7318168,296,7090,utRho19
mdtK,3486538,3486914,3486538,376,46,utRho19
mdtP,8602472,8602472,8602060,412,52,utRho19
melA,8683774,8683822,8683774,48,104,utRho19
melR,8683300,8683300,8683256,44,78,utRho19
menA,8240812,8240812,8240698,114,2,utRho19
menB,4753774,4753774,4753638,136,1330,utRho19
mepH,3468714,3468870,3468714,156,0,utRho19
mepM,3883666,3883666,3883270,396,238,utRho19
mepS,4539840,4539958,4539840,118,144,utRho19
metA,8428318,8428560,8428318,242,0,utRho19
metB,8257272,8257344,8257272,72,1758,utRho19
metC,6304150,6304472,6304150,322,2,utRho19
metE,8025768,8026106,8025768,338,264,utRho19
metF,8265092,8265232,8265092,140,122,utRho19
metG,4388538,4388600,4388538,62,66,utRho19
metH,8447010,8447656,8447010,646,2800,utRho19
metJ,8257116,8257116,8256790,326,280,utRho19
metK,6173154,6173412,6173154,258,240,utRho19
metN,445428,445428,445290,138,0,utRho19
metR,8025710,8025710,8025632,78,10,utRho19
metT,1394326,1394326,1394266,60,98,utRho19
metY,19910250,19910250,19909734,516,102,utRho19
metZ,11789528,11789548,11789528,20,48,utRho19
mfd,2348056,2348056,2347928,128,132,utRho19
mglA,4478782,4478782,4478578,204,710,utRho19
mglB,4481132,4481132,4480696,436,28784,utRho19
mglC,4475918,4475918,4475506,412,650,utRho19
mgrB,3817584,3817584,3817532,52,4,utRho19
mgrR,3245828,3245828,3245828,0,0,utRho19
mgsA,2054082,2054082,2054030,52,50,utRho19
mgtL,8934560,8934862,8934560,302,96,utRho19
mhpA,737038,737222,737038,184,90,utRho19
mhpR,737072,737072,736840,232,148,utRho19
mhpT,750772,750918,750772,146,126,utRho19
miaA,8797964,8798504,8797964,540,722,utRho19
micA,5629604,5629604,5629604,0,0,utRho19
micC,2874242,2874238,2874242,4,0,utRho19
micF,4626168,4626168,4626168,0,0,utRho19
micM,1014408,1014408,1014408,0,0,utRho19
minE,2449422,2449422,2449090,332,5378,utRho19
mioC,7852950,7852950,7852910,40,0,utRho19
mipA,3733012,3733012,3732944,68,1178,utRho19
mlaA,4930270,4930270,4930014,256,20,utRho19
mlc,3337206,3337206,3337128,78,0,utRho19
mlrA,4429498,4429732,4429498,234,8,utRho19
mltA,5894546,5894546,5894356,190,62,utRho19
mltD,468050,468050,467910,140,2,utRho19
mltF,5391534,5391602,5391534,68,0,utRho19
mmuP,550238,550650,550238,412,712,utRho19
mngA,1531622,1531968,1531622,346,4,utRho19
mngR,1531852,1531852,1531750,102,0,utRho19
mnmG,7851348,7851348,7851266,82,366,utRho19
mntH,5025470,5025470,5025412,58,0,utRho19
mntP,3810918,3811376,3810918,458,18,utRho19
mntR,1706160,1706366,1706160,206,0,utRho19
mntS,1706128,1706128,1705994,134,0,utRho19
moaA,1633654,1634088,1633654,434,968,utRho19
moaB,1635954,1636110,1635954,156,4160,utRho19
mobA,8084242,8084242,8083998,244,116,utRho19
mocA,6030112,6030320,6030112,208,18,utRho19
modA,1589990,1590178,1589990,188,0,utRho19
moeA,1732788,1732788,1732728,60,134,utRho19
mokB,2984610,2984610,2984258,352,688,utRho19
molR_1,4392888,4392948,4392888,60,10,utRho19
motA,3954604,3954604,3954278,326,0,utRho19
mpaA,2781278,2781278,2781196,82,1074,utRho19
mpl,8911456,8911570,8911456,114,10,utRho19
mppA,2786108,2786454,2786108,346,2,utRho19
mprA,5621494,5621540,5621494,46,466,utRho19
mqo,4613848,4613848,4613508,340,22,utRho19
mqsA,6336742,6336742,6336492,250,1158,utRho19
mqsR,6337306,6337306,6337088,218,514,utRho19
mraZ,179192,179268,179192,76,0,utRho19
mrcA,7045652,7045742,7045652,90,2,utRho19
mrcB,329442,329460,329442,18,0,utRho19
mreB,13605424,13605424,13604348,1076,1212,utRho19
mreD,6798166,6798166,6797750,416,148,utRho19
mrp,4388360,4388360,4388336,24,0,utRho19
mscK,972984,973072,972984,88,0,utRho19
mscL,6876002,6876048,6876002,46,2,utRho19
mscS,6139742,6139742,6139614,128,386,utRho19
msrA,8884522,8884522,8884352,170,462,utRho19
msrB,3725168,3725168,3724858,310,0,utRho19
msyB,2228426,2228426,2228362,64,350,utRho19
mtfA,4087236,4087302,4087236,66,4972,utRho19
mtgA,6699662,6699662,6699618,44,14,utRho19
mtlA,30177504,30178248,30177504,744,4432,utRho19
mtn,358366,358366,358306,60,10,utRho19
mtr,6611864,6611864,6611634,230,0,utRho19
mug,6430992,6430992,6430946,46,2,utRho19
murQ,5091466,5091546,5091466,80,8,utRho19
murR,5091586,5091586,5091218,368,36,utRho19
mutH,5939164,5939324,5939164,160,436,utRho19
mutL,8794092,8794824,8794092,732,1156,utRho19
mutM,7622554,7622554,7622304,250,36,utRho19
mutS,5714038,5714186,5714038,148,676,utRho19
mutY,18617466,18618078,18617466,612,822,utRho19
nac,4123956,4123956,4123866,90,4,utRho19
nadA,1564122,1564170,1564122,48,0,utRho19
nadB,5420714,5420840,5420714,126,0,utRho19
nadC,237326,237326,237290,36,2,utRho19
nadE,3644604,3644916,3644604,312,80,utRho19
nadK,5501526,5501662,5501526,136,332,utRho19
nagA,1406350,1406350,1405502,848,19644,utRho19
nagB,1407416,1407416,1407222,194,4,utRho19
nagC,1404016,1404016,1403188,828,824,utRho19
nagE,1407680,1407888,1407680,208,54,utRho19
nagK,2357080,2357186,2357080,106,0,utRho19
nanA,6747240,6747240,6747152,88,4,utRho19
nanC,9079856,9079856,9079002,854,4,utRho19
nanR,6749406,6749406,6748978,428,6,utRho19
nanS,9075406,9075406,9075188,218,0,utRho19
napF,4607390,4607390,4606994,396,0,utRho19
narG,2559614,2559728,2559614,114,104,utRho19
narK,2555642,2555914,2555642,272,4,utRho19
narP,4580844,4581000,4580844,156,158,utRho19
narQ,5171154,5171462,5171154,308,82,utRho19
narU,3088326,3088326,3088120,206,2,utRho19
narW,3077374,3077374,3074618,2756,372,utRho19
narX,2555554,2555554,2555236,318,152,utRho19
narZ,3085380,3085380,3085180,200,0,utRho19
ndh,2331984,2332170,2331984,186,2,utRho19
ndk,5289920,5289920,5289728,192,420,utRho19
nemR,6904084,6904092,6904084,8,4,utRho19
nepI,7683542,7683542,7683478,64,0,utRho19
nfo,4501612,4501680,4501612,68,52,utRho19
nfsB,1210906,1210906,1210848,58,2,utRho19
nfuA,7090916,7091248,7090916,332,466,utRho19
nhaA,34634,34978,34634,344,6,utRho19
nhaB,2469534,2469534,2469434,100,80,utRho19
nhoA,3067926,3068048,3067926,122,0,utRho19
nikA,7226878,7227334,7226878,456,318,utRho19
nikR,7237074,7237176,7237074,102,390,utRho19
nirB,6987974,6988022,6987974,48,0,utRho19
nlpA,7680034,7680034,7679986,48,2,utRho19
nlpC,3585654,3585654,3585462,192,0,utRho19
nlpD,5737658,5737658,5737506,152,0,utRho19
nlpI,6618080,6618080,6617848,232,4,utRho19
nmpC,1153740,1153740,1153650,90,4,utRho19
nohA,3273206,3273206,3272734,472,6,utRho19
norR,5664614,5664614,5664578,36,0,utRho19
norV,5664878,5664952,5664878,74,2,utRho19
nrdA,4689510,4689730,4689510,220,11962,utRho19
nrdD,8925676,8925676,8925320,356,804,utRho19
nrdH,5601312,5601446,5601312,134,1504,utRho19
nrdR,865954,866004,865954,50,114,utRho19
nrfA,8575342,8575528,8575342,186,0,utRho19
nsrR,8812088,8812380,8812088,292,412,utRho19
nudB,3897348,3897348,3897264,84,0,utRho19
nudC,8393428,8393806,8393428,378,196,utRho19
nudE,7052658,7052658,7052298,360,812,utRho19
nudG,3682876,3682980,3682876,104,0,utRho19
nudI,4729050,4729108,4729050,58,0,utRho19
nudJ,2388874,2388874,2388576,298,1292,utRho19
nuoA,4810670,4810670,4810144,526,3780,utRho19
nuoN,4783434,4783434,4783010,424,1630,utRho19
nupC,5026018,5026084,5026018,66,0,utRho19
nupG,6211302,6211428,6211302,126,0,utRho19
ogrK,4335096,4335096,4335040,56,0,utRho19
ogt,2800568,2800568,2800472,96,130,utRho19
ohsC,5401036,5401040,5401036,4,0,utRho19
ompA,2040382,2040382,2040106,276,41086,utRho19
ompC,4625774,4625774,4625498,276,280,utRho19
ompF,1974184,1974184,1973964,220,102,utRho19
ompL,8128958,8128958,8128590,368,6,utRho19
ompN,2874158,2874158,2873786,372,20,utRho19
ompR,7073510,7073510,7073168,342,188,utRho19
ompT,1171330,1171330,1171266,64,264,utRho19
ompW,2627982,2628040,2627982,58,0,utRho19
ompX,1700418,1700900,1700418,482,690,utRho19
omrA,5952378,5952378,5952378,0,0,utRho19
omrB,5952770,5952770,5952770,0,0,utRho19
oppA,2602170,2602364,2602170,194,4806,utRho19
orn,8783168,8783208,8783168,40,64,utRho19
osmB,2686952,2686952,2686656,296,20,utRho19
osmC,3113192,3113250,3113192,58,2490,utRho19
osmE,3644566,3644566,3644512,54,60,utRho19
osmF,4439046,4439046,4438962,84,522,utRho19
osmY,9222306,9222792,9222306,486,2032,utRho19
otsA,3963302,3963302,3963224,78,76,utRho19
otsB,3964930,3964930,3964774,156,296,utRho19
oxc,4984288,4984288,4983900,388,4,utRho19
oxyR,8316914,8316980,8316914,66,14,utRho19
oxyS,8316788,8316788,8316788,0,0,utRho19
paaA,2907730,2907854,2907730,124,0,utRho19
paaX,2927018,2927078,2927018,60,48,utRho19
paaZ,2907340,2907340,2907284,56,0,utRho19
pabA,6981702,6981702,6981658,44,0,utRho19
pabB,3789256,3789610,3789256,354,512,utRho19
pabC,2306186,2306600,2306186,414,202,utRho19
pagP,1313052,1313114,1313052,62,0,utRho19
panB,299260,299260,299202,58,304,utRho19
panC,297840,297840,297590,250,296,utRho19
panD,293490,293490,293388,102,2,utRho19
panZ,7195656,7195968,7195656,312,254,utRho19
parC,6332060,6332060,6331946,114,396,utRho19
patA,6438916,6438988,6438916,72,78,utRho19
patD,3030830,3031156,3030830,326,2,utRho19
pbpC,5294986,5294986,5294650,336,0,utRho19
pbpG,4450132,4450132,4449740,392,32,utRho19
pck,7065358,7065636,7065358,278,1614,utRho19
pcnB,318782,318782,318252,530,338,utRho19
pdhR,244068,244184,244068,116,2,utRho19
pdxB,4875768,4875768,4875702,66,4,utRho19
pdxH,3436068,3436068,3436014,54,518,utRho19
pdxJ,5403626,5403626,5403458,168,0,utRho19
pdxK,5074638,5074638,5074474,164,0,utRho19
pepA,8972278,8972278,8971902,376,472,utRho19
pepD,511618,511618,511432,186,13114,utRho19
pepN,1981182,1981244,1981182,62,94,utRho19
pepQ,8062294,8062322,8062294,28,0,utRho19
pepT,2371646,2371688,2371646,42,56,utRho19
pfkA,8214948,8215104,8214948,156,552,utRho19
pfkB,3612646,3612740,3612646,94,268,utRho19
pflA,1902456,1902456,1902160,296,2,utRho19
pflB,1907850,1907850,1907108,742,856,utRho19
pflD,8287716,8287990,8287716,274,2,utRho19
pgaA,2185046,2185046,2184578,468,6,utRho19
pgi,8467444,8467516,8467444,72,66,utRho19
pgk,12291428,12291428,12290488,940,5444,utRho19
pgl,1597078,1597172,1597078,94,84,utRho19
pgpB,2678324,2678660,2678324,336,14,utRho19
pgpC,5397276,5397276,5397100,176,2,utRho19
pgrR,2783744,2783982,2783744,238,112,utRho19
pheL,5475158,5475198,5475158,40,4,utRho19
pheM,7197204,7197204,7197080,124,188,utRho19
pheP,1203858,1203918,1203858,60,0,utRho19
pheU,8725254,8725254,8725252,2,0,utRho19
pheV,6220730,6220732,6220730,2,32,utRho19
phnC,8650412,8650412,8650330,82,94,utRho19
phoA,803414,803494,803414,80,78,utRho19
phoB,834202,834284,834202,82,0,utRho19
phoE,520316,520316,520200,116,14,utRho19
phoH,2169730,2169984,2169730,254,414,utRho19
phoP,2381016,2381016,2380894,122,3290,utRho19
phoQ,2379880,2379880,2379552,328,966,utRho19
phoU,7815330,7815330,7815156,174,78,utRho19
phr,1478842,1479014,1478842,172,60,utRho19
pinE,2419054,2419370,2419054,316,14,utRho19
pinQ,3267168,3267244,3267168,76,2,utRho19
pinR,2867424,2867424,2867348,76,2,utRho19
pitA,7275224,7275284,7275224,60,78,utRho19
pitB,6272806,6272806,6272742,64,106,utRho19
pka,5439862,5439906,5439862,44,4,utRho19
plaP,4174476,4174476,4174124,352,16,utRho19
pldA,8009628,8009724,8009628,96,24,utRho19
pldB,8018028,8018340,8018028,312,272,utRho19
plsB,8513196,8513196,8512932,264,526,utRho19
pmbA,8915890,8915918,8915890,28,0,utRho19
pmrD,4747148,4747148,4747076,72,0,utRho19
pncB,1980828,1980828,1980712,116,0,utRho19
pncC,5648788,5648788,5648692,96,88,utRho19
pnp,6622652,6622652,6622336,316,12,utRho19
pntA,3355950,3355950,3355806,144,0,utRho19
pntB,3353096,3353096,3352720,376,256,utRho19
polA,8093880,8093932,8093880,52,2,utRho19
polB,131606,131606,131560,46,0,utRho19
potD,2365700,2365700,2365658,42,0,utRho19
potE,1436688,1436688,1436530,158,0,utRho19
potF,1787268,1787568,1787268,300,0,utRho19
poxB,1822152,1822152,1822098,54,26,utRho19
ppa,8899372,8899372,8899304,68,4,utRho19
ppc,8306380,8306380,8306196,184,494,utRho19
ppdA,5928440,5928440,5928354,86,60,utRho19
ppdD,235410,235410,235098,312,2,utRho19
pphA,3846770,3846770,3845938,832,2556,utRho19
pphB,5719474,5719520,5719474,46,0,utRho19
ppiA,6984898,6984898,6984594,304,0,utRho19
ppiC,7919682,7919682,7919626,56,0,utRho19
ppiD,923638,923830,923638,192,150,utRho19
ppk,5245748,5246088,5245748,340,284,utRho19
pppA,6228958,6228958,6228704,254,762,utRho19
ppsA,3574322,3574322,3574224,98,4,utRho19
ppsR,3574678,3574890,3574678,212,0,utRho19
pptA,3065716,3066104,3065716,388,80,utRho19
pqiA,2023318,2024002,2023318,684,60,utRho19
prc,3830054,3830054,3829632,422,17860,utRho19
preT,4467978,4468066,4467978,88,16,utRho19
prfC,9218688,9218828,9218688,140,706,utRho19
prkB,6968622,6968980,6968622,358,1622,utRho19
prlC,7290476,7290476,7290364,112,232,utRho19
prlF,6553944,6554004,6553944,60,324,utRho19
proB,520432,520776,520432,344,10,utRho19
proC,811372,811372,811288,84,0,utRho19
proK,7417388,7417388,7417384,4,2,utRho19
proL,4572414,4572422,4572414,8,60,utRho19
proP,8660640,8661004,8660640,364,1104,utRho19
proS,437674,437674,437550,124,276,utRho19
proV,5609126,5609630,5609126,504,98,utRho19
prpB,697292,697364,697292,72,0,utRho19
prpR,696942,696942,696886,56,0,utRho19
prs,2524354,2524354,2523750,604,57808,utRho19
psd,8781276,8781276,8780720,556,2078,utRho19
psiE,8480600,8480650,8480600,50,2,utRho19
pspA,2736076,2736158,2736076,82,0,utRho19
pspF,2736080,2736080,2735824,256,0,utRho19
pspG,8525632,8525680,8525632,48,2,utRho19
pssA,5445156,5445454,5445156,298,9280,utRho19
pstB,7817112,7817112,7816732,380,8,utRho19
pstC,7821084,7821084,7820796,288,4,utRho19
pstS,23469408,23469408,23469150,258,0,utRho19
psuG,4517114,4517114,4516734,380,2308,utRho19
psuT,4514992,4514992,4514670,322,0,utRho19
pth,2517084,2517084,2517026,58,0,utRho19
ptrA,5918022,5918022,5917768,254,0,utRho19
ptrB,3857730,3857730,3857678,52,282,utRho19
ptsG,2315252,2315738,2315252,486,1526,utRho19
ptsH,5066996,5067528,5066996,532,4494,utRho19
purA,8809328,8809374,8809328,46,0,utRho19
purC,5195562,5195562,5195236,326,332,utRho19
purD,8411972,8411972,8411862,110,60,utRho19
purE,1106284,1106284,1106200,84,160,utRho19
purH,8415254,8415254,8415064,190,0,utRho19
purL,5391178,5391178,5391086,92,428,utRho19
purM,5242306,5242394,5242306,88,0,utRho19
purR,3475378,3475688,3475378,310,472,utRho19
purT,3861438,3861762,3861438,324,0,utRho19
purU,2577512,2577512,2577248,264,1022,utRho19
putA,2157850,2157850,2157764,86,134,utRho19
putP,2158336,2158610,2158336,274,1332,utRho19
puuA,2721936,2721936,2721816,120,0,utRho19
puuC,2725456,2725486,2725456,30,6,utRho19
puuD,2722104,2722240,2722104,136,0,utRho19
puuP,2718746,2718746,2718374,372,552,utRho19
pykA,3874988,3875298,3874988,310,580,utRho19
pykF,3510934,3511396,3510934,462,868,utRho19
pyrC,2245286,2245286,2245214,72,2,utRho19
pyrD,2009464,2009536,2009464,72,54,utRho19
pyrE,7631970,7631970,7631536,434,8,utRho19
pyrF,2683740,2683842,2683740,102,22,utRho19
pyrG,5819594,5819594,5819332,262,630,utRho19
pyrH,383624,383710,383624,86,912,utRho19
pyrL,8945490,8945490,8945066,424,338,utRho19
qmcA,1031646,1031646,1031546,100,26,utRho19
qor,8528608,8528608,8528462,146,348,utRho19
qseB,6339502,6339656,6339502,154,66,utRho19
queA,849970,850022,849970,52,50,utRho19
queE,5811212,5811212,5810836,376,50,utRho19
queF,5850642,5850696,5850642,54,0,utRho19
queG,8788184,8788184,8788134,50,7324,utRho19
racC,2835630,2835630,2835526,104,0,utRho19
racR,2840898,2840898,2840482,416,0,utRho19
raiA,5474208,5474308,5474208,100,386,utRho19
rarD,8008594,8008594,8008356,238,250,utRho19
ravA,7862256,7862256,7862186,70,0,utRho19
rayT,495088,495274,495088,186,168,utRho19
rbn,4763162,4763216,4763162,54,0,utRho19
rbsD,7866644,7866702,7866644,58,192,utRho19
rcnA,4371654,4371834,4371654,180,24,utRho19
rcnB,4373768,4373920,4373768,152,284,utRho19
rcnR,4371806,4371806,4371592,214,92,utRho19
rcsA,4047672,4047936,4047672,264,314,utRho19
rcsB,4631390,4632354,4631390,964,1520,utRho19
rcsC,4640162,4640162,4639656,506,542,utRho19
rcsD,4626904,4626976,4626904,72,54,utRho19
rdgB,6193240,6193362,6193240,122,262,utRho19
rdlA,2538646,2538646,2538646,0,0,utRho19
rdlB,2539712,2539716,2539712,4,0,utRho19
rdlC,2540782,2540786,2540782,4,0,utRho19
rdlD,7400272,7400272,7400272,0,0,utRho19
rdoA,8084782,8084830,8084782,48,56,utRho19
recA,11295276,11295276,11295076,200,1008,utRho19
recC,5925014,5925014,5924856,158,42,utRho19
recF,7763722,7763722,7762442,1280,8298,utRho19
recN,5503518,5503590,5503518,72,0,utRho19
recQ,8011666,8011728,8011666,62,0,utRho19
relA,5828554,5828554,5827302,1252,278,utRho19
relB,3291806,3291806,3291744,62,0,utRho19
rem,3289950,3289950,3289804,146,0,utRho19
rep,7921294,7921354,7921294,60,184,utRho19
rfaD,7587730,7587974,7587730,244,126,utRho19
rfaE,6393852,6393852,6393506,346,720,utRho19
rfaH,8049930,8049930,8049642,288,1254,utRho19
rfbX,4219436,4219436,4219168,268,1082,utRho19
rfe,7935600,7935832,7935600,232,50,utRho19
rhaB,8194944,8194944,8194896,48,0,utRho19
rhaD,8188770,8188770,8188544,226,0,utRho19
rhaS,8195422,8195472,8195422,50,2,utRho19
rhaT,8201132,8201132,8201050,82,60,utRho19
rhlE,1661566,1661744,1661566,178,44,utRho19
rhoL,47593944,47594772,47593944,828,39000,utRho19
rhsB,7238006,7238384,7238006,378,70,utRho19
rhsC,1458758,1459166,1458758,408,0,utRho19
rhsD,1046132,1046522,1046132,390,6,utRho19
rhtA,1700608,1700608,1700194,414,188,utRho19
rhtC,8015478,8015514,8015478,36,442,utRho19
ribA,2678468,2678468,2678320,148,8,utRho19
ribC,3486916,3486916,3486484,432,74,utRho19
ribE,869008,869294,869008,286,6896,utRho19
ribF,42766,42814,42766,48,0,utRho19
ridA,8941892,8941892,8941826,66,68,utRho19
rihA,1369204,1369204,1368824,380,170,utRho19
rihB,4510504,4510504,4510372,132,110,utRho19
rimJ,2251044,2251124,2251044,80,0,utRho19
rimK,1783752,1783934,1783752,182,476,utRho19
rimL,2997486,2997876,2997486,390,548,utRho19
rimO,1756140,1756140,1756070,70,2,utRho19
rimP,6636350,6636350,6636012,338,966,utRho19
rlmA,3814172,3814172,3814120,52,10,utRho19
rlmD,5830086,5830086,5830000,86,0,utRho19
rlmE,6655520,6655520,6655328,192,576,utRho19
rlmF,1684384,1684664,1684384,280,0,utRho19
rlmG,6471784,6471784,6471750,34,4,utRho19
rlmI,2060002,2060002,2059938,64,54,utRho19
rlmJ,7290700,7290770,7290700,70,0,utRho19
rlmL,2015344,2015688,2015344,344,828,utRho19
rlpA,1330444,1330444,1330380,64,248,utRho19
rluA,120900,120900,120692,208,28,utRho19
rluF,8460324,8460708,8460324,384,0,utRho19
rmf,2031006,2031430,2031006,424,438,utRho19
rna,1290068,1290068,1290006,62,10,utRho19
rnb,2698258,2698258,2697824,434,2176,utRho19
rnc,10816892,10816892,10816252,640,6000,utRho19
rnd,3776122,3776122,3775982,140,128,utRho19
rne,2289746,2289746,2288734,1012,11096,utRho19
rnhA,472082,472082,472004,78,912,utRho19
rnk,1288360,1288360,1287934,426,104,utRho19
rnlA,5531788,5531836,5531788,48,146,utRho19
rnlB,5533414,5533968,5533414,554,890,utRho19
rnpB,19623552,19623552,19623552,0,0,utRho19
rob,9270706,9270706,9270620,86,0,utRho19
rodZ,5285868,5285868,5285688,180,0,utRho19
rpe,7030306,7030306,7030118,188,68,utRho19
rph,15266320,15266320,15266196,124,0,utRho19
rpiA,6118706,6118706,6118650,56,10,utRho19
rpiB,8626514,8626700,8626514,186,8,utRho19
rpiR,8626274,8626274,8625982,292,0,utRho19
rplJ,8359246,8359992,8359246,746,4538,utRho19
rplK,8356708,8356894,8356708,186,184,utRho19
rplM,6757344,6757344,6757302,42,2308,utRho19
rplN,6896444,6896444,6896298,146,1090,utRho19
rplS,5489284,5489284,5489060,224,4388,utRho19
rplT,7199052,7199052,7198996,56,168,utRho19
rplU,6667036,6667036,6666902,134,60,utRho19
rplY,4564866,4565034,4564866,168,20,utRho19
rpmA,6666450,6666450,6666238,212,390,utRho19
rpmB,15247980,15247980,15246696,1284,47016,utRho19
rpmE,8253816,8254026,8253816,210,576,utRho19
rpmF,2294676,2294734,2294676,58,17248,utRho19
rpmH,7768130,7768672,7768130,542,2614,utRho19
rpmI,3600854,3600854,3599998,856,8154,utRho19
rpoB,8362126,8362490,8362126,364,266,utRho19
rpoD,6424946,6426094,6424946,1148,33156,utRho19
rpoE,5420372,5420372,5420024,348,0,utRho19
rpoH,7202006,7202006,7201566,440,5218,utRho19
rpoN,6689324,6689434,6689324,110,316,utRho19
rpoS,5736236,5736236,5735102,1134,14280,utRho19
rpoZ,7644154,7644212,7644154,58,654,utRho19
rppH,5937986,5937986,5937954,32,70,utRho19
rprA,3540744,3540744,3540744,0,0,utRho19
rpsA,1923434,1923990,1923434,556,76910,utRho19
rpsF,8850050,8850236,8850050,186,7110,utRho19
rpsI,6756580,6756580,6756414,166,2660,utRho19
rpsJ,6906884,6906884,6906540,344,2408,utRho19
rpsL,6949242,6949242,6949104,138,662,utRho19
rpsM,6885130,6885130,6884942,188,718,utRho19
rpsO,13247144,13247144,13246736,408,200,utRho19
rpsP,5492508,5492508,5492370,138,44,utRho19
rpsT,42420,42420,42156,264,360,utRho19
rpsU,12842584,12843124,12842584,540,304,utRho19
rraA,8238716,8238716,8238660,56,158,utRho19
rraB,8956768,8956946,8956768,178,88,utRho19
rrsA,8070478,8071062,8070478,584,7886,utRho19
rrsB,16665468,16666636,16665468,1168,16800,utRho19
rrsC,7883032,7883616,7883032,584,4168,utRho19
rrsD,6858094,6858094,6857524,570,346,utRho19
rrsE,8415726,8416294,8415726,568,1334,utRho19
rrsG,5462896,5462896,5462314,582,8310,utRho19
rrsH,446970,447542,446970,572,1862,utRho19
rsd,8393908,8393908,8393616,292,176,utRho19
rseA,5419264,5419264,5418808,456,400,utRho19
rseP,392940,393092,392940,152,120,utRho19
rseX,4067298,4067298,4067298,0,0,utRho19
rsfS,1338144,1338144,1338072,72,104,utRho19
rsgA,8783132,8783132,8783018,114,162,utRho19
rsmA,105176,105176,104860,316,3202,utRho19
rsmB,6869982,6870414,6869982,432,166,utRho19
rsmC,9215736,9215736,9215400,336,566,utRho19
rsmD,7208594,7208786,7208594,192,306,utRho19
rsmE,6182036,6182268,6182036,232,200,utRho19
rsmG,7847512,7847512,7847360,152,436,utRho19
rsmH,180020,180188,180020,168,140,utRho19
rsmI,6587106,6587106,6586670,436,1866,utRho19
rssA,2578212,2578412,2578212,200,112,utRho19
rssB,2580440,2580484,2580440,44,334,utRho19
rstA,3364276,3364300,3364276,24,0,utRho19
rsuA,4561096,4561096,4560966,130,38,utRho19
rsxA,3411510,3411534,3411510,24,146,utRho19
rtcA,7114004,7114004,7113698,306,32,utRho19
rtcB,7116214,7116214,7116158,56,2,utRho19
rtn,4541356,4541452,4541356,96,0,utRho19
rutA,2148052,2148052,2148022,30,0,utRho19
rutG,2140090,2140090,2139678,412,200,utRho19
rutR,2148226,2148484,2148226,258,8,utRho19
ruvA,7784096,7784096,7783904,192,256,utRho19
ruvB,7782176,7782176,7781424,752,1172,utRho19
ruvC,3894878,3894878,3894752,126,0,utRho19
rybB,1776114,1776114,1776114,0,0,utRho19
rydB,3529860,3529860,3529322,538,74,utRho19
rydC,2983012,2983012,2983012,0,0,utRho19
ryfA,5307398,5307710,5307398,312,0,utRho19
ryfD,5468590,5468590,5468590,0,0,utRho19
ryhB,7162032,7162032,7162032,0,0,utRho19
ryjA,8556132,8556132,8556132,0,0,utRho19
ryjB,9055954,9055954,9055954,0,0,utRho19
sad,3229598,3229598,3229406,192,172,utRho19
safA,3168056,3168056,3167918,138,0,utRho19
sanA,4465368,4465756,4465368,388,64,utRho19
sapF,2705314,2705314,2705268,46,60,utRho19
sbcB,4165456,4165512,4165456,56,0,utRho19
sbcC,831694,831694,831506,188,34,utRho19
sbcD,833954,833954,833904,50,0,utRho19
sbmA,793106,793278,793106,172,102,utRho19
sbmC,4162650,4162650,4162524,126,0,utRho19
sdaA,3793618,3793864,3793618,246,410,utRho19
sdaC,5856070,5856458,5856070,388,862,utRho19
sdhC,1509916,1510354,1509916,438,41314,utRho19
sdhD,1510808,1511120,1510808,312,12150,utRho19
sdiA,3993834,3993834,3993664,170,60,utRho19
secE,8354354,8354716,8354354,362,2,utRho19
secG,6645180,6645180,6645010,170,422,utRho19
selA,7522594,7522594,7522498,96,168,utRho19
selB,7519850,7519850,7519722,128,482,utRho19
selC,7672396,7672444,7672396,48,2,utRho19
selD,3696058,3696058,3696016,42,6498,utRho19
seqA,1425884,1425974,1425884,90,838,utRho19
serA,6117098,6117098,6116820,278,102,utRho19
serB,9249712,9249790,9249712,78,186,utRho19
serC,3830380,3830612,3830380,232,80,utRho19
serS,1878730,1878856,1878730,126,450,utRho19
serT,2063438,2063438,2063424,14,0,utRho19
serU,4087124,4087124,4087114,10,508,utRho19
serV,5637394,5637394,5637290,104,0,utRho19
serW,1852014,1852014,1851942,72,270,utRho19
serX,2195352,2195352,2195304,48,4,utRho19
setB,4527426,4527726,4527426,300,2,utRho19
setC,7673488,7673906,7673488,418,96,utRho19
sfmA,1116124,1116424,1116124,300,4,utRho19
sfmC,1117606,1117948,1117606,342,2,utRho19
sfsA,323030,323030,322972,58,410,utRho19
sfsB,6669592,6669818,6669592,226,4,utRho19
sgrR,154676,154676,154598,78,44,utRho19
sgrS,154734,154734,154734,0,0,utRho19
shiA,4107068,4107286,4107068,218,2,utRho19
sibA,4306622,4306622,4306622,0,0,utRho19
sibB,4307292,4307292,4307292,0,0,utRho19
sibC,6113702,6113702,6113702,0,0,utRho19
sibD,6389730,6389730,6389730,0,0,utRho19
sibE,6390480,6390480,6390480,0,0,utRho19
sixA,4913998,4913998,4913624,374,36,utRho19
slp,7307872,7307922,7307872,50,48,utRho19
slt,9261400,9261466,9261400,66,94,utRho19
slyA,3442028,3442028,3441648,380,62,utRho19
slyB,3439496,3439752,3439496,256,0,utRho19
slyD,6957398,6957398,6956994,404,1424,utRho19
slyX,6954862,6955280,6954862,418,3602,utRho19
smf,6867372,6867372,6867120,252,86,utRho19
smpB,5509534,5509792,5509534,258,608,utRho19
smrA,2811872,2811958,2811872,86,566,utRho19
smrB,4896872,4897212,4896872,340,130,utRho19
smtA,1946808,1947074,1946808,266,0,utRho19
sodA,8201518,8201620,8201518,102,18710,utRho19
sodB,3470646,3470756,3470646,110,294,utRho19
sodC,3449358,3449358,3449310,48,40,utRho19
sohB,2658568,2658664,2658568,96,82,utRho19
sokB,2984232,2984238,2984232,6,222,utRho19
solA,2241218,2241218,2241172,46,0,utRho19
soxR,8554894,8554938,8554894,44,134,utRho19
soxS,8554846,8554846,8554766,80,0,utRho19
speA,6172096,6172096,6171822,274,2,utRho19
speB,6167892,6167892,6167594,298,146,utRho19
speC,6218350,6218350,6218310,40,0,utRho19
spf,8099798,8099798,8099798,0,0,utRho19
sppA,3697422,3697674,3697422,252,12,utRho19
spy,3651376,3651376,3651250,126,0,utRho19
sra,3112092,3112092,3111926,166,30,utRho19
sraB,2293178,2293178,2293178,0,0,utRho19
sraC,3846132,3846132,3846132,0,0,utRho19
srlA,5651582,5651664,5651582,82,0,utRho19
srlR,5657720,5658094,5657720,374,26232,utRho19
srmB,5425752,5425792,5425752,40,304,utRho19
sroA,151216,151216,151216,0,0,utRho19
sroG,6369436,6369436,6369436,0,0,utRho19
sroH,8380974,8380974,8380974,0,0,utRho19
ssb,8548022,8548250,8548022,228,2,utRho19
sseA,5304782,5304988,5304782,206,13278,utRho19
sspA,6755138,6755138,6754840,298,1058,utRho19
ssrA,5511014,5511186,5511014,172,102,utRho19
ssrS,12223036,12223932,12223036,896,3348,utRho19
sstT,6479726,6479888,6479726,162,0,utRho19
ssuB,1988282,1988282,1988088,194,2,utRho19
ssuE,1995126,1995126,1995024,102,26,utRho19
sthA,8321604,8321604,8321580,24,3072,utRho19
stpA,5597156,5597156,5596990,166,2,utRho19
sucA,3034344,3034824,3034344,480,5092,utRho19
sufA,3528836,3528836,3528772,64,1148,utRho19
sufE,3518962,3518962,3518580,382,2216,utRho19
sugE,8753588,8753750,8753588,162,906,utRho19
sulA,2041894,2041894,2041838,56,82,utRho19
syd,5850738,5850738,5850560,178,240,utRho19
symE,9159834,9159834,9159680,154,14,utRho19
symR,9159670,9159670,9159670,0,0,utRho19
tabA,8949566,8949724,8949566,158,0,utRho19
talA,5157140,5157332,5157140,192,0,utRho19
talB,16382,16476,16382,94,18708,utRho19
tam,3214442,3214692,3214442,250,464,utRho19
tamA,8884540,8884764,8884540,224,74,utRho19
tar,3945432,3945432,3945382,50,0,utRho19
tas,5943138,5943194,5943138,56,244,utRho19
tatA,16087636,16087780,16087636,144,192,utRho19
tatE,1317742,1317894,1317742,152,58,utRho19
tauA,770410,770464,770410,54,0,utRho19
tdcA,6534186,6534186,6534130,56,0,utRho19
tdcG,6519652,6519652,6519298,354,34,utRho19
tdcR,6534380,6534760,6534380,380,2,utRho19
tdk,2586986,2587054,2586986,68,144,utRho19
tehA,3001072,3001146,3001072,74,0,utRho19
tesA,1039898,1039898,1039530,368,96,utRho19
tesB,950402,950402,950322,80,0,utRho19
tfaE,2418532,2418532,2418238,294,10,utRho19
tfaQ,3269912,3269912,3269770,142,60,utRho19
tff,379424,379256,379424,168,240,utRho19
tgt,852110,852274,852110,164,0,utRho19
thiD,4369346,4369346,4369032,314,0,utRho19
thiI,882936,883098,882936,162,168,utRho19
thiM,4370902,4370902,4370602,300,512,utRho19
thiQ,146170,146170,145854,316,50,utRho19
thrL,592,760,592,168,200,utRho19
thrS,7210932,7210932,7210280,652,252,utRho19
thrU,8350762,8350776,8350762,14,0,utRho19
thrV,6847414,6847414,6847310,104,285712,utRho19
thrW,525682,525742,525682,60,296,utRho19
thyA,5930696,5930696,5930310,386,2302,utRho19
tig,909986,910266,909986,280,118,utRho19
tisB,7706674,7707106,7706674,432,870,utRho19
tktA,6163414,6163414,6163270,144,182,utRho19
tktB,5158616,5159272,5158616,656,54804,utRho19
tldD,6784368,6784368,6784056,312,32,utRho19
tmcA,5191876,5191876,5191718,158,40,utRho19
tnaC,15553644,15553740,15553644,96,49924,utRho19
tolB,1555074,1555480,1555074,406,542,utRho19
tolC,6356008,6356230,6356008,222,0,utRho19
tomB,961588,961588,961416,172,630,utRho19
tonB,2622108,2622178,2622108,70,24,utRho19
topA,2661578,2662096,2661578,518,266,utRho19
torC,2116112,2116168,2116112,56,256,utRho19
torR,2115968,2115968,2115908,60,518,utRho19
torS,2112364,2112364,2112356,8,0,utRho19
torT,2112414,2112522,2112414,108,0,utRho19
tpiA,8223138,8223138,8223014,124,550,utRho19
tppB,3425342,3425538,3425342,196,1670,utRho19
tpr,2574376,2574376,2574376,0,0,utRho19
tpx,2777688,2777688,2777622,66,314,utRho19
tqsA,3347780,3347826,3347780,46,0,utRho19
treA,2494850,2494850,2494752,98,34,utRho19
treB,8932420,8932420,8932360,60,122,utRho19
treF,7339102,7339184,7339102,82,16,utRho19
treR,8934694,8934694,8934492,202,96,utRho19
trg,2984878,2984940,2984878,62,0,utRho19
trkG,2847342,2847564,2847342,222,6,utRho19
trmA,8326590,8326590,8326540,50,2,utRho19
trpA,2634678,2634678,2634444,234,604,utRho19
trpC,2639888,2639888,2639570,318,0,utRho19
trpL,5292432,5292432,5292328,104,0,utRho19
trpR,9265408,9265520,9265408,112,302,utRho19
trpS,7027394,7027394,7027276,118,1818,utRho19
trpT,7893560,7893914,7893560,354,120904,utRho19
trxA,7931294,7931522,7931294,228,676,utRho19
trxB,1864156,1864156,1864100,56,106,utRho19
trxC,5437350,5437470,5437350,120,318,utRho19
tsaD,6421256,6421256,6421086,170,2,utRho19
tsgA,6985038,6985136,6985038,98,4,utRho19
tsr,9182824,9183314,9182824,490,84,utRho19
tsx,864490,864490,864026,464,490,utRho19
ttcA,2823970,2823970,2823896,74,1510,utRho19
ttdA,6412848,6412926,6412848,78,0,utRho19
ttdR,6412760,6412760,6412512,248,0,utRho19
tufA,6943448,6943448,6942658,790,96034,utRho19
tus,3368346,3368518,3368346,172,448,utRho19
tusA,7218040,7218040,7217992,48,230,utRho19
tusB,6950218,6950218,6949930,288,2138,utRho19
tynA,2902996,2902996,2902698,298,0,utRho19
typA,8116460,8116814,8116460,354,2788,utRho19
tyrB,8534164,8534228,8534164,64,1872,utRho19
tyrP,3979004,3979362,3979004,358,0,utRho19
tyrR,2773384,2773440,2773384,56,16,utRho19
tyrS,3434566,3434566,3434444,122,0,utRho19
tyrT,2575330,2575330,2575244,86,90,utRho19
uacT,6062378,6062734,6062378,356,18,utRho19
ubiC,8504886,8505012,8504886,126,48,utRho19
ubiD,8049618,8049976,8049618,358,1340,utRho19
ubiE,8037494,8037710,8037494,216,0,utRho19
ubiG,4679078,4679134,4679078,56,2,utRho19
ucpA,5089342,5089342,5089246,96,0,utRho19
udp,8032782,8032862,8032782,80,120,utRho19
ugd,4199470,4199470,4199226,244,0,utRho19
ugpB,7184852,7184852,7184650,202,1010,utRho19
ugpQ,7176600,7176600,7176226,374,494,utRho19
uhpT,7694396,7694396,7694334,62,0,utRho19
uidA,3392304,3392304,3392142,162,60,utRho19
uidC,3386012,3386012,3385702,310,0,utRho19
uidR,3394150,3394150,3394104,46,334,utRho19
ulaA,8839854,8839960,8839854,106,0,utRho19
ulaG,8839350,8839350,8839250,100,2,utRho19
ulaR,8837124,8837124,8836906,218,10,utRho19
umpG,5741372,5741372,5740548,824,336,utRho19
umpH,1400704,1400704,1400652,52,0,utRho19
umuD,2461476,2461534,2461476,58,0,utRho19
ung,5433476,5433508,5433476,32,0,utRho19
uof,2843316,2843316,2842900,416,7096,utRho19
upp,5241818,5241818,5241744,74,116,utRho19
usg,4873780,4873780,4873298,482,418,utRho19
ushA,1009772,1009828,1009772,56,0,utRho19
uspA,7279966,7280222,7279966,256,1064,utRho19
uspB,7279696,7279696,7279440,256,252,utRho19
uspC,3959172,3959506,3959172,334,0,utRho19
uspE,2797318,2797318,2797244,74,114,utRho19
uspF,2871282,2871282,2871238,44,2,utRho19
uspG,1283806,1283806,1283734,72,444,utRho19
uvrA,8547872,8547872,8547742,130,130,utRho19
uvrB,1626304,1627052,1626304,748,2832,utRho19
uvrC,3989758,3989758,3989412,346,436,utRho19
uvrD,7995814,7995966,7995814,152,316,utRho19
uvrY,3990812,3990812,3990718,94,0,utRho19
uxaB,3221474,3221474,3221360,114,0,utRho19
uxaC,6489714,6489714,6489482,232,136,utRho19
uxuA,9103036,9103272,9103036,236,1478,utRho19
uxuR,9108916,9109152,9108916,236,136,utRho19
valS,8967854,8967854,8967674,180,930,utRho19
valU,5041848,5041862,5041848,14,52,utRho19
valV,3492830,3492870,3492830,40,38,utRho19
ves,3649968,3649968,3649874,94,0,utRho19
waaA,7616512,7617080,7616512,568,14,utRho19
waaH,7580298,7580298,7580162,136,0,utRho19
waaQ,7616476,7616476,7616196,280,136,utRho19
waaU,7598996,7598996,7598624,372,2,utRho19
waaY,7602272,7602272,7601930,342,2470,utRho19
wbbH,4214888,4214888,4214452,436,2942,utRho19
wbbK,4209212,4209212,4209018,194,124,utRho19
wcaM,4231868,4231868,4231792,76,0,utRho19
wrbA,2135516,2135516,2135416,100,90,utRho19
wza,4275166,4275166,4274486,680,0,utRho19
wzxC,4240674,4240674,4240316,358,0,utRho19
wzzB,4196950,4196950,4196602,348,0,utRho19
xanP,7657642,7657890,7657642,248,0,utRho19
xanQ,6048520,6048702,6048520,182,2,utRho19
xapA,5049820,5049820,5049756,64,0,utRho19
xapR,10090252,10090252,10089908,344,0,utRho19
xdhA,6000514,6000690,6000514,176,32,utRho19
xerD,6079702,6079702,6079486,216,0,utRho19
xseA,5268394,5268464,5268394,70,2,utRho19
xseB,882746,882746,882686,60,422,utRho19
xthA,3664798,3664856,3664798,58,0,utRho19
xylA,7461614,7461614,7461530,84,1622,utRho19
xylE,8484540,8484540,8484508,32,0,utRho19
xylF,7462138,7462262,7462138,124,128,utRho19
xylR,7469812,7469958,7469812,146,0,utRho19
yaaA,13230,13230,12918,312,154,utRho19
yaaI,23876,23876,23572,304,134,utRho19
yaaJ,16034,16034,15918,116,84,utRho19
yaaU,91184,91614,91184,430,12,utRho19
yaaW,23084,23084,22712,372,2,utRho19
yaaX,10060,10468,10060,408,92,utRho19
yabI,142542,142702,142542,160,174,utRho19
yacC,273880,273880,273834,46,422,utRho19
yacH,262932,262932,262520,412,222,utRho19
yacL,268678,268776,268678,98,34,utRho19
yadD,293796,293936,293796,140,4,utRho19
yadE,289930,290162,289930,232,710,utRho19
yadN,314110,314110,313766,344,0,utRho19
yadS,355572,355572,355248,324,150,utRho19
yadV,312470,312470,312402,68,122,utRho19
yaeF,434270,434270,434006,264,2,utRho19
yaeP,428374,428374,428250,124,74,utRho19
yaeQ,428176,428582,428176,406,78,utRho19
yaeR,423716,423754,423716,38,0,utRho19
yafC,462166,462166,461762,404,272,utRho19
yafD,462128,462244,462128,116,266,utRho19
yafK,491986,491986,491610,376,1240,utRho19
yafL,493282,493424,493282,142,0,utRho19
yafN,503938,504010,503938,72,0,utRho19
yafS,469568,469632,469568,64,1418,utRho19
yafT,474470,474670,474470,200,2,utRho19
yafV,480432,480432,480378,54,2,utRho19
yafZ,536052,536052,536010,42,2,utRho19
yagE,564446,564556,564446,110,6,utRho19
yagG,570414,570790,570414,376,22,utRho19
yagI,578384,578384,578324,60,0,utRho19
yagK,586236,586236,585896,340,270,utRho19
yagL,588062,588062,587836,226,24,utRho19
yagN,591342,591342,591158,184,4148,utRho19
yahA,663746,664742,663746,996,392,utRho19
yahC,670136,670136,670044,92,24,utRho19
yahE,671478,671850,671478,372,2,utRho19
yahM,690504,690808,690504,304,26,utRho19
yahN,692872,692872,692674,198,74,utRho19
yahO,692864,692968,692864,104,146,utRho19
yaiE,816296,816354,816296,58,232,utRho19
yaiI,811396,811528,811396,132,4,utRho19
yaiO,761946,761946,761684,262,8,utRho19
yaiP,767970,767970,767870,100,4,utRho19
yaiS,769660,769660,769232,428,72,utRho19
yaiV,788922,788922,788922,0,0,utRho19
yaiY,799094,799094,798666,428,2,utRho19
yaiZ,798888,799186,798888,298,20,utRho19
yajC,854410,854574,854410,164,96,utRho19
yajD,860938,861210,860938,272,316,utRho19
yajI,866068,866068,865702,366,418,utRho19
yajL,887496,887496,887282,214,398,utRho19
yajQ,889316,889366,889316,50,0,utRho19
yajR,893374,893374,893332,42,24,utRho19
ybaB,987418,988152,987418,734,2614,utRho19
ybaL,1006590,1006590,1006476,114,54,utRho19
ybaM,980648,980648,980542,106,232,utRho19
ybaN,981436,981764,981436,328,1470,utRho19
ybaO,936704,936766,936704,62,0,utRho19
ybaP,1016568,1016568,1016160,408,1492,utRho19
ybaQ,1016348,1016436,1016348,88,4,utRho19
ybaS,1023146,1023282,1023146,136,412,utRho19
ybaV,927504,927874,927504,370,0,utRho19
ybaY,950490,950758,950490,268,2258,utRho19
ybbB,1062724,1062724,1062452,272,196,utRho19
ybbJ,1030154,1030154,1029718,436,298,utRho19
ybbL,1031784,1031838,1031784,54,0,utRho19
ybbN,1037136,1037136,1036558,578,1398,utRho19
ybbO,1038658,1038658,1038298,360,1954,utRho19
ybbY,1080718,1081130,1080718,412,1204,utRho19
ybcH,1176140,1176140,1175962,178,6,utRho19
ybcI,1113264,1113264,1113106,158,152,utRho19
ybcJ,1114050,1114050,1113746,304,492,utRho19
ybcK,1137502,1137804,1137502,302,6,utRho19
ybcL,1141690,1141786,1141690,96,0,utRho19
ybcN,1144628,1144932,1144628,304,6,utRho19
ybcQ,1147548,1147912,1147548,364,22,utRho19
ybcW,1159610,1159760,1159610,150,0,utRho19
ybdD,1263982,1264364,1263982,382,106,utRho19
ybdF,1212106,1212106,1211772,334,200,utRho19
ybdH,1267048,1267048,1266954,94,0,utRho19
ybdJ,1212822,1212822,1212398,424,66,utRho19
ybdK,1215122,1215122,1214766,356,6,utRho19
ybdL,1267114,1267172,1267114,58,40,utRho19
ybdM,1271110,1271110,1270752,358,190,utRho19
ybdN,1273372,1273372,1273138,234,0,utRho19
ybdR,1283844,1284176,1283844,332,770,utRho19
ybeD,1325412,1325412,1325284,128,318,utRho19
ybeF,1323090,1323090,1322756,334,16,utRho19
ybeL,1349986,1350036,1349986,50,976,utRho19
ybeQ,1353412,1353412,1353094,318,2,utRho19
ybeR,1353120,1353422,1353120,302,0,utRho19
ybeT,1358832,1358832,1358812,20,2,utRho19
ybeU,1358924,1359016,1358924,92,0,utRho19
ybeZ,1386938,1386938,1386834,104,1318,utRho19
ybfA,1458074,1458268,1458074,194,0,utRho19
ybfE,1423878,1423878,1423796,82,88,utRho19
ybfF,1425692,1425692,1425604,88,210,utRho19
ybfH,1433282,1433282,1433194,88,0,utRho19
ybgA,1477840,1478002,1477840,162,6,utRho19
ybgC,1549288,1549504,1549288,216,0,utRho19
ybgD,1505916,1505916,1505590,326,222,utRho19
ybgI,1485238,1485654,1485238,416,0,utRho19
ybgO,1498370,1498370,1497964,406,0,utRho19
ybgS,1570992,1570992,1570634,358,1306,utRho19
ybhA,1597184,1597184,1596862,322,94,utRho19
ybhB,1616070,1616070,1615818,252,2,utRho19
ybhC,1614642,1614642,1614562,80,2328,utRho19
ybhD,1601418,1601418,1601276,142,2,utRho19
ybhH,1601104,1601518,1601104,414,2,utRho19
ybhK,1633384,1633384,1633294,90,4,utRho19
ybhM,1641556,1641586,1641556,30,0,utRho19
ybhN,1645296,1645296,1644996,300,612,utRho19
ybhQ,1649202,1649260,1649202,58,10,utRho19
ybiA,1665920,1665920,1665900,20,0,utRho19
ybiI,1676968,1676968,1676912,56,4,utRho19
ybiO,1691328,1691328,1690960,368,406,utRho19
ybiP,1705252,1705252,1705194,58,74,utRho19
ybiS,1711572,1711572,1711488,84,594,utRho19
ybiT,1711894,1711926,1711894,32,0,utRho19
ybiU,1718212,1718212,1718122,90,2,utRho19
ybiV,1720176,1720176,1720056,120,26,utRho19
ybiW,1725566,1725566,1725212,354,1972,utRho19
ybiX,1678548,1678548,1678414,134,208,utRho19
ybjC,1781784,1781826,1781784,42,0,utRho19
ybjE,1830154,1830154,1829714,440,204,utRho19
ybjG,1767016,1767016,1766776,240,1496,utRho19
ybjL,1779882,1779882,1779638,244,268,utRho19
ybjM,1779770,1780178,1779770,408,132,utRho19
ybjO,1795704,1795978,1795704,274,0,utRho19
ybjP,1809046,1809046,1808934,112,38,utRho19
ybjQ,1809034,1809186,1809034,152,174,utRho19
ybjS,1813796,1813796,1813506,290,86,utRho19
ybjX,1838206,1838206,1838168,38,0,utRho19
ycaD,1891438,1891742,1891438,304,0,utRho19
ycaI,1928210,1928640,1928210,430,152,utRho19
ycaK,1899094,1899336,1899094,242,0,utRho19
ycaL,1920264,1920528,1920264,264,0,utRho19
ycaM,1894240,1894458,1894240,218,4,utRho19
ycaR,1941284,1941346,1941284,62,850,utRho19
ycbB,1961862,1962094,1961862,232,2,utRho19
ycbJ,1943344,1943504,1943344,160,0,utRho19
ycbK,1966046,1966150,1966046,104,772,utRho19
ycbZ,2036920,2036920,2036598,322,220,utRho19
yccA,2062886,2062886,2062836,50,0,utRho19
yccF,2048730,2048730,2048696,34,2,utRho19
yccS,2047988,2047988,2047766,222,8,utRho19
yccT,2055674,2055674,2055546,128,28,utRho19
yccX,2059960,2060128,2059960,168,52,utRho19
ycdT,2185682,2185752,2185682,70,0,utRho19
ycdU,2191266,2191686,2191266,420,4,utRho19
ycdZ,2200504,2200592,2200504,88,224,utRho19
yceA,2233544,2233614,2233544,70,42,utRho19
yceD,2293298,2293588,2293298,290,878,utRho19
yceF,2293522,2293522,2293190,332,520,utRho19
yceH,2252154,2252314,2252154,160,5454,utRho19
yceI,2237282,2237282,2236952,330,704,utRho19
yceJ,2238142,2238142,2238092,50,2,utRho19
yceM,2253208,2253612,2253208,404,232,utRho19
yceO,2239264,2239264,2238894,370,456,utRho19
yceQ,2288760,2289004,2288760,244,8612,utRho19
ycfD,2376540,2376540,2376480,60,114,utRho19
ycfJ,2334814,2335198,2334814,384,2,utRho19
ycfS,2340834,2340834,2340748,86,2,utRho19
ycfT,2350658,2350658,2350330,328,2,utRho19
ycfZ,2362760,2362760,2362534,226,76,utRho19
ycgB,2474570,2474570,2474482,88,0,utRho19
ycgG,2434614,2434656,2434614,42,164,utRho19
ycgJ,2452956,2453200,2452956,244,6,utRho19
ycgL,2455218,2455362,2455218,144,0,utRho19
ycgN,2457366,2457660,2457366,294,430,utRho19
ycgR,2489112,2489112,2489054,58,0,utRho19
ycgV,2512222,2512222,2511904,318,4,utRho19
ycgX,2426568,2426568,2426214,354,418,utRho19
ycgY,2490166,2490320,2490166,154,4,utRho19
ycgZ,2431504,2431578,2431504,74,2,utRho19
ychE,2596904,2597196,2596904,292,0,utRho19
ychF,2515764,2515764,2515624,140,104,utRho19
ychH,2517476,2517582,2517476,106,250,utRho19
ychJ,2578354,2578354,2578264,90,34,utRho19
ychN,2547310,2547310,2547198,112,0,utRho19
ychO,2547520,2547850,2547520,330,224,utRho19
ychQ,2533798,2533848,2533798,50,0,utRho19
yciA,2624828,2624828,2624492,336,200,utRho19
yciB,2626110,2626110,2625780,330,3200,utRho19
yciC,2627396,2627396,2627326,70,0,utRho19
yciE,2630794,2630794,2630448,346,564,utRho19
yciG,5264368,5264368,5264140,228,0,utRho19
yciI,2621784,2621784,2621730,54,0,utRho19
yciN,2661606,2661606,2661336,270,124,utRho19
yciS,2680270,2680486,2680270,216,0,utRho19
yciT,2689088,2689088,2688692,396,806,utRho19
yciU,2614718,2614718,2614300,418,1034,utRho19
yciV,2646376,2646440,2646376,64,0,utRho19
yciW,2700472,2700472,2700214,258,76,utRho19
yciZ,2689276,2689276,2689218,58,140,utRho19
ycjD,2703792,2703792,2703520,272,144,utRho19
ycjG,2777748,2777860,2777748,112,238,utRho19
ycjM,2740006,2740432,2740006,426,110,utRho19
ycjW,2767982,2767982,2767922,60,0,utRho19
ycjX,2768138,2768234,2768138,96,0,utRho19
ycjY,5568288,5568288,5567460,828,352,utRho19
ydaE,2836438,2836438,2836016,422,0,utRho19
ydaN,2816048,2816100,2816048,52,0,utRho19
ydaS,2840340,2840730,2840340,390,0,utRho19
ydbC,2948376,2948442,2948376,66,0,utRho19
ydbD,2950132,2950288,2950132,156,0,utRho19
ydbH,2885800,2886102,2885800,302,408,utRho19
ydbJ,2881712,2882116,2881712,404,10,utRho19
ydbK,2881692,2881692,2881568,124,116,utRho19
ydcA,2983294,2983354,2983294,60,60,utRho19
ydcF,2974404,2974470,2974404,66,118,utRho19
ydcI,2990268,2990268,2990142,126,20,utRho19
ydcJ,2990266,2990576,2990266,310,0,utRho19
ydcK,3001280,3001280,3000898,382,0,utRho19
ydcL,3004646,3004914,3004646,268,0,utRho19
ydcN,3012308,3012344,3012308,36,62,utRho19
ydcP,3013508,3013562,3013508,54,138,utRho19
ydcR,3019956,3020006,3019956,50,54,utRho19
ydcS,3022906,3023308,3022906,402,12,utRho19
ydcX,3034442,3034778,3034442,336,98,utRho19
ydcY,3035220,3035296,3035220,76,94,utRho19
ydcZ,3036750,3036750,3036662,88,222,utRho19
yddB,3155332,3155332,3155238,94,50,utRho19
yddE,3071738,3071738,3071716,22,0,utRho19
yddG,3094410,3094410,3094338,72,0,utRho19
yddJ,3089732,3089732,3089438,294,12,utRho19
yddW,3137704,3137704,3137646,58,62,utRho19
ydeA,3233910,3234056,3233910,146,142,utRho19
ydeE,3242528,3242664,3242528,136,2,utRho19
ydeI,3249118,3249118,3248994,124,98,utRho19
ydeJ,3249376,3249546,3249376,170,4,utRho19
ydeN,3165458,3165458,3165048,410,0,utRho19
ydeP,3173328,3173328,3172972,356,0,utRho19
ydeR,3176596,3176596,3176592,4,8,utRho19
ydfA,3296872,3297016,3296872,144,0,utRho19
ydfG,3254982,3255034,3254982,52,4,utRho19
ydfH,3256652,3256704,3256652,52,12,utRho19
ydfK,3265446,3266144,3265446,698,476,utRho19
ydgA,3379588,3379704,3379588,116,56,utRho19
ydgC,3364124,3364124,3364060,64,0,utRho19
ydgD,3343906,3343920,3343906,14,6,utRho19
ydgH,3356754,3356854,3356754,100,62,utRho19
ydgJ,3408798,3408798,3408616,182,4,utRho19
ydgK,3410414,3410500,3410414,86,260,utRho19
ydhB,3479618,3479618,3479596,22,0,utRho19
ydhC,3479698,3479822,3479698,124,0,utRho19
ydhF,3451310,3451310,3451264,46,0,utRho19
ydhI,3441996,3442050,3441996,54,0,utRho19
ydhL,3451864,3451864,3451840,24,8,utRho19
ydhQ,3492404,3492404,3492254,150,72,utRho19
ydhS,3494136,3494262,3494136,126,10,utRho19
ydhT,3499138,3499138,3499118,20,2,utRho19
ydhY,3509284,3509284,3508954,330,12,utRho19
ydhZ,3510418,3510418,3510282,136,6,utRho19
ydiE,3579206,3579226,3579206,20,0,utRho19
ydiH,3530582,3530582,3530406,176,0,utRho19
ydiM,3541852,3542142,3541852,290,186,utRho19
ydiN,3544818,3545024,3544818,206,0,utRho19
ydiP,3558656,3558656,3558602,54,2,utRho19
ydiU,3582508,3582508,3582488,20,6,utRho19
ydiV,3584174,3584174,3584040,134,52,utRho19
ydiY,3612500,3612500,3612166,334,0,utRho19
ydjA,3697400,3697400,3697352,48,50,utRho19
ydjE,3708082,3708082,3707958,124,0,utRho19
ydjF,3709848,3709848,3709708,140,0,utRho19
ydjM,3620340,3620422,3620340,82,0,utRho19
ydjO,3626696,3626696,3626288,408,28,utRho19
ydjX,3666434,3666802,3666434,368,706,utRho19
yeaE,3731448,3731448,3731272,176,40,utRho19
yeaG,3733530,3733816,3733530,286,356,utRho19
yeaI,3740486,3740770,3740486,284,0,utRho19
yeaJ,3743874,3744082,3743874,208,86,utRho19
yeaL,3748646,3748704,3748646,58,192,utRho19
yeaM,3751296,3751296,3751152,144,14,utRho19
yeaN,3750926,3751346,3750926,420,84,utRho19
yeaO,3753554,3753818,3753554,264,8,utRho19
yeaP,3755314,3755430,3755314,116,308,utRho19
yeaQ,3758780,3758780,3758510,270,42,utRho19
yeaR,3759988,3759988,3759896,92,0,utRho19
yeaY,3781122,3781122,3781064,58,8,utRho19
yebB,3892220,3892502,3892220,282,2,utRho19
yebC,3896370,3896370,3896302,68,54,utRho19
yebE,3859464,3859464,3859414,50,8,utRho19
yebG,3861530,3861530,3861494,36,0,utRho19
yebK,3873180,3873304,3873180,124,60,utRho19
yebQ,3820314,3820552,3820314,238,88,utRho19
yebS,3832238,3832516,3832238,278,0,utRho19
yebV,3843430,3843560,3843430,130,60,utRho19
yebW,3843914,3844242,3843914,328,15414,utRho19
yecC,3995646,3995646,3995628,18,0,utRho19
yecD,3901272,3901664,3901272,392,36,utRho19
yecF,3991434,3991636,3991434,202,172,utRho19
yecH,3979304,3979304,3978980,324,4,utRho19
yecJ,3975604,3975604,3975516,88,60,utRho19
yecM,3919968,3919968,3919692,276,114,utRho19
yecR,3976400,3976444,3976400,44,68,utRho19
yecT,3923862,3923944,3923862,82,0,utRho19
yedD,4016522,4016522,4016180,342,6,utRho19
yedE,4016310,4016554,4016310,244,4,utRho19
yedI,4058922,4058922,4058732,190,6,utRho19
yedJ,4066446,4066446,4066158,288,36,utRho19
yedV,4076404,4076404,4076304,100,6,utRho19
yedX,4077680,4077912,4077680,232,4,utRho19
yedY,4078572,4078956,4078572,384,130,utRho19
yeeA,4161322,4161322,4161182,140,0,utRho19
yeeE,4171104,4171104,4171050,54,2,utRho19
yeeJ,4089526,4089822,4089526,296,4,utRho19
yeeN,4113508,4113716,4113508,208,4,utRho19
yeeO,4119444,4119444,4119692,248,0,utRho19
yeeX,4158834,4158834,4158722,112,806,utRho19
yeeZ,4178422,4178422,4178256,166,0,utRho19
yefM,4179466,4179466,4179426,40,70,utRho19
yegD,4295288,4295348,4295288,60,142,utRho19
yegH,4275726,4275804,4275726,78,4,utRho19
yegI,4302154,4302154,4301970,184,0,utRho19
yegJ,4302032,4302370,4302032,338,0,utRho19
yegQ,4331182,4331336,4331182,154,636,utRho19
yegR,4336698,4336698,4336612,86,2,utRho19
yegS,4337086,4337424,4337086,338,0,utRho19
yegT,4357562,4357642,4357562,80,6,utRho19
yegX,4367640,4367640,4367302,338,32,utRho19
yehA,4376944,4376944,4376828,116,8,utRho19
yehE,4385818,4385818,4385592,226,0,utRho19
yehK,4407568,4407944,4407568,376,0,utRho19
yehL,4408804,4409192,4408804,388,2,utRho19
yeiB,4486146,4486146,4485934,212,54,utRho19
yeiE,4499422,4499422,4499236,186,0,utRho19
yeiG,4487776,4487820,4487776,44,318,utRho19
yeiH,4499332,4499434,4499332,102,74,utRho19
yeiI,4503306,4503400,4503306,94,142,utRho19
yeiL,4510580,4510710,4510580,130,0,utRho19
yeiP,4530834,4530900,4530834,66,502,utRho19
yeiQ,4532328,4532490,4532328,162,100,utRho19
yeiR,4535484,4535658,4535484,174,32,utRho19
yeiW,4530840,4530840,4530590,250,792,utRho19
yejA,4544624,4544728,4544624,104,10,utRho19
yejG,4556892,4556892,4556474,418,872,utRho19
yejH,4561244,4561264,4561244,20,0,utRho19
yejK,4568218,4568218,4567894,324,496,utRho19
yejO,4578352,4578352,4577800,552,274,utRho19
yfaD,4713380,4713808,4713380,428,8,utRho19
yfaE,4696676,4697028,4696676,352,1532,utRho19
yfaL,4688568,4688568,4688338,230,0,utRho19
yfaP,4656398,4656398,4656286,112,46,utRho19
yfaU,4717892,4717892,4717690,202,0,utRho19
yfaY,4727310,4727310,4727266,44,8,utRho19
yfaZ,4728744,4728744,4728550,194,8,utRho19
yfbK,4771810,4771810,4771444,366,6,utRho19
yfbL,4771500,4771720,4771500,220,6,utRho19
yfbN,4777174,4777174,4776852,322,66,utRho19
yfbO,4776916,4777162,4776916,246,66,utRho19
yfbP,4777990,4778232,4777990,242,128,utRho19
yfbR,4817662,4817724,4817662,62,0,utRho19
yfcI,4847424,4847424,4847078,346,4,utRho19
yfcJ,4880482,4880482,4880240,242,22,utRho19
yfcL,4888502,4888502,4888338,164,0,utRho19
yfcV,4911642,4911642,4911292,350,50,utRho19
yfcZ,4921958,4921958,4921868,90,86,utRho19
yfdF,4925604,4926024,4925604,420,110,utRho19
yfdG,4935474,4935710,4935474,236,48,utRho19
yfdP,4946844,4947040,4946844,196,4,utRho19
yfdX,4988866,4988866,4988804,62,0,utRho19
yfdY,4990672,4990672,4990584,88,6,utRho19
yfeA,5035784,5035784,5035664,120,12816,utRho19
yfeC,5036668,5036934,5036668,266,98,utRho19
yfeH,5053818,5053892,5053818,74,4,utRho19
yfeK,5074630,5074684,5074630,54,0,utRho19
yfeO,5018906,5019260,5018906,354,378,utRho19
yfeR,5054078,5054078,5053712,366,4,utRho19
yfeX,5101356,5101356,5101090,266,44,utRho19
yfeY,5102486,5102486,5102432,54,0,utRho19
yfeZ,5103842,5103842,5103452,390,436,utRho19
yffO,5123804,5124222,5123804,418,12,utRho19
yffQ,5126778,5127154,5126778,376,80,utRho19
yffS,5128800,5128986,5128800,186,10,utRho19
yfgC,5232052,5232188,5232052,136,4,utRho19
yfgF,5258062,5258062,5257876,186,18,utRho19
yfgG,5258170,5258580,5258170,410,54,utRho19
yfgH,5259344,5259584,5259344,240,0,utRho19
yfgM,5278866,5278866,5278566,300,688,utRho19
yfhH,5397414,5397518,5397414,104,86,utRho19
yfhM,5304648,5304648,5304574,74,0,utRho19
yfhR,5328408,5328726,5328408,318,192,utRho19
yfiC,5425610,5425610,5425528,82,0,utRho19
yfiE,5430688,5430688,5430640,48,18,utRho19
yfiL,5482630,5482720,5482630,90,0,utRho19
yfiM,5448066,5448358,5448066,292,1750,utRho19
yfiR,5483354,5483750,5483354,396,414,utRho19
yfjH,5517326,5517326,5517200,126,0,utRho19
yfjI,5517710,5517970,5517710,260,4,utRho19
yfjJ,5521014,5521094,5521014,80,4,utRho19
yfjM,5531970,5531970,5531552,418,466,utRho19
yfjP,5535080,5535420,5535080,340,16,utRho19
yfjW,5546570,5546636,5546570,66,0,utRho19
yfjX,5551776,5551838,5551776,62,0,utRho19
ygaC,5601180,5601180,5599988,1192,862,utRho19
ygaM,5600242,5600292,5600242,50,26,utRho19
ygaU,5593628,5593628,5593572,56,564,utRho19
ygaZ,5619190,5619234,5619190,44,2,utRho19
ygbA,5713656,5713656,5713612,44,0,utRho19
ygbE,5746784,5746784,5746674,110,260,utRho19
ygbI,5722882,5722882,5722528,354,8,utRho19
ygbK,5724394,5724670,5724394,276,2854,utRho19
ygbL,5727074,5727186,5727074,112,434,utRho19
ygbN,5729814,5730202,5729814,388,1208,utRho19
ygcG,5811210,5811422,5811210,212,0,utRho19
ygcN,5785144,5785314,5785144,170,0,utRho19
ygcU,5799214,5799214,5798836,378,10,utRho19
ygcW,5800942,5800942,5800546,396,0,utRho19
ygdD,5883442,5883442,5883262,180,26,utRho19
ygdG,5861746,5861930,5861746,184,546,utRho19
ygdI,5886526,5886526,5886290,236,82,utRho19
ygdQ,5940784,5940840,5940784,56,0,utRho19
ygdR,5942494,5942542,5942494,48,2,utRho19
ygeA,5961606,5961606,5961270,336,2,utRho19
ygeH,5983758,5984188,5983758,430,8,utRho19
ygeI,5987162,5987276,5987162,114,52,utRho19
ygeR,6000078,6000078,5999782,296,10,utRho19
ygeV,6011694,6011694,6011572,122,0,utRho19
ygeW,6012234,6012524,6012234,290,6,utRho19
ygfB,6110946,6110946,6110888,58,20,utRho19
ygfK,6031984,6032120,6031984,136,4,utRho19
ygfS,6058328,6058328,6058024,304,0,utRho19
ygfZ,6082564,6082626,6082564,62,68,utRho19
yggC,6149512,6149512,6149378,134,302,utRho19
yggE,6136370,6136370,6136160,210,444,utRho19
yggI,6179176,6179510,6179176,334,294,utRho19
yggL,6204508,6204508,6204266,242,194,utRho19
yggM,6199514,6199514,6199130,384,62,utRho19
yggN,6203596,6203596,6203246,350,70,utRho19
yggX,18623958,18624558,18623958,600,504,utRho19
yghA,6298966,6299324,6298966,358,0,utRho19
yghB,6307058,6307126,6307058,68,154,utRho19
yghD,6222614,6222614,6222252,362,160,utRho19
yghF,6225798,6225798,6225840,42,0,utRho19
yghJ,6238640,6238640,6238224,416,246,utRho19
yghQ,6265186,6265186,6264816,370,0,utRho19
yghT,6267830,6268262,6267830,432,8,utRho19
yghU,6277400,6277454,6277400,54,74,utRho19
yghW,6293506,6293506,6293474,32,2,utRho19
yghZ,6295562,6295794,6295562,232,0,utRho19
ygiD,6365122,6365122,6364868,254,556,utRho19
ygiH,6409066,6409388,6409066,322,2,utRho19
ygiL,6370622,6370828,6370622,206,2,utRho19
ygiM,6402084,6402414,6402084,330,450,utRho19
ygiN,6346156,6346284,6346156,128,4600,utRho19
ygiQ,6322620,6322620,6322292,328,8,utRho19
ygiS,6335462,6335462,6335436,26,0,utRho19
ygiV,6338582,6338582,6338462,120,350,utRho19
ygiW,6339774,6339774,6339352,422,126,utRho19
ygiZ,6344506,6344506,6344422,84,0,utRho19
ygjH,6442528,6442528,6442494,34,0,utRho19
ygjI,6452140,6452468,6452140,328,4,utRho19
ygjQ,6472730,6473080,6472730,350,180,utRho19
ygjR,6474564,6474586,6474564,22,50,utRho19
ygjV,6483638,6483638,6483488,150,0,utRho19
yhaB,6535632,6535708,6535632,76,0,utRho19
yhaH,6504498,6504608,6504498,110,4,utRho19
yhaI,6505400,6505822,6505400,422,134,utRho19
yhaJ,6508560,6508560,6508428,132,8,utRho19
yhaK,6508538,6508638,6508538,100,6,utRho19
yhbQ,6599878,6599932,6599878,54,44,utRho19
yhbT,6602736,6602736,6602552,184,12,utRho19
yhbU,6602558,6602970,6602558,412,16,utRho19
yhbX,6643302,6643302,6643226,76,0,utRho19
yhbY,6655518,6655580,6655518,62,202,utRho19
yhcA,6723956,6724224,6723956,268,12,utRho19
yhcB,6760364,6760382,6760364,18,74,utRho19
yhcC,6708470,6708470,6708100,370,94,utRho19
yhcF,6733440,6733852,6733440,412,216,utRho19
yhcH,6739124,6739124,6738956,168,182,utRho19
yhcM,6760312,6760312,6759994,318,24,utRho19
yhcN,6770812,6771076,6770812,264,56,utRho19
yhcO,6772606,6772606,6772258,348,0,utRho19
yhdH,6806560,6806968,6806560,408,800,utRho19
yhdJ,6823234,6823306,6823234,72,0,utRho19
yhdN,6879092,6879092,6879018,74,398,utRho19
yhdT,6814702,6814750,6814702,48,70,utRho19
yhdU,6824994,6825242,6824994,248,212,utRho19
yhdV,6836392,6836780,6836392,388,18,utRho19
yhdW,6837944,6838298,6837944,354,0,utRho19
yheO,6953082,6953082,6952880,202,1034,utRho19
yheV,6957970,6957970,6957584,386,102,utRho19
yhfA,6971902,6971902,6971636,266,114,utRho19
yhfG,6983294,6983294,6983240,54,110,utRho19
yhfL,6998622,6998896,6998622,274,2,utRho19
yhfY,7023244,7023244,7022844,400,0,utRho19
yhgA,7086294,7086334,7086294,40,0,utRho19
yhgE,7065176,7065176,7064878,298,422,utRho19
yhgF,7074352,7074770,7074352,418,3850,utRho19
yhhA,7173458,7173886,7173458,428,12,utRho19
yhhI,7248346,7248756,7248346,410,0,utRho19
yhhJ,7253696,7253696,7253606,90,116,utRho19
yhhM,7211588,7211588,7211220,368,90,utRho19
yhhN,7211150,7211502,7211150,352,84,utRho19
yhhQ,7218238,7218434,7218238,196,334,utRho19
yhhT,7223682,7223730,7223682,48,144,utRho19
yhhX,7162032,7162032,7161610,422,10,utRho19
yhhY,7162222,7162276,7162222,54,4,utRho19
yhhZ,7163516,7163726,7163516,210,78,utRho19
yhiD,7312220,7312220,7311804,416,157574,utRho19
yhiJ,7265190,7265190,7265180,10,0,utRho19
yhiM,7269270,7269682,7269270,412,32,utRho19
yhiN,7275000,7275000,7274820,180,250,utRho19
yhjA,7338522,7338522,7338376,146,2,utRho19
yhjB,7344090,7344090,7343788,302,20,utRho19
yhjC,7344272,7344684,7344272,412,6,utRho19
yhjD,7346660,7346724,7346660,64,104,utRho19
yhjE,7349274,7349572,7349274,298,20,utRho19
yhjG,7356824,7356824,7356730,94,0,utRho19
yhjH,7358458,7358458,7358374,84,44,utRho19
yhjJ,7364032,7364032,7363880,152,4,utRho19
yhjK,7371296,7371296,7371158,138,0,utRho19
yhjR,7392750,7392750,7392370,380,386,utRho19
yhjV,7400796,7401126,7400796,330,26,utRho19
yhjX,7424194,7424194,7424014,180,2,utRho19
yhjY,7425966,7425966,7425868,98,0,utRho19
yiaB,7455654,7455654,7455496,158,0,utRho19
yiaD,7432712,7433094,7432712,382,8,utRho19
yiaF,7438194,7438194,7438088,106,4,utRho19
yiaG,7438862,7438956,7438862,94,1236,utRho19
yiaJ,7485236,7485236,7485064,172,8,utRho19
yiaK,7485348,7485466,7485348,118,0,utRho19
yiaT,7503924,7503924,7503736,188,0,utRho19
yiaU,7503792,7503984,7503792,192,0,utRho19
yiaY,7515856,7515856,7515654,202,114,utRho19
yibF,7523950,7523950,7523910,40,10,utRho19
yibG,7536128,7536354,7536128,226,4,utRho19
yibL,7553194,7553330,7553194,136,390,utRho19
yibN,7570112,7570112,7570030,82,326,utRho19
yibT,7552848,7552848,7552760,88,158,utRho19
yicC,7633290,7633352,7633290,62,64,utRho19
yicH,7660862,7660914,7660862,52,0,utRho19
yicJ,7673328,7673328,7671858,1470,290,utRho19
yicN,7685018,7685018,7684804,214,20,utRho19
yicO,7687914,7687914,7687578,336,0,utRho19
yicR,15250308,15250308,15250236,72,0,utRho19
yidB,7755230,7755230,7754930,300,0,utRho19
yidE,7732780,7732780,7732546,234,0,utRho19
yidF,7711580,7711580,7711222,358,0,utRho19
yidQ,7735088,7735456,7735088,368,2524,utRho19
yidR,7738824,7738824,7738618,206,0,utRho19
yieE,7787658,7787738,7787658,80,18,utRho19
yieH,7793314,7793548,7793314,234,0,utRho19
yieK,7798928,7798928,7798786,142,0,utRho19
yifB,7900350,7900350,7899998,352,68,utRho19
yifL,7988984,7989044,7988984,60,94,utRho19
yigF,8005750,8005750,8005598,152,320,utRho19
yigI,8009448,8009448,8009394,54,6,utRho19
yigM,8022100,8022152,8022100,52,2,utRho19
yihA,8101970,8101970,8101458,512,142,utRho19
yihD,8084098,8084138,8084098,40,2,utRho19
yihF,8088110,8088398,8088110,288,0,utRho19
yihG,8093304,8093304,8093204,100,0,utRho19
yihI,8102616,8102694,8102616,78,56,utRho19
yihL,8120506,8120894,8120506,388,8,utRho19
yihN,8124332,8124494,8124332,162,4,utRho19
yihO,8131942,8131942,8131532,410,0,utRho19
yihQ,8138892,8138892,8138552,340,0,utRho19
yihV,8147064,8147478,8147064,414,8,utRho19
yihX,8151096,8151106,8151096,10,162,utRho19
yiiE,8158192,8158582,8158192,390,26,utRho19
yiiF,8159124,8159502,8159124,378,4,utRho19
yiiG,8173762,8174004,8173762,242,2,utRho19
yiiM,8205506,8205644,8205506,138,22,utRho19
yiiQ,8224624,8224624,8224428,196,116,utRho19
yiiS,8225738,8225934,8225738,196,2,utRho19
yijE,8272178,8272216,8272178,38,48,utRho19
yijF,8275728,8275728,8275314,414,52,utRho19
yijO,8296858,8296858,8296634,224,68,utRho19
yjaA,8426240,8426468,8426240,228,116320,utRho19
yjaB,8428312,8428312,8428246,66,6,utRho19
yjaG,8398746,8399008,8398746,262,1962,utRho19
yjaH,8401022,8401132,8401022,110,500,utRho19
yjaZ,8379506,8379572,8379506,66,2,utRho19
yjbB,8455204,8455462,8455204,258,0,utRho19
yjbE,16943432,16943624,16943432,192,12,utRho19
yjbL,8520318,8520642,8520318,324,0,utRho19
yjbQ,8540428,8540476,8540428,48,0,utRho19
yjcB,8550328,8550328,8550082,246,148,utRho19
yjcC,8550836,8550942,8550836,106,166,utRho19
yjcD,8556628,8556958,8556628,330,36,utRho19
yjcE,8559658,8559960,8559658,302,2,utRho19
yjcF,8566212,8566212,8566150,62,0,utRho19
yjcO,8594660,8594660,8594250,410,112,utRho19
yjdA,8654128,8654270,8654128,142,0,utRho19
yjdC,8726660,8726660,8726616,44,0,utRho19
yjdK,8704780,8705168,8704780,388,404,utRho19
yjdL,8713034,8713034,8712822,212,26,utRho19
yjdM,8653672,8653672,8653468,204,2402,utRho19
yjeF,8787354,8788132,8787354,778,14832,utRho19
yjeI,8745522,8745618,8745522,96,8,utRho19
yjeJ,8748806,8748806,8748468,338,40,utRho19
yjeV,8785472,8785784,8785472,312,12,utRho19
yjfP,8833512,8833904,8833512,392,0,utRho19
yjfY,8849656,8849656,8849582,74,2,utRho19
yjfZ,8855052,8855052,8854844,208,12,utRho19
yjgA,8916162,8916162,8915730,432,116,utRho19
yjgL,8950802,8950874,8950802,72,0,utRho19
yjgM,8959342,8959342,8959074,268,0,utRho19
yjgN,8959132,8959460,8959132,328,0,utRho19
yjgR,8980170,8980170,8980126,44,422,utRho19
yjgZ,9002116,9002520,9002116,404,238,utRho19
yjhB,9007764,9008116,9007764,352,258,utRho19
yjhG,9048452,9048452,9048188,264,2370,utRho19
yjhU,9041080,9041080,9040648,432,1590,utRho19
yjiA,9178096,9178096,9177730,366,1226,utRho19
yjiJ,9125364,9125364,9125350,14,0,utRho19
yjiK,9127270,9127270,9127422,152,220,utRho19
yjiL,9129604,9129604,9129378,226,0,utRho19
yjiS,9143410,9143502,9143410,92,2,utRho19
yjiY,9182734,9182734,9182558,176,18,utRho19
yjjA,9200674,9200674,9200378,296,156,utRho19
yjjB,18408708,18408708,18407800,908,8,utRho19
yjjJ,9243314,9243538,9243314,224,0,utRho19
yjjK,9261132,9261132,9261044,88,4,utRho19
yjjL,9189764,9189764,9189444,320,298,utRho19
yjjM,9191894,9191894,9191702,192,112,utRho19
yjjP,9206068,9206068,9205716,352,80,utRho19
yjjQ,9206638,9206954,9206638,316,60,utRho19
yjjX,9267798,9267798,9267490,308,1160,utRho19
yjjY,9280716,9280804,9280716,88,1038,utRho19
yjjZ,9211554,9211608,9211554,54,220,utRho19
yjtD,9281676,9281884,9281676,208,50,utRho19
ykfB,532454,532454,532174,280,352,utRho19
ykfI,527636,527636,527338,298,22,utRho19
ykgB,637050,637050,636638,412,0,utRho19
ykgC,640430,640430,640002,428,8,utRho19
ykgD,640232,640454,640232,222,6,utRho19
ykgE,642962,643216,642962,254,154,utRho19
ykgJ,608524,608524,608364,160,1690,utRho19
ykgL,623878,624224,623878,346,10,utRho19
ykgM,625610,625610,625554,56,2,utRho19
ykgR,626570,626570,626484,86,0,utRho19
ylaC,958576,958576,958502,74,774,utRho19
yliE,1745938,1745958,1745938,20,0,utRho19
ymcE,2103660,2103694,2103660,34,4,utRho19
ymdA,2210450,2210828,2210450,378,6,utRho19
ymdB,2211428,2211640,2211428,212,0,utRho19
ymfD,2395322,2395322,2395064,258,404,utRho19
ymfI,2402880,2402994,2402880,114,0,utRho19
ymfJ,2404518,2404518,2404168,350,608,utRho19
ymfK,2406176,2406176,2405866,310,0,utRho19
ymfT,2405766,2406048,2405766,282,118,utRho19
ymgE,2489110,2489456,2489110,346,8,utRho19
ymgF,2437628,2437966,2437628,338,2,utRho19
ymiA,2670112,2670320,2670112,208,72,utRho19
ymjA,2715620,2715620,2715336,284,120,utRho19
ynaI,2791946,2791946,2791844,102,0,utRho19
ynaK,2850438,2850754,2850438,316,2,utRho19
ynbA,2954924,2955242,2954924,318,0,utRho19
yncD,3046552,3046552,3046130,422,54,utRho19
yncE,3046454,3046614,3046454,160,96,utRho19
yncG,3052456,3052494,3052456,38,142,utRho19
yncL,3034492,3034492,3034388,104,60,utRho19
yneE,3218364,3218364,3218044,320,0,utRho19
yneF,3223748,3223748,3223708,40,0,utRho19
yneJ,3229560,3229608,3229560,48,46,utRho19
yneK,3231100,3231526,3231100,426,4,utRho19
yneM,3245176,3245292,3245176,116,44,utRho19
ynfA,3311398,3311398,3311346,52,0,utRho19
ynfB,3311418,3311616,3311418,198,318,utRho19
ynfC,3315094,3315094,3314914,180,156,utRho19
ynfD,3314828,3315130,3314828,302,156,utRho19
ynfE,3316006,3316138,3316006,132,6,utRho19
ynfK,3334670,3334670,3334438,232,162,utRho19
ynfL,3339304,3339304,3339184,120,0,utRho19
ynfM,3339260,3339398,3339260,138,56,utRho19
ynfN,3276598,3276598,3276218,380,0,utRho19
ynfO,3273454,3273512,3273454,58,4,utRho19
ynhG,3517890,3517890,3517450,440,1272,utRho19
yniA,3615158,3615592,3615158,434,204,utRho19
yniB,3618526,3618526,3618466,60,0,utRho19
yniC,3618652,3618760,3618652,108,0,utRho19
yniD,3610202,3610330,3610202,128,2,utRho19
ynjE,3678880,3678934,3678880,54,0,utRho19
ynjF,3683222,3683222,3682806,416,4,utRho19
ynjH,3684376,3684376,3684270,106,160,utRho19
ynjI,3690022,3690022,3689742,280,2,utRho19
yoaB,3786642,3786734,3786642,92,246,utRho19
yoaC,3787932,3788146,3787932,214,20,utRho19
yoaE,3803544,3803544,3803170,374,680,utRho19
yoaF,3755444,3755444,3755064,380,526,utRho19
yoaH,3789866,3789866,3789462,404,1662,utRho19
yobB,3850418,3850880,3850418,462,1542,utRho19
yobF,3815586,3815586,3815182,404,2,utRho19
yobH,3817800,3817850,3817800,50,0,utRho19
yodB,4084352,4084736,4084352,384,4,utRho19
yodC,4057008,4057008,4056740,268,0,utRho19
yohC,4451358,4451358,4451262,96,2,utRho19
yohD,4451526,4451602,4451526,76,4,utRho19
yohJ,4460986,4461248,4460986,262,0,utRho19
yohO,4431172,4431314,4431172,142,416,utRho19
yojI,4617282,4617282,4617230,52,0,utRho19
ypdI,4988988,4989396,4988988,408,4,utRho19
ypfG,5165786,5165786,5165554,232,48,utRho19
ypfM,5182140,5182140,5181732,408,986,utRho19
yphB,5349590,5349590,5349376,214,94,utRho19
ypjA,5565644,5565644,5565452,192,16,utRho19
ypjB,5569636,5569636,5568858,778,8,utRho19
ypjD,5495860,5495774,5495860,86,0,utRho19
yqaE,5594170,5594170,5594056,114,44,utRho19
yqcA,5846100,5846100,5845968,132,40,utRho19
yqcE,5800944,5801184,5800944,240,0,utRho19
yqeC,6030468,6030468,6030114,354,20,utRho19
yqeF,5971618,5971618,5971184,434,80,utRho19
yqeG,5971438,5971694,5971438,256,114,utRho19
yqeH,5975016,5975072,5975016,56,94,utRho19
yqeI,5976688,5977004,5976688,316,0,utRho19
yqeK,5981140,5981140,5980720,420,42,utRho19
yqfA,6086728,6086728,6086296,432,334,utRho19
yqgA,6219042,6219106,6219042,64,0,utRho19
yqgB,6172500,6172500,6172102,398,248,utRho19
yqgE,6185768,6185874,6185768,106,320,utRho19
yqhA,6299150,6299150,6298942,208,0,utRho19
yqhC,6310768,6310768,6310436,332,576,utRho19
yqhD,6310604,6310710,6310604,106,354,utRho19
yqhH,6316842,6317254,6316842,412,4,utRho19
yqiC,6369662,6369680,6369662,18,68,utRho19
yqiJ,6384108,6384416,6384108,308,4,utRho19
yqjA,6495096,6495546,6495096,450,1216,utRho19
yqjF,6500932,6501124,6500932,192,2366,utRho19
yqjG,6501948,6502048,6501948,100,0,utRho19
yqjH,6433078,6433078,6432982,96,0,utRho19
yqjI,6433506,6433558,6433506,52,2,utRho19
yraH,6574552,6574852,6574552,300,2,utRho19
yraP,6592144,6592818,6592144,674,300,utRho19
yraQ,6596414,6596414,6596276,138,0,utRho19
yraR,6598024,6598024,6597692,332,636,utRho19
yrbG,13360844,13361100,13360844,256,0,utRho19
yrbL,6696842,6696904,6696842,62,46,utRho19
yrbN,6616172,6616172,6615866,306,142,utRho19
yrdB,6860176,6860176,6860046,130,0,utRho19
yrfF,7052548,7052938,7052548,390,1032,utRho19
yrhB,7169440,7169518,7169440,78,2,utRho19
ysaB,7451804,7451804,7451424,380,4,utRho19
ysgA,8032686,8032686,8032338,348,362,utRho19
ytfB,8857638,8857638,8857434,204,310,utRho19
ytfE,8864018,8864018,8863966,52,0,utRho19
ytfF,8866296,8866296,8866130,166,2,utRho19
ytfH,8868164,8868226,8868164,62,8,utRho19
ytfI,8875234,8875414,8875234,180,12,utRho19
ytfJ,8878572,8878572,8878524,48,284,utRho19
ytfK,8879022,8879174,8879022,152,514,utRho19
ytfL,8882642,8882642,8882430,212,66,utRho19
ytfQ,8899634,8899924,8899634,290,1118,utRho19
ytjB,9249598,9249598,9249578,20,84,utRho19
yzfA,8896588,8896588,8896490,98,0,utRho19
zapA,6111102,6111224,6111102,122,1912,utRho19
zapB,8236772,8237030,8236772,258,448,utRho19
zapC,2011700,2011904,2011700,204,0,utRho19
zinT,4082692,4082750,4082692,58,2,utRho19
zipA,5062814,5062814,5062466,348,12,utRho19
zitB,1569716,1569716,1569646,70,2,utRho19
zntA,7212844,7212902,7212844,58,8,utRho19
zntR,6878336,6878336,6878260,76,0,utRho19
znuA,3885322,3885322,3885166,156,0,utRho19
znuC,3885268,3885324,3885268,56,0,utRho19
zraP,8403424,8403424,8403376,48,0,utRho19
zraS,8403810,8403852,8403810,42,0,utRho19
zupT,6364866,6365100,6364866,234,556,utRho19
zur,8520282,8520282,8520006,276,394,utRho19
zwf,3872752,3872752,3872628,124,170,utRho19
C0343,2818676,2818728,2818676,52,284,utRho20
aaeB,6776526,6776526,6776376,150,0,utRho20
aaeR,6778762,6779040,6778762,278,14,utRho20
aaeX,6778860,6778860,6778674,186,84,utRho20
aat,1854920,1854920,1854864,56,0,utRho20
accA,416822,417242,416822,420,1970,utRho20
accB,6810280,6810872,6810280,592,4734,utRho20
accD,4868030,4868030,4867852,178,28,utRho20
aceB,8430804,8430956,8430804,152,236,utRho20
aceE,245938,246034,245938,96,68,utRho20
ackA,4826918,4826940,4826918,22,210,utRho20
acnA,2670848,2671662,2670848,814,5118,utRho20
acnB,263038,263230,263038,192,1936,utRho20
acpP,2303148,2303230,2303148,82,548,utRho20
acpS,5402324,5402324,5401996,328,352,utRho20
acrA,971396,971396,971238,158,340,utRho20
acrB,969370,969370,968806,564,5266,utRho20
acrD,5174950,5175190,5174950,240,0,utRho20
acrE,6827404,6827728,6827404,324,0,utRho20
acrR,971398,971522,971398,124,82,utRho20
acrZ,1589502,1589546,1589502,44,168,utRho20
acs,8575190,8575190,8574742,448,138,utRho20
actP,8569870,8569870,8569804,66,90,utRho20
ada,4620854,4620854,4620810,44,0,utRho20
add,3404404,3404466,3404404,62,70,utRho20
ade,7687802,7687928,7687802,126,0,utRho20
adhE,2596826,2596826,2596242,584,140,utRho20
adhP,3107988,3107988,3107676,312,2364,utRho20
adiA,8681112,8681112,8681042,70,100,utRho20
adiC,8674404,8674404,8674062,342,4,utRho20
adiY,8676084,8676084,8675858,226,0,utRho20
adk,994278,994350,994278,72,24,utRho20
adrA,807374,807406,807374,32,62,utRho20
aer,6438240,6438240,6438152,88,80,utRho20
aes,1000102,1000102,999946,156,0,utRho20
agaR,6557406,6557406,6557330,76,0,utRho20
agaS,6563778,6563952,6563778,174,0,utRho20
agp,2131118,2131170,2131118,52,50,utRho20
agrA,7296126,7296126,7296126,0,0,utRho20
agrB,7296588,7296588,7296588,0,0,utRho20
ahpC,1277386,1277890,1277386,504,5526,utRho20
ahpF,1278004,1279506,1278004,1502,485932,utRho20
ahr,8992698,8992698,8992418,280,0,utRho20
aidB,8828494,8828550,8828494,56,0,utRho20
ais,4731512,4731512,4731240,272,0,utRho20
alaA,4814816,4815122,4814816,306,0,utRho20
alaC,4996798,4996798,4996590,208,182,utRho20
alaE,5598140,5598328,5598140,188,1166,utRho20
alaS,5644180,5644180,5644022,158,7036,utRho20
alaW,5036612,5036612,5036462,150,0,utRho20
aldA,2976380,2976464,2976380,84,1198,utRho20
aldB,7513070,7513070,7513022,48,52,utRho20
alkA,4295118,4295118,4295080,38,0,utRho20
alkB,4618890,4618890,4618682,208,140,utRho20
allA,1064780,1064902,1064780,122,0,utRho20
allD,1092822,1092822,1092726,96,0,utRho20
allE,1088112,1088112,1088092,20,82,utRho20
allS,1064600,1064600,1064442,158,2,utRho20
alr,8531178,8531564,8531178,386,2684,utRho20
alsE,8617334,8617334,8616956,378,154,utRho20
alsK,8615990,8615990,8615598,392,0,utRho20
alx,6476740,6477160,6476740,420,70,utRho20
amiA,5104482,5104704,5104482,222,0,utRho20
amiC,5898378,5898378,5898020,358,0,utRho20
amn,4110062,4110122,4110062,60,0,utRho20
ampC,8758006,8758006,8757888,118,0,utRho20
ampD,237362,237466,237362,104,114,utRho20
ampG,907372,907372,907090,282,236,utRho20
ampH,792726,792726,792574,152,34,utRho20
amyA,4012230,4012312,4012230,82,188,utRho20
anmK,3439346,3439346,3439204,142,0,utRho20
ansB,6201580,6201580,6201456,124,0,utRho20
ansP,3052040,3052040,3051960,80,0,utRho20
apaG,104068,104068,103212,856,6978,utRho20
apaH,102586,102586,102444,142,5840,utRho20
apbE,4623188,4623188,4623068,120,0,utRho20
appA,2081198,2081234,2081198,36,392,utRho20
appC,2075420,2075480,2075420,60,0,utRho20
appY,1167134,1167362,1167134,228,0,utRho20
apt,982620,982824,982620,204,18,utRho20
aqpZ,1832424,1832424,1832094,330,34,utRho20
araB,140150,140150,140096,54,0,utRho20
araC,140482,140774,140482,292,1438,utRho20
araE,5964416,5964416,5964364,52,54,utRho20
araF,3972476,3972476,3972256,220,150,utRho20
araH,3967120,3967120,3967086,34,0,utRho20
araJ,825058,825058,824962,96,2,utRho20
arcA,9281602,9281602,9280612,990,19900,utRho20
arcB,6706098,6706098,6706050,48,0,utRho20
arcZ,6701154,6701154,6701154,0,0,utRho20
arfA,6877346,6877346,6877298,48,94,utRho20
argA,5898312,5898484,5898312,172,40,utRho20
argC,8309770,8310002,8309770,232,52,utRho20
argD,6980442,6980442,6980360,82,0,utRho20
argE,8310156,8310156,8309694,462,266,utRho20
argF,580680,580680,580610,70,0,utRho20
argG,6637124,6637274,6637124,150,26,utRho20
argI,8956688,8956688,8956622,66,0,utRho20
argO,6137672,6137672,6137616,56,64,utRho20
argP,6119460,6119506,6119460,46,2,utRho20
argR,6769204,6769406,6769204,202,0,utRho20
argS,3920002,3920124,3920002,122,0,utRho20
argT,4855698,4855698,4855582,116,200,utRho20
argU,1129406,1129446,1129406,40,4,utRho20
argW,4932616,4932618,4932616,2,32,utRho20
argX,7964728,7964750,7964728,22,14,utRho20
aroF,5482402,5482402,5482300,102,0,utRho20
aroG,1571182,1571266,1571182,84,152,utRho20
aroH,3576636,3576870,3576636,234,894,utRho20
aroK,7038760,7038760,7038128,632,1432,utRho20
aroL,812560,812810,812560,250,0,utRho20
aroP,243342,243342,243102,240,0,utRho20
arpA,8445382,8445382,8444974,408,2,utRho20
arrS,7316108,7316108,7316108,0,0,utRho20
arsR,7297024,7297056,7297024,32,0,utRho20
artJ,1801252,1801252,1801150,102,0,utRho20
artP,1807686,1807686,1807468,218,2244,utRho20
ascF,5678858,5679048,5678858,190,0,utRho20
ascG,5678574,5678574,5678528,46,20,utRho20
aslB,7965562,7965916,7965562,354,104,utRho20
asnA,7854258,7854310,7854258,52,4,utRho20
asnB,1398444,1398444,1398354,90,4,utRho20
asnC,23562186,23562186,23562018,168,0,utRho20
asnS,1978088,1978088,1977970,118,13598,utRho20
asnT,4089082,4089098,4089082,16,474,utRho20
asnU,4119690,4119702,4119690,12,0,utRho20
asnV,4124504,4124520,4124504,16,58,utRho20
aspA,17473728,17473728,17473308,420,132,utRho20
aspC,1971486,1971486,1971418,68,52,utRho20
aspS,3901402,3901402,3901044,358,224,utRho20
aspT,7893560,7893744,7893560,184,186610,utRho20
aspV,473826,473862,473826,36,8,utRho20
asr,3342654,3342752,3342654,98,78,utRho20
astC,3664088,3664088,3663964,124,0,utRho20
astE,3654138,3654138,3653846,292,74,utRho20
atoD,4646824,4646894,4646824,70,2,utRho20
atpB,7844540,7844540,7844102,438,354,utRho20
atpC,7832118,7832118,7831944,174,1328,utRho20
atpI,7845050,7845050,7844880,170,2,utRho20
avtA,7479348,7479410,7479348,62,10,utRho20
azoR,2965982,2965982,2965720,262,384,utRho20
azuC,3976002,3976002,3975918,84,0,utRho20
bacA,6408350,6408350,6408262,88,0,utRho20
bamA,394052,395856,394052,1804,1762,utRho20
bamB,5277950,5277950,5277304,646,1444,utRho20
bamC,5198028,5198028,5197730,298,2152,utRho20
bamD,5471922,5472292,5471922,370,1164,utRho20
bamE,5506972,5507210,5506972,238,1052,utRho20
basS,8666954,8666954,8666544,410,444,utRho20
bax,7474468,7474468,7474354,114,626,utRho20
bcp,5200874,5200956,5200874,82,3574,utRho20
bcsB,7385346,7385346,7385214,132,0,utRho20
bcsE,7392644,7392916,7392644,272,36,utRho20
bdcA,8948128,8948128,8948106,22,0,utRho20
bdcR,8948192,8948248,8948192,56,0,utRho20
bdm,3112680,3112680,3112560,120,0,utRho20
betA,654522,654522,654494,28,780,utRho20
betI,658722,658722,658668,54,34,utRho20
betT,658842,658926,658842,84,0,utRho20
bfr,6933498,6933498,6933450,48,0,utRho20
bglG,23440182,23440182,23439402,780,0,utRho20
bglX,4444240,4444240,4443978,262,0,utRho20
bhsA,2337962,2338146,2337962,184,0,utRho20
bioA,1618584,1618584,1618514,70,0,utRho20
bioB,1618604,1618688,1618604,84,8,utRho20
bioH,7089716,7089716,7089688,28,0,utRho20
bisC,7433026,7433026,7432788,238,0,utRho20
blc,8755490,8755490,8755444,46,0,utRho20
blr,3409024,3409102,3409024,78,94,utRho20
bluF,2431226,2431226,2430950,276,176,utRho20
bluR,2428226,2428226,2428118,108,0,utRho20
bolA,908698,908944,908698,246,178,utRho20
borD,1157842,1157842,1157786,56,58,utRho20
brnQ,838976,839182,838976,206,418,utRho20
bssR,1756492,1756496,1756492,4,0,utRho20
bssS,2242116,2242116,2241910,206,594,utRho20
btuB,8326798,8327278,8326798,480,1644,utRho20
cadB,8720212,8720212,8720062,150,4,utRho20
cadC,8723926,8723926,8723868,58,0,utRho20
caiE,70998,70998,70742,256,38,utRho20
caiF,68436,68600,68436,164,34,utRho20
caiT,84074,84074,83862,212,0,utRho20
can,285406,285406,285340,66,124,utRho20
carA,59102,59302,59102,200,0,utRho20
carB,61550,61634,61550,84,680,utRho20
cas2,5757830,5757830,5757706,124,224,utRho20
casA,5768638,5768638,5768276,362,0,utRho20
cbl,4121882,4121882,4121828,54,0,utRho20
cbpA,2128074,2128074,2127550,524,476,utRho20
cbrA,7738628,7738754,7738628,126,0,utRho20
cbrB,7794958,7795012,7794958,54,88,utRho20
ccmH,4585242,4585242,4584820,422,4,utRho20
cdaR,364894,364926,364894,32,0,utRho20
cdd,4463638,4463688,4463638,50,112,utRho20
cdh,8219814,8219860,8219814,46,0,utRho20
cdsA,391110,391354,391110,244,564,utRho20
cedA,3627484,3627484,3627326,158,100,utRho20
cfa,3482402,3482826,3482402,424,632,utRho20
chaC,2544844,2544972,2544844,128,78,utRho20
chbB,3643452,3643452,3643238,214,0,utRho20
chbG,3634624,3634624,3634270,354,0,utRho20
cheW,3946924,3946924,3946678,246,12,utRho20
chiA,6939792,6939792,6939706,86,0,utRho20
chiP,1416472,1416668,1416472,196,2,utRho20
cho,3646984,3647030,3646984,46,170,utRho20
chpS,8896804,8896894,8896804,90,0,utRho20
cirA,4493884,4493884,4493538,346,48,utRho20
citC,1304078,1304078,1303712,366,0,utRho20
citT,1293264,1293264,1293160,104,0,utRho20
clcA,350104,350214,350104,110,2,utRho20
clpA,1846160,1846528,1846160,368,474,utRho20
clpB,5468410,5468410,5468346,64,996,utRho20
clpP,913154,913354,913154,200,580,utRho20
clpS,1845500,1845826,1845500,326,28,utRho20
clpX,914404,914852,914404,448,4672,utRho20
clsA,2617346,2617346,2617290,56,2,utRho20
clsC,2212584,2212710,2212584,126,482,utRho20
cmk,1922330,1922402,1922330,72,92,utRho20
cnu,3409522,3409898,3409522,376,874,utRho20
coaA,8350214,8350214,8350052,162,374,utRho20
cobC,1340092,1340092,1339814,278,344,utRho20
cobT,4129202,4129202,4128934,268,28,utRho20
cobU,4131944,4131944,4131528,416,16,utRho20
codB,709768,709844,709768,76,0,utRho20
comR,2337726,2337726,2337664,62,0,utRho20
copA,1022822,1022822,1022758,64,0,utRho20
corA,8002388,8002852,8002388,464,6830,utRho20
cpdB,8873258,8873258,8873130,128,588,utRho20
cptB,6082198,6082198,6082140,58,30,utRho20
cpxA,8210202,8210202,8209950,252,2090,utRho20
cpxP,8211570,8211640,8211570,70,392,utRho20
cpxR,8211372,8211372,8211340,32,306,utRho20
cra,175894,176056,175894,162,0,utRho20
crcB,1316016,1316016,1315876,140,76,utRho20
creA,9270486,9271042,9270486,556,1262,utRho20
creD,9276320,9276356,9276320,36,0,utRho20
crl,515620,515658,515620,38,3338,utRho20
crp,6971906,6972240,6971906,334,5184,utRho20
crr,5070960,5071668,5070960,708,19500,utRho20
csdA,5886414,5886674,5886414,260,20,utRho20
csgB,2207718,2207902,2207718,184,0,utRho20
csgD,2206688,2206688,2206392,296,0,utRho20
csgG,2203510,2203510,2203368,142,74,utRho20
csiD,5577854,5577970,5577854,116,2004,utRho20
csiE,5330802,5330870,5330802,68,88,utRho20
csiR,5590942,5591348,5590942,406,796,utRho20
cspA,7439778,7440098,7439778,320,746,utRho20
cspB,3283430,3283430,3283108,322,0,utRho20
cspC,3815018,3815018,3814870,148,752,utRho20
cspD,1845352,1845352,1845180,172,36914,utRho20
cspE,1314294,1314584,1314294,290,0,utRho20
cspF,3283380,3283710,3283380,330,0,utRho20
cspG,2102610,2102922,2102610,312,506,utRho20
cspH,2102746,2102746,2102350,396,2,utRho20
cspI,3277624,3277624,3277334,290,0,utRho20
csrA,5638746,5638746,5638292,454,3216,utRho20
csrB,5849048,5849048,5849048,0,0,utRho20
csrC,8102072,8102072,8102072,0,0,utRho20
csrD,6806850,6806850,6806664,186,84,utRho20
cstA,1259710,1259788,1259710,78,0,utRho20
cueO,274090,274166,274090,76,0,utRho20
cueR,1027948,1027986,1027948,38,62,utRho20
curA,3037784,3038054,3037784,270,28,utRho20
cusC,1191146,1191200,1191146,54,0,utRho20
cusR,1190924,1190924,1190886,38,0,utRho20
cutA,8730784,8730784,8730712,72,0,utRho20
cutC,3918534,3918534,3917920,614,194,utRho20
cvpA,4861600,4861600,4861526,74,0,utRho20
cvrA,2484328,2484328,2484142,186,176,utRho20
cyaA,7981548,7982306,7981548,758,850,utRho20
cyaR,4334228,4334224,4334228,4,0,utRho20
cyaY,7988166,7988166,7988118,48,168,utRho20
cybB,2981522,2981804,2981522,282,102,utRho20
cycA,8859560,8859728,8859560,168,310,utRho20
cydA,1542340,1542916,1542340,576,6,utRho20
cydC,1858800,1858800,1858390,410,280,utRho20
cydD,1862062,1862062,1861924,138,0,utRho20
cydX,1548300,1548392,1548300,92,682,utRho20
cynR,717418,717418,717380,38,0,utRho20
cynT,1435092,1435196,1435092,104,0,utRho20
cyoA,903306,903306,903220,86,1180,utRho20
cyoE,895540,895540,895410,130,930,utRho20
cysB,2667576,2667710,2667576,134,988,utRho20
cysC,5748056,5748056,5747984,72,62,utRho20
cysD,5752736,5752736,5752658,78,0,utRho20
cysE,7565362,7565362,7565124,238,1708,utRho20
cysG,6995508,6995656,6995508,148,38,utRho20
cysJ,5783928,5783928,5783796,132,216,utRho20
cysK,5064688,5064818,5064688,130,200,utRho20
cysP,5087114,5087114,5087056,58,0,utRho20
cysS,1109154,1109222,1109154,68,358,utRho20
cysT,3984100,3984100,3983974,126,396,utRho20
cysZ,5062766,5062926,5062766,160,282,utRho20
cytR,8249018,8249018,8248912,106,2,utRho20
dacA,1328002,1328002,1327926,76,104,utRho20
dacB,6657714,6657926,6657714,212,104,utRho20
dacC,1761306,1761454,1761306,148,88,utRho20
dadA,2475018,2475142,2475018,124,114,utRho20
dam,7032504,7032504,7031826,678,1552,utRho20
damX,7035200,7035200,7034612,588,660,utRho20
dapA,5199568,5199568,5199520,48,0,utRho20
dapB,56576,56748,56576,172,4,utRho20
dapD,371954,371954,371894,60,514,utRho20
dapE,5183120,5183214,5183120,94,1788,utRho20
dcp,3254844,3254844,3254760,84,320,utRho20
dcrB,7219534,7219910,7219534,376,88,utRho20
dctA,7366996,7366996,7366894,102,394,utRho20
dcuA,8733686,8733686,8733546,140,2,utRho20
dcuB,8698182,8698182,8697488,694,74,utRho20
dcuC,1312166,1312166,1311936,230,0,utRho20
dcuD,6749166,6749738,6749166,572,0,utRho20
dcuR,8701130,8701130,8700068,1062,250,utRho20
dcuS,8703370,8703370,8703324,46,0,utRho20
dcyD,3999016,3999016,3998960,56,42,utRho20
ddpX,3126498,3126498,3126152,346,0,utRho20
deaD,6615818,6615818,6615720,98,210,utRho20
dedA,4869880,4869880,4869482,398,8036,utRho20
dedD,4863750,4863750,4863368,382,2,utRho20
def,6867300,6867380,6867300,80,0,utRho20
degP,361690,361768,361690,78,0,utRho20
degQ,6761308,6761486,6761308,178,678,utRho20
deoB,9239134,9239206,9239134,72,68,utRho20
deoC,9233358,9234646,9233358,1288,1652,utRho20
dfp,7625406,7625462,7625406,56,2,utRho20
dgcZ,3247758,3247758,3247700,58,0,utRho20
dgkA,8512914,8513274,8512914,360,930,utRho20
dgt,358392,358474,358392,82,74,utRho20
dhaK,2501888,2501888,2501676,212,138,utRho20
dhaR,2502006,2502132,2502006,126,0,utRho20
dicB,3299194,3299218,3299194,24,0,utRho20
dicC,3295752,3295752,3295700,52,0,utRho20
dinB,501760,501796,501760,36,0,utRho20
dinD,7635398,7635520,7635398,122,0,utRho20
dinG,1666146,1666140,1666146,6,0,utRho20
dinI,2243018,2243018,2242974,44,52,utRho20
dinJ,493230,493230,493004,226,102,utRho20
dinQ,7295964,7295964,7295576,388,1092,utRho20
djlA,114536,114728,114536,192,0,utRho20
dkgA,6313142,6313246,6313142,104,1214,utRho20
dkgB,458196,458334,458196,138,102,utRho20
dksA,321502,321502,321208,294,996,utRho20
dld,4444164,4444370,4444164,206,64,utRho20
dmlA,3763424,3763824,3763424,400,18,utRho20
dmlR,3763710,3763710,3763618,92,0,utRho20
dmsA,1881646,1881918,1881646,272,0,utRho20
dnaA,7767922,7767922,7767458,464,1756,utRho20
dnaB,8528566,8528628,8528566,62,446,utRho20
dnaK,24096,24326,24096,230,4750,utRho20
dnaN,7765466,7765466,7764642,824,606,utRho20
dnaQ,471868,472134,471868,266,3142,utRho20
dnaT,18406460,18406460,18406068,392,76,utRho20
dnaX,984112,984184,984112,72,182,utRho20
dosP,3131486,3131486,3131466,20,134,utRho20
dpiB,1303968,1304470,1303968,502,0,utRho20
dppA,7415740,7415740,7415410,330,6250,utRho20
dps,1697900,1697900,1697822,78,440,utRho20
dsbA,8086754,8086836,8086754,82,3342,utRho20
dsbB,2466294,2466294,2466060,234,0,utRho20
dsbC,6079266,6079266,6077644,1622,1490,utRho20
dsbG,1277600,1277600,1277146,454,780,utRho20
dsdA,4958242,4958404,4958242,162,10,utRho20
dsdC,4955492,4955492,4955258,234,0,utRho20
dsdX,4955642,4955694,4955642,52,0,utRho20
dsrA,4050626,4050626,4050626,0,0,utRho20
dsrB,4049686,4049686,4049646,40,0,utRho20
dtpD,1485340,1485340,1485112,228,28,utRho20
dusA,8523200,8523338,8523200,138,1690,utRho20
dusB,6820492,6820560,6820492,68,0,utRho20
dusC,4460790,4460790,4460770,20,0,utRho20
dut,7627704,7627864,7627704,160,1442,utRho20
dxr,386670,387042,386670,372,1630,utRho20
ebgA,6445102,6445266,6445102,164,0,utRho20
ebgR,6442874,6442932,6442874,58,40,utRho20
ecnB,8753018,8753106,8753018,88,66,utRho20
eco,4607594,4607810,4607594,216,0,utRho20
ecpA,621594,621594,621342,252,0,utRho20
ecpB,620238,620238,620052,186,0,utRho20
ecpR,622964,622964,622672,292,0,utRho20
eda,3866218,3866218,3865512,706,100,utRho20
edd,3869426,3869426,3869208,218,0,utRho20
efeO,2164308,2164486,2164308,178,112,utRho20
efeU_1,2162614,2162712,2162614,98,76,utRho20
efp,8751134,8751398,8751134,264,3228,utRho20
elaA,4763372,4763372,4763086,286,158,utRho20
elaD,4765308,4765426,4765308,118,62,utRho20
elfA,1995530,1995736,1995530,206,0,utRho20
elfD,1996642,1996980,1996642,338,0,utRho20
emrD,7707690,7707844,7707690,154,0,utRho20
emrK,4966896,4966896,4966678,218,0,utRho20
emrY,4964668,4964668,4964352,316,184,utRho20
emtA,2486250,2486360,2486250,110,32,utRho20
endA,12361100,12361388,12361100,288,0,utRho20
eno,5817692,5817692,5815882,1810,6634,utRho20
entC,1249662,1249770,1249662,108,42,utRho20
entD,1220508,1220508,1220158,350,0,utRho20
entH,1258584,1258600,1258584,16,100,utRho20
entS,1244506,1244600,1244506,94,0,utRho20
envR,6827266,6827266,6826930,336,0,utRho20
epd,12295292,12295292,12294764,528,0,utRho20
epmA,8765236,8765286,8765236,50,0,utRho20
epmB,8751406,8751406,8751314,92,1400,utRho20
eptB,7421162,7421162,7420950,212,56,utRho20
eptC,8300622,8300622,8300530,92,28,utRho20
erfK,4126708,4126708,4126646,62,298,utRho20
erpA,353122,353220,353122,98,212,utRho20
esrE,8039956,8039956,8039956,0,0,utRho20
essD,1153746,1154796,1153746,1050,124,utRho20
etk,2088606,2088606,2088420,186,0,utRho20
evgA,4967262,4967510,4967262,248,0,utRho20
exbB,6304028,6304028,6303968,60,120,utRho20
exbD,6302780,6302780,6302486,294,210,utRho20
exuR,6493016,6493304,6493016,288,108,utRho20
exuT,6490004,6490208,6490004,204,0,utRho20
fabA,2032996,2032996,2032940,56,116,utRho20
fabB,4883282,4883282,4883210,72,0,utRho20
fabH,2297032,2297518,2297032,486,1962,utRho20
fabI,2702236,2702236,2702078,158,0,utRho20
fadB,8062026,8062026,8061942,84,0,utRho20
fadD,3779614,3779614,3779492,122,12,utRho20
fadE,486812,486812,486606,206,0,utRho20
fadH,6463248,6463330,6463248,82,4,utRho20
fadI,4921022,4921022,4920938,84,0,utRho20
fadL,4922410,4922600,4922410,190,812,utRho20
fadM,928720,928804,928720,84,72,utRho20
fadR,2469810,2469876,2469810,66,0,utRho20
fbaB,4357334,4357334,4357128,206,1182,utRho20
fdhE,8162722,8162722,8162456,266,2524,utRho20
fdhF,8598814,8598814,8598732,82,0,utRho20
fdnG,3094744,3094802,3094744,58,0,utRho20
fdrA,1093012,1093360,1093012,348,0,utRho20
feaB,2894994,2895038,2894994,44,0,utRho20
feaR,2894734,2894734,2894566,168,254,utRho20
fecA,9033454,9033454,9033354,100,80,utRho20
fecE,9023288,9023288,9022914,374,1846,utRho20
fecI,9036564,9036564,9036470,94,0,utRho20
feoA,7080114,7080326,7080114,212,488,utRho20
fepA,1225334,1225334,1224988,346,0,utRho20
fepB,1249454,1249454,1249020,434,604,utRho20
fepD,1244468,1244468,1244378,90,0,utRho20
fes,1225374,1225630,1225374,256,146,utRho20
ffh,5495706,5495706,5495590,116,998,utRho20
ffs,952576,952848,952576,272,186,utRho20
fhuA,334884,334968,334884,84,34,utRho20
fhuE,2323294,2323294,2323102,192,292,utRho20
fhuF,9211504,9211504,9211326,178,290,utRho20
fic,6983296,6983296,6982926,370,88,utRho20
fieF,8212864,8212938,8212864,74,0,utRho20
fimA,9085388,9086230,9085388,842,998,utRho20
fimB,9081334,9081914,9081334,580,1716,utRho20
fimE,9083742,9084074,9083742,332,0,utRho20
fimZ,1129214,1129214,1128960,254,150,utRho20
fiu,1683296,1683296,1683062,234,0,utRho20
fixA,84650,84806,84650,156,0,utRho20
fkpA,6955050,6955050,6954838,212,5632,utRho20
fldA,2846084,2846084,2845860,224,5356,utRho20
fldB,6079644,6079710,6079644,66,30,utRho20
flgA,2261770,2261770,2261726,44,0,utRho20
flgB,2261986,2262036,2261986,50,0,utRho20
flgK,2276702,2276756,2276702,54,6,utRho20
flgM,2260330,2260330,2260256,74,174,utRho20
flgN,2259828,2259828,2259660,168,0,utRho20
flhB,3932432,3932432,3932382,50,62,utRho20
flhC,3955864,3955864,3955688,176,96,utRho20
flhD,3957154,3957154,3956394,760,418,utRho20
fliA,4003638,4003638,4003578,60,0,utRho20
fliC,4007352,4007352,4007212,140,0,utRho20
fliD,4007634,4007744,4007634,110,0,utRho20
fliE,4026186,4026186,4026028,158,0,utRho20
fliF,4026292,4026458,4026292,166,2,utRho20
fliL,4039168,4039236,4039168,68,0,utRho20
flk,4875824,4875900,4875824,76,8,utRho20
flu,4142634,4143078,4142634,444,0,utRho20
flxA,3292776,3292810,3292776,34,386,utRho20
fnr,2799104,2799104,2799052,52,0,utRho20
fnrS,2818258,2818258,2818258,0,0,utRho20
focA,1909628,1909628,1908932,696,52,utRho20
folA,99598,99646,99598,48,0,utRho20
folB,6409296,6409296,6409178,118,0,utRho20
folD,1115562,1115562,1115482,80,58,utRho20
folE,4487696,4487696,4487304,392,2612,utRho20
fpr,8228998,8228998,8228944,54,0,utRho20
frc,4986878,4986878,4986508,370,0,utRho20
frdA,8764824,8764824,8764636,188,0,utRho20
frdD,8758948,8758948,8758732,216,1422,utRho20
fre,8052886,8053054,8052886,168,2352,utRho20
frlA,6999518,6999820,6999518,302,0,utRho20
frr,385624,385744,385624,120,3584,utRho20
frsA,513004,513054,513004,50,82,utRho20
fruB,4527194,4527194,4526990,204,116,utRho20
frvR,8179804,8179804,8179710,94,0,utRho20
fryA,5008986,5008986,5008970,16,0,utRho20
fsaA,1727060,1727284,1727060,224,0,utRho20
fsr,1009710,1009710,1009392,318,238,utRho20
ftnA,3977364,3977432,3977364,68,0,utRho20
ftnB,3973550,3973850,3973550,300,76,utRho20
ftsA,207122,207964,207122,842,920,utRho20
ftsB,5745802,5745802,5745640,162,88,utRho20
ftsH,6654204,6654204,6653870,334,450,utRho20
ftsK,1865858,1866448,1865858,590,3470,utRho20
ftsL,181376,182064,181376,688,4360,utRho20
ftsP,6325732,6325732,6325338,394,150,utRho20
ftsQ,205484,206310,205484,826,1436,utRho20
ftsX,7204512,7204512,7204172,340,1460,utRho20
ftsZ,209272,210610,209272,1338,300,utRho20
fucA,5867708,5867708,5867376,332,48,utRho20
fucP,5868238,5868470,5868238,232,0,utRho20
fumA,6753760,6753760,6753508,252,11280,utRho20
fumB,8694696,8694696,8694652,44,0,utRho20
fumC,3373418,3373418,3373176,242,64,utRho20
fur,2842892,2842892,2842584,308,6484,utRho20
fusA,6947370,6947370,6947028,342,17678,utRho20
fxsA,8737206,8737328,8737206,122,592,utRho20
gabD,5581824,5582546,5581824,722,50258,utRho20
gadA,7335214,7335214,7335160,54,16,utRho20
gadB,3144144,3144144,3144090,54,0,utRho20
gadC,3141168,3141168,3140978,190,112,utRho20
gadE,7315600,7316732,7315600,1132,96,utRho20
gadW,7329562,7329562,7329236,326,2,utRho20
gadX,14663356,14663356,14663240,116,320,utRho20
gadY,7329728,7329728,7329728,0,0,utRho20
galE,1584354,1584354,1584110,244,32,utRho20
galF,4228702,4228702,4228654,48,0,utRho20
galM,1577796,1577796,1577674,122,4786,utRho20
galP,6176510,6176568,6176510,58,0,utRho20
galR,5953138,5953198,5953138,60,2,utRho20
galS,4483420,4483420,4483336,84,0,utRho20
galU,2582810,2582914,2582810,104,1708,utRho20
gapA,3724480,3725542,3724480,1062,20980,utRho20
garP,6549868,6549868,6549814,54,0,utRho20
gatY,4354468,4354468,4354408,60,50,utRho20
gatZ,4352864,4352864,4352642,222,51132,utRho20
gcd,282558,282558,282450,108,0,utRho20
gcl,1067814,1067832,1067814,18,0,utRho20
gcvA,5885278,5885278,5885134,144,0,utRho20
gcvB,5885392,5885392,5885392,0,0,utRho20
gcvR,5199758,5199812,5199758,54,74,utRho20
gcvT,6101544,6101544,6101334,210,3484,utRho20
gdhA,3684616,3684742,3684616,126,0,utRho20
gfcA,2099668,2099668,2099488,180,62,utRho20
gfcD,2096236,2096236,2095890,346,4,utRho20
ghrA,2195648,2195772,2195648,124,80,utRho20
ghrB,7434378,7434620,7434378,242,852,utRho20
glcA,6242728,6242728,6242558,170,438,utRho20
glcC,6256412,6256544,6256412,132,0,utRho20
glcD,6256152,6256152,6256042,110,0,utRho20
gldA,8278092,8278092,8278070,22,588,utRho20
glgA,7136784,7136784,7136066,718,3398,utRho20
glgB,7147314,7147314,7147004,310,556,utRho20
glgC,7139142,7139142,7138656,486,2058,utRho20
glgP,7133546,7133546,7133162,384,1668,utRho20
glgS,6384024,6384024,6383878,146,108,utRho20
glgX,7142838,7142838,7142638,200,264,utRho20
glk,5018922,5018922,5018852,70,104,utRho20
glmS,7827622,7827622,7827336,286,9066,utRho20
glmU,7830652,7830652,7830400,252,0,utRho20
glmY,10765360,10765360,10765360,0,0,utRho20
glmZ,7972864,7972864,7972864,0,0,utRho20
glnA,16232888,16232888,16232136,752,1392,utRho20
glnB,5375052,5375052,5374816,236,196,utRho20
glnD,377310,377310,377300,10,0,utRho20
glnE,6399602,6399602,6399282,320,984,utRho20
glnH,1696396,1696396,1696008,388,640,utRho20
glnK,945112,945196,945112,84,0,utRho20
glnL,8112742,8112742,8112678,64,0,utRho20
glnQ,1693262,1693262,1692926,336,2138,utRho20
glnS,1411998,1412186,1411998,188,432,utRho20
gloA,3455602,3455674,3455602,72,72,utRho20
gloB,469852,469852,469564,288,3752,utRho20
glpA,4705166,4705294,4705166,128,0,utRho20
glpD,7123942,7124026,7123942,84,0,utRho20
glpE,7123698,7123698,7123646,52,0,utRho20
glpF,8236322,8236322,8236180,142,0,utRho20
glpG,7122960,7122960,7122904,56,26,utRho20
glpR,7121782,7121782,7121210,572,346,utRho20
glpT,4704902,4704902,4704748,154,0,utRho20
glpX,8231212,8231212,8231158,54,154,utRho20
glrK,5382246,5382246,5382196,50,0,utRho20
gltA,1509534,1509534,1508936,598,61032,utRho20
gltB,6709018,6709264,6709018,246,92,utRho20
gltI,1375792,1375792,1375494,298,2686,utRho20
gltP,8588536,8588962,8588536,426,766,utRho20
gltS,7657382,7657382,7657330,52,246,utRho20
gltX,5041568,5041568,5041344,224,634,utRho20
gluQ,320286,320286,320224,62,314,utRho20
glyA,5371148,5371148,5371014,134,236,utRho20
glyQ,7450708,7450708,7450636,72,124,utRho20
glyS,7448990,7448990,7448794,196,3072,utRho20
glyU,5998128,5998128,5998114,14,88,utRho20
glyV,8784626,8784720,8784626,94,396,utRho20
glyW,3984360,3984360,3984234,126,0,utRho20
gmhB,445612,445666,445612,54,0,utRho20
gmk,7642776,7642856,7642776,80,8,utRho20
gmr,2693686,2693686,2693484,202,278,utRho20
gnd,4202648,4202648,4202536,112,852,utRho20
gnsB,3275692,3275692,3275564,128,20,utRho20
gntK,14310580,14310580,14310368,212,0,utRho20
gntP,9102668,9102668,9102592,76,0,utRho20
gntR,7157760,7157760,7157452,308,1392,utRho20
gntT,7092810,7093118,7092810,308,4,utRho20
gntU,7154170,7154170,7154122,48,0,utRho20
gntX,7089334,7089764,7089334,430,0,utRho20
gor,7292224,7292598,7292224,374,120,utRho20
gpmA,1575340,1575340,1575190,150,16,utRho20
gpmM,7570374,7570520,7570374,146,80,utRho20
gpsA,7567620,7567620,7567322,298,25556,utRho20
gpt,511828,511954,511828,126,276,utRho20
grcA,5433046,5433046,5432898,148,0,utRho20
greA,6657728,6657728,6657430,298,586,utRho20
greB,7073488,7073624,7073488,136,122,utRho20
groL,8741566,8742050,8741566,484,36778,utRho20
groS,8741232,8741376,8741232,144,24128,utRho20
grpE,5501494,5501494,5501416,78,468,utRho20
grxA,1781552,1781552,1781506,46,0,utRho20
grxB,2248206,2248206,2248108,98,68,utRho20
grxC,7569152,7569152,7568884,268,9164,utRho20
grxD,3468324,3468324,3468202,122,7960,utRho20
gspA,6911268,6911268,6910796,472,34,utRho20
gspC,6910964,6911156,6910964,192,0,utRho20
gss,6277220,6277220,6277044,176,168,utRho20
gstA,3428654,3428754,3428654,100,0,utRho20
gstB,1761038,1761038,1760960,78,42,utRho20
guaB,5268214,5268214,5268140,74,90,utRho20
gudD,5839026,5839026,5838770,256,146,utRho20
gyrA,4678914,4678914,4678840,74,4,utRho20
gyrB,7760300,7760300,7760238,62,134,utRho20
hcaE,5337964,5338064,5337964,100,48,utRho20
hcaR,5337928,5337928,5337792,136,0,utRho20
hcaT,5336106,5336106,5335692,414,486,utRho20
hchA,4071260,4071670,4071260,410,1292,utRho20
hcp,1828258,1828258,1827628,630,0,utRho20
hcr,1824400,1824400,1824300,100,44,utRho20
hdeA,7313582,7313582,7313480,102,52,utRho20
hdeD,7313920,7313990,7313920,70,0,utRho20
hdfR,7896320,7896320,7895934,386,570,utRho20
hdhA,3396244,3396244,3396080,164,26,utRho20
helD,2048876,2048942,2048876,66,0,utRho20
hemA,2527166,2527428,2527166,262,200,utRho20
hemB,779722,779722,779454,268,40,utRho20
hemF,5106410,5106450,5106410,40,140,utRho20
hemH,996062,996110,996062,48,56,utRho20
hemL,349882,349882,349764,118,190,utRho20
hemN,8103886,8104090,8103886,204,282,utRho20
hepA,127176,127176,126528,648,1662,utRho20
hflD,2385372,2385372,2385262,110,796,utRho20
hfq,8799602,8800576,8799602,974,11900,utRho20
hha,961006,961006,960616,390,0,utRho20
hicA,3018442,3018572,3018442,130,0,utRho20
higA,6468682,6468682,6468288,394,354,utRho20
higB,6468960,6468960,6468910,50,2,utRho20
hinT,2323642,2323770,2323642,128,88,utRho20
hipB,3184964,3184964,3184884,80,274,utRho20
hisB,4186720,4186936,4186720,216,1590,utRho20
hisJ,4853674,4853674,4853576,98,696,utRho20
hisL,8359856,8359984,8359856,128,60,utRho20
hisS,5281284,5281284,5281150,134,284,utRho20
hlpA,400910,400964,400910,54,392,utRho20
hlyE,2460932,2460932,2460788,144,0,utRho20
hmp,5371594,5371670,5371594,76,174,utRho20
hns,2585916,2585916,2585844,72,1076,utRho20
hofM,7045856,7045856,7045502,354,0,utRho20
hokA,7441620,7441620,7441200,420,76,utRho20
hokC,33902,33902,33806,96,0,utRho20
hokE,1215462,1215672,1215462,210,0,utRho20
holC,8968546,8968546,8968560,14,2596,utRho20
holD,9215562,9215606,9215562,44,50,utRho20
holE,3850040,3850216,3850040,176,72,utRho20
hpt,282720,282862,282720,142,160,utRho20
hrpB,324150,324210,324150,60,22,utRho20
hscB,5319048,5319048,5318934,114,1972,utRho20
hscC,1367188,1367188,1366786,402,1086,utRho20
hsdS,9163004,9163004,9162924,80,0,utRho20
hslJ,2883560,2883560,2883486,74,264,utRho20
hslO,7059344,7059548,7059344,204,12634,utRho20
hslR,7058220,7058696,7058220,476,2076,utRho20
hslV,8244708,8244708,8244574,134,0,utRho20
hsrA,7881412,7881412,7881224,188,64,utRho20
htgA,21286,21660,21286,374,10,utRho20
htpG,989634,990240,989634,606,2126,utRho20
htpX,3825236,3825236,3825152,84,0,utRho20
htrE,311036,311036,310852,184,0,utRho20
htrL,7587668,7587668,7587366,302,0,utRho20
hupA,8400352,8400562,8400352,210,288,utRho20
hupB,1845220,1845804,1845220,584,632,utRho20
hyaA,2063968,2064278,2063968,310,0,utRho20
hybO,6292726,6292726,6292522,204,1062,utRho20
hycA,5700922,5700922,5700870,52,0,utRho20
hycI,5686204,5686204,5686086,118,460,utRho20
hydN,5676264,5676264,5676210,54,0,utRho20
hyfA,5202342,5202402,5202342,60,0,utRho20
hypA,11402508,11402588,11402508,80,0,utRho20
hypB,11403356,11404004,11403356,648,104,utRho20
hypF,5676210,5676210,5674850,1360,380,utRho20
hypT,9116634,9116634,9116578,56,0,utRho20
hyuA,6019660,6020056,6019660,396,0,utRho20
iaaA,1733074,1733136,1733074,62,0,utRho20
iadA,9119074,9119074,9119052,22,164,utRho20
iap,5753072,5753162,5753072,90,104,utRho20
ibaG,6673966,6673966,6673606,360,188,utRho20
ibpA,7735036,7735036,7734844,192,318,utRho20
ibpB,7733962,7733962,7733794,168,860,utRho20
icd,2389922,2390246,2389922,324,886,utRho20
iclR,8447304,8447304,8447256,48,40,utRho20
idi,6065876,6066130,6065876,254,0,utRho20
idnD,8988870,8988870,8988812,58,0,utRho20
idnK,8989194,8989246,8989194,52,0,utRho20
ihfA,3591442,3591442,3591104,338,1342,utRho20
ihfB,1927498,1927656,1927498,158,2666,utRho20
ileS,43666,44782,43666,1116,10006,utRho20
ileX,6431194,6431196,6431194,2,62,utRho20
ilvA,15820940,15821324,15820940,384,0,utRho20
ilvC,7915824,7915940,7915824,116,0,utRho20
ilvE,15809552,15809936,15809552,384,156,utRho20
ilvI,170840,171260,170840,420,0,utRho20
ilvL,23701308,23701932,23701308,624,168,utRho20
ilvY,7915734,7915734,7915640,94,0,utRho20
inaA,4698998,4698998,4698944,54,66,utRho20
infA,1853370,1853370,1852886,484,1214,utRho20
infC,3602692,3602692,3601276,1416,8608,utRho20
insA-5,3958452,3958452,3958430,22,0,utRho20
insA-7,9036758,9037054,9036758,296,400,utRho20
insC-5,6372080,6372284,6372080,204,236,utRho20
insEF-2,785238,785238,785820,582,728,utRho20
insEF-4,2190310,2190310,2190892,582,520,utRho20
insG,9007098,9007098,9006862,236,0,utRho20
insH-1,550596,550596,550234,362,192,utRho20
insH-11,7306538,7306538,7306396,142,244,utRho20
insH-2,1151548,1151548,1151506,42,1092,utRho20
insH-3,1378444,1378444,1378026,418,306,utRho20
insH-4,2791942,2792152,2791942,210,244,utRho20
insH-5,2857852,2857852,2857452,400,0,utRho20
insH-6,4135022,4135022,4134642,380,204,utRho20
insH-7,4206186,4206186,4205822,364,2704,utRho20
insH-9,6260050,6260356,6260050,306,320,utRho20
insI-3,9017372,9017372,9017234,138,0,utRho20
insJ,7441188,7441360,7441188,172,0,utRho20
insK,7442130,7442308,7442130,178,0,utRho20
insL-1,30760,30890,30760,130,4596,utRho20
insL-2,1216112,1216130,1216112,18,72,utRho20
insL-3,5028644,5028662,5028644,18,158,utRho20
insN-1,540452,540484,540452,32,0,utRho20
intD,1132202,1132202,1131956,246,160,utRho20
intR,2826520,2826520,2826470,50,0,utRho20
intS,4933026,4933090,4933026,64,44,utRho20
intZ,5117386,5117542,5117386,156,382,utRho20
iraD,9113152,9113986,9113152,834,122,utRho20
iraM,2424246,2424246,2424006,240,0,utRho20
iraP,802638,802772,802638,134,0,utRho20
iscA,5319924,5319924,5319772,152,2602,utRho20
iscR,5324398,5324398,5324262,136,11952,utRho20
iscX,5313834,5313834,5313472,362,1924,utRho20
ispF,5743968,5743968,5743560,408,2384,utRho20
ispG,5283908,5283908,5283608,300,1228,utRho20
ispU,389568,389806,389568,238,154,utRho20
isrA,2811502,2811502,2811618,116,140,utRho20
istr-1,7706384,7706384,7706384,0,0,utRho20
istr-2,7706514,7706514,7706514,0,0,utRho20
ivbL,15412092,15412092,15411952,140,744,utRho20
ivy,480638,480686,480638,48,0,utRho20
katE,3627628,3627734,3627628,106,610,utRho20
katG,8267624,8267670,8267624,46,208,utRho20
kbaZ,6557732,6557828,6557732,96,0,utRho20
kbl,7585154,7585154,7585102,52,376,utRho20
kch,2621046,2621046,2620538,508,0,utRho20
kdgR,3820506,3820506,3820198,308,16,utRho20
kdpE,1443788,1443788,1443466,322,382,utRho20
kdpF,1457698,1457698,1457642,56,0,utRho20
kdsA,2535708,2536330,2535708,622,2874,utRho20
kdsC,6683438,6684546,6683438,1108,8372,utRho20
kduI,5968388,5968388,5968248,140,68,utRho20
kefF,94160,94492,94160,332,0,utRho20
kgtP,5451624,5451624,5451492,132,2,utRho20
kup,7862206,7862632,7862206,426,74,utRho20
lacI,735076,735076,735020,56,378,utRho20
lacZ,1465508,1465508,1465220,288,588,utRho20
ldcA,2486394,2486394,2486160,234,32,utRho20
ldhA,2885830,2885830,2885686,144,34,utRho20
ldrA,2538954,2538954,2538550,404,12,utRho20
ldrB,2540024,2540024,2539620,404,8,utRho20
ldrC,2541092,2541092,2540690,402,2,utRho20
ldrD,7400544,7400544,7400174,370,60,utRho20
lepA,5414392,5414392,5414248,144,198,utRho20
lepB,5410928,5410928,5410618,310,704,utRho20
leuD,159188,159188,158906,282,316,utRho20
leuE,3761600,3761600,3761518,82,0,utRho20
leuL,168048,168048,167416,632,0,utRho20
leuO,168308,168736,168308,428,0,utRho20
leuQ,9212864,9212864,9212802,62,0,utRho20
leuU,6644556,6644556,6644316,240,2466,utRho20
leuV,9212546,9212546,9212330,216,556,utRho20
leuX,8992772,8992810,8992772,38,0,utRho20
lexA,8514174,8514230,8514174,56,36,utRho20
lhr,3456706,3458174,3456706,1468,1260,utRho20
ligA,5060402,5060402,5060352,50,0,utRho20
ligB,7642576,7642576,7642340,236,8,utRho20
lipA,1320602,1320602,1320432,170,78,utRho20
lipB,1324802,1324802,1324556,246,2470,utRho20
lit,2397032,2397390,2397032,358,204,utRho20
livJ,7199524,7199524,7199316,208,80,utRho20
livK,7195510,7195510,7195120,390,120,utRho20
lldP,7554578,7554798,7554578,220,5762,utRho20
lnt,1381968,1381968,1381762,206,1210,utRho20
loiP,6163784,6163826,6163784,42,38,utRho20
lolA,1874656,1874738,1874656,82,340,utRho20
lolB,2527112,2527112,2527000,112,0,utRho20
lolC,2350748,2350854,2350748,106,0,utRho20
lon,917630,917776,917630,146,584,utRho20
lpcA,486936,487086,486936,150,0,utRho20
lpd,255434,255824,255434,390,3002,utRho20
lplA,9248476,9248476,9248234,242,3292,utRho20
lplT,5947878,5947878,5947724,154,0,utRho20
lpoA,6586422,6586800,6586422,378,824,utRho20
lpp,3514592,3514842,3514592,250,514,utRho20
lptA,6686598,6686760,6686598,162,870,utRho20
lptB,6686792,6687888,6686792,1096,3216,utRho20
lptD,114672,114672,114218,454,1970,utRho20
lptF,8972244,8972436,8972244,192,0,utRho20
lpxC,213016,213114,213016,98,8270,utRho20
lpxD,401920,401942,401920,22,48,utRho20
lpxL,2233418,2233418,2233164,254,14,utRho20
lpxM,3880456,3880456,3880386,70,2,utRho20
lpxP,4991156,4991290,4991156,134,80,utRho20
lrhA,4813312,4813312,4813282,30,98,utRho20
lrp,1864656,1865190,1864656,534,1810,utRho20
lspA,50028,50414,50028,386,2624,utRho20
lsrA,3202920,3202980,3202920,60,0,utRho20
lsrR,3202514,3202514,3202482,32,0,utRho20
ltaE,1818640,1818640,1818588,52,170,utRho20
luxS,5630130,5630130,5629466,664,1518,utRho20
lysA,5957902,5957902,5957798,104,0,utRho20
lysC,8467232,8467232,8466466,766,5226,utRho20
lysP,4497120,4497120,4497064,56,98,utRho20
lysR,5957900,5958042,5957900,142,0,utRho20
lysT,1561028,1561108,1561028,80,44,utRho20
lysU,8709610,8709610,8709434,176,18,utRho20
macB,1840188,1840694,1840188,506,1768,utRho20
maeA,3111484,3111484,3111338,146,7150,utRho20
mak,820236,820288,820236,52,240,utRho20
malE,8492928,8492928,8492838,90,0,utRho20
malI,3398456,3398456,3398360,96,0,utRho20
malK,8493472,8493568,8493472,96,0,utRho20
malP,7105020,7105020,7104946,74,3368,utRho20
malQ,7100798,7100798,7100140,658,346,utRho20
malS,14949880,14949988,14949880,108,0,utRho20
malT,7106048,7106170,7106048,122,218,utRho20
malX,3398626,3398710,3398626,84,0,utRho20
malZ,1689980,1690072,1689980,92,132,utRho20
manA,3377102,3377152,3377102,50,0,utRho20
manX,3803866,3804096,3803866,230,0,utRho20
marC,3237882,3237882,3237816,66,62,utRho20
marR,3238186,3238240,3238186,54,0,utRho20
matP,2036918,2036970,2036918,52,0,utRho20
mazE,5822736,5822736,5822678,58,86,utRho20
mazG,5821720,5821720,5821370,350,7092,utRho20
mcbA,1684306,1684306,1684112,194,18,utRho20
mcbR,3040192,3040524,3040192,332,16,utRho20
mcrA,2420278,2420692,2420278,414,32,utRho20
mcrC,9156124,9156124,9155916,208,456,utRho20
mdaB,6344814,6345060,6344814,246,0,utRho20
mdfA,1767138,1767346,1767138,208,0,utRho20
mdh,6768940,6768940,6768536,404,526,utRho20
mdoB,9198988,9198988,9198882,106,1406,utRho20
mdoD,2993290,2993712,2993290,422,0,utRho20
mdoG,2218514,2218670,2218514,156,218,utRho20
mdtA,4307958,4308032,4307958,74,0,utRho20
mdtE,7318168,7318464,7318168,296,5070,utRho20
mdtK,3486538,3486914,3486538,376,62,utRho20
mdtP,8602472,8602472,8602060,412,56,utRho20
melA,8683774,8683822,8683774,48,0,utRho20
melR,8683300,8683300,8683256,44,114,utRho20
menA,8240812,8240812,8240698,114,24,utRho20
menB,4753774,4753774,4753638,136,798,utRho20
mepH,3468714,3468870,3468714,156,0,utRho20
mepM,3883666,3883666,3883270,396,304,utRho20
mepS,4539840,4539958,4539840,118,36,utRho20
metA,8428318,8428560,8428318,242,0,utRho20
metB,8257272,8257344,8257272,72,1576,utRho20
metC,6304150,6304472,6304150,322,250,utRho20
metE,8025768,8026106,8025768,338,204,utRho20
metF,8265092,8265232,8265092,140,0,utRho20
metG,4388538,4388600,4388538,62,150,utRho20
metH,8447010,8447656,8447010,646,2028,utRho20
metJ,8257116,8257116,8256790,326,242,utRho20
metK,6173154,6173412,6173154,258,0,utRho20
metN,445428,445428,445290,138,60,utRho20
metR,8025710,8025710,8025632,78,104,utRho20
metT,1394326,1394326,1394266,60,202,utRho20
metY,19910250,19910250,19909734,516,366,utRho20
metZ,11789528,11789548,11789528,20,172,utRho20
mfd,2348056,2348056,2347928,128,132,utRho20
mglA,4478782,4478782,4478578,204,682,utRho20
mglB,4481132,4481132,4480696,436,41936,utRho20
mglC,4475918,4475918,4475506,412,1902,utRho20
mgrB,3817584,3817584,3817532,52,0,utRho20
mgrR,3245828,3245828,3245828,0,0,utRho20
mgsA,2054082,2054082,2054030,52,10,utRho20
mgtL,8934560,8934862,8934560,302,80,utRho20
mhpA,737038,737222,737038,184,0,utRho20
mhpR,737072,737072,736840,232,356,utRho20
mhpT,750772,750918,750772,146,0,utRho20
miaA,8797964,8798504,8797964,540,620,utRho20
micA,5629604,5629604,5629604,0,0,utRho20
micC,2874242,2874238,2874242,4,0,utRho20
micF,4626168,4626168,4626168,0,0,utRho20
micM,1014408,1014408,1014408,0,0,utRho20
minE,2449422,2449422,2449090,332,3556,utRho20
mioC,7852950,7852950,7852910,40,0,utRho20
mipA,3733012,3733012,3732944,68,1868,utRho20
mlaA,4930270,4930270,4930014,256,196,utRho20
mlc,3337206,3337206,3337128,78,38,utRho20
mlrA,4429498,4429732,4429498,234,108,utRho20
mltA,5894546,5894546,5894356,190,40,utRho20
mltD,468050,468050,467910,140,40,utRho20
mltF,5391534,5391602,5391534,68,0,utRho20
mmuP,550238,550650,550238,412,192,utRho20
mngA,1531622,1531968,1531622,346,70,utRho20
mngR,1531852,1531852,1531750,102,0,utRho20
mnmG,7851348,7851348,7851266,82,346,utRho20
mntH,5025470,5025470,5025412,58,202,utRho20
mntP,3810918,3811376,3810918,458,406,utRho20
mntR,1706160,1706366,1706160,206,0,utRho20
mntS,1706128,1706128,1705994,134,0,utRho20
moaA,1633654,1634088,1633654,434,1050,utRho20
moaB,1635954,1636110,1635954,156,4594,utRho20
mobA,8084242,8084242,8083998,244,16,utRho20
mocA,6030112,6030320,6030112,208,0,utRho20
modA,1589990,1590178,1589990,188,20,utRho20
moeA,1732788,1732788,1732728,60,368,utRho20
mokB,2984610,2984610,2984258,352,830,utRho20
molR_1,4392888,4392948,4392888,60,0,utRho20
motA,3954604,3954604,3954278,326,100,utRho20
mpaA,2781278,2781278,2781196,82,498,utRho20
mpl,8911456,8911570,8911456,114,0,utRho20
mppA,2786108,2786454,2786108,346,38,utRho20
mprA,5621494,5621540,5621494,46,544,utRho20
mqo,4613848,4613848,4613508,340,122,utRho20
mqsA,6336742,6336742,6336492,250,1584,utRho20
mqsR,6337306,6337306,6337088,218,1332,utRho20
mraZ,179192,179268,179192,76,44,utRho20
mrcA,7045652,7045742,7045652,90,0,utRho20
mrcB,329442,329460,329442,18,0,utRho20
mreB,13605424,13605424,13604348,1076,1100,utRho20
mreD,6798166,6798166,6797750,416,32,utRho20
mrp,4388360,4388360,4388336,24,30,utRho20
mscK,972984,973072,972984,88,20,utRho20
mscL,6876002,6876048,6876002,46,126,utRho20
mscS,6139742,6139742,6139614,128,668,utRho20
msrA,8884522,8884522,8884352,170,816,utRho20
msrB,3725168,3725168,3724858,310,0,utRho20
msyB,2228426,2228426,2228362,64,410,utRho20
mtfA,4087236,4087302,4087236,66,4768,utRho20
mtgA,6699662,6699662,6699618,44,228,utRho20
mtlA,30177504,30178248,30177504,744,4040,utRho20
mtn,358366,358366,358306,60,74,utRho20
mtr,6611864,6611864,6611634,230,0,utRho20
mug,6430992,6430992,6430946,46,4,utRho20
murQ,5091466,5091546,5091466,80,0,utRho20
murR,5091586,5091586,5091218,368,0,utRho20
mutH,5939164,5939324,5939164,160,408,utRho20
mutL,8794092,8794824,8794092,732,736,utRho20
mutM,7622554,7622554,7622304,250,352,utRho20
mutS,5714038,5714186,5714038,148,710,utRho20
mutY,18617466,18618078,18617466,612,546,utRho20
nac,4123956,4123956,4123866,90,0,utRho20
nadA,1564122,1564170,1564122,48,88,utRho20
nadB,5420714,5420840,5420714,126,0,utRho20
nadC,237326,237326,237290,36,102,utRho20
nadE,3644604,3644916,3644604,312,158,utRho20
nadK,5501526,5501662,5501526,136,314,utRho20
nagA,1406350,1406350,1405502,848,18710,utRho20
nagB,1407416,1407416,1407222,194,400,utRho20
nagC,1404016,1404016,1403188,828,458,utRho20
nagE,1407680,1407888,1407680,208,0,utRho20
nagK,2357080,2357186,2357080,106,48,utRho20
nanA,6747240,6747240,6747152,88,0,utRho20
nanC,9079856,9079856,9079002,854,68,utRho20
nanR,6749406,6749406,6748978,428,14,utRho20
nanS,9075406,9075406,9075188,218,0,utRho20
napF,4607390,4607390,4606994,396,0,utRho20
narG,2559614,2559728,2559614,114,224,utRho20
narK,2555642,2555914,2555642,272,22,utRho20
narP,4580844,4581000,4580844,156,256,utRho20
narQ,5171154,5171462,5171154,308,76,utRho20
narU,3088326,3088326,3088120,206,132,utRho20
narW,3077374,3077374,3074618,2756,1608,utRho20
narX,2555554,2555554,2555236,318,22,utRho20
narZ,3085380,3085380,3085180,200,78,utRho20
ndh,2331984,2332170,2331984,186,0,utRho20
ndk,5289920,5289920,5289728,192,600,utRho20
nemR,6904084,6904092,6904084,8,0,utRho20
nepI,7683542,7683542,7683478,64,0,utRho20
nfo,4501612,4501680,4501612,68,0,utRho20
nfsB,1210906,1210906,1210848,58,0,utRho20
nfuA,7090916,7091248,7090916,332,570,utRho20
nhaA,34634,34978,34634,344,108,utRho20
nhaB,2469534,2469534,2469434,100,46,utRho20
nhoA,3067926,3068048,3067926,122,0,utRho20
nikA,7226878,7227334,7226878,456,296,utRho20
nikR,7237074,7237176,7237074,102,234,utRho20
nirB,6987974,6988022,6987974,48,0,utRho20
nlpA,7680034,7680034,7679986,48,0,utRho20
nlpC,3585654,3585654,3585462,192,144,utRho20
nlpD,5737658,5737658,5737506,152,8,utRho20
nlpI,6618080,6618080,6617848,232,0,utRho20
nmpC,1153740,1153740,1153650,90,4,utRho20
nohA,3273206,3273206,3272734,472,0,utRho20
norR,5664614,5664614,5664578,36,0,utRho20
norV,5664878,5664952,5664878,74,0,utRho20
nrdA,4689510,4689730,4689510,220,11288,utRho20
nrdD,8925676,8925676,8925320,356,738,utRho20
nrdH,5601312,5601446,5601312,134,1872,utRho20
nrdR,865954,866004,865954,50,130,utRho20
nrfA,8575342,8575528,8575342,186,0,utRho20
nsrR,8812088,8812380,8812088,292,510,utRho20
nudB,3897348,3897348,3897264,84,10,utRho20
nudC,8393428,8393806,8393428,378,306,utRho20
nudE,7052658,7052658,7052298,360,1156,utRho20
nudG,3682876,3682980,3682876,104,56,utRho20
nudI,4729050,4729108,4729050,58,0,utRho20
nudJ,2388874,2388874,2388576,298,1660,utRho20
nuoA,4810670,4810670,4810144,526,5604,utRho20
nuoN,4783434,4783434,4783010,424,2506,utRho20
nupC,5026018,5026084,5026018,66,0,utRho20
nupG,6211302,6211428,6211302,126,96,utRho20
ogrK,4335096,4335096,4335040,56,0,utRho20
ogt,2800568,2800568,2800472,96,140,utRho20
ohsC,5401036,5401040,5401036,4,0,utRho20
ompA,2040382,2040382,2040106,276,60398,utRho20
ompC,4625774,4625774,4625498,276,334,utRho20
ompF,1974184,1974184,1973964,220,212,utRho20
ompL,8128958,8128958,8128590,368,0,utRho20
ompN,2874158,2874158,2873786,372,0,utRho20
ompR,7073510,7073510,7073168,342,16,utRho20
ompT,1171330,1171330,1171266,64,2,utRho20
ompW,2627982,2628040,2627982,58,0,utRho20
ompX,1700418,1700900,1700418,482,482,utRho20
omrA,5952378,5952378,5952378,0,0,utRho20
omrB,5952770,5952770,5952770,0,0,utRho20
oppA,2602170,2602364,2602170,194,5768,utRho20
orn,8783168,8783208,8783168,40,166,utRho20
osmB,2686952,2686952,2686656,296,24,utRho20
osmC,3113192,3113250,3113192,58,3810,utRho20
osmE,3644566,3644566,3644512,54,0,utRho20
osmF,4439046,4439046,4438962,84,230,utRho20
osmY,9222306,9222792,9222306,486,3450,utRho20
otsA,3963302,3963302,3963224,78,140,utRho20
otsB,3964930,3964930,3964774,156,314,utRho20
oxc,4984288,4984288,4983900,388,0,utRho20
oxyR,8316914,8316980,8316914,66,136,utRho20
oxyS,8316788,8316788,8316788,0,0,utRho20
paaA,2907730,2907854,2907730,124,0,utRho20
paaX,2927018,2927078,2927018,60,0,utRho20
paaZ,2907340,2907340,2907284,56,0,utRho20
pabA,6981702,6981702,6981658,44,0,utRho20
pabB,3789256,3789610,3789256,354,598,utRho20
pabC,2306186,2306600,2306186,414,524,utRho20
pagP,1313052,1313114,1313052,62,0,utRho20
panB,299260,299260,299202,58,344,utRho20
panC,297840,297840,297590,250,676,utRho20
panD,293490,293490,293388,102,38,utRho20
panZ,7195656,7195968,7195656,312,0,utRho20
parC,6332060,6332060,6331946,114,306,utRho20
patA,6438916,6438988,6438916,72,116,utRho20
patD,3030830,3031156,3030830,326,46,utRho20
pbpC,5294986,5294986,5294650,336,152,utRho20
pbpG,4450132,4450132,4449740,392,206,utRho20
pck,7065358,7065636,7065358,278,2364,utRho20
pcnB,318782,318782,318252,530,886,utRho20
pdhR,244068,244184,244068,116,154,utRho20
pdxB,4875768,4875768,4875702,66,0,utRho20
pdxH,3436068,3436068,3436014,54,642,utRho20
pdxJ,5403626,5403626,5403458,168,102,utRho20
pdxK,5074638,5074638,5074474,164,0,utRho20
pepA,8972278,8972278,8971902,376,464,utRho20
pepD,511618,511618,511432,186,16158,utRho20
pepN,1981182,1981244,1981182,62,0,utRho20
pepQ,8062294,8062322,8062294,28,0,utRho20
pepT,2371646,2371688,2371646,42,24,utRho20
pfkA,8214948,8215104,8214948,156,118,utRho20
pfkB,3612646,3612740,3612646,94,34,utRho20
pflA,1902456,1902456,1902160,296,0,utRho20
pflB,1907850,1907850,1907108,742,2256,utRho20
pflD,8287716,8287990,8287716,274,0,utRho20
pgaA,2185046,2185046,2184578,468,0,utRho20
pgi,8467444,8467516,8467444,72,146,utRho20
pgk,12291428,12291428,12290488,940,6844,utRho20
pgl,1597078,1597172,1597078,94,0,utRho20
pgpB,2678324,2678660,2678324,336,2,utRho20
pgpC,5397276,5397276,5397100,176,0,utRho20
pgrR,2783744,2783982,2783744,238,96,utRho20
pheL,5475158,5475198,5475158,40,20,utRho20
pheM,7197204,7197204,7197080,124,0,utRho20
pheP,1203858,1203918,1203858,60,0,utRho20
pheU,8725254,8725254,8725252,2,102,utRho20
pheV,6220730,6220732,6220730,2,50,utRho20
phnC,8650412,8650412,8650330,82,0,utRho20
phoA,803414,803494,803414,80,136,utRho20
phoB,834202,834284,834202,82,24,utRho20
phoE,520316,520316,520200,116,60,utRho20
phoH,2169730,2169984,2169730,254,526,utRho20
phoP,2381016,2381016,2380894,122,4240,utRho20
phoQ,2379880,2379880,2379552,328,2202,utRho20
phoU,7815330,7815330,7815156,174,92,utRho20
phr,1478842,1479014,1478842,172,198,utRho20
pinE,2419054,2419370,2419054,316,0,utRho20
pinQ,3267168,3267244,3267168,76,6,utRho20
pinR,2867424,2867424,2867348,76,2,utRho20
pitA,7275224,7275284,7275224,60,26,utRho20
pitB,6272806,6272806,6272742,64,76,utRho20
pka,5439862,5439906,5439862,44,2,utRho20
plaP,4174476,4174476,4174124,352,116,utRho20
pldA,8009628,8009724,8009628,96,162,utRho20
pldB,8018028,8018340,8018028,312,160,utRho20
plsB,8513196,8513196,8512932,264,700,utRho20
pmbA,8915890,8915918,8915890,28,0,utRho20
pmrD,4747148,4747148,4747076,72,0,utRho20
pncB,1980828,1980828,1980712,116,36,utRho20
pncC,5648788,5648788,5648692,96,144,utRho20
pnp,6622652,6622652,6622336,316,16,utRho20
pntA,3355950,3355950,3355806,144,42,utRho20
pntB,3353096,3353096,3352720,376,32,utRho20
polA,8093880,8093932,8093880,52,0,utRho20
polB,131606,131606,131560,46,0,utRho20
potD,2365700,2365700,2365658,42,0,utRho20
potE,1436688,1436688,1436530,158,0,utRho20
potF,1787268,1787568,1787268,300,0,utRho20
poxB,1822152,1822152,1822098,54,0,utRho20
ppa,8899372,8899372,8899304,68,150,utRho20
ppc,8306380,8306380,8306196,184,920,utRho20
ppdA,5928440,5928440,5928354,86,4,utRho20
ppdD,235410,235410,235098,312,0,utRho20
pphA,3846770,3846770,3845938,832,3978,utRho20
pphB,5719474,5719520,5719474,46,0,utRho20
ppiA,6984898,6984898,6984594,304,0,utRho20
ppiC,7919682,7919682,7919626,56,48,utRho20
ppiD,923638,923830,923638,192,224,utRho20
ppk,5245748,5246088,5245748,340,136,utRho20
pppA,6228958,6228958,6228704,254,572,utRho20
ppsA,3574322,3574322,3574224,98,56,utRho20
ppsR,3574678,3574890,3574678,212,0,utRho20
pptA,3065716,3066104,3065716,388,204,utRho20
pqiA,2023318,2024002,2023318,684,210,utRho20
prc,3830054,3830054,3829632,422,20406,utRho20
preT,4467978,4468066,4467978,88,34,utRho20
prfC,9218688,9218828,9218688,140,682,utRho20
prkB,6968622,6968980,6968622,358,1960,utRho20
prlC,7290476,7290476,7290364,112,168,utRho20
prlF,6553944,6554004,6553944,60,138,utRho20
proB,520432,520776,520432,344,260,utRho20
proC,811372,811372,811288,84,0,utRho20
proK,7417388,7417388,7417384,4,0,utRho20
proL,4572414,4572422,4572414,8,0,utRho20
proP,8660640,8661004,8660640,364,1588,utRho20
proS,437674,437674,437550,124,1060,utRho20
proV,5609126,5609630,5609126,504,86,utRho20
prpB,697292,697364,697292,72,0,utRho20
prpR,696942,696942,696886,56,0,utRho20
prs,2524354,2524354,2523750,604,69878,utRho20
psd,8781276,8781276,8780720,556,3096,utRho20
psiE,8480600,8480650,8480600,50,0,utRho20
pspA,2736076,2736158,2736076,82,2,utRho20
pspF,2736080,2736080,2735824,256,2,utRho20
pspG,8525632,8525680,8525632,48,0,utRho20
pssA,5445156,5445454,5445156,298,14274,utRho20
pstB,7817112,7817112,7816732,380,12,utRho20
pstC,7821084,7821084,7820796,288,114,utRho20
pstS,23469408,23469408,23469150,258,90,utRho20
psuG,4517114,4517114,4516734,380,2664,utRho20
psuT,4514992,4514992,4514670,322,0,utRho20
pth,2517084,2517084,2517026,58,0,utRho20
ptrA,5918022,5918022,5917768,254,0,utRho20
ptrB,3857730,3857730,3857678,52,216,utRho20
ptsG,2315252,2315738,2315252,486,1514,utRho20
ptsH,5066996,5067528,5066996,532,10438,utRho20
purA,8809328,8809374,8809328,46,2,utRho20
purC,5195562,5195562,5195236,326,302,utRho20
purD,8411972,8411972,8411862,110,146,utRho20
purE,1106284,1106284,1106200,84,42,utRho20
purH,8415254,8415254,8415064,190,2,utRho20
purL,5391178,5391178,5391086,92,442,utRho20
purM,5242306,5242394,5242306,88,30,utRho20
purR,3475378,3475688,3475378,310,960,utRho20
purT,3861438,3861762,3861438,324,0,utRho20
purU,2577512,2577512,2577248,264,1128,utRho20
putA,2157850,2157850,2157764,86,116,utRho20
putP,2158336,2158610,2158336,274,1348,utRho20
puuA,2721936,2721936,2721816,120,0,utRho20
puuC,2725456,2725486,2725456,30,0,utRho20
puuD,2722104,2722240,2722104,136,0,utRho20
puuP,2718746,2718746,2718374,372,604,utRho20
pykA,3874988,3875298,3874988,310,732,utRho20
pykF,3510934,3511396,3510934,462,1762,utRho20
pyrC,2245286,2245286,2245214,72,148,utRho20
pyrD,2009464,2009536,2009464,72,0,utRho20
pyrE,7631970,7631970,7631536,434,4,utRho20
pyrF,2683740,2683842,2683740,102,166,utRho20
pyrG,5819594,5819594,5819332,262,1250,utRho20
pyrH,383624,383710,383624,86,1362,utRho20
pyrL,8945490,8945490,8945066,424,244,utRho20
qmcA,1031646,1031646,1031546,100,0,utRho20
qor,8528608,8528608,8528462,146,258,utRho20
qseB,6339502,6339656,6339502,154,0,utRho20
queA,849970,850022,849970,52,88,utRho20
queE,5811212,5811212,5810836,376,0,utRho20
queF,5850642,5850696,5850642,54,0,utRho20
queG,8788184,8788184,8788134,50,7346,utRho20
racC,2835630,2835630,2835526,104,0,utRho20
racR,2840898,2840898,2840482,416,0,utRho20
raiA,5474208,5474308,5474208,100,752,utRho20
rarD,8008594,8008594,8008356,238,224,utRho20
ravA,7862256,7862256,7862186,70,12,utRho20
rayT,495088,495274,495088,186,0,utRho20
rbn,4763162,4763216,4763162,54,0,utRho20
rbsD,7866644,7866702,7866644,58,138,utRho20
rcnA,4371654,4371834,4371654,180,0,utRho20
rcnB,4373768,4373920,4373768,152,410,utRho20
rcnR,4371806,4371806,4371592,214,0,utRho20
rcsA,4047672,4047936,4047672,264,6,utRho20
rcsB,4631390,4632354,4631390,964,932,utRho20
rcsC,4640162,4640162,4639656,506,126,utRho20
rcsD,4626904,4626976,4626904,72,108,utRho20
rdgB,6193240,6193362,6193240,122,1216,utRho20
rdlA,2538646,2538646,2538646,0,0,utRho20
rdlB,2539712,2539716,2539712,4,0,utRho20
rdlC,2540782,2540786,2540782,4,0,utRho20
rdlD,7400272,7400272,7400272,0,0,utRho20
rdoA,8084782,8084830,8084782,48,226,utRho20
recA,11295276,11295276,11295076,200,1232,utRho20
recC,5925014,5925014,5924856,158,94,utRho20
recF,7763722,7763722,7762442,1280,8258,utRho20
recN,5503518,5503590,5503518,72,0,utRho20
recQ,8011666,8011728,8011666,62,0,utRho20
relA,5828554,5828554,5827302,1252,660,utRho20
relB,3291806,3291806,3291744,62,0,utRho20
rem,3289950,3289950,3289804,146,0,utRho20
rep,7921294,7921354,7921294,60,84,utRho20
rfaD,7587730,7587974,7587730,244,210,utRho20
rfaE,6393852,6393852,6393506,346,116,utRho20
rfaH,8049930,8049930,8049642,288,1470,utRho20
rfbX,4219436,4219436,4219168,268,1558,utRho20
rfe,7935600,7935832,7935600,232,0,utRho20
rhaB,8194944,8194944,8194896,48,0,utRho20
rhaD,8188770,8188770,8188544,226,0,utRho20
rhaS,8195422,8195472,8195422,50,0,utRho20
rhaT,8201132,8201132,8201050,82,2,utRho20
rhlE,1661566,1661744,1661566,178,0,utRho20
rhoL,47593944,47594772,47593944,828,38892,utRho20
rhsB,7238006,7238384,7238006,378,0,utRho20
rhsC,1458758,1459166,1458758,408,0,utRho20
rhsD,1046132,1046522,1046132,390,0,utRho20
rhtA,1700608,1700608,1700194,414,0,utRho20
rhtC,8015478,8015514,8015478,36,374,utRho20
ribA,2678468,2678468,2678320,148,2,utRho20
ribC,3486916,3486916,3486484,432,62,utRho20
ribE,869008,869294,869008,286,7410,utRho20
ribF,42766,42814,42766,48,10,utRho20
ridA,8941892,8941892,8941826,66,150,utRho20
rihA,1369204,1369204,1368824,380,482,utRho20
rihB,4510504,4510504,4510372,132,0,utRho20
rimJ,2251044,2251124,2251044,80,152,utRho20
rimK,1783752,1783934,1783752,182,512,utRho20
rimL,2997486,2997876,2997486,390,302,utRho20
rimO,1756140,1756140,1756070,70,4,utRho20
rimP,6636350,6636350,6636012,338,926,utRho20
rlmA,3814172,3814172,3814120,52,130,utRho20
rlmD,5830086,5830086,5830000,86,132,utRho20
rlmE,6655520,6655520,6655328,192,1092,utRho20
rlmF,1684384,1684664,1684384,280,0,utRho20
rlmG,6471784,6471784,6471750,34,16,utRho20
rlmI,2060002,2060002,2059938,64,88,utRho20
rlmJ,7290700,7290770,7290700,70,12,utRho20
rlmL,2015344,2015688,2015344,344,1482,utRho20
rlpA,1330444,1330444,1330380,64,332,utRho20
rluA,120900,120900,120692,208,76,utRho20
rluF,8460324,8460708,8460324,384,2,utRho20
rmf,2031006,2031430,2031006,424,454,utRho20
rna,1290068,1290068,1290006,62,0,utRho20
rnb,2698258,2698258,2697824,434,2172,utRho20
rnc,10816892,10816892,10816252,640,6076,utRho20
rnd,3776122,3776122,3775982,140,2,utRho20
rne,2289746,2289746,2288734,1012,12108,utRho20
rnhA,472082,472082,472004,78,1228,utRho20
rnk,1288360,1288360,1287934,426,204,utRho20
rnlA,5531788,5531836,5531788,48,86,utRho20
rnlB,5533414,5533968,5533414,554,1438,utRho20
rnpB,19623552,19623552,19623552,0,0,utRho20
rob,9270706,9270706,9270620,86,32,utRho20
rodZ,5285868,5285868,5285688,180,130,utRho20
rpe,7030306,7030306,7030118,188,414,utRho20
rph,15266320,15266320,15266196,124,0,utRho20
rpiA,6118706,6118706,6118650,56,0,utRho20
rpiB,8626514,8626700,8626514,186,0,utRho20
rpiR,8626274,8626274,8625982,292,0,utRho20
rplJ,8359246,8359992,8359246,746,5758,utRho20
rplK,8356708,8356894,8356708,186,208,utRho20
rplM,6757344,6757344,6757302,42,2344,utRho20
rplN,6896444,6896444,6896298,146,2526,utRho20
rplS,5489284,5489284,5489060,224,6646,utRho20
rplT,7199052,7199052,7198996,56,904,utRho20
rplU,6667036,6667036,6666902,134,48,utRho20
rplY,4564866,4565034,4564866,168,0,utRho20
rpmA,6666450,6666450,6666238,212,636,utRho20
rpmB,15247980,15247980,15246696,1284,58212,utRho20
rpmE,8253816,8254026,8253816,210,150,utRho20
rpmF,2294676,2294734,2294676,58,25088,utRho20
rpmH,7768130,7768672,7768130,542,2666,utRho20
rpmI,3600854,3600854,3599998,856,11474,utRho20
rpoB,8362126,8362490,8362126,364,560,utRho20
rpoD,6424946,6426094,6424946,1148,48324,utRho20
rpoE,5420372,5420372,5420024,348,0,utRho20
rpoH,7202006,7202006,7201566,440,6168,utRho20
rpoN,6689324,6689434,6689324,110,136,utRho20
rpoS,5736236,5736236,5735102,1134,21888,utRho20
rpoZ,7644154,7644212,7644154,58,600,utRho20
rppH,5937986,5937986,5937954,32,44,utRho20
rprA,3540744,3540744,3540744,0,0,utRho20
rpsA,1923434,1923990,1923434,556,105854,utRho20
rpsF,8850050,8850236,8850050,186,10002,utRho20
rpsI,6756580,6756580,6756414,166,3750,utRho20
rpsJ,6906884,6906884,6906540,344,4966,utRho20
rpsL,6949242,6949242,6949104,138,238,utRho20
rpsM,6885130,6885130,6884942,188,918,utRho20
rpsO,13247144,13247144,13246736,408,448,utRho20
rpsP,5492508,5492508,5492370,138,0,utRho20
rpsT,42420,42420,42156,264,200,utRho20
rpsU,12842584,12843124,12842584,540,736,utRho20
rraA,8238716,8238716,8238660,56,72,utRho20
rraB,8956768,8956946,8956768,178,0,utRho20
rrsA,8070478,8071062,8070478,584,9830,utRho20
rrsB,16665468,16666636,16665468,1168,19508,utRho20
rrsC,7883032,7883616,7883032,584,4884,utRho20
rrsD,6858094,6858094,6857524,570,762,utRho20
rrsE,8415726,8416294,8415726,568,1008,utRho20
rrsG,5462896,5462896,5462314,582,9296,utRho20
rrsH,446970,447542,446970,572,2016,utRho20
rsd,8393908,8393908,8393616,292,340,utRho20
rseA,5419264,5419264,5418808,456,1266,utRho20
rseP,392940,393092,392940,152,92,utRho20
rseX,4067298,4067298,4067298,0,0,utRho20
rsfS,1338144,1338144,1338072,72,262,utRho20
rsgA,8783132,8783132,8783018,114,60,utRho20
rsmA,105176,105176,104860,316,4054,utRho20
rsmB,6869982,6870414,6869982,432,396,utRho20
rsmC,9215736,9215736,9215400,336,472,utRho20
rsmD,7208594,7208786,7208594,192,0,utRho20
rsmE,6182036,6182268,6182036,232,268,utRho20
rsmG,7847512,7847512,7847360,152,10,utRho20
rsmH,180020,180188,180020,168,402,utRho20
rsmI,6587106,6587106,6586670,436,2514,utRho20
rssA,2578212,2578412,2578212,200,164,utRho20
rssB,2580440,2580484,2580440,44,328,utRho20
rstA,3364276,3364300,3364276,24,0,utRho20
rsuA,4561096,4561096,4560966,130,284,utRho20
rsxA,3411510,3411534,3411510,24,70,utRho20
rtcA,7114004,7114004,7113698,306,92,utRho20
rtcB,7116214,7116214,7116158,56,0,utRho20
rtn,4541356,4541452,4541356,96,236,utRho20
rutA,2148052,2148052,2148022,30,0,utRho20
rutG,2140090,2140090,2139678,412,0,utRho20
rutR,2148226,2148484,2148226,258,2,utRho20
ruvA,7784096,7784096,7783904,192,0,utRho20
ruvB,7782176,7782176,7781424,752,1508,utRho20
ruvC,3894878,3894878,3894752,126,20,utRho20
rybB,1776114,1776114,1776114,0,0,utRho20
rydB,3529860,3529860,3529322,538,268,utRho20
rydC,2983012,2983012,2983012,0,0,utRho20
ryfA,5307398,5307710,5307398,312,2,utRho20
ryfD,5468590,5468590,5468590,0,0,utRho20
ryhB,7162032,7162032,7162032,0,0,utRho20
ryjA,8556132,8556132,8556132,0,0,utRho20
ryjB,9055954,9055954,9055954,0,0,utRho20
sad,3229598,3229598,3229406,192,0,utRho20
safA,3168056,3168056,3167918,138,0,utRho20
sanA,4465368,4465756,4465368,388,184,utRho20
sapF,2705314,2705314,2705268,46,0,utRho20
sbcB,4165456,4165512,4165456,56,0,utRho20
sbcC,831694,831694,831506,188,148,utRho20
sbcD,833954,833954,833904,50,0,utRho20
sbmA,793106,793278,793106,172,0,utRho20
sbmC,4162650,4162650,4162524,126,0,utRho20
sdaA,3793618,3793864,3793618,246,936,utRho20
sdaC,5856070,5856458,5856070,388,1110,utRho20
sdhC,1509916,1510354,1509916,438,38316,utRho20
sdhD,1510808,1511120,1510808,312,7994,utRho20
sdiA,3993834,3993834,3993664,170,58,utRho20
secE,8354354,8354716,8354354,362,22,utRho20
secG,6645180,6645180,6645010,170,1604,utRho20
selA,7522594,7522594,7522498,96,282,utRho20
selB,7519850,7519850,7519722,128,214,utRho20
selC,7672396,7672444,7672396,48,0,utRho20
selD,3696058,3696058,3696016,42,7076,utRho20
seqA,1425884,1425974,1425884,90,868,utRho20
serA,6117098,6117098,6116820,278,0,utRho20
serB,9249712,9249790,9249712,78,0,utRho20
serC,3830380,3830612,3830380,232,0,utRho20
serS,1878730,1878856,1878730,126,520,utRho20
serT,2063438,2063438,2063424,14,0,utRho20
serU,4087124,4087124,4087114,10,214,utRho20
serV,5637394,5637394,5637290,104,90,utRho20
serW,1852014,1852014,1851942,72,656,utRho20
serX,2195352,2195352,2195304,48,32,utRho20
setB,4527426,4527726,4527426,300,0,utRho20
setC,7673488,7673906,7673488,418,0,utRho20
sfmA,1116124,1116424,1116124,300,0,utRho20
sfmC,1117606,1117948,1117606,342,0,utRho20
sfsA,323030,323030,322972,58,394,utRho20
sfsB,6669592,6669818,6669592,226,2,utRho20
sgrR,154676,154676,154598,78,40,utRho20
sgrS,154734,154734,154734,0,0,utRho20
shiA,4107068,4107286,4107068,218,0,utRho20
sibA,4306622,4306622,4306622,0,0,utRho20
sibB,4307292,4307292,4307292,0,0,utRho20
sibC,6113702,6113702,6113702,0,0,utRho20
sibD,6389730,6389730,6389730,0,0,utRho20
sibE,6390480,6390480,6390480,0,0,utRho20
sixA,4913998,4913998,4913624,374,70,utRho20
slp,7307872,7307922,7307872,50,0,utRho20
slt,9261400,9261466,9261400,66,0,utRho20
slyA,3442028,3442028,3441648,380,6,utRho20
slyB,3439496,3439752,3439496,256,114,utRho20
slyD,6957398,6957398,6956994,404,1550,utRho20
slyX,6954862,6955280,6954862,418,5528,utRho20
smf,6867372,6867372,6867120,252,0,utRho20
smpB,5509534,5509792,5509534,258,462,utRho20
smrA,2811872,2811958,2811872,86,412,utRho20
smrB,4896872,4897212,4896872,340,148,utRho20
smtA,1946808,1947074,1946808,266,0,utRho20
sodA,8201518,8201620,8201518,102,17096,utRho20
sodB,3470646,3470756,3470646,110,0,utRho20
sodC,3449358,3449358,3449310,48,116,utRho20
sohB,2658568,2658664,2658568,96,2,utRho20
sokB,2984232,2984238,2984232,6,132,utRho20
solA,2241218,2241218,2241172,46,0,utRho20
soxR,8554894,8554938,8554894,44,0,utRho20
soxS,8554846,8554846,8554766,80,0,utRho20
speA,6172096,6172096,6171822,274,74,utRho20
speB,6167892,6167892,6167594,298,0,utRho20
speC,6218350,6218350,6218310,40,68,utRho20
spf,8099798,8099798,8099798,0,0,utRho20
sppA,3697422,3697674,3697422,252,64,utRho20
spy,3651376,3651376,3651250,126,6,utRho20
sra,3112092,3112092,3111926,166,260,utRho20
sraB,2293178,2293178,2293178,0,0,utRho20
sraC,3846132,3846132,3846132,0,0,utRho20
srlA,5651582,5651664,5651582,82,36,utRho20
srlR,5657720,5658094,5657720,374,24582,utRho20
srmB,5425752,5425792,5425752,40,350,utRho20
sroA,151216,151216,151216,0,0,utRho20
sroG,6369436,6369436,6369436,0,0,utRho20
sroH,8380974,8380974,8380974,0,0,utRho20
ssb,8548022,8548250,8548022,228,120,utRho20
sseA,5304782,5304988,5304782,206,15500,utRho20
sspA,6755138,6755138,6754840,298,1866,utRho20
ssrA,5511014,5511186,5511014,172,2,utRho20
ssrS,12223036,12223932,12223036,896,2764,utRho20
sstT,6479726,6479888,6479726,162,0,utRho20
ssuB,1988282,1988282,1988088,194,0,utRho20
ssuE,1995126,1995126,1995024,102,0,utRho20
sthA,8321604,8321604,8321580,24,2594,utRho20
stpA,5597156,5597156,5596990,166,0,utRho20
sucA,3034344,3034824,3034344,480,6212,utRho20
sufA,3528836,3528836,3528772,64,1018,utRho20
sufE,3518962,3518962,3518580,382,2456,utRho20
sugE,8753588,8753750,8753588,162,718,utRho20
sulA,2041894,2041894,2041838,56,228,utRho20
syd,5850738,5850738,5850560,178,36,utRho20
symE,9159834,9159834,9159680,154,26,utRho20
symR,9159670,9159670,9159670,0,0,utRho20
tabA,8949566,8949724,8949566,158,0,utRho20
talA,5157140,5157332,5157140,192,190,utRho20
talB,16382,16476,16382,94,20434,utRho20
tam,3214442,3214692,3214442,250,318,utRho20
tamA,8884540,8884764,8884540,224,118,utRho20
tar,3945432,3945432,3945382,50,0,utRho20
tas,5943138,5943194,5943138,56,198,utRho20
tatA,16087636,16087780,16087636,144,0,utRho20
tatE,1317742,1317894,1317742,152,76,utRho20
tauA,770410,770464,770410,54,0,utRho20
tdcA,6534186,6534186,6534130,56,0,utRho20
tdcG,6519652,6519652,6519298,354,64,utRho20
tdcR,6534380,6534760,6534380,380,20,utRho20
tdk,2586986,2587054,2586986,68,48,utRho20
tehA,3001072,3001146,3001072,74,0,utRho20
tesA,1039898,1039898,1039530,368,162,utRho20
tesB,950402,950402,950322,80,0,utRho20
tfaE,2418532,2418532,2418238,294,28,utRho20
tfaQ,3269912,3269912,3269770,142,64,utRho20
tff,379424,379256,379424,168,72,utRho20
tgt,852110,852274,852110,164,0,utRho20
thiD,4369346,4369346,4369032,314,0,utRho20
thiI,882936,883098,882936,162,68,utRho20
thiM,4370902,4370902,4370602,300,196,utRho20
thiQ,146170,146170,145854,316,274,utRho20
thrL,592,760,592,168,568,utRho20
thrS,7210932,7210932,7210280,652,1508,utRho20
thrU,8350762,8350776,8350762,14,64,utRho20
thrV,6847414,6847414,6847310,104,338674,utRho20
thrW,525682,525742,525682,60,348,utRho20
thyA,5930696,5930696,5930310,386,1080,utRho20
tig,909986,910266,909986,280,820,utRho20
tisB,7706674,7707106,7706674,432,800,utRho20
tktA,6163414,6163414,6163270,144,132,utRho20
tktB,5158616,5159272,5158616,656,43572,utRho20
tldD,6784368,6784368,6784056,312,22,utRho20
tmcA,5191876,5191876,5191718,158,0,utRho20
tnaC,15553644,15553740,15553644,96,47084,utRho20
tolB,1555074,1555480,1555074,406,488,utRho20
tolC,6356008,6356230,6356008,222,882,utRho20
tomB,961588,961588,961416,172,814,utRho20
tonB,2622108,2622178,2622108,70,2,utRho20
topA,2661578,2662096,2661578,518,776,utRho20
torC,2116112,2116168,2116112,56,190,utRho20
torR,2115968,2115968,2115908,60,132,utRho20
torS,2112364,2112364,2112356,8,0,utRho20
torT,2112414,2112522,2112414,108,0,utRho20
tpiA,8223138,8223138,8223014,124,894,utRho20
tppB,3425342,3425538,3425342,196,1368,utRho20
tpr,2574376,2574376,2574376,0,0,utRho20
tpx,2777688,2777688,2777622,66,394,utRho20
tqsA,3347780,3347826,3347780,46,66,utRho20
treA,2494850,2494850,2494752,98,166,utRho20
treB,8932420,8932420,8932360,60,10,utRho20
treF,7339102,7339184,7339102,82,106,utRho20
treR,8934694,8934694,8934492,202,2,utRho20
trg,2984878,2984940,2984878,62,0,utRho20
trkG,2847342,2847564,2847342,222,6,utRho20
trmA,8326590,8326590,8326540,50,0,utRho20
trpA,2634678,2634678,2634444,234,876,utRho20
trpC,2639888,2639888,2639570,318,190,utRho20
trpL,5292432,5292432,5292328,104,0,utRho20
trpR,9265408,9265520,9265408,112,446,utRho20
trpS,7027394,7027394,7027276,118,3536,utRho20
trpT,7893560,7893914,7893560,354,187018,utRho20
trxA,7931294,7931522,7931294,228,890,utRho20
trxB,1864156,1864156,1864100,56,108,utRho20
trxC,5437350,5437470,5437350,120,382,utRho20
tsaD,6421256,6421256,6421086,170,8,utRho20
tsgA,6985038,6985136,6985038,98,50,utRho20
tsr,9182824,9183314,9182824,490,0,utRho20
tsx,864490,864490,864026,464,490,utRho20
ttcA,2823970,2823970,2823896,74,1960,utRho20
ttdA,6412848,6412926,6412848,78,0,utRho20
ttdR,6412760,6412760,6412512,248,0,utRho20
tufA,6943448,6943448,6942658,790,137256,utRho20
tus,3368346,3368518,3368346,172,268,utRho20
tusA,7218040,7218040,7217992,48,514,utRho20
tusB,6950218,6950218,6949930,288,1312,utRho20
tynA,2902996,2902996,2902698,298,0,utRho20
typA,8116460,8116814,8116460,354,3180,utRho20
tyrB,8534164,8534228,8534164,64,2566,utRho20
tyrP,3979004,3979362,3979004,358,4,utRho20
tyrR,2773384,2773440,2773384,56,132,utRho20
tyrS,3434566,3434566,3434444,122,0,utRho20
tyrT,2575330,2575330,2575244,86,30,utRho20
uacT,6062378,6062734,6062378,356,8,utRho20
ubiC,8504886,8505012,8504886,126,88,utRho20
ubiD,8049618,8049976,8049618,358,1690,utRho20
ubiE,8037494,8037710,8037494,216,0,utRho20
ubiG,4679078,4679134,4679078,56,0,utRho20
ucpA,5089342,5089342,5089246,96,0,utRho20
udp,8032782,8032862,8032782,80,458,utRho20
ugd,4199470,4199470,4199226,244,0,utRho20
ugpB,7184852,7184852,7184650,202,1574,utRho20
ugpQ,7176600,7176600,7176226,374,152,utRho20
uhpT,7694396,7694396,7694334,62,0,utRho20
uidA,3392304,3392304,3392142,162,0,utRho20
uidC,3386012,3386012,3385702,310,0,utRho20
uidR,3394150,3394150,3394104,46,178,utRho20
ulaA,8839854,8839960,8839854,106,0,utRho20
ulaG,8839350,8839350,8839250,100,0,utRho20
ulaR,8837124,8837124,8836906,218,0,utRho20
umpG,5741372,5741372,5740548,824,234,utRho20
umpH,1400704,1400704,1400652,52,34,utRho20
umuD,2461476,2461534,2461476,58,0,utRho20
ung,5433476,5433508,5433476,32,0,utRho20
uof,2843316,2843316,2842900,416,6984,utRho20
upp,5241818,5241818,5241744,74,158,utRho20
usg,4873780,4873780,4873298,482,362,utRho20
ushA,1009772,1009828,1009772,56,0,utRho20
uspA,7279966,7280222,7279966,256,1544,utRho20
uspB,7279696,7279696,7279440,256,526,utRho20
uspC,3959172,3959506,3959172,334,122,utRho20
uspE,2797318,2797318,2797244,74,138,utRho20
uspF,2871282,2871282,2871238,44,86,utRho20
uspG,1283806,1283806,1283734,72,772,utRho20
uvrA,8547872,8547872,8547742,130,272,utRho20
uvrB,1626304,1627052,1626304,748,3510,utRho20
uvrC,3989758,3989758,3989412,346,158,utRho20
uvrD,7995814,7995966,7995814,152,368,utRho20
uvrY,3990812,3990812,3990718,94,24,utRho20
uxaB,3221474,3221474,3221360,114,0,utRho20
uxaC,6489714,6489714,6489482,232,292,utRho20
uxuA,9103036,9103272,9103036,236,1432,utRho20
uxuR,9108916,9109152,9108916,236,24,utRho20
valS,8967854,8967854,8967674,180,2114,utRho20
valU,5041848,5041862,5041848,14,56,utRho20
valV,3492830,3492870,3492830,40,0,utRho20
ves,3649968,3649968,3649874,94,0,utRho20
waaA,7616512,7617080,7616512,568,88,utRho20
waaH,7580298,7580298,7580162,136,20,utRho20
waaQ,7616476,7616476,7616196,280,72,utRho20
waaU,7598996,7598996,7598624,372,0,utRho20
waaY,7602272,7602272,7601930,342,3726,utRho20
wbbH,4214888,4214888,4214452,436,3306,utRho20
wbbK,4209212,4209212,4209018,194,176,utRho20
wcaM,4231868,4231868,4231792,76,0,utRho20
wrbA,2135516,2135516,2135416,100,0,utRho20
wza,4275166,4275166,4274486,680,0,utRho20
wzxC,4240674,4240674,4240316,358,0,utRho20
wzzB,4196950,4196950,4196602,348,0,utRho20
xanP,7657642,7657890,7657642,248,30,utRho20
xanQ,6048520,6048702,6048520,182,0,utRho20
xapA,5049820,5049820,5049756,64,0,utRho20
xapR,10090252,10090252,10089908,344,0,utRho20
xdhA,6000514,6000690,6000514,176,0,utRho20
xerD,6079702,6079702,6079486,216,188,utRho20
xseA,5268394,5268464,5268394,70,4,utRho20
xseB,882746,882746,882686,60,184,utRho20
xthA,3664798,3664856,3664798,58,0,utRho20
xylA,7461614,7461614,7461530,84,1410,utRho20
xylE,8484540,8484540,8484508,32,0,utRho20
xylF,7462138,7462262,7462138,124,224,utRho20
xylR,7469812,7469958,7469812,146,0,utRho20
yaaA,13230,13230,12918,312,150,utRho20
yaaI,23876,23876,23572,304,126,utRho20
yaaJ,16034,16034,15918,116,46,utRho20
yaaU,91184,91614,91184,430,88,utRho20
yaaW,23084,23084,22712,372,20,utRho20
yaaX,10060,10468,10060,408,398,utRho20
yabI,142542,142702,142542,160,398,utRho20
yacC,273880,273880,273834,46,494,utRho20
yacH,262932,262932,262520,412,96,utRho20
yacL,268678,268776,268678,98,48,utRho20
yadD,293796,293936,293796,140,0,utRho20
yadE,289930,290162,289930,232,346,utRho20
yadN,314110,314110,313766,344,0,utRho20
yadS,355572,355572,355248,324,60,utRho20
yadV,312470,312470,312402,68,306,utRho20
yaeF,434270,434270,434006,264,168,utRho20
yaeP,428374,428374,428250,124,0,utRho20
yaeQ,428176,428582,428176,406,144,utRho20
yaeR,423716,423754,423716,38,0,utRho20
yafC,462166,462166,461762,404,254,utRho20
yafD,462128,462244,462128,116,386,utRho20
yafK,491986,491986,491610,376,276,utRho20
yafL,493282,493424,493282,142,36,utRho20
yafN,503938,504010,503938,72,0,utRho20
yafS,469568,469632,469568,64,1662,utRho20
yafT,474470,474670,474470,200,0,utRho20
yafV,480432,480432,480378,54,0,utRho20
yafZ,536052,536052,536010,42,0,utRho20
yagE,564446,564556,564446,110,54,utRho20
yagG,570414,570790,570414,376,0,utRho20
yagI,578384,578384,578324,60,74,utRho20
yagK,586236,586236,585896,340,172,utRho20
yagL,588062,588062,587836,226,74,utRho20
yagN,591342,591342,591158,184,2904,utRho20
yahA,663746,664742,663746,996,60,utRho20
yahC,670136,670136,670044,92,0,utRho20
yahE,671478,671850,671478,372,0,utRho20
yahM,690504,690808,690504,304,54,utRho20
yahN,692872,692872,692674,198,0,utRho20
yahO,692864,692968,692864,104,178,utRho20
yaiE,816296,816354,816296,58,94,utRho20
yaiI,811396,811528,811396,132,0,utRho20
yaiO,761946,761946,761684,262,0,utRho20
yaiP,767970,767970,767870,100,0,utRho20
yaiS,769660,769660,769232,428,0,utRho20
yaiV,788922,788922,788922,0,0,utRho20
yaiY,799094,799094,798666,428,0,utRho20
yaiZ,798888,799186,798888,298,24,utRho20
yajC,854410,854574,854410,164,668,utRho20
yajD,860938,861210,860938,272,384,utRho20
yajI,866068,866068,865702,366,708,utRho20
yajL,887496,887496,887282,214,716,utRho20
yajQ,889316,889366,889316,50,0,utRho20
yajR,893374,893374,893332,42,0,utRho20
ybaB,987418,988152,987418,734,4228,utRho20
ybaL,1006590,1006590,1006476,114,58,utRho20
ybaM,980648,980648,980542,106,374,utRho20
ybaN,981436,981764,981436,328,808,utRho20
ybaO,936704,936766,936704,62,0,utRho20
ybaP,1016568,1016568,1016160,408,1146,utRho20
ybaQ,1016348,1016436,1016348,88,0,utRho20
ybaS,1023146,1023282,1023146,136,728,utRho20
ybaV,927504,927874,927504,370,18,utRho20
ybaY,950490,950758,950490,268,1826,utRho20
ybbB,1062724,1062724,1062452,272,314,utRho20
ybbJ,1030154,1030154,1029718,436,688,utRho20
ybbL,1031784,1031838,1031784,54,0,utRho20
ybbN,1037136,1037136,1036558,578,2014,utRho20
ybbO,1038658,1038658,1038298,360,1958,utRho20
ybbY,1080718,1081130,1080718,412,902,utRho20
ybcH,1176140,1176140,1175962,178,26,utRho20
ybcI,1113264,1113264,1113106,158,230,utRho20
ybcJ,1114050,1114050,1113746,304,770,utRho20
ybcK,1137502,1137804,1137502,302,44,utRho20
ybcL,1141690,1141786,1141690,96,30,utRho20
ybcN,1144628,1144932,1144628,304,0,utRho20
ybcQ,1147548,1147912,1147548,364,0,utRho20
ybcW,1159610,1159760,1159610,150,0,utRho20
ybdD,1263982,1264364,1263982,382,476,utRho20
ybdF,1212106,1212106,1211772,334,108,utRho20
ybdH,1267048,1267048,1266954,94,0,utRho20
ybdJ,1212822,1212822,1212398,424,24,utRho20
ybdK,1215122,1215122,1214766,356,4,utRho20
ybdL,1267114,1267172,1267114,58,0,utRho20
ybdM,1271110,1271110,1270752,358,4,utRho20
ybdN,1273372,1273372,1273138,234,0,utRho20
ybdR,1283844,1284176,1283844,332,1030,utRho20
ybeD,1325412,1325412,1325284,128,258,utRho20
ybeF,1323090,1323090,1322756,334,0,utRho20
ybeL,1349986,1350036,1349986,50,922,utRho20
ybeQ,1353412,1353412,1353094,318,40,utRho20
ybeR,1353120,1353422,1353120,302,40,utRho20
ybeT,1358832,1358832,1358812,20,0,utRho20
ybeU,1358924,1359016,1358924,92,0,utRho20
ybeZ,1386938,1386938,1386834,104,1782,utRho20
ybfA,1458074,1458268,1458074,194,8,utRho20
ybfE,1423878,1423878,1423796,82,50,utRho20
ybfF,1425692,1425692,1425604,88,252,utRho20
ybfH,1433282,1433282,1433194,88,0,utRho20
ybgA,1477840,1478002,1477840,162,0,utRho20
ybgC,1549288,1549504,1549288,216,0,utRho20
ybgD,1505916,1505916,1505590,326,4,utRho20
ybgI,1485238,1485654,1485238,416,64,utRho20
ybgO,1498370,1498370,1497964,406,0,utRho20
ybgS,1570992,1570992,1570634,358,2202,utRho20
ybhA,1597184,1597184,1596862,322,0,utRho20
ybhB,1616070,1616070,1615818,252,0,utRho20
ybhC,1614642,1614642,1614562,80,4086,utRho20
ybhD,1601418,1601418,1601276,142,0,utRho20
ybhH,1601104,1601518,1601104,414,0,utRho20
ybhK,1633384,1633384,1633294,90,0,utRho20
ybhM,1641556,1641586,1641556,30,4,utRho20
ybhN,1645296,1645296,1644996,300,578,utRho20
ybhQ,1649202,1649260,1649202,58,0,utRho20
ybiA,1665920,1665920,1665900,20,60,utRho20
ybiI,1676968,1676968,1676912,56,66,utRho20
ybiO,1691328,1691328,1690960,368,84,utRho20
ybiP,1705252,1705252,1705194,58,66,utRho20
ybiS,1711572,1711572,1711488,84,598,utRho20
ybiT,1711894,1711926,1711894,32,0,utRho20
ybiU,1718212,1718212,1718122,90,0,utRho20
ybiV,1720176,1720176,1720056,120,0,utRho20
ybiW,1725566,1725566,1725212,354,1228,utRho20
ybiX,1678548,1678548,1678414,134,294,utRho20
ybjC,1781784,1781826,1781784,42,0,utRho20
ybjE,1830154,1830154,1829714,440,464,utRho20
ybjG,1767016,1767016,1766776,240,2598,utRho20
ybjL,1779882,1779882,1779638,244,116,utRho20
ybjM,1779770,1780178,1779770,408,60,utRho20
ybjO,1795704,1795978,1795704,274,0,utRho20
ybjP,1809046,1809046,1808934,112,12,utRho20
ybjQ,1809034,1809186,1809034,152,398,utRho20
ybjS,1813796,1813796,1813506,290,328,utRho20
ybjX,1838206,1838206,1838168,38,122,utRho20
ycaD,1891438,1891742,1891438,304,118,utRho20
ycaI,1928210,1928640,1928210,430,112,utRho20
ycaK,1899094,1899336,1899094,242,0,utRho20
ycaL,1920264,1920528,1920264,264,48,utRho20
ycaM,1894240,1894458,1894240,218,0,utRho20
ycaR,1941284,1941346,1941284,62,822,utRho20
ycbB,1961862,1962094,1961862,232,216,utRho20
ycbJ,1943344,1943504,1943344,160,0,utRho20
ycbK,1966046,1966150,1966046,104,932,utRho20
ycbZ,2036920,2036920,2036598,322,48,utRho20
yccA,2062886,2062886,2062836,50,42,utRho20
yccF,2048730,2048730,2048696,34,0,utRho20
yccS,2047988,2047988,2047766,222,0,utRho20
yccT,2055674,2055674,2055546,128,162,utRho20
yccX,2059960,2060128,2059960,168,126,utRho20
ycdT,2185682,2185752,2185682,70,0,utRho20
ycdU,2191266,2191686,2191266,420,94,utRho20
ycdZ,2200504,2200592,2200504,88,302,utRho20
yceA,2233544,2233614,2233544,70,178,utRho20
yceD,2293298,2293588,2293298,290,4308,utRho20
yceF,2293522,2293522,2293190,332,2486,utRho20
yceH,2252154,2252314,2252154,160,6480,utRho20
yceI,2237282,2237282,2236952,330,1250,utRho20
yceJ,2238142,2238142,2238092,50,0,utRho20
yceM,2253208,2253612,2253208,404,642,utRho20
yceO,2239264,2239264,2238894,370,576,utRho20
yceQ,2288760,2289004,2288760,244,7928,utRho20
ycfD,2376540,2376540,2376480,60,384,utRho20
ycfJ,2334814,2335198,2334814,384,80,utRho20
ycfS,2340834,2340834,2340748,86,0,utRho20
ycfT,2350658,2350658,2350330,328,16,utRho20
ycfZ,2362760,2362760,2362534,226,0,utRho20
ycgB,2474570,2474570,2474482,88,0,utRho20
ycgG,2434614,2434656,2434614,42,456,utRho20
ycgJ,2452956,2453200,2452956,244,0,utRho20
ycgL,2455218,2455362,2455218,144,54,utRho20
ycgN,2457366,2457660,2457366,294,230,utRho20
ycgR,2489112,2489112,2489054,58,0,utRho20
ycgV,2512222,2512222,2511904,318,0,utRho20
ycgX,2426568,2426568,2426214,354,782,utRho20
ycgY,2490166,2490320,2490166,154,0,utRho20
ycgZ,2431504,2431578,2431504,74,0,utRho20
ychE,2596904,2597196,2596904,292,0,utRho20
ychF,2515764,2515764,2515624,140,0,utRho20
ychH,2517476,2517582,2517476,106,62,utRho20
ychJ,2578354,2578354,2578264,90,0,utRho20
ychN,2547310,2547310,2547198,112,0,utRho20
ychO,2547520,2547850,2547520,330,428,utRho20
ychQ,2533798,2533848,2533798,50,0,utRho20
yciA,2624828,2624828,2624492,336,106,utRho20
yciB,2626110,2626110,2625780,330,3274,utRho20
yciC,2627396,2627396,2627326,70,0,utRho20
yciE,2630794,2630794,2630448,346,1254,utRho20
yciG,5264368,5264368,5264140,228,0,utRho20
yciI,2621784,2621784,2621730,54,32,utRho20
yciN,2661606,2661606,2661336,270,262,utRho20
yciS,2680270,2680486,2680270,216,24,utRho20
yciT,2689088,2689088,2688692,396,192,utRho20
yciU,2614718,2614718,2614300,418,922,utRho20
yciV,2646376,2646440,2646376,64,0,utRho20
yciW,2700472,2700472,2700214,258,98,utRho20
yciZ,2689276,2689276,2689218,58,4,utRho20
ycjD,2703792,2703792,2703520,272,0,utRho20
ycjG,2777748,2777860,2777748,112,0,utRho20
ycjM,2740006,2740432,2740006,426,132,utRho20
ycjW,2767982,2767982,2767922,60,52,utRho20
ycjX,2768138,2768234,2768138,96,190,utRho20
ycjY,5568288,5568288,5567460,828,628,utRho20
ydaE,2836438,2836438,2836016,422,0,utRho20
ydaN,2816048,2816100,2816048,52,0,utRho20
ydaS,2840340,2840730,2840340,390,74,utRho20
ydbC,2948376,2948442,2948376,66,70,utRho20
ydbD,2950132,2950288,2950132,156,0,utRho20
ydbH,2885800,2886102,2885800,302,350,utRho20
ydbJ,2881712,2882116,2881712,404,4,utRho20
ydbK,2881692,2881692,2881568,124,14,utRho20
ydcA,2983294,2983354,2983294,60,0,utRho20
ydcF,2974404,2974470,2974404,66,68,utRho20
ydcI,2990268,2990268,2990142,126,0,utRho20
ydcJ,2990266,2990576,2990266,310,0,utRho20
ydcK,3001280,3001280,3000898,382,0,utRho20
ydcL,3004646,3004914,3004646,268,20,utRho20
ydcN,3012308,3012344,3012308,36,0,utRho20
ydcP,3013508,3013562,3013508,54,58,utRho20
ydcR,3019956,3020006,3019956,50,52,utRho20
ydcS,3022906,3023308,3022906,402,50,utRho20
ydcX,3034442,3034778,3034442,336,480,utRho20
ydcY,3035220,3035296,3035220,76,82,utRho20
ydcZ,3036750,3036750,3036662,88,38,utRho20
yddB,3155332,3155332,3155238,94,206,utRho20
yddE,3071738,3071738,3071716,22,6,utRho20
yddG,3094410,3094410,3094338,72,0,utRho20
yddJ,3089732,3089732,3089438,294,0,utRho20
yddW,3137704,3137704,3137646,58,50,utRho20
ydeA,3233910,3234056,3233910,146,74,utRho20
ydeE,3242528,3242664,3242528,136,0,utRho20
ydeI,3249118,3249118,3248994,124,100,utRho20
ydeJ,3249376,3249546,3249376,170,0,utRho20
ydeN,3165458,3165458,3165048,410,0,utRho20
ydeP,3173328,3173328,3172972,356,0,utRho20
ydeR,3176596,3176596,3176592,4,0,utRho20
ydfA,3296872,3297016,3296872,144,46,utRho20
ydfG,3254982,3255034,3254982,52,120,utRho20
ydfH,3256652,3256704,3256652,52,296,utRho20
ydfK,3265446,3266144,3265446,698,142,utRho20
ydgA,3379588,3379704,3379588,116,180,utRho20
ydgC,3364124,3364124,3364060,64,0,utRho20
ydgD,3343906,3343920,3343906,14,2,utRho20
ydgH,3356754,3356854,3356754,100,28,utRho20
ydgJ,3408798,3408798,3408616,182,0,utRho20
ydgK,3410414,3410500,3410414,86,88,utRho20
ydhB,3479618,3479618,3479596,22,0,utRho20
ydhC,3479698,3479822,3479698,124,0,utRho20
ydhF,3451310,3451310,3451264,46,120,utRho20
ydhI,3441996,3442050,3441996,54,0,utRho20
ydhL,3451864,3451864,3451840,24,0,utRho20
ydhQ,3492404,3492404,3492254,150,104,utRho20
ydhS,3494136,3494262,3494136,126,8,utRho20
ydhT,3499138,3499138,3499118,20,0,utRho20
ydhY,3509284,3509284,3508954,330,0,utRho20
ydhZ,3510418,3510418,3510282,136,0,utRho20
ydiE,3579206,3579226,3579206,20,0,utRho20
ydiH,3530582,3530582,3530406,176,0,utRho20
ydiM,3541852,3542142,3541852,290,0,utRho20
ydiN,3544818,3545024,3544818,206,0,utRho20
ydiP,3558656,3558656,3558602,54,0,utRho20
ydiU,3582508,3582508,3582488,20,0,utRho20
ydiV,3584174,3584174,3584040,134,266,utRho20
ydiY,3612500,3612500,3612166,334,0,utRho20
ydjA,3697400,3697400,3697352,48,66,utRho20
ydjE,3708082,3708082,3707958,124,0,utRho20
ydjF,3709848,3709848,3709708,140,0,utRho20
ydjM,3620340,3620422,3620340,82,0,utRho20
ydjO,3626696,3626696,3626288,408,0,utRho20
ydjX,3666434,3666802,3666434,368,816,utRho20
yeaE,3731448,3731448,3731272,176,0,utRho20
yeaG,3733530,3733816,3733530,286,216,utRho20
yeaI,3740486,3740770,3740486,284,0,utRho20
yeaJ,3743874,3744082,3743874,208,8,utRho20
yeaL,3748646,3748704,3748646,58,158,utRho20
yeaM,3751296,3751296,3751152,144,0,utRho20
yeaN,3750926,3751346,3750926,420,224,utRho20
yeaO,3753554,3753818,3753554,264,58,utRho20
yeaP,3755314,3755430,3755314,116,882,utRho20
yeaQ,3758780,3758780,3758510,270,88,utRho20
yeaR,3759988,3759988,3759896,92,4,utRho20
yeaY,3781122,3781122,3781064,58,48,utRho20
yebB,3892220,3892502,3892220,282,0,utRho20
yebC,3896370,3896370,3896302,68,74,utRho20
yebE,3859464,3859464,3859414,50,4,utRho20
yebG,3861530,3861530,3861494,36,0,utRho20
yebK,3873180,3873304,3873180,124,70,utRho20
yebQ,3820314,3820552,3820314,238,32,utRho20
yebS,3832238,3832516,3832238,278,12,utRho20
yebV,3843430,3843560,3843430,130,36,utRho20
yebW,3843914,3844242,3843914,328,18126,utRho20
yecC,3995646,3995646,3995628,18,0,utRho20
yecD,3901272,3901664,3901272,392,138,utRho20
yecF,3991434,3991636,3991434,202,2,utRho20
yecH,3979304,3979304,3978980,324,4,utRho20
yecJ,3975604,3975604,3975516,88,0,utRho20
yecM,3919968,3919968,3919692,276,0,utRho20
yecR,3976400,3976444,3976400,44,0,utRho20
yecT,3923862,3923944,3923862,82,0,utRho20
yedD,4016522,4016522,4016180,342,0,utRho20
yedE,4016310,4016554,4016310,244,0,utRho20
yedI,4058922,4058922,4058732,190,0,utRho20
yedJ,4066446,4066446,4066158,288,150,utRho20
yedV,4076404,4076404,4076304,100,8,utRho20
yedX,4077680,4077912,4077680,232,0,utRho20
yedY,4078572,4078956,4078572,384,552,utRho20
yeeA,4161322,4161322,4161182,140,2,utRho20
yeeE,4171104,4171104,4171050,54,0,utRho20
yeeJ,4089526,4089822,4089526,296,0,utRho20
yeeN,4113508,4113716,4113508,208,114,utRho20
yeeO,4119444,4119444,4119692,248,0,utRho20
yeeX,4158834,4158834,4158722,112,774,utRho20
yeeZ,4178422,4178422,4178256,166,234,utRho20
yefM,4179466,4179466,4179426,40,64,utRho20
yegD,4295288,4295348,4295288,60,46,utRho20
yegH,4275726,4275804,4275726,78,0,utRho20
yegI,4302154,4302154,4301970,184,0,utRho20
yegJ,4302032,4302370,4302032,338,0,utRho20
yegQ,4331182,4331336,4331182,154,578,utRho20
yegR,4336698,4336698,4336612,86,2,utRho20
yegS,4337086,4337424,4337086,338,0,utRho20
yegT,4357562,4357642,4357562,80,0,utRho20
yegX,4367640,4367640,4367302,338,146,utRho20
yehA,4376944,4376944,4376828,116,18,utRho20
yehE,4385818,4385818,4385592,226,52,utRho20
yehK,4407568,4407944,4407568,376,0,utRho20
yehL,4408804,4409192,4408804,388,0,utRho20
yeiB,4486146,4486146,4485934,212,8,utRho20
yeiE,4499422,4499422,4499236,186,0,utRho20
yeiG,4487776,4487820,4487776,44,732,utRho20
yeiH,4499332,4499434,4499332,102,164,utRho20
yeiI,4503306,4503400,4503306,94,604,utRho20
yeiL,4510580,4510710,4510580,130,34,utRho20
yeiP,4530834,4530900,4530834,66,220,utRho20
yeiQ,4532328,4532490,4532328,162,8,utRho20
yeiR,4535484,4535658,4535484,174,76,utRho20
yeiW,4530840,4530840,4530590,250,512,utRho20
yejA,4544624,4544728,4544624,104,0,utRho20
yejG,4556892,4556892,4556474,418,1828,utRho20
yejH,4561244,4561264,4561244,20,14,utRho20
yejK,4568218,4568218,4567894,324,112,utRho20
yejO,4578352,4578352,4577800,552,308,utRho20
yfaD,4713380,4713808,4713380,428,0,utRho20
yfaE,4696676,4697028,4696676,352,1368,utRho20
yfaL,4688568,4688568,4688338,230,0,utRho20
yfaP,4656398,4656398,4656286,112,0,utRho20
yfaU,4717892,4717892,4717690,202,0,utRho20
yfaY,4727310,4727310,4727266,44,0,utRho20
yfaZ,4728744,4728744,4728550,194,0,utRho20
yfbK,4771810,4771810,4771444,366,4,utRho20
yfbL,4771500,4771720,4771500,220,4,utRho20
yfbN,4777174,4777174,4776852,322,0,utRho20
yfbO,4776916,4777162,4776916,246,0,utRho20
yfbP,4777990,4778232,4777990,242,264,utRho20
yfbR,4817662,4817724,4817662,62,26,utRho20
yfcI,4847424,4847424,4847078,346,14,utRho20
yfcJ,4880482,4880482,4880240,242,106,utRho20
yfcL,4888502,4888502,4888338,164,28,utRho20
yfcV,4911642,4911642,4911292,350,68,utRho20
yfcZ,4921958,4921958,4921868,90,28,utRho20
yfdF,4925604,4926024,4925604,420,14,utRho20
yfdG,4935474,4935710,4935474,236,0,utRho20
yfdP,4946844,4947040,4946844,196,0,utRho20
yfdX,4988866,4988866,4988804,62,0,utRho20
yfdY,4990672,4990672,4990584,88,0,utRho20
yfeA,5035784,5035784,5035664,120,13036,utRho20
yfeC,5036668,5036934,5036668,266,44,utRho20
yfeH,5053818,5053892,5053818,74,64,utRho20
yfeK,5074630,5074684,5074630,54,0,utRho20
yfeO,5018906,5019260,5018906,354,614,utRho20
yfeR,5054078,5054078,5053712,366,184,utRho20
yfeX,5101356,5101356,5101090,266,260,utRho20
yfeY,5102486,5102486,5102432,54,2,utRho20
yfeZ,5103842,5103842,5103452,390,440,utRho20
yffO,5123804,5124222,5123804,418,0,utRho20
yffQ,5126778,5127154,5126778,376,68,utRho20
yffS,5128800,5128986,5128800,186,22,utRho20
yfgC,5232052,5232188,5232052,136,0,utRho20
yfgF,5258062,5258062,5257876,186,0,utRho20
yfgG,5258170,5258580,5258170,410,44,utRho20
yfgH,5259344,5259584,5259344,240,2,utRho20
yfgM,5278866,5278866,5278566,300,416,utRho20
yfhH,5397414,5397518,5397414,104,0,utRho20
yfhM,5304648,5304648,5304574,74,0,utRho20
yfhR,5328408,5328726,5328408,318,6,utRho20
yfiC,5425610,5425610,5425528,82,2,utRho20
yfiE,5430688,5430688,5430640,48,0,utRho20
yfiL,5482630,5482720,5482630,90,0,utRho20
yfiM,5448066,5448358,5448066,292,1088,utRho20
yfiR,5483354,5483750,5483354,396,520,utRho20
yfjH,5517326,5517326,5517200,126,0,utRho20
yfjI,5517710,5517970,5517710,260,66,utRho20
yfjJ,5521014,5521094,5521014,80,20,utRho20
yfjM,5531970,5531970,5531552,418,736,utRho20
yfjP,5535080,5535420,5535080,340,4,utRho20
yfjW,5546570,5546636,5546570,66,0,utRho20
yfjX,5551776,5551838,5551776,62,0,utRho20
ygaC,5601180,5601180,5599988,1192,1400,utRho20
ygaM,5600242,5600292,5600242,50,4,utRho20
ygaU,5593628,5593628,5593572,56,228,utRho20
ygaZ,5619190,5619234,5619190,44,2,utRho20
ygbA,5713656,5713656,5713612,44,0,utRho20
ygbE,5746784,5746784,5746674,110,166,utRho20
ygbI,5722882,5722882,5722528,354,0,utRho20
ygbK,5724394,5724670,5724394,276,3530,utRho20
ygbL,5727074,5727186,5727074,112,402,utRho20
ygbN,5729814,5730202,5729814,388,2192,utRho20
ygcG,5811210,5811422,5811210,212,0,utRho20
ygcN,5785144,5785314,5785144,170,0,utRho20
ygcU,5799214,5799214,5798836,378,0,utRho20
ygcW,5800942,5800942,5800546,396,0,utRho20
ygdD,5883442,5883442,5883262,180,334,utRho20
ygdG,5861746,5861930,5861746,184,218,utRho20
ygdI,5886526,5886526,5886290,236,144,utRho20
ygdQ,5940784,5940840,5940784,56,8,utRho20
ygdR,5942494,5942542,5942494,48,92,utRho20
ygeA,5961606,5961606,5961270,336,0,utRho20
ygeH,5983758,5984188,5983758,430,0,utRho20
ygeI,5987162,5987276,5987162,114,4,utRho20
ygeR,6000078,6000078,5999782,296,0,utRho20
ygeV,6011694,6011694,6011572,122,4,utRho20
ygeW,6012234,6012524,6012234,290,0,utRho20
ygfB,6110946,6110946,6110888,58,34,utRho20
ygfK,6031984,6032120,6031984,136,0,utRho20
ygfS,6058328,6058328,6058024,304,166,utRho20
ygfZ,6082564,6082626,6082564,62,30,utRho20
yggC,6149512,6149512,6149378,134,228,utRho20
yggE,6136370,6136370,6136160,210,380,utRho20
yggI,6179176,6179510,6179176,334,136,utRho20
yggL,6204508,6204508,6204266,242,222,utRho20
yggM,6199514,6199514,6199130,384,80,utRho20
yggN,6203596,6203596,6203246,350,4,utRho20
yggX,18623958,18624558,18623958,600,2592,utRho20
yghA,6298966,6299324,6298966,358,138,utRho20
yghB,6307058,6307126,6307058,68,0,utRho20
yghD,6222614,6222614,6222252,362,202,utRho20
yghF,6225798,6225798,6225840,42,0,utRho20
yghJ,6238640,6238640,6238224,416,204,utRho20
yghQ,6265186,6265186,6264816,370,0,utRho20
yghT,6267830,6268262,6267830,432,0,utRho20
yghU,6277400,6277454,6277400,54,58,utRho20
yghW,6293506,6293506,6293474,32,114,utRho20
yghZ,6295562,6295794,6295562,232,8,utRho20
ygiD,6365122,6365122,6364868,254,1480,utRho20
ygiH,6409066,6409388,6409066,322,2,utRho20
ygiL,6370622,6370828,6370622,206,0,utRho20
ygiM,6402084,6402414,6402084,330,552,utRho20
ygiN,6346156,6346284,6346156,128,6860,utRho20
ygiQ,6322620,6322620,6322292,328,76,utRho20
ygiS,6335462,6335462,6335436,26,44,utRho20
ygiV,6338582,6338582,6338462,120,1030,utRho20
ygiW,6339774,6339774,6339352,422,0,utRho20
ygiZ,6344506,6344506,6344422,84,0,utRho20
ygjH,6442528,6442528,6442494,34,0,utRho20
ygjI,6452140,6452468,6452140,328,0,utRho20
ygjQ,6472730,6473080,6472730,350,52,utRho20
ygjR,6474564,6474586,6474564,22,2,utRho20
ygjV,6483638,6483638,6483488,150,0,utRho20
yhaB,6535632,6535708,6535632,76,0,utRho20
yhaH,6504498,6504608,6504498,110,0,utRho20
yhaI,6505400,6505822,6505400,422,28,utRho20
yhaJ,6508560,6508560,6508428,132,60,utRho20
yhaK,6508538,6508638,6508538,100,0,utRho20
yhbQ,6599878,6599932,6599878,54,2,utRho20
yhbT,6602736,6602736,6602552,184,120,utRho20
yhbU,6602558,6602970,6602558,412,120,utRho20
yhbX,6643302,6643302,6643226,76,48,utRho20
yhbY,6655518,6655580,6655518,62,452,utRho20
yhcA,6723956,6724224,6723956,268,0,utRho20
yhcB,6760364,6760382,6760364,18,340,utRho20
yhcC,6708470,6708470,6708100,370,6,utRho20
yhcF,6733440,6733852,6733440,412,224,utRho20
yhcH,6739124,6739124,6738956,168,32,utRho20
yhcM,6760312,6760312,6759994,318,334,utRho20
yhcN,6770812,6771076,6770812,264,0,utRho20
yhcO,6772606,6772606,6772258,348,2,utRho20
yhdH,6806560,6806968,6806560,408,328,utRho20
yhdJ,6823234,6823306,6823234,72,0,utRho20
yhdN,6879092,6879092,6879018,74,88,utRho20
yhdT,6814702,6814750,6814702,48,82,utRho20
yhdU,6824994,6825242,6824994,248,260,utRho20
yhdV,6836392,6836780,6836392,388,0,utRho20
yhdW,6837944,6838298,6837944,354,0,utRho20
yheO,6953082,6953082,6952880,202,1392,utRho20
yheV,6957970,6957970,6957584,386,360,utRho20
yhfA,6971902,6971902,6971636,266,0,utRho20
yhfG,6983294,6983294,6983240,54,76,utRho20
yhfL,6998622,6998896,6998622,274,0,utRho20
yhfY,7023244,7023244,7022844,400,84,utRho20
yhgA,7086294,7086334,7086294,40,0,utRho20
yhgE,7065176,7065176,7064878,298,58,utRho20
yhgF,7074352,7074770,7074352,418,4276,utRho20
yhhA,7173458,7173886,7173458,428,0,utRho20
yhhI,7248346,7248756,7248346,410,0,utRho20
yhhJ,7253696,7253696,7253606,90,246,utRho20
yhhM,7211588,7211588,7211220,368,4,utRho20
yhhN,7211150,7211502,7211150,352,2,utRho20
yhhQ,7218238,7218434,7218238,196,284,utRho20
yhhT,7223682,7223730,7223682,48,0,utRho20
yhhX,7162032,7162032,7161610,422,0,utRho20
yhhY,7162222,7162276,7162222,54,0,utRho20
yhhZ,7163516,7163726,7163516,210,4,utRho20
yhiD,7312220,7312220,7311804,416,179118,utRho20
yhiJ,7265190,7265190,7265180,10,0,utRho20
yhiM,7269270,7269682,7269270,412,8,utRho20
yhiN,7275000,7275000,7274820,180,466,utRho20
yhjA,7338522,7338522,7338376,146,4,utRho20
yhjB,7344090,7344090,7343788,302,0,utRho20
yhjC,7344272,7344684,7344272,412,0,utRho20
yhjD,7346660,7346724,7346660,64,74,utRho20
yhjE,7349274,7349572,7349274,298,54,utRho20
yhjG,7356824,7356824,7356730,94,0,utRho20
yhjH,7358458,7358458,7358374,84,0,utRho20
yhjJ,7364032,7364032,7363880,152,36,utRho20
yhjK,7371296,7371296,7371158,138,0,utRho20
yhjR,7392750,7392750,7392370,380,72,utRho20
yhjV,7400796,7401126,7400796,330,0,utRho20
yhjX,7424194,7424194,7424014,180,0,utRho20
yhjY,7425966,7425966,7425868,98,234,utRho20
yiaB,7455654,7455654,7455496,158,0,utRho20
yiaD,7432712,7433094,7432712,382,0,utRho20
yiaF,7438194,7438194,7438088,106,0,utRho20
yiaG,7438862,7438956,7438862,94,1806,utRho20
yiaJ,7485236,7485236,7485064,172,0,utRho20
yiaK,7485348,7485466,7485348,118,0,utRho20
yiaT,7503924,7503924,7503736,188,0,utRho20
yiaU,7503792,7503984,7503792,192,0,utRho20
yiaY,7515856,7515856,7515654,202,0,utRho20
yibF,7523950,7523950,7523910,40,0,utRho20
yibG,7536128,7536354,7536128,226,0,utRho20
yibL,7553194,7553330,7553194,136,544,utRho20
yibN,7570112,7570112,7570030,82,204,utRho20
yibT,7552848,7552848,7552760,88,594,utRho20
yicC,7633290,7633352,7633290,62,0,utRho20
yicH,7660862,7660914,7660862,52,120,utRho20
yicJ,7673328,7673328,7671858,1470,404,utRho20
yicN,7685018,7685018,7684804,214,0,utRho20
yicO,7687914,7687914,7687578,336,0,utRho20
yicR,15250308,15250308,15250236,72,0,utRho20
yidB,7755230,7755230,7754930,300,2,utRho20
yidE,7732780,7732780,7732546,234,2,utRho20
yidF,7711580,7711580,7711222,358,30,utRho20
yidQ,7735088,7735456,7735088,368,2628,utRho20
yidR,7738824,7738824,7738618,206,0,utRho20
yieE,7787658,7787738,7787658,80,4,utRho20
yieH,7793314,7793548,7793314,234,0,utRho20
yieK,7798928,7798928,7798786,142,0,utRho20
yifB,7900350,7900350,7899998,352,32,utRho20
yifL,7988984,7989044,7988984,60,40,utRho20
yigF,8005750,8005750,8005598,152,120,utRho20
yigI,8009448,8009448,8009394,54,0,utRho20
yigM,8022100,8022152,8022100,52,0,utRho20
yihA,8101970,8101970,8101458,512,0,utRho20
yihD,8084098,8084138,8084098,40,0,utRho20
yihF,8088110,8088398,8088110,288,2,utRho20
yihG,8093304,8093304,8093204,100,0,utRho20
yihI,8102616,8102694,8102616,78,0,utRho20
yihL,8120506,8120894,8120506,388,0,utRho20
yihN,8124332,8124494,8124332,162,4,utRho20
yihO,8131942,8131942,8131532,410,0,utRho20
yihQ,8138892,8138892,8138552,340,0,utRho20
yihV,8147064,8147478,8147064,414,40,utRho20
yihX,8151096,8151106,8151096,10,140,utRho20
yiiE,8158192,8158582,8158192,390,0,utRho20
yiiF,8159124,8159502,8159124,378,0,utRho20
yiiG,8173762,8174004,8173762,242,0,utRho20
yiiM,8205506,8205644,8205506,138,0,utRho20
yiiQ,8224624,8224624,8224428,196,0,utRho20
yiiS,8225738,8225934,8225738,196,28,utRho20
yijE,8272178,8272216,8272178,38,164,utRho20
yijF,8275728,8275728,8275314,414,94,utRho20
yijO,8296858,8296858,8296634,224,0,utRho20
yjaA,8426240,8426468,8426240,228,181160,utRho20
yjaB,8428312,8428312,8428246,66,2,utRho20
yjaG,8398746,8399008,8398746,262,2714,utRho20
yjaH,8401022,8401132,8401022,110,844,utRho20
yjaZ,8379506,8379572,8379506,66,0,utRho20
yjbB,8455204,8455462,8455204,258,0,utRho20
yjbE,16943432,16943624,16943432,192,0,utRho20
yjbL,8520318,8520642,8520318,324,0,utRho20
yjbQ,8540428,8540476,8540428,48,208,utRho20
yjcB,8550328,8550328,8550082,246,356,utRho20
yjcC,8550836,8550942,8550836,106,172,utRho20
yjcD,8556628,8556958,8556628,330,6,utRho20
yjcE,8559658,8559960,8559658,302,0,utRho20
yjcF,8566212,8566212,8566150,62,0,utRho20
yjcO,8594660,8594660,8594250,410,406,utRho20
yjdA,8654128,8654270,8654128,142,0,utRho20
yjdC,8726660,8726660,8726616,44,104,utRho20
yjdK,8704780,8705168,8704780,388,464,utRho20
yjdL,8713034,8713034,8712822,212,0,utRho20
yjdM,8653672,8653672,8653468,204,1928,utRho20
yjeF,8787354,8788132,8787354,778,14268,utRho20
yjeI,8745522,8745618,8745522,96,130,utRho20
yjeJ,8748806,8748806,8748468,338,52,utRho20
yjeV,8785472,8785784,8785472,312,0,utRho20
yjfP,8833512,8833904,8833512,392,0,utRho20
yjfY,8849656,8849656,8849582,74,0,utRho20
yjfZ,8855052,8855052,8854844,208,0,utRho20
yjgA,8916162,8916162,8915730,432,176,utRho20
yjgL,8950802,8950874,8950802,72,2,utRho20
yjgM,8959342,8959342,8959074,268,0,utRho20
yjgN,8959132,8959460,8959132,328,0,utRho20
yjgR,8980170,8980170,8980126,44,324,utRho20
yjgZ,9002116,9002520,9002116,404,142,utRho20
yjhB,9007764,9008116,9007764,352,154,utRho20
yjhG,9048452,9048452,9048188,264,2498,utRho20
yjhU,9041080,9041080,9040648,432,542,utRho20
yjiA,9178096,9178096,9177730,366,2266,utRho20
yjiJ,9125364,9125364,9125350,14,0,utRho20
yjiK,9127270,9127270,9127422,152,256,utRho20
yjiL,9129604,9129604,9129378,226,70,utRho20
yjiS,9143410,9143502,9143410,92,0,utRho20
yjiY,9182734,9182734,9182558,176,0,utRho20
yjjA,9200674,9200674,9200378,296,404,utRho20
yjjB,18408708,18408708,18407800,908,0,utRho20
yjjJ,9243314,9243538,9243314,224,166,utRho20
yjjK,9261132,9261132,9261044,88,0,utRho20
yjjL,9189764,9189764,9189444,320,62,utRho20
yjjM,9191894,9191894,9191702,192,0,utRho20
yjjP,9206068,9206068,9205716,352,4,utRho20
yjjQ,9206638,9206954,9206638,316,4,utRho20
yjjX,9267798,9267798,9267490,308,910,utRho20
yjjY,9280716,9280804,9280716,88,1624,utRho20
yjjZ,9211554,9211608,9211554,54,92,utRho20
yjtD,9281676,9281884,9281676,208,56,utRho20
ykfB,532454,532454,532174,280,144,utRho20
ykfI,527636,527636,527338,298,192,utRho20
ykgB,637050,637050,636638,412,0,utRho20
ykgC,640430,640430,640002,428,4,utRho20
ykgD,640232,640454,640232,222,4,utRho20
ykgE,642962,643216,642962,254,264,utRho20
ykgJ,608524,608524,608364,160,940,utRho20
ykgL,623878,624224,623878,346,68,utRho20
ykgM,625610,625610,625554,56,0,utRho20
ykgR,626570,626570,626484,86,0,utRho20
ylaC,958576,958576,958502,74,946,utRho20
yliE,1745938,1745958,1745938,20,18,utRho20
ymcE,2103660,2103694,2103660,34,0,utRho20
ymdA,2210450,2210828,2210450,378,0,utRho20
ymdB,2211428,2211640,2211428,212,0,utRho20
ymfD,2395322,2395322,2395064,258,586,utRho20
ymfI,2402880,2402994,2402880,114,0,utRho20
ymfJ,2404518,2404518,2404168,350,222,utRho20
ymfK,2406176,2406176,2405866,310,0,utRho20
ymfT,2405766,2406048,2405766,282,68,utRho20
ymgE,2489110,2489456,2489110,346,146,utRho20
ymgF,2437628,2437966,2437628,338,0,utRho20
ymiA,2670112,2670320,2670112,208,0,utRho20
ymjA,2715620,2715620,2715336,284,434,utRho20
ynaI,2791946,2791946,2791844,102,26,utRho20
ynaK,2850438,2850754,2850438,316,260,utRho20
ynbA,2954924,2955242,2954924,318,0,utRho20
yncD,3046552,3046552,3046130,422,142,utRho20
yncE,3046454,3046614,3046454,160,0,utRho20
yncG,3052456,3052494,3052456,38,66,utRho20
yncL,3034492,3034492,3034388,104,360,utRho20
yneE,3218364,3218364,3218044,320,0,utRho20
yneF,3223748,3223748,3223708,40,0,utRho20
yneJ,3229560,3229608,3229560,48,0,utRho20
yneK,3231100,3231526,3231100,426,0,utRho20
yneM,3245176,3245292,3245176,116,0,utRho20
ynfA,3311398,3311398,3311346,52,0,utRho20
ynfB,3311418,3311616,3311418,198,194,utRho20
ynfC,3315094,3315094,3314914,180,124,utRho20
ynfD,3314828,3315130,3314828,302,154,utRho20
ynfE,3316006,3316138,3316006,132,0,utRho20
ynfK,3334670,3334670,3334438,232,64,utRho20
ynfL,3339304,3339304,3339184,120,0,utRho20
ynfM,3339260,3339398,3339260,138,0,utRho20
ynfN,3276598,3276598,3276218,380,6,utRho20
ynfO,3273454,3273512,3273454,58,0,utRho20
ynhG,3517890,3517890,3517450,440,1742,utRho20
yniA,3615158,3615592,3615158,434,318,utRho20
yniB,3618526,3618526,3618466,60,0,utRho20
yniC,3618652,3618760,3618652,108,0,utRho20
yniD,3610202,3610330,3610202,128,0,utRho20
ynjE,3678880,3678934,3678880,54,0,utRho20
ynjF,3683222,3683222,3682806,416,88,utRho20
ynjH,3684376,3684376,3684270,106,224,utRho20
ynjI,3690022,3690022,3689742,280,20,utRho20
yoaB,3786642,3786734,3786642,92,146,utRho20
yoaC,3787932,3788146,3787932,214,136,utRho20
yoaE,3803544,3803544,3803170,374,242,utRho20
yoaF,3755444,3755444,3755064,380,882,utRho20
yoaH,3789866,3789866,3789462,404,1046,utRho20
yobB,3850418,3850880,3850418,462,2190,utRho20
yobF,3815586,3815586,3815182,404,0,utRho20
yobH,3817800,3817850,3817800,50,0,utRho20
yodB,4084352,4084736,4084352,384,0,utRho20
yodC,4057008,4057008,4056740,268,0,utRho20
yohC,4451358,4451358,4451262,96,0,utRho20
yohD,4451526,4451602,4451526,76,0,utRho20
yohJ,4460986,4461248,4460986,262,4,utRho20
yohO,4431172,4431314,4431172,142,268,utRho20
yojI,4617282,4617282,4617230,52,0,utRho20
ypdI,4988988,4989396,4988988,408,4,utRho20
ypfG,5165786,5165786,5165554,232,52,utRho20
ypfM,5182140,5182140,5181732,408,2412,utRho20
yphB,5349590,5349590,5349376,214,192,utRho20
ypjA,5565644,5565644,5565452,192,0,utRho20
ypjB,5569636,5569636,5568858,778,0,utRho20
ypjD,5495860,5495774,5495860,86,0,utRho20
yqaE,5594170,5594170,5594056,114,250,utRho20
yqcA,5846100,5846100,5845968,132,0,utRho20
yqcE,5800944,5801184,5800944,240,0,utRho20
yqeC,6030468,6030468,6030114,354,0,utRho20
yqeF,5971618,5971618,5971184,434,68,utRho20
yqeG,5971438,5971694,5971438,256,154,utRho20
yqeH,5975016,5975072,5975016,56,0,utRho20
yqeI,5976688,5977004,5976688,316,6,utRho20
yqeK,5981140,5981140,5980720,420,0,utRho20
yqfA,6086728,6086728,6086296,432,542,utRho20
yqgA,6219042,6219106,6219042,64,0,utRho20
yqgB,6172500,6172500,6172102,398,226,utRho20
yqgE,6185768,6185874,6185768,106,218,utRho20
yqhA,6299150,6299150,6298942,208,138,utRho20
yqhC,6310768,6310768,6310436,332,744,utRho20
yqhD,6310604,6310710,6310604,106,500,utRho20
yqhH,6316842,6317254,6316842,412,208,utRho20
yqiC,6369662,6369680,6369662,18,10,utRho20
yqiJ,6384108,6384416,6384108,308,40,utRho20
yqjA,6495096,6495546,6495096,450,1382,utRho20
yqjF,6500932,6501124,6500932,192,840,utRho20
yqjG,6501948,6502048,6501948,100,0,utRho20
yqjH,6433078,6433078,6432982,96,0,utRho20
yqjI,6433506,6433558,6433506,52,0,utRho20
yraH,6574552,6574852,6574552,300,0,utRho20
yraP,6592144,6592818,6592144,674,248,utRho20
yraQ,6596414,6596414,6596276,138,0,utRho20
yraR,6598024,6598024,6597692,332,390,utRho20
yrbG,13360844,13361100,13360844,256,0,utRho20
yrbL,6696842,6696904,6696842,62,32,utRho20
yrbN,6616172,6616172,6615866,306,580,utRho20
yrdB,6860176,6860176,6860046,130,0,utRho20
yrfF,7052548,7052938,7052548,390,860,utRho20
yrhB,7169440,7169518,7169440,78,4,utRho20
ysaB,7451804,7451804,7451424,380,0,utRho20
ysgA,8032686,8032686,8032338,348,286,utRho20
ytfB,8857638,8857638,8857434,204,174,utRho20
ytfE,8864018,8864018,8863966,52,0,utRho20
ytfF,8866296,8866296,8866130,166,2,utRho20
ytfH,8868164,8868226,8868164,62,0,utRho20
ytfI,8875234,8875414,8875234,180,34,utRho20
ytfJ,8878572,8878572,8878524,48,0,utRho20
ytfK,8879022,8879174,8879022,152,744,utRho20
ytfL,8882642,8882642,8882430,212,0,utRho20
ytfQ,8899634,8899924,8899634,290,2342,utRho20
ytjB,9249598,9249598,9249578,20,0,utRho20
yzfA,8896588,8896588,8896490,98,58,utRho20
zapA,6111102,6111224,6111102,122,3666,utRho20
zapB,8236772,8237030,8236772,258,1028,utRho20
zapC,2011700,2011904,2011700,204,4,utRho20
zinT,4082692,4082750,4082692,58,76,utRho20
zipA,5062814,5062814,5062466,348,0,utRho20
zitB,1569716,1569716,1569646,70,8,utRho20
zntA,7212844,7212902,7212844,58,186,utRho20
zntR,6878336,6878336,6878260,76,0,utRho20
znuA,3885322,3885322,3885166,156,0,utRho20
znuC,3885268,3885324,3885268,56,0,utRho20
zraP,8403424,8403424,8403376,48,0,utRho20
zraS,8403810,8403852,8403810,42,0,utRho20
zupT,6364866,6365100,6364866,234,1382,utRho20
zur,8520282,8520282,8520006,276,404,utRho20
zwf,3872752,3872752,3872628,124,318,utRho20
C0343,2818676,2818728,2818676,52,120,utRho21
aaeB,6776526,6776526,6776376,150,0,utRho21
aaeR,6778762,6779040,6778762,278,120,utRho21
aaeX,6778860,6778860,6778674,186,144,utRho21
aat,1854920,1854920,1854864,56,0,utRho21
accA,416822,417242,416822,420,1520,utRho21
accB,6810280,6810872,6810280,592,5168,utRho21
accD,4868030,4868030,4867852,178,606,utRho21
aceB,8430804,8430956,8430804,152,2,utRho21
aceE,245938,246034,245938,96,0,utRho21
ackA,4826918,4826940,4826918,22,340,utRho21
acnA,2670848,2671662,2670848,814,4990,utRho21
acnB,263038,263230,263038,192,1758,utRho21
acpP,2303148,2303230,2303148,82,344,utRho21
acpS,5402324,5402324,5401996,328,864,utRho21
acrA,971396,971396,971238,158,326,utRho21
acrB,969370,969370,968806,564,4284,utRho21
acrD,5174950,5175190,5174950,240,30,utRho21
acrE,6827404,6827728,6827404,324,0,utRho21
acrR,971398,971522,971398,124,202,utRho21
acrZ,1589502,1589546,1589502,44,20,utRho21
acs,8575190,8575190,8574742,448,224,utRho21
actP,8569870,8569870,8569804,66,146,utRho21
ada,4620854,4620854,4620810,44,0,utRho21
add,3404404,3404466,3404404,62,46,utRho21
ade,7687802,7687928,7687802,126,0,utRho21
adhE,2596826,2596826,2596242,584,244,utRho21
adhP,3107988,3107988,3107676,312,2810,utRho21
adiA,8681112,8681112,8681042,70,148,utRho21
adiC,8674404,8674404,8674062,342,0,utRho21
adiY,8676084,8676084,8675858,226,0,utRho21
adk,994278,994350,994278,72,24,utRho21
adrA,807374,807406,807374,32,0,utRho21
aer,6438240,6438240,6438152,88,134,utRho21
aes,1000102,1000102,999946,156,18,utRho21
agaR,6557406,6557406,6557330,76,0,utRho21
agaS,6563778,6563952,6563778,174,0,utRho21
agp,2131118,2131170,2131118,52,0,utRho21
agrA,7296126,7296126,7296126,0,0,utRho21
agrB,7296588,7296588,7296588,0,0,utRho21
ahpC,1277386,1277890,1277386,504,5004,utRho21
ahpF,1278004,1279506,1278004,1502,406848,utRho21
ahr,8992698,8992698,8992418,280,0,utRho21
aidB,8828494,8828550,8828494,56,0,utRho21
ais,4731512,4731512,4731240,272,0,utRho21
alaA,4814816,4815122,4814816,306,0,utRho21
alaC,4996798,4996798,4996590,208,0,utRho21
alaE,5598140,5598328,5598140,188,842,utRho21
alaS,5644180,5644180,5644022,158,2402,utRho21
alaW,5036612,5036612,5036462,150,142,utRho21
aldA,2976380,2976464,2976380,84,1046,utRho21
aldB,7513070,7513070,7513022,48,110,utRho21
alkA,4295118,4295118,4295080,38,154,utRho21
alkB,4618890,4618890,4618682,208,84,utRho21
allA,1064780,1064902,1064780,122,34,utRho21
allD,1092822,1092822,1092726,96,0,utRho21
allE,1088112,1088112,1088092,20,206,utRho21
allS,1064600,1064600,1064442,158,0,utRho21
alr,8531178,8531564,8531178,386,1234,utRho21
alsE,8617334,8617334,8616956,378,212,utRho21
alsK,8615990,8615990,8615598,392,6,utRho21
alx,6476740,6477160,6476740,420,24,utRho21
amiA,5104482,5104704,5104482,222,0,utRho21
amiC,5898378,5898378,5898020,358,0,utRho21
amn,4110062,4110122,4110062,60,48,utRho21
ampC,8758006,8758006,8757888,118,0,utRho21
ampD,237362,237466,237362,104,138,utRho21
ampG,907372,907372,907090,282,368,utRho21
ampH,792726,792726,792574,152,154,utRho21
amyA,4012230,4012312,4012230,82,24,utRho21
anmK,3439346,3439346,3439204,142,0,utRho21
ansB,6201580,6201580,6201456,124,2,utRho21
ansP,3052040,3052040,3051960,80,6,utRho21
apaG,104068,104068,103212,856,4802,utRho21
apaH,102586,102586,102444,142,3494,utRho21
apbE,4623188,4623188,4623068,120,142,utRho21
appA,2081198,2081234,2081198,36,20,utRho21
appC,2075420,2075480,2075420,60,0,utRho21
appY,1167134,1167362,1167134,228,0,utRho21
apt,982620,982824,982620,204,254,utRho21
aqpZ,1832424,1832424,1832094,330,2,utRho21
araB,140150,140150,140096,54,30,utRho21
araC,140482,140774,140482,292,2018,utRho21
araE,5964416,5964416,5964364,52,0,utRho21
araF,3972476,3972476,3972256,220,234,utRho21
araH,3967120,3967120,3967086,34,0,utRho21
araJ,825058,825058,824962,96,0,utRho21
arcA,9281602,9281602,9280612,990,19266,utRho21
arcB,6706098,6706098,6706050,48,4,utRho21
arcZ,6701154,6701154,6701154,0,0,utRho21
arfA,6877346,6877346,6877298,48,180,utRho21
argA,5898312,5898484,5898312,172,0,utRho21
argC,8309770,8310002,8309770,232,254,utRho21
argD,6980442,6980442,6980360,82,0,utRho21
argE,8310156,8310156,8309694,462,522,utRho21
argF,580680,580680,580610,70,0,utRho21
argG,6637124,6637274,6637124,150,324,utRho21
argI,8956688,8956688,8956622,66,0,utRho21
argO,6137672,6137672,6137616,56,90,utRho21
argP,6119460,6119506,6119460,46,0,utRho21
argR,6769204,6769406,6769204,202,0,utRho21
argS,3920002,3920124,3920002,122,0,utRho21
argT,4855698,4855698,4855582,116,44,utRho21
argU,1129406,1129446,1129406,40,0,utRho21
argW,4932616,4932618,4932616,2,12,utRho21
argX,7964728,7964750,7964728,22,134,utRho21
aroF,5482402,5482402,5482300,102,18,utRho21
aroG,1571182,1571266,1571182,84,62,utRho21
aroH,3576636,3576870,3576636,234,1156,utRho21
aroK,7038760,7038760,7038128,632,1098,utRho21
aroL,812560,812810,812560,250,12,utRho21
aroP,243342,243342,243102,240,0,utRho21
arpA,8445382,8445382,8444974,408,0,utRho21
arrS,7316108,7316108,7316108,0,0,utRho21
arsR,7297024,7297056,7297024,32,0,utRho21
artJ,1801252,1801252,1801150,102,0,utRho21
artP,1807686,1807686,1807468,218,1684,utRho21
ascF,5678858,5679048,5678858,190,0,utRho21
ascG,5678574,5678574,5678528,46,0,utRho21
aslB,7965562,7965916,7965562,354,204,utRho21
asnA,7854258,7854310,7854258,52,0,utRho21
asnB,1398444,1398444,1398354,90,0,utRho21
asnC,23562186,23562186,23562018,168,0,utRho21
asnS,1978088,1978088,1977970,118,10128,utRho21
asnT,4089082,4089098,4089082,16,926,utRho21
asnU,4119690,4119702,4119690,12,0,utRho21
asnV,4124504,4124520,4124504,16,22,utRho21
aspA,17473728,17473728,17473308,420,0,utRho21
aspC,1971486,1971486,1971418,68,116,utRho21
aspS,3901402,3901402,3901044,358,440,utRho21
aspT,7893560,7893744,7893560,184,124652,utRho21
aspV,473826,473862,473826,36,86,utRho21
asr,3342654,3342752,3342654,98,176,utRho21
astC,3664088,3664088,3663964,124,0,utRho21
astE,3654138,3654138,3653846,292,0,utRho21
atoD,4646824,4646894,4646824,70,36,utRho21
atpB,7844540,7844540,7844102,438,70,utRho21
atpC,7832118,7832118,7831944,174,852,utRho21
atpI,7845050,7845050,7844880,170,108,utRho21
avtA,7479348,7479410,7479348,62,440,utRho21
azoR,2965982,2965982,2965720,262,210,utRho21
azuC,3976002,3976002,3975918,84,0,utRho21
bacA,6408350,6408350,6408262,88,0,utRho21
bamA,394052,395856,394052,1804,1190,utRho21
bamB,5277950,5277950,5277304,646,1250,utRho21
bamC,5198028,5198028,5197730,298,2836,utRho21
bamD,5471922,5472292,5471922,370,1640,utRho21
bamE,5506972,5507210,5506972,238,466,utRho21
basS,8666954,8666954,8666544,410,898,utRho21
bax,7474468,7474468,7474354,114,224,utRho21
bcp,5200874,5200956,5200874,82,4866,utRho21
bcsB,7385346,7385346,7385214,132,0,utRho21
bcsE,7392644,7392916,7392644,272,0,utRho21
bdcA,8948128,8948128,8948106,22,0,utRho21
bdcR,8948192,8948248,8948192,56,0,utRho21
bdm,3112680,3112680,3112560,120,0,utRho21
betA,654522,654522,654494,28,696,utRho21
betI,658722,658722,658668,54,0,utRho21
betT,658842,658926,658842,84,0,utRho21
bfr,6933498,6933498,6933450,48,122,utRho21
bglG,23440182,23440182,23439402,780,0,utRho21
bglX,4444240,4444240,4443978,262,0,utRho21
bhsA,2337962,2338146,2337962,184,0,utRho21
bioA,1618584,1618584,1618514,70,0,utRho21
bioB,1618604,1618688,1618604,84,0,utRho21
bioH,7089716,7089716,7089688,28,0,utRho21
bisC,7433026,7433026,7432788,238,96,utRho21
blc,8755490,8755490,8755444,46,0,utRho21
blr,3409024,3409102,3409024,78,82,utRho21
bluF,2431226,2431226,2430950,276,0,utRho21
bluR,2428226,2428226,2428118,108,0,utRho21
bolA,908698,908944,908698,246,80,utRho21
borD,1157842,1157842,1157786,56,22,utRho21
brnQ,838976,839182,838976,206,652,utRho21
bssR,1756492,1756496,1756492,4,0,utRho21
bssS,2242116,2242116,2241910,206,0,utRho21
btuB,8326798,8327278,8326798,480,1502,utRho21
cadB,8720212,8720212,8720062,150,4,utRho21
cadC,8723926,8723926,8723868,58,0,utRho21
caiE,70998,70998,70742,256,2,utRho21
caiF,68436,68600,68436,164,4,utRho21
caiT,84074,84074,83862,212,0,utRho21
can,285406,285406,285340,66,56,utRho21
carA,59102,59302,59102,200,2,utRho21
carB,61550,61634,61550,84,600,utRho21
cas2,5757830,5757830,5757706,124,30,utRho21
casA,5768638,5768638,5768276,362,0,utRho21
cbl,4121882,4121882,4121828,54,0,utRho21
cbpA,2128074,2128074,2127550,524,104,utRho21
cbrA,7738628,7738754,7738628,126,0,utRho21
cbrB,7794958,7795012,7794958,54,212,utRho21
ccmH,4585242,4585242,4584820,422,0,utRho21
cdaR,364894,364926,364894,32,0,utRho21
cdd,4463638,4463688,4463638,50,148,utRho21
cdh,8219814,8219860,8219814,46,0,utRho21
cdsA,391110,391354,391110,244,230,utRho21
cedA,3627484,3627484,3627326,158,290,utRho21
cfa,3482402,3482826,3482402,424,496,utRho21
chaC,2544844,2544972,2544844,128,120,utRho21
chbB,3643452,3643452,3643238,214,0,utRho21
chbG,3634624,3634624,3634270,354,0,utRho21
cheW,3946924,3946924,3946678,246,64,utRho21
chiA,6939792,6939792,6939706,86,2,utRho21
chiP,1416472,1416668,1416472,196,12,utRho21
cho,3646984,3647030,3646984,46,20,utRho21
chpS,8896804,8896894,8896804,90,0,utRho21
cirA,4493884,4493884,4493538,346,0,utRho21
citC,1304078,1304078,1303712,366,2,utRho21
citT,1293264,1293264,1293160,104,0,utRho21
clcA,350104,350214,350104,110,490,utRho21
clpA,1846160,1846528,1846160,368,62,utRho21
clpB,5468410,5468410,5468346,64,672,utRho21
clpP,913154,913354,913154,200,386,utRho21
clpS,1845500,1845826,1845500,326,0,utRho21
clpX,914404,914852,914404,448,3442,utRho21
clsA,2617346,2617346,2617290,56,2,utRho21
clsC,2212584,2212710,2212584,126,672,utRho21
cmk,1922330,1922402,1922330,72,162,utRho21
cnu,3409522,3409898,3409522,376,546,utRho21
coaA,8350214,8350214,8350052,162,4,utRho21
cobC,1340092,1340092,1339814,278,558,utRho21
cobT,4129202,4129202,4128934,268,0,utRho21
cobU,4131944,4131944,4131528,416,4,utRho21
codB,709768,709844,709768,76,0,utRho21
comR,2337726,2337726,2337664,62,0,utRho21
copA,1022822,1022822,1022758,64,0,utRho21
corA,8002388,8002852,8002388,464,5626,utRho21
cpdB,8873258,8873258,8873130,128,872,utRho21
cptB,6082198,6082198,6082140,58,0,utRho21
cpxA,8210202,8210202,8209950,252,1504,utRho21
cpxP,8211570,8211640,8211570,70,252,utRho21
cpxR,8211372,8211372,8211340,32,174,utRho21
cra,175894,176056,175894,162,2,utRho21
crcB,1316016,1316016,1315876,140,0,utRho21
creA,9270486,9271042,9270486,556,834,utRho21
creD,9276320,9276356,9276320,36,0,utRho21
crl,515620,515658,515620,38,3698,utRho21
crp,6971906,6972240,6971906,334,3100,utRho21
crr,5070960,5071668,5070960,708,16382,utRho21
csdA,5886414,5886674,5886414,260,0,utRho21
csgB,2207718,2207902,2207718,184,0,utRho21
csgD,2206688,2206688,2206392,296,0,utRho21
csgG,2203510,2203510,2203368,142,116,utRho21
csiD,5577854,5577970,5577854,116,1730,utRho21
csiE,5330802,5330870,5330802,68,148,utRho21
csiR,5590942,5591348,5590942,406,192,utRho21
cspA,7439778,7440098,7439778,320,604,utRho21
cspB,3283430,3283430,3283108,322,0,utRho21
cspC,3815018,3815018,3814870,148,332,utRho21
cspD,1845352,1845352,1845180,172,25044,utRho21
cspE,1314294,1314584,1314294,290,12,utRho21
cspF,3283380,3283710,3283380,330,28,utRho21
cspG,2102610,2102922,2102610,312,202,utRho21
cspH,2102746,2102746,2102350,396,0,utRho21
cspI,3277624,3277624,3277334,290,0,utRho21
csrA,5638746,5638746,5638292,454,3324,utRho21
csrB,5849048,5849048,5849048,0,0,utRho21
csrC,8102072,8102072,8102072,0,0,utRho21
csrD,6806850,6806850,6806664,186,362,utRho21
cstA,1259710,1259788,1259710,78,0,utRho21
cueO,274090,274166,274090,76,0,utRho21
cueR,1027948,1027986,1027948,38,76,utRho21
curA,3037784,3038054,3037784,270,0,utRho21
cusC,1191146,1191200,1191146,54,0,utRho21
cusR,1190924,1190924,1190886,38,252,utRho21
cutA,8730784,8730784,8730712,72,74,utRho21
cutC,3918534,3918534,3917920,614,40,utRho21
cvpA,4861600,4861600,4861526,74,0,utRho21
cvrA,2484328,2484328,2484142,186,2,utRho21
cyaA,7981548,7982306,7981548,758,982,utRho21
cyaR,4334228,4334224,4334228,4,0,utRho21
cyaY,7988166,7988166,7988118,48,452,utRho21
cybB,2981522,2981804,2981522,282,58,utRho21
cycA,8859560,8859728,8859560,168,268,utRho21
cydA,1542340,1542916,1542340,576,40,utRho21
cydC,1858800,1858800,1858390,410,140,utRho21
cydD,1862062,1862062,1861924,138,92,utRho21
cydX,1548300,1548392,1548300,92,396,utRho21
cynR,717418,717418,717380,38,32,utRho21
cynT,1435092,1435196,1435092,104,0,utRho21
cyoA,903306,903306,903220,86,1708,utRho21
cyoE,895540,895540,895410,130,330,utRho21
cysB,2667576,2667710,2667576,134,284,utRho21
cysC,5748056,5748056,5747984,72,0,utRho21
cysD,5752736,5752736,5752658,78,54,utRho21
cysE,7565362,7565362,7565124,238,1448,utRho21
cysG,6995508,6995656,6995508,148,0,utRho21
cysJ,5783928,5783928,5783796,132,60,utRho21
cysK,5064688,5064818,5064688,130,312,utRho21
cysP,5087114,5087114,5087056,58,2,utRho21
cysS,1109154,1109222,1109154,68,0,utRho21
cysT,3984100,3984100,3983974,126,66,utRho21
cysZ,5062766,5062926,5062766,160,268,utRho21
cytR,8249018,8249018,8248912,106,108,utRho21
dacA,1328002,1328002,1327926,76,314,utRho21
dacB,6657714,6657926,6657714,212,0,utRho21
dacC,1761306,1761454,1761306,148,0,utRho21
dadA,2475018,2475142,2475018,124,40,utRho21
dam,7032504,7032504,7031826,678,1568,utRho21
damX,7035200,7035200,7034612,588,908,utRho21
dapA,5199568,5199568,5199520,48,0,utRho21
dapB,56576,56748,56576,172,4,utRho21
dapD,371954,371954,371894,60,138,utRho21
dapE,5183120,5183214,5183120,94,1094,utRho21
dcp,3254844,3254844,3254760,84,108,utRho21
dcrB,7219534,7219910,7219534,376,30,utRho21
dctA,7366996,7366996,7366894,102,376,utRho21
dcuA,8733686,8733686,8733546,140,0,utRho21
dcuB,8698182,8698182,8697488,694,14,utRho21
dcuC,1312166,1312166,1311936,230,0,utRho21
dcuD,6749166,6749738,6749166,572,2,utRho21
dcuR,8701130,8701130,8700068,1062,262,utRho21
dcuS,8703370,8703370,8703324,46,28,utRho21
dcyD,3999016,3999016,3998960,56,0,utRho21
ddpX,3126498,3126498,3126152,346,0,utRho21
deaD,6615818,6615818,6615720,98,4,utRho21
dedA,4869880,4869880,4869482,398,7938,utRho21
dedD,4863750,4863750,4863368,382,34,utRho21
def,6867300,6867380,6867300,80,24,utRho21
degP,361690,361768,361690,78,56,utRho21
degQ,6761308,6761486,6761308,178,1096,utRho21
deoB,9239134,9239206,9239134,72,80,utRho21
deoC,9233358,9234646,9233358,1288,332,utRho21
dfp,7625406,7625462,7625406,56,0,utRho21
dgcZ,3247758,3247758,3247700,58,0,utRho21
dgkA,8512914,8513274,8512914,360,292,utRho21
dgt,358392,358474,358392,82,0,utRho21
dhaK,2501888,2501888,2501676,212,128,utRho21
dhaR,2502006,2502132,2502006,126,2,utRho21
dicB,3299194,3299218,3299194,24,0,utRho21
dicC,3295752,3295752,3295700,52,0,utRho21
dinB,501760,501796,501760,36,0,utRho21
dinD,7635398,7635520,7635398,122,0,utRho21
dinG,1666146,1666140,1666146,6,0,utRho21
dinI,2243018,2243018,2242974,44,0,utRho21
dinJ,493230,493230,493004,226,44,utRho21
dinQ,7295964,7295964,7295576,388,900,utRho21
djlA,114536,114728,114536,192,0,utRho21
dkgA,6313142,6313246,6313142,104,1208,utRho21
dkgB,458196,458334,458196,138,4,utRho21
dksA,321502,321502,321208,294,734,utRho21
dld,4444164,4444370,4444164,206,0,utRho21
dmlA,3763424,3763824,3763424,400,152,utRho21
dmlR,3763710,3763710,3763618,92,0,utRho21
dmsA,1881646,1881918,1881646,272,0,utRho21
dnaA,7767922,7767922,7767458,464,642,utRho21
dnaB,8528566,8528628,8528566,62,44,utRho21
dnaK,24096,24326,24096,230,3076,utRho21
dnaN,7765466,7765466,7764642,824,624,utRho21
dnaQ,471868,472134,471868,266,2554,utRho21
dnaT,18406460,18406460,18406068,392,136,utRho21
dnaX,984112,984184,984112,72,60,utRho21
dosP,3131486,3131486,3131466,20,76,utRho21
dpiB,1303968,1304470,1303968,502,0,utRho21
dppA,7415740,7415740,7415410,330,4806,utRho21
dps,1697900,1697900,1697822,78,588,utRho21
dsbA,8086754,8086836,8086754,82,2018,utRho21
dsbB,2466294,2466294,2466060,234,108,utRho21
dsbC,6079266,6079266,6077644,1622,1600,utRho21
dsbG,1277600,1277600,1277146,454,996,utRho21
dsdA,4958242,4958404,4958242,162,126,utRho21
dsdC,4955492,4955492,4955258,234,30,utRho21
dsdX,4955642,4955694,4955642,52,2,utRho21
dsrA,4050626,4050626,4050626,0,0,utRho21
dsrB,4049686,4049686,4049646,40,2,utRho21
dtpD,1485340,1485340,1485112,228,0,utRho21
dusA,8523200,8523338,8523200,138,624,utRho21
dusB,6820492,6820560,6820492,68,0,utRho21
dusC,4460790,4460790,4460770,20,0,utRho21
dut,7627704,7627864,7627704,160,1442,utRho21
dxr,386670,387042,386670,372,1606,utRho21
ebgA,6445102,6445266,6445102,164,0,utRho21
ebgR,6442874,6442932,6442874,58,0,utRho21
ecnB,8753018,8753106,8753018,88,0,utRho21
eco,4607594,4607810,4607594,216,72,utRho21
ecpA,621594,621594,621342,252,112,utRho21
ecpB,620238,620238,620052,186,0,utRho21
ecpR,622964,622964,622672,292,2,utRho21
eda,3866218,3866218,3865512,706,258,utRho21
edd,3869426,3869426,3869208,218,20,utRho21
efeO,2164308,2164486,2164308,178,614,utRho21
efeU_1,2162614,2162712,2162614,98,0,utRho21
efp,8751134,8751398,8751134,264,2808,utRho21
elaA,4763372,4763372,4763086,286,154,utRho21
elaD,4765308,4765426,4765308,118,0,utRho21
elfA,1995530,1995736,1995530,206,0,utRho21
elfD,1996642,1996980,1996642,338,0,utRho21
emrD,7707690,7707844,7707690,154,0,utRho21
emrK,4966896,4966896,4966678,218,0,utRho21
emrY,4964668,4964668,4964352,316,0,utRho21
emtA,2486250,2486360,2486250,110,0,utRho21
endA,12361100,12361388,12361100,288,256,utRho21
eno,5817692,5817692,5815882,1810,3866,utRho21
entC,1249662,1249770,1249662,108,0,utRho21
entD,1220508,1220508,1220158,350,320,utRho21
entH,1258584,1258600,1258584,16,48,utRho21
entS,1244506,1244600,1244506,94,0,utRho21
envR,6827266,6827266,6826930,336,0,utRho21
epd,12295292,12295292,12294764,528,92,utRho21
epmA,8765236,8765286,8765236,50,70,utRho21
epmB,8751406,8751406,8751314,92,1030,utRho21
eptB,7421162,7421162,7420950,212,0,utRho21
eptC,8300622,8300622,8300530,92,48,utRho21
erfK,4126708,4126708,4126646,62,0,utRho21
erpA,353122,353220,353122,98,406,utRho21
esrE,8039956,8039956,8039956,0,0,utRho21
essD,1153746,1154796,1153746,1050,66,utRho21
etk,2088606,2088606,2088420,186,128,utRho21
evgA,4967262,4967510,4967262,248,26,utRho21
exbB,6304028,6304028,6303968,60,0,utRho21
exbD,6302780,6302780,6302486,294,0,utRho21
exuR,6493016,6493304,6493016,288,6,utRho21
exuT,6490004,6490208,6490004,204,0,utRho21
fabA,2032996,2032996,2032940,56,30,utRho21
fabB,4883282,4883282,4883210,72,98,utRho21
fabH,2297032,2297518,2297032,486,1434,utRho21
fabI,2702236,2702236,2702078,158,108,utRho21
fadB,8062026,8062026,8061942,84,0,utRho21
fadD,3779614,3779614,3779492,122,0,utRho21
fadE,486812,486812,486606,206,0,utRho21
fadH,6463248,6463330,6463248,82,4,utRho21
fadI,4921022,4921022,4920938,84,90,utRho21
fadL,4922410,4922600,4922410,190,184,utRho21
fadM,928720,928804,928720,84,0,utRho21
fadR,2469810,2469876,2469810,66,0,utRho21
fbaB,4357334,4357334,4357128,206,866,utRho21
fdhE,8162722,8162722,8162456,266,2200,utRho21
fdhF,8598814,8598814,8598732,82,2,utRho21
fdnG,3094744,3094802,3094744,58,30,utRho21
fdrA,1093012,1093360,1093012,348,0,utRho21
feaB,2894994,2895038,2894994,44,0,utRho21
feaR,2894734,2894734,2894566,168,24,utRho21
fecA,9033454,9033454,9033354,100,66,utRho21
fecE,9023288,9023288,9022914,374,2358,utRho21
fecI,9036564,9036564,9036470,94,0,utRho21
feoA,7080114,7080326,7080114,212,810,utRho21
fepA,1225334,1225334,1224988,346,4,utRho21
fepB,1249454,1249454,1249020,434,388,utRho21
fepD,1244468,1244468,1244378,90,0,utRho21
fes,1225374,1225630,1225374,256,218,utRho21
ffh,5495706,5495706,5495590,116,1640,utRho21
ffs,952576,952848,952576,272,110,utRho21
fhuA,334884,334968,334884,84,0,utRho21
fhuE,2323294,2323294,2323102,192,206,utRho21
fhuF,9211504,9211504,9211326,178,434,utRho21
fic,6983296,6983296,6982926,370,126,utRho21
fieF,8212864,8212938,8212864,74,0,utRho21
fimA,9085388,9086230,9085388,842,242,utRho21
fimB,9081334,9081914,9081334,580,1232,utRho21
fimE,9083742,9084074,9083742,332,44,utRho21
fimZ,1129214,1129214,1128960,254,0,utRho21
fiu,1683296,1683296,1683062,234,128,utRho21
fixA,84650,84806,84650,156,0,utRho21
fkpA,6955050,6955050,6954838,212,3544,utRho21
fldA,2846084,2846084,2845860,224,5008,utRho21
fldB,6079644,6079710,6079644,66,0,utRho21
flgA,2261770,2261770,2261726,44,2,utRho21
flgB,2261986,2262036,2261986,50,0,utRho21
flgK,2276702,2276756,2276702,54,132,utRho21
flgM,2260330,2260330,2260256,74,0,utRho21
flgN,2259828,2259828,2259660,168,4,utRho21
flhB,3932432,3932432,3932382,50,84,utRho21
flhC,3955864,3955864,3955688,176,340,utRho21
flhD,3957154,3957154,3956394,760,588,utRho21
fliA,4003638,4003638,4003578,60,0,utRho21
fliC,4007352,4007352,4007212,140,4,utRho21
fliD,4007634,4007744,4007634,110,0,utRho21
fliE,4026186,4026186,4026028,158,0,utRho21
fliF,4026292,4026458,4026292,166,12,utRho21
fliL,4039168,4039236,4039168,68,0,utRho21
flk,4875824,4875900,4875824,76,0,utRho21
flu,4142634,4143078,4142634,444,50,utRho21
flxA,3292776,3292810,3292776,34,276,utRho21
fnr,2799104,2799104,2799052,52,30,utRho21
fnrS,2818258,2818258,2818258,0,0,utRho21
focA,1909628,1909628,1908932,696,86,utRho21
folA,99598,99646,99598,48,2,utRho21
folB,6409296,6409296,6409178,118,0,utRho21
folD,1115562,1115562,1115482,80,2,utRho21
folE,4487696,4487696,4487304,392,3092,utRho21
fpr,8228998,8228998,8228944,54,0,utRho21
frc,4986878,4986878,4986508,370,0,utRho21
frdA,8764824,8764824,8764636,188,0,utRho21
frdD,8758948,8758948,8758732,216,1844,utRho21
fre,8052886,8053054,8052886,168,1242,utRho21
frlA,6999518,6999820,6999518,302,0,utRho21
frr,385624,385744,385624,120,1192,utRho21
frsA,513004,513054,513004,50,212,utRho21
fruB,4527194,4527194,4526990,204,0,utRho21
frvR,8179804,8179804,8179710,94,86,utRho21
fryA,5008986,5008986,5008970,16,0,utRho21
fsaA,1727060,1727284,1727060,224,2,utRho21
fsr,1009710,1009710,1009392,318,116,utRho21
ftnA,3977364,3977432,3977364,68,0,utRho21
ftnB,3973550,3973850,3973550,300,0,utRho21
ftsA,207122,207964,207122,842,2600,utRho21
ftsB,5745802,5745802,5745640,162,360,utRho21
ftsH,6654204,6654204,6653870,334,438,utRho21
ftsK,1865858,1866448,1865858,590,3492,utRho21
ftsL,181376,182064,181376,688,4152,utRho21
ftsP,6325732,6325732,6325338,394,546,utRho21
ftsQ,205484,206310,205484,826,602,utRho21
ftsX,7204512,7204512,7204172,340,1270,utRho21
ftsZ,209272,210610,209272,1338,82,utRho21
fucA,5867708,5867708,5867376,332,6,utRho21
fucP,5868238,5868470,5868238,232,0,utRho21
fumA,6753760,6753760,6753508,252,11068,utRho21
fumB,8694696,8694696,8694652,44,0,utRho21
fumC,3373418,3373418,3373176,242,42,utRho21
fur,2842892,2842892,2842584,308,8864,utRho21
fusA,6947370,6947370,6947028,342,12512,utRho21
fxsA,8737206,8737328,8737206,122,312,utRho21
gabD,5581824,5582546,5581824,722,50584,utRho21
gadA,7335214,7335214,7335160,54,0,utRho21
gadB,3144144,3144144,3144090,54,4,utRho21
gadC,3141168,3141168,3140978,190,10,utRho21
gadE,7315600,7316732,7315600,1132,10,utRho21
gadW,7329562,7329562,7329236,326,74,utRho21
gadX,14663356,14663356,14663240,116,188,utRho21
gadY,7329728,7329728,7329728,0,0,utRho21
galE,1584354,1584354,1584110,244,0,utRho21
galF,4228702,4228702,4228654,48,60,utRho21
galM,1577796,1577796,1577674,122,3344,utRho21
galP,6176510,6176568,6176510,58,0,utRho21
galR,5953138,5953198,5953138,60,18,utRho21
galS,4483420,4483420,4483336,84,0,utRho21
galU,2582810,2582914,2582810,104,906,utRho21
gapA,3724480,3725542,3724480,1062,11880,utRho21
garP,6549868,6549868,6549814,54,102,utRho21
gatY,4354468,4354468,4354408,60,82,utRho21
gatZ,4352864,4352864,4352642,222,56862,utRho21
gcd,282558,282558,282450,108,0,utRho21
gcl,1067814,1067832,1067814,18,0,utRho21
gcvA,5885278,5885278,5885134,144,0,utRho21
gcvB,5885392,5885392,5885392,0,0,utRho21
gcvR,5199758,5199812,5199758,54,44,utRho21
gcvT,6101544,6101544,6101334,210,3924,utRho21
gdhA,3684616,3684742,3684616,126,0,utRho21
gfcA,2099668,2099668,2099488,180,6,utRho21
gfcD,2096236,2096236,2095890,346,302,utRho21
ghrA,2195648,2195772,2195648,124,0,utRho21
ghrB,7434378,7434620,7434378,242,1600,utRho21
glcA,6242728,6242728,6242558,170,892,utRho21
glcC,6256412,6256544,6256412,132,0,utRho21
glcD,6256152,6256152,6256042,110,26,utRho21
gldA,8278092,8278092,8278070,22,216,utRho21
glgA,7136784,7136784,7136066,718,4944,utRho21
glgB,7147314,7147314,7147004,310,1036,utRho21
glgC,7139142,7139142,7138656,486,1616,utRho21
glgP,7133546,7133546,7133162,384,1754,utRho21
glgS,6384024,6384024,6383878,146,88,utRho21
glgX,7142838,7142838,7142638,200,122,utRho21
glk,5018922,5018922,5018852,70,52,utRho21
glmS,7827622,7827622,7827336,286,6240,utRho21
glmU,7830652,7830652,7830400,252,0,utRho21
glmY,10765360,10765360,10765360,0,0,utRho21
glmZ,7972864,7972864,7972864,0,0,utRho21
glnA,16232888,16232888,16232136,752,516,utRho21
glnB,5375052,5375052,5374816,236,112,utRho21
glnD,377310,377310,377300,10,0,utRho21
glnE,6399602,6399602,6399282,320,690,utRho21
glnH,1696396,1696396,1696008,388,502,utRho21
glnK,945112,945196,945112,84,0,utRho21
glnL,8112742,8112742,8112678,64,0,utRho21
glnQ,1693262,1693262,1692926,336,1288,utRho21
glnS,1411998,1412186,1411998,188,1314,utRho21
gloA,3455602,3455674,3455602,72,0,utRho21
gloB,469852,469852,469564,288,3670,utRho21
glpA,4705166,4705294,4705166,128,0,utRho21
glpD,7123942,7124026,7123942,84,0,utRho21
glpE,7123698,7123698,7123646,52,4,utRho21
glpF,8236322,8236322,8236180,142,28,utRho21
glpG,7122960,7122960,7122904,56,74,utRho21
glpR,7121782,7121782,7121210,572,470,utRho21
glpT,4704902,4704902,4704748,154,0,utRho21
glpX,8231212,8231212,8231158,54,210,utRho21
glrK,5382246,5382246,5382196,50,0,utRho21
gltA,1509534,1509534,1508936,598,64306,utRho21
gltB,6709018,6709264,6709018,246,0,utRho21
gltI,1375792,1375792,1375494,298,4108,utRho21
gltP,8588536,8588962,8588536,426,1572,utRho21
gltS,7657382,7657382,7657330,52,168,utRho21
gltX,5041568,5041568,5041344,224,296,utRho21
gluQ,320286,320286,320224,62,28,utRho21
glyA,5371148,5371148,5371014,134,2,utRho21
glyQ,7450708,7450708,7450636,72,222,utRho21
glyS,7448990,7448990,7448794,196,2678,utRho21
glyU,5998128,5998128,5998114,14,0,utRho21
glyV,8784626,8784720,8784626,94,86,utRho21
glyW,3984360,3984360,3984234,126,0,utRho21
gmhB,445612,445666,445612,54,0,utRho21
gmk,7642776,7642856,7642776,80,12,utRho21
gmr,2693686,2693686,2693484,202,46,utRho21
gnd,4202648,4202648,4202536,112,788,utRho21
gnsB,3275692,3275692,3275564,128,92,utRho21
gntK,14310580,14310580,14310368,212,92,utRho21
gntP,9102668,9102668,9102592,76,36,utRho21
gntR,7157760,7157760,7157452,308,1086,utRho21
gntT,7092810,7093118,7092810,308,0,utRho21
gntU,7154170,7154170,7154122,48,0,utRho21
gntX,7089334,7089764,7089334,430,10,utRho21
gor,7292224,7292598,7292224,374,734,utRho21
gpmA,1575340,1575340,1575190,150,8,utRho21
gpmM,7570374,7570520,7570374,146,0,utRho21
gpsA,7567620,7567620,7567322,298,17540,utRho21
gpt,511828,511954,511828,126,260,utRho21
grcA,5433046,5433046,5432898,148,112,utRho21
greA,6657728,6657728,6657430,298,462,utRho21
greB,7073488,7073624,7073488,136,226,utRho21
groL,8741566,8742050,8741566,484,29992,utRho21
groS,8741232,8741376,8741232,144,17288,utRho21
grpE,5501494,5501494,5501416,78,798,utRho21
grxA,1781552,1781552,1781506,46,0,utRho21
grxB,2248206,2248206,2248108,98,80,utRho21
grxC,7569152,7569152,7568884,268,6724,utRho21
grxD,3468324,3468324,3468202,122,7020,utRho21
gspA,6911268,6911268,6910796,472,0,utRho21
gspC,6910964,6911156,6910964,192,0,utRho21
gss,6277220,6277220,6277044,176,144,utRho21
gstA,3428654,3428754,3428654,100,0,utRho21
gstB,1761038,1761038,1760960,78,28,utRho21
guaB,5268214,5268214,5268140,74,110,utRho21
gudD,5839026,5839026,5838770,256,152,utRho21
gyrA,4678914,4678914,4678840,74,2,utRho21
gyrB,7760300,7760300,7760238,62,226,utRho21
hcaE,5337964,5338064,5337964,100,194,utRho21
hcaR,5337928,5337928,5337792,136,114,utRho21
hcaT,5336106,5336106,5335692,414,1008,utRho21
hchA,4071260,4071670,4071260,410,1060,utRho21
hcp,1828258,1828258,1827628,630,28,utRho21
hcr,1824400,1824400,1824300,100,116,utRho21
hdeA,7313582,7313582,7313480,102,0,utRho21
hdeD,7313920,7313990,7313920,70,2,utRho21
hdfR,7896320,7896320,7895934,386,120,utRho21
hdhA,3396244,3396244,3396080,164,0,utRho21
helD,2048876,2048942,2048876,66,0,utRho21
hemA,2527166,2527428,2527166,262,320,utRho21
hemB,779722,779722,779454,268,120,utRho21
hemF,5106410,5106450,5106410,40,146,utRho21
hemH,996062,996110,996062,48,0,utRho21
hemL,349882,349882,349764,118,186,utRho21
hemN,8103886,8104090,8103886,204,134,utRho21
hepA,127176,127176,126528,648,1524,utRho21
hflD,2385372,2385372,2385262,110,510,utRho21
hfq,8799602,8800576,8799602,974,6262,utRho21
hha,961006,961006,960616,390,240,utRho21
hicA,3018442,3018572,3018442,130,150,utRho21
higA,6468682,6468682,6468288,394,96,utRho21
higB,6468960,6468960,6468910,50,0,utRho21
hinT,2323642,2323770,2323642,128,28,utRho21
hipB,3184964,3184964,3184884,80,18,utRho21
hisB,4186720,4186936,4186720,216,986,utRho21
hisJ,4853674,4853674,4853576,98,110,utRho21
hisL,8359856,8359984,8359856,128,84,utRho21
hisS,5281284,5281284,5281150,134,148,utRho21
hlpA,400910,400964,400910,54,172,utRho21
hlyE,2460932,2460932,2460788,144,68,utRho21
hmp,5371594,5371670,5371594,76,2,utRho21
hns,2585916,2585916,2585844,72,1580,utRho21
hofM,7045856,7045856,7045502,354,0,utRho21
hokA,7441620,7441620,7441200,420,2,utRho21
hokC,33902,33902,33806,96,96,utRho21
hokE,1215462,1215672,1215462,210,2,utRho21
holC,8968546,8968546,8968560,14,1852,utRho21
holD,9215562,9215606,9215562,44,0,utRho21
holE,3850040,3850216,3850040,176,190,utRho21
hpt,282720,282862,282720,142,4,utRho21
hrpB,324150,324210,324150,60,98,utRho21
hscB,5319048,5319048,5318934,114,1492,utRho21
hscC,1367188,1367188,1366786,402,814,utRho21
hsdS,9163004,9163004,9162924,80,0,utRho21
hslJ,2883560,2883560,2883486,74,142,utRho21
hslO,7059344,7059548,7059344,204,12076,utRho21
hslR,7058220,7058696,7058220,476,1524,utRho21
hslV,8244708,8244708,8244574,134,14,utRho21
hsrA,7881412,7881412,7881224,188,162,utRho21
htgA,21286,21660,21286,374,44,utRho21
htpG,989634,990240,989634,606,2406,utRho21
htpX,3825236,3825236,3825152,84,0,utRho21
htrE,311036,311036,310852,184,0,utRho21
htrL,7587668,7587668,7587366,302,4,utRho21
hupA,8400352,8400562,8400352,210,520,utRho21
hupB,1845220,1845804,1845220,584,108,utRho21
hyaA,2063968,2064278,2063968,310,0,utRho21
hybO,6292726,6292726,6292522,204,2230,utRho21
hycA,5700922,5700922,5700870,52,112,utRho21
hycI,5686204,5686204,5686086,118,368,utRho21
hydN,5676264,5676264,5676210,54,0,utRho21
hyfA,5202342,5202402,5202342,60,0,utRho21
hypA,11402508,11402588,11402508,80,8,utRho21
hypB,11403356,11404004,11403356,648,504,utRho21
hypF,5676210,5676210,5674850,1360,328,utRho21
hypT,9116634,9116634,9116578,56,0,utRho21
hyuA,6019660,6020056,6019660,396,86,utRho21
iaaA,1733074,1733136,1733074,62,0,utRho21
iadA,9119074,9119074,9119052,22,36,utRho21
iap,5753072,5753162,5753072,90,0,utRho21
ibaG,6673966,6673966,6673606,360,96,utRho21
ibpA,7735036,7735036,7734844,192,144,utRho21
ibpB,7733962,7733962,7733794,168,1092,utRho21
icd,2389922,2390246,2389922,324,622,utRho21
iclR,8447304,8447304,8447256,48,0,utRho21
idi,6065876,6066130,6065876,254,0,utRho21
idnD,8988870,8988870,8988812,58,0,utRho21
idnK,8989194,8989246,8989194,52,0,utRho21
ihfA,3591442,3591442,3591104,338,908,utRho21
ihfB,1927498,1927656,1927498,158,1948,utRho21
ileS,43666,44782,43666,1116,5592,utRho21
ileX,6431194,6431196,6431194,2,0,utRho21
ilvA,15820940,15821324,15820940,384,404,utRho21
ilvC,7915824,7915940,7915824,116,192,utRho21
ilvE,15809552,15809936,15809552,384,0,utRho21
ilvI,170840,171260,170840,420,0,utRho21
ilvL,23701308,23701932,23701308,624,114,utRho21
ilvY,7915734,7915734,7915640,94,4,utRho21
inaA,4698998,4698998,4698944,54,0,utRho21
infA,1853370,1853370,1852886,484,598,utRho21
infC,3602692,3602692,3601276,1416,6300,utRho21
insA-5,3958452,3958452,3958430,22,4,utRho21
insA-7,9036758,9037054,9036758,296,346,utRho21
insC-5,6372080,6372284,6372080,204,208,utRho21
insEF-2,785238,785238,785820,582,768,utRho21
insEF-4,2190310,2190310,2190892,582,638,utRho21
insG,9007098,9007098,9006862,236,16,utRho21
insH-1,550596,550596,550234,362,250,utRho21
insH-11,7306538,7306538,7306396,142,214,utRho21
insH-2,1151548,1151548,1151506,42,984,utRho21
insH-3,1378444,1378444,1378026,418,246,utRho21
insH-4,2791942,2792152,2791942,210,358,utRho21
insH-5,2857852,2857852,2857452,400,104,utRho21
insH-6,4135022,4135022,4134642,380,38,utRho21
insH-7,4206186,4206186,4205822,364,2456,utRho21
insH-9,6260050,6260356,6260050,306,428,utRho21
insI-3,9017372,9017372,9017234,138,2,utRho21
insJ,7441188,7441360,7441188,172,0,utRho21
insK,7442130,7442308,7442130,178,0,utRho21
insL-1,30760,30890,30760,130,3384,utRho21
insL-2,1216112,1216130,1216112,18,74,utRho21
insL-3,5028644,5028662,5028644,18,156,utRho21
insN-1,540452,540484,540452,32,0,utRho21
intD,1132202,1132202,1131956,246,22,utRho21
intR,2826520,2826520,2826470,50,0,utRho21
intS,4933026,4933090,4933026,64,74,utRho21
intZ,5117386,5117542,5117386,156,348,utRho21
iraD,9113152,9113986,9113152,834,4,utRho21
iraM,2424246,2424246,2424006,240,0,utRho21
iraP,802638,802772,802638,134,0,utRho21
iscA,5319924,5319924,5319772,152,2904,utRho21
iscR,5324398,5324398,5324262,136,11916,utRho21
iscX,5313834,5313834,5313472,362,2238,utRho21
ispF,5743968,5743968,5743560,408,2444,utRho21
ispG,5283908,5283908,5283608,300,784,utRho21
ispU,389568,389806,389568,238,8,utRho21
isrA,2811502,2811502,2811618,116,0,utRho21
istr-1,7706384,7706384,7706384,0,0,utRho21
istr-2,7706514,7706514,7706514,0,0,utRho21
ivbL,15412092,15412092,15411952,140,1492,utRho21
ivy,480638,480686,480638,48,80,utRho21
katE,3627628,3627734,3627628,106,300,utRho21
katG,8267624,8267670,8267624,46,398,utRho21
kbaZ,6557732,6557828,6557732,96,0,utRho21
kbl,7585154,7585154,7585102,52,578,utRho21
kch,2621046,2621046,2620538,508,0,utRho21
kdgR,3820506,3820506,3820198,308,42,utRho21
kdpE,1443788,1443788,1443466,322,292,utRho21
kdpF,1457698,1457698,1457642,56,0,utRho21
kdsA,2535708,2536330,2535708,622,3630,utRho21
kdsC,6683438,6684546,6683438,1108,4506,utRho21
kduI,5968388,5968388,5968248,140,166,utRho21
kefF,94160,94492,94160,332,6,utRho21
kgtP,5451624,5451624,5451492,132,2,utRho21
kup,7862206,7862632,7862206,426,52,utRho21
lacI,735076,735076,735020,56,80,utRho21
lacZ,1465508,1465508,1465220,288,24,utRho21
ldcA,2486394,2486394,2486160,234,0,utRho21
ldhA,2885830,2885830,2885686,144,0,utRho21
ldrA,2538954,2538954,2538550,404,538,utRho21
ldrB,2540024,2540024,2539620,404,8,utRho21
ldrC,2541092,2541092,2540690,402,26,utRho21
ldrD,7400544,7400544,7400174,370,44,utRho21
lepA,5414392,5414392,5414248,144,102,utRho21
lepB,5410928,5410928,5410618,310,744,utRho21
leuD,159188,159188,158906,282,266,utRho21
leuE,3761600,3761600,3761518,82,0,utRho21
leuL,168048,168048,167416,632,0,utRho21
leuO,168308,168736,168308,428,0,utRho21
leuQ,9212864,9212864,9212802,62,0,utRho21
leuU,6644556,6644556,6644316,240,2022,utRho21
leuV,9212546,9212546,9212330,216,754,utRho21
leuX,8992772,8992810,8992772,38,112,utRho21
lexA,8514174,8514230,8514174,56,2,utRho21
lhr,3456706,3458174,3456706,1468,3160,utRho21
ligA,5060402,5060402,5060352,50,0,utRho21
ligB,7642576,7642576,7642340,236,0,utRho21
lipA,1320602,1320602,1320432,170,42,utRho21
lipB,1324802,1324802,1324556,246,1980,utRho21
lit,2397032,2397390,2397032,358,242,utRho21
livJ,7199524,7199524,7199316,208,6,utRho21
livK,7195510,7195510,7195120,390,84,utRho21
lldP,7554578,7554798,7554578,220,5292,utRho21
lnt,1381968,1381968,1381762,206,956,utRho21
loiP,6163784,6163826,6163784,42,0,utRho21
lolA,1874656,1874738,1874656,82,328,utRho21
lolB,2527112,2527112,2527000,112,248,utRho21
lolC,2350748,2350854,2350748,106,0,utRho21
lon,917630,917776,917630,146,156,utRho21
lpcA,486936,487086,486936,150,20,utRho21
lpd,255434,255824,255434,390,3722,utRho21
lplA,9248476,9248476,9248234,242,3238,utRho21
lplT,5947878,5947878,5947724,154,92,utRho21
lpoA,6586422,6586800,6586422,378,88,utRho21
lpp,3514592,3514842,3514592,250,182,utRho21
lptA,6686598,6686760,6686598,162,1396,utRho21
lptB,6686792,6687888,6686792,1096,3168,utRho21
lptD,114672,114672,114218,454,2752,utRho21
lptF,8972244,8972436,8972244,192,0,utRho21
lpxC,213016,213114,213016,98,4360,utRho21
lpxD,401920,401942,401920,22,36,utRho21
lpxL,2233418,2233418,2233164,254,194,utRho21
lpxM,3880456,3880456,3880386,70,0,utRho21
lpxP,4991156,4991290,4991156,134,272,utRho21
lrhA,4813312,4813312,4813282,30,94,utRho21
lrp,1864656,1865190,1864656,534,1588,utRho21
lspA,50028,50414,50028,386,1792,utRho21
lsrA,3202920,3202980,3202920,60,0,utRho21
lsrR,3202514,3202514,3202482,32,0,utRho21
ltaE,1818640,1818640,1818588,52,22,utRho21
luxS,5630130,5630130,5629466,664,1642,utRho21
lysA,5957902,5957902,5957798,104,0,utRho21
lysC,8467232,8467232,8466466,766,4106,utRho21
lysP,4497120,4497120,4497064,56,230,utRho21
lysR,5957900,5958042,5957900,142,0,utRho21
lysT,1561028,1561108,1561028,80,62,utRho21
lysU,8709610,8709610,8709434,176,6,utRho21
macB,1840188,1840694,1840188,506,774,utRho21
maeA,3111484,3111484,3111338,146,6198,utRho21
mak,820236,820288,820236,52,0,utRho21
malE,8492928,8492928,8492838,90,8,utRho21
malI,3398456,3398456,3398360,96,0,utRho21
malK,8493472,8493568,8493472,96,0,utRho21
malP,7105020,7105020,7104946,74,2400,utRho21
malQ,7100798,7100798,7100140,658,1348,utRho21
malS,14949880,14949988,14949880,108,0,utRho21
malT,7106048,7106170,7106048,122,32,utRho21
malX,3398626,3398710,3398626,84,0,utRho21
malZ,1689980,1690072,1689980,92,124,utRho21
manA,3377102,3377152,3377102,50,70,utRho21
manX,3803866,3804096,3803866,230,0,utRho21
marC,3237882,3237882,3237816,66,194,utRho21
marR,3238186,3238240,3238186,54,0,utRho21
matP,2036918,2036970,2036918,52,18,utRho21
mazE,5822736,5822736,5822678,58,56,utRho21
mazG,5821720,5821720,5821370,350,7468,utRho21
mcbA,1684306,1684306,1684112,194,0,utRho21
mcbR,3040192,3040524,3040192,332,0,utRho21
mcrA,2420278,2420692,2420278,414,0,utRho21
mcrC,9156124,9156124,9155916,208,148,utRho21
mdaB,6344814,6345060,6344814,246,40,utRho21
mdfA,1767138,1767346,1767138,208,0,utRho21
mdh,6768940,6768940,6768536,404,848,utRho21
mdoB,9198988,9198988,9198882,106,1512,utRho21
mdoD,2993290,2993712,2993290,422,0,utRho21
mdoG,2218514,2218670,2218514,156,0,utRho21
mdtA,4307958,4308032,4307958,74,0,utRho21
mdtE,7318168,7318464,7318168,296,11286,utRho21
mdtK,3486538,3486914,3486538,376,248,utRho21
mdtP,8602472,8602472,8602060,412,70,utRho21
melA,8683774,8683822,8683774,48,0,utRho21
melR,8683300,8683300,8683256,44,72,utRho21
menA,8240812,8240812,8240698,114,0,utRho21
menB,4753774,4753774,4753638,136,562,utRho21
mepH,3468714,3468870,3468714,156,0,utRho21
mepM,3883666,3883666,3883270,396,450,utRho21
mepS,4539840,4539958,4539840,118,104,utRho21
metA,8428318,8428560,8428318,242,0,utRho21
metB,8257272,8257344,8257272,72,1666,utRho21
metC,6304150,6304472,6304150,322,24,utRho21
metE,8025768,8026106,8025768,338,88,utRho21
metF,8265092,8265232,8265092,140,0,utRho21
metG,4388538,4388600,4388538,62,58,utRho21
metH,8447010,8447656,8447010,646,2650,utRho21
metJ,8257116,8257116,8256790,326,12,utRho21
metK,6173154,6173412,6173154,258,96,utRho21
metN,445428,445428,445290,138,82,utRho21
metR,8025710,8025710,8025632,78,0,utRho21
metT,1394326,1394326,1394266,60,150,utRho21
metY,19910250,19910250,19909734,516,0,utRho21
metZ,11789528,11789548,11789528,20,4,utRho21
mfd,2348056,2348056,2347928,128,112,utRho21
mglA,4478782,4478782,4478578,204,684,utRho21
mglB,4481132,4481132,4480696,436,40170,utRho21
mglC,4475918,4475918,4475506,412,164,utRho21
mgrB,3817584,3817584,3817532,52,0,utRho21
mgrR,3245828,3245828,3245828,0,0,utRho21
mgsA,2054082,2054082,2054030,52,144,utRho21
mgtL,8934560,8934862,8934560,302,252,utRho21
mhpA,737038,737222,737038,184,158,utRho21
mhpR,737072,737072,736840,232,352,utRho21
mhpT,750772,750918,750772,146,112,utRho21
miaA,8797964,8798504,8797964,540,320,utRho21
micA,5629604,5629604,5629604,0,0,utRho21
micC,2874242,2874238,2874242,4,0,utRho21
micF,4626168,4626168,4626168,0,0,utRho21
micM,1014408,1014408,1014408,0,0,utRho21
minE,2449422,2449422,2449090,332,3922,utRho21
mioC,7852950,7852950,7852910,40,0,utRho21
mipA,3733012,3733012,3732944,68,1640,utRho21
mlaA,4930270,4930270,4930014,256,0,utRho21
mlc,3337206,3337206,3337128,78,0,utRho21
mlrA,4429498,4429732,4429498,234,0,utRho21
mltA,5894546,5894546,5894356,190,94,utRho21
mltD,468050,468050,467910,140,0,utRho21
mltF,5391534,5391602,5391534,68,0,utRho21
mmuP,550238,550650,550238,412,262,utRho21
mngA,1531622,1531968,1531622,346,2,utRho21
mngR,1531852,1531852,1531750,102,0,utRho21
mnmG,7851348,7851348,7851266,82,398,utRho21
mntH,5025470,5025470,5025412,58,0,utRho21
mntP,3810918,3811376,3810918,458,34,utRho21
mntR,1706160,1706366,1706160,206,36,utRho21
mntS,1706128,1706128,1705994,134,0,utRho21
moaA,1633654,1634088,1633654,434,1578,utRho21
moaB,1635954,1636110,1635954,156,3300,utRho21
mobA,8084242,8084242,8083998,244,4,utRho21
mocA,6030112,6030320,6030112,208,0,utRho21
modA,1589990,1590178,1589990,188,4,utRho21
moeA,1732788,1732788,1732728,60,134,utRho21
mokB,2984610,2984610,2984258,352,568,utRho21
molR_1,4392888,4392948,4392888,60,2,utRho21
motA,3954604,3954604,3954278,326,128,utRho21
mpaA,2781278,2781278,2781196,82,694,utRho21
mpl,8911456,8911570,8911456,114,0,utRho21
mppA,2786108,2786454,2786108,346,76,utRho21
mprA,5621494,5621540,5621494,46,254,utRho21
mqo,4613848,4613848,4613508,340,72,utRho21
mqsA,6336742,6336742,6336492,250,532,utRho21
mqsR,6337306,6337306,6337088,218,602,utRho21
mraZ,179192,179268,179192,76,0,utRho21
mrcA,7045652,7045742,7045652,90,0,utRho21
mrcB,329442,329460,329442,18,0,utRho21
mreB,13605424,13605424,13604348,1076,1040,utRho21
mreD,6798166,6798166,6797750,416,166,utRho21
mrp,4388360,4388360,4388336,24,10,utRho21
mscK,972984,973072,972984,88,0,utRho21
mscL,6876002,6876048,6876002,46,128,utRho21
mscS,6139742,6139742,6139614,128,236,utRho21
msrA,8884522,8884522,8884352,170,838,utRho21
msrB,3725168,3725168,3724858,310,8,utRho21
msyB,2228426,2228426,2228362,64,340,utRho21
mtfA,4087236,4087302,4087236,66,4394,utRho21
mtgA,6699662,6699662,6699618,44,22,utRho21
mtlA,30177504,30178248,30177504,744,1448,utRho21
mtn,358366,358366,358306,60,14,utRho21
mtr,6611864,6611864,6611634,230,0,utRho21
mug,6430992,6430992,6430946,46,0,utRho21
murQ,5091466,5091546,5091466,80,0,utRho21
murR,5091586,5091586,5091218,368,0,utRho21
mutH,5939164,5939324,5939164,160,392,utRho21
mutL,8794092,8794824,8794092,732,902,utRho21
mutM,7622554,7622554,7622304,250,276,utRho21
mutS,5714038,5714186,5714038,148,984,utRho21
mutY,18617466,18618078,18617466,612,192,utRho21
nac,4123956,4123956,4123866,90,2,utRho21
nadA,1564122,1564170,1564122,48,0,utRho21
nadB,5420714,5420840,5420714,126,0,utRho21
nadC,237326,237326,237290,36,0,utRho21
nadE,3644604,3644916,3644604,312,2,utRho21
nadK,5501526,5501662,5501526,136,226,utRho21
nagA,1406350,1406350,1405502,848,23598,utRho21
nagB,1407416,1407416,1407222,194,312,utRho21
nagC,1404016,1404016,1403188,828,456,utRho21
nagE,1407680,1407888,1407680,208,2,utRho21
nagK,2357080,2357186,2357080,106,188,utRho21
nanA,6747240,6747240,6747152,88,90,utRho21
nanC,9079856,9079856,9079002,854,98,utRho21
nanR,6749406,6749406,6748978,428,2,utRho21
nanS,9075406,9075406,9075188,218,0,utRho21
napF,4607390,4607390,4606994,396,0,utRho21
narG,2559614,2559728,2559614,114,74,utRho21
narK,2555642,2555914,2555642,272,0,utRho21
narP,4580844,4581000,4580844,156,220,utRho21
narQ,5171154,5171462,5171154,308,0,utRho21
narU,3088326,3088326,3088120,206,24,utRho21
narW,3077374,3077374,3074618,2756,732,utRho21
narX,2555554,2555554,2555236,318,336,utRho21
narZ,3085380,3085380,3085180,200,0,utRho21
ndh,2331984,2332170,2331984,186,158,utRho21
ndk,5289920,5289920,5289728,192,282,utRho21
nemR,6904084,6904092,6904084,8,4,utRho21
nepI,7683542,7683542,7683478,64,2,utRho21
nfo,4501612,4501680,4501612,68,2,utRho21
nfsB,1210906,1210906,1210848,58,76,utRho21
nfuA,7090916,7091248,7090916,332,992,utRho21
nhaA,34634,34978,34634,344,0,utRho21
nhaB,2469534,2469534,2469434,100,0,utRho21
nhoA,3067926,3068048,3067926,122,0,utRho21
nikA,7226878,7227334,7226878,456,238,utRho21
nikR,7237074,7237176,7237074,102,134,utRho21
nirB,6987974,6988022,6987974,48,0,utRho21
nlpA,7680034,7680034,7679986,48,0,utRho21
nlpC,3585654,3585654,3585462,192,242,utRho21
nlpD,5737658,5737658,5737506,152,172,utRho21
nlpI,6618080,6618080,6617848,232,58,utRho21
nmpC,1153740,1153740,1153650,90,244,utRho21
nohA,3273206,3273206,3272734,472,0,utRho21
norR,5664614,5664614,5664578,36,0,utRho21
norV,5664878,5664952,5664878,74,0,utRho21
nrdA,4689510,4689730,4689510,220,15026,utRho21
nrdD,8925676,8925676,8925320,356,98,utRho21
nrdH,5601312,5601446,5601312,134,1368,utRho21
nrdR,865954,866004,865954,50,0,utRho21
nrfA,8575342,8575528,8575342,186,0,utRho21
nsrR,8812088,8812380,8812088,292,286,utRho21
nudB,3897348,3897348,3897264,84,0,utRho21
nudC,8393428,8393806,8393428,378,322,utRho21
nudE,7052658,7052658,7052298,360,200,utRho21
nudG,3682876,3682980,3682876,104,0,utRho21
nudI,4729050,4729108,4729050,58,0,utRho21
nudJ,2388874,2388874,2388576,298,1920,utRho21
nuoA,4810670,4810670,4810144,526,3818,utRho21
nuoN,4783434,4783434,4783010,424,1782,utRho21
nupC,5026018,5026084,5026018,66,0,utRho21
nupG,6211302,6211428,6211302,126,110,utRho21
ogrK,4335096,4335096,4335040,56,152,utRho21
ogt,2800568,2800568,2800472,96,208,utRho21
ohsC,5401036,5401040,5401036,4,0,utRho21
ompA,2040382,2040382,2040106,276,50854,utRho21
ompC,4625774,4625774,4625498,276,268,utRho21
ompF,1974184,1974184,1973964,220,0,utRho21
ompL,8128958,8128958,8128590,368,2,utRho21
ompN,2874158,2874158,2873786,372,0,utRho21
ompR,7073510,7073510,7073168,342,0,utRho21
ompT,1171330,1171330,1171266,64,118,utRho21
ompW,2627982,2628040,2627982,58,0,utRho21
ompX,1700418,1700900,1700418,482,632,utRho21
omrA,5952378,5952378,5952378,0,0,utRho21
omrB,5952770,5952770,5952770,0,0,utRho21
oppA,2602170,2602364,2602170,194,4380,utRho21
orn,8783168,8783208,8783168,40,68,utRho21
osmB,2686952,2686952,2686656,296,198,utRho21
osmC,3113192,3113250,3113192,58,1650,utRho21
osmE,3644566,3644566,3644512,54,2,utRho21
osmF,4439046,4439046,4438962,84,582,utRho21
osmY,9222306,9222792,9222306,486,2056,utRho21
otsA,3963302,3963302,3963224,78,304,utRho21
otsB,3964930,3964930,3964774,156,926,utRho21
oxc,4984288,4984288,4983900,388,0,utRho21
oxyR,8316914,8316980,8316914,66,0,utRho21
oxyS,8316788,8316788,8316788,0,0,utRho21
paaA,2907730,2907854,2907730,124,0,utRho21
paaX,2927018,2927078,2927018,60,114,utRho21
paaZ,2907340,2907340,2907284,56,0,utRho21
pabA,6981702,6981702,6981658,44,0,utRho21
pabB,3789256,3789610,3789256,354,434,utRho21
pabC,2306186,2306600,2306186,414,258,utRho21
pagP,1313052,1313114,1313052,62,0,utRho21
panB,299260,299260,299202,58,106,utRho21
panC,297840,297840,297590,250,718,utRho21
panD,293490,293490,293388,102,0,utRho21
panZ,7195656,7195968,7195656,312,66,utRho21
parC,6332060,6332060,6331946,114,168,utRho21
patA,6438916,6438988,6438916,72,0,utRho21
patD,3030830,3031156,3030830,326,260,utRho21
pbpC,5294986,5294986,5294650,336,28,utRho21
pbpG,4450132,4450132,4449740,392,0,utRho21
pck,7065358,7065636,7065358,278,2214,utRho21
pcnB,318782,318782,318252,530,906,utRho21
pdhR,244068,244184,244068,116,0,utRho21
pdxB,4875768,4875768,4875702,66,0,utRho21
pdxH,3436068,3436068,3436014,54,478,utRho21
pdxJ,5403626,5403626,5403458,168,108,utRho21
pdxK,5074638,5074638,5074474,164,0,utRho21
pepA,8972278,8972278,8971902,376,746,utRho21
pepD,511618,511618,511432,186,14214,utRho21
pepN,1981182,1981244,1981182,62,284,utRho21
pepQ,8062294,8062322,8062294,28,0,utRho21
pepT,2371646,2371688,2371646,42,60,utRho21
pfkA,8214948,8215104,8214948,156,436,utRho21
pfkB,3612646,3612740,3612646,94,46,utRho21
pflA,1902456,1902456,1902160,296,120,utRho21
pflB,1907850,1907850,1907108,742,1912,utRho21
pflD,8287716,8287990,8287716,274,6,utRho21
pgaA,2185046,2185046,2184578,468,4,utRho21
pgi,8467444,8467516,8467444,72,0,utRho21
pgk,12291428,12291428,12290488,940,5312,utRho21
pgl,1597078,1597172,1597078,94,208,utRho21
pgpB,2678324,2678660,2678324,336,0,utRho21
pgpC,5397276,5397276,5397100,176,0,utRho21
pgrR,2783744,2783982,2783744,238,48,utRho21
pheL,5475158,5475198,5475158,40,0,utRho21
pheM,7197204,7197204,7197080,124,116,utRho21
pheP,1203858,1203918,1203858,60,0,utRho21
pheU,8725254,8725254,8725252,2,14,utRho21
pheV,6220730,6220732,6220730,2,12,utRho21
phnC,8650412,8650412,8650330,82,0,utRho21
phoA,803414,803494,803414,80,110,utRho21
phoB,834202,834284,834202,82,30,utRho21
phoE,520316,520316,520200,116,10,utRho21
phoH,2169730,2169984,2169730,254,552,utRho21
phoP,2381016,2381016,2380894,122,4742,utRho21
phoQ,2379880,2379880,2379552,328,1162,utRho21
phoU,7815330,7815330,7815156,174,404,utRho21
phr,1478842,1479014,1478842,172,134,utRho21
pinE,2419054,2419370,2419054,316,0,utRho21
pinQ,3267168,3267244,3267168,76,2,utRho21
pinR,2867424,2867424,2867348,76,0,utRho21
pitA,7275224,7275284,7275224,60,16,utRho21
pitB,6272806,6272806,6272742,64,48,utRho21
pka,5439862,5439906,5439862,44,0,utRho21
plaP,4174476,4174476,4174124,352,2,utRho21
pldA,8009628,8009724,8009628,96,10,utRho21
pldB,8018028,8018340,8018028,312,336,utRho21
plsB,8513196,8513196,8512932,264,122,utRho21
pmbA,8915890,8915918,8915890,28,60,utRho21
pmrD,4747148,4747148,4747076,72,2,utRho21
pncB,1980828,1980828,1980712,116,0,utRho21
pncC,5648788,5648788,5648692,96,0,utRho21
pnp,6622652,6622652,6622336,316,10,utRho21
pntA,3355950,3355950,3355806,144,0,utRho21
pntB,3353096,3353096,3352720,376,158,utRho21
polA,8093880,8093932,8093880,52,56,utRho21
polB,131606,131606,131560,46,0,utRho21
potD,2365700,2365700,2365658,42,0,utRho21
potE,1436688,1436688,1436530,158,0,utRho21
potF,1787268,1787568,1787268,300,0,utRho21
poxB,1822152,1822152,1822098,54,0,utRho21
ppa,8899372,8899372,8899304,68,152,utRho21
ppc,8306380,8306380,8306196,184,440,utRho21
ppdA,5928440,5928440,5928354,86,6,utRho21
ppdD,235410,235410,235098,312,32,utRho21
pphA,3846770,3846770,3845938,832,2362,utRho21
pphB,5719474,5719520,5719474,46,0,utRho21
ppiA,6984898,6984898,6984594,304,0,utRho21
ppiC,7919682,7919682,7919626,56,0,utRho21
ppiD,923638,923830,923638,192,340,utRho21
ppk,5245748,5246088,5245748,340,48,utRho21
pppA,6228958,6228958,6228704,254,344,utRho21
ppsA,3574322,3574322,3574224,98,16,utRho21
ppsR,3574678,3574890,3574678,212,68,utRho21
pptA,3065716,3066104,3065716,388,170,utRho21
pqiA,2023318,2024002,2023318,684,224,utRho21
prc,3830054,3830054,3829632,422,16954,utRho21
preT,4467978,4468066,4467978,88,32,utRho21
prfC,9218688,9218828,9218688,140,1112,utRho21
prkB,6968622,6968980,6968622,358,2650,utRho21
prlC,7290476,7290476,7290364,112,446,utRho21
prlF,6553944,6554004,6553944,60,252,utRho21
proB,520432,520776,520432,344,164,utRho21
proC,811372,811372,811288,84,0,utRho21
proK,7417388,7417388,7417384,4,0,utRho21
proL,4572414,4572422,4572414,8,2,utRho21
proP,8660640,8661004,8660640,364,1268,utRho21
proS,437674,437674,437550,124,178,utRho21
proV,5609126,5609630,5609126,504,40,utRho21
prpB,697292,697364,697292,72,0,utRho21
prpR,696942,696942,696886,56,2,utRho21
prs,2524354,2524354,2523750,604,58694,utRho21
psd,8781276,8781276,8780720,556,1368,utRho21
psiE,8480600,8480650,8480600,50,0,utRho21
pspA,2736076,2736158,2736076,82,0,utRho21
pspF,2736080,2736080,2735824,256,0,utRho21
pspG,8525632,8525680,8525632,48,0,utRho21
pssA,5445156,5445454,5445156,298,7880,utRho21
pstB,7817112,7817112,7816732,380,0,utRho21
pstC,7821084,7821084,7820796,288,108,utRho21
pstS,23469408,23469408,23469150,258,0,utRho21
psuG,4517114,4517114,4516734,380,2174,utRho21
psuT,4514992,4514992,4514670,322,0,utRho21
pth,2517084,2517084,2517026,58,0,utRho21
ptrA,5918022,5918022,5917768,254,32,utRho21
ptrB,3857730,3857730,3857678,52,146,utRho21
ptsG,2315252,2315738,2315252,486,1268,utRho21
ptsH,5066996,5067528,5066996,532,6626,utRho21
purA,8809328,8809374,8809328,46,0,utRho21
purC,5195562,5195562,5195236,326,4,utRho21
purD,8411972,8411972,8411862,110,0,utRho21
purE,1106284,1106284,1106200,84,154,utRho21
purH,8415254,8415254,8415064,190,196,utRho21
purL,5391178,5391178,5391086,92,546,utRho21
purM,5242306,5242394,5242306,88,0,utRho21
purR,3475378,3475688,3475378,310,446,utRho21
purT,3861438,3861762,3861438,324,0,utRho21
purU,2577512,2577512,2577248,264,596,utRho21
putA,2157850,2157850,2157764,86,78,utRho21
putP,2158336,2158610,2158336,274,1246,utRho21
puuA,2721936,2721936,2721816,120,0,utRho21
puuC,2725456,2725486,2725456,30,0,utRho21
puuD,2722104,2722240,2722104,136,0,utRho21
puuP,2718746,2718746,2718374,372,584,utRho21
pykA,3874988,3875298,3874988,310,214,utRho21
pykF,3510934,3511396,3510934,462,1904,utRho21
pyrC,2245286,2245286,2245214,72,196,utRho21
pyrD,2009464,2009536,2009464,72,16,utRho21
pyrE,7631970,7631970,7631536,434,90,utRho21
pyrF,2683740,2683842,2683740,102,18,utRho21
pyrG,5819594,5819594,5819332,262,946,utRho21
pyrH,383624,383710,383624,86,1112,utRho21
pyrL,8945490,8945490,8945066,424,446,utRho21
qmcA,1031646,1031646,1031546,100,0,utRho21
qor,8528608,8528608,8528462,146,104,utRho21
qseB,6339502,6339656,6339502,154,164,utRho21
queA,849970,850022,849970,52,100,utRho21
queE,5811212,5811212,5810836,376,0,utRho21
queF,5850642,5850696,5850642,54,0,utRho21
queG,8788184,8788184,8788134,50,6034,utRho21
racC,2835630,2835630,2835526,104,0,utRho21
racR,2840898,2840898,2840482,416,90,utRho21
raiA,5474208,5474308,5474208,100,438,utRho21
rarD,8008594,8008594,8008356,238,890,utRho21
ravA,7862256,7862256,7862186,70,0,utRho21
rayT,495088,495274,495088,186,0,utRho21
rbn,4763162,4763216,4763162,54,0,utRho21
rbsD,7866644,7866702,7866644,58,46,utRho21
rcnA,4371654,4371834,4371654,180,10,utRho21
rcnB,4373768,4373920,4373768,152,290,utRho21
rcnR,4371806,4371806,4371592,214,20,utRho21
rcsA,4047672,4047936,4047672,264,146,utRho21
rcsB,4631390,4632354,4631390,964,2624,utRho21
rcsC,4640162,4640162,4639656,506,580,utRho21
rcsD,4626904,4626976,4626904,72,198,utRho21
rdgB,6193240,6193362,6193240,122,990,utRho21
rdlA,2538646,2538646,2538646,0,0,utRho21
rdlB,2539712,2539716,2539712,4,0,utRho21
rdlC,2540782,2540786,2540782,4,0,utRho21
rdlD,7400272,7400272,7400272,0,0,utRho21
rdoA,8084782,8084830,8084782,48,148,utRho21
recA,11295276,11295276,11295076,200,552,utRho21
recC,5925014,5925014,5924856,158,16,utRho21
recF,7763722,7763722,7762442,1280,11010,utRho21
recN,5503518,5503590,5503518,72,94,utRho21
recQ,8011666,8011728,8011666,62,0,utRho21
relA,5828554,5828554,5827302,1252,216,utRho21
relB,3291806,3291806,3291744,62,0,utRho21
rem,3289950,3289950,3289804,146,0,utRho21
rep,7921294,7921354,7921294,60,64,utRho21
rfaD,7587730,7587974,7587730,244,146,utRho21
rfaE,6393852,6393852,6393506,346,636,utRho21
rfaH,8049930,8049930,8049642,288,1112,utRho21
rfbX,4219436,4219436,4219168,268,1262,utRho21
rfe,7935600,7935832,7935600,232,24,utRho21
rhaB,8194944,8194944,8194896,48,0,utRho21
rhaD,8188770,8188770,8188544,226,0,utRho21
rhaS,8195422,8195472,8195422,50,0,utRho21
rhaT,8201132,8201132,8201050,82,8,utRho21
rhlE,1661566,1661744,1661566,178,0,utRho21
rhoL,47593944,47594772,47593944,828,44280,utRho21
rhsB,7238006,7238384,7238006,378,28,utRho21
rhsC,1458758,1459166,1458758,408,0,utRho21
rhsD,1046132,1046522,1046132,390,0,utRho21
rhtA,1700608,1700608,1700194,414,76,utRho21
rhtC,8015478,8015514,8015478,36,620,utRho21
ribA,2678468,2678468,2678320,148,0,utRho21
ribC,3486916,3486916,3486484,432,248,utRho21
ribE,869008,869294,869008,286,7750,utRho21
ribF,42766,42814,42766,48,36,utRho21
ridA,8941892,8941892,8941826,66,0,utRho21
rihA,1369204,1369204,1368824,380,40,utRho21
rihB,4510504,4510504,4510372,132,0,utRho21
rimJ,2251044,2251124,2251044,80,0,utRho21
rimK,1783752,1783934,1783752,182,490,utRho21
rimL,2997486,2997876,2997486,390,598,utRho21
rimO,1756140,1756140,1756070,70,0,utRho21
rimP,6636350,6636350,6636012,338,1622,utRho21
rlmA,3814172,3814172,3814120,52,72,utRho21
rlmD,5830086,5830086,5830000,86,120,utRho21
rlmE,6655520,6655520,6655328,192,286,utRho21
rlmF,1684384,1684664,1684384,280,0,utRho21
rlmG,6471784,6471784,6471750,34,18,utRho21
rlmI,2060002,2060002,2059938,64,30,utRho21
rlmJ,7290700,7290770,7290700,70,0,utRho21
rlmL,2015344,2015688,2015344,344,716,utRho21
rlpA,1330444,1330444,1330380,64,146,utRho21
rluA,120900,120900,120692,208,154,utRho21
rluF,8460324,8460708,8460324,384,2,utRho21
rmf,2031006,2031430,2031006,424,274,utRho21
rna,1290068,1290068,1290006,62,0,utRho21
rnb,2698258,2698258,2697824,434,2440,utRho21
rnc,10816892,10816892,10816252,640,4808,utRho21
rnd,3776122,3776122,3775982,140,84,utRho21
rne,2289746,2289746,2288734,1012,13490,utRho21
rnhA,472082,472082,472004,78,1096,utRho21
rnk,1288360,1288360,1287934,426,0,utRho21
rnlA,5531788,5531836,5531788,48,0,utRho21
rnlB,5533414,5533968,5533414,554,718,utRho21
rnpB,19623552,19623552,19623552,0,0,utRho21
rob,9270706,9270706,9270620,86,54,utRho21
rodZ,5285868,5285868,5285688,180,38,utRho21
rpe,7030306,7030306,7030118,188,360,utRho21
rph,15266320,15266320,15266196,124,0,utRho21
rpiA,6118706,6118706,6118650,56,92,utRho21
rpiB,8626514,8626700,8626514,186,2,utRho21
rpiR,8626274,8626274,8625982,292,0,utRho21
rplJ,8359246,8359992,8359246,746,5274,utRho21
rplK,8356708,8356894,8356708,186,436,utRho21
rplM,6757344,6757344,6757302,42,1684,utRho21
rplN,6896444,6896444,6896298,146,1470,utRho21
rplS,5489284,5489284,5489060,224,6620,utRho21
rplT,7199052,7199052,7198996,56,336,utRho21
rplU,6667036,6667036,6666902,134,0,utRho21
rplY,4564866,4565034,4564866,168,0,utRho21
rpmA,6666450,6666450,6666238,212,468,utRho21
rpmB,15247980,15247980,15246696,1284,56048,utRho21
rpmE,8253816,8254026,8253816,210,146,utRho21
rpmF,2294676,2294734,2294676,58,17034,utRho21
rpmH,7768130,7768672,7768130,542,2584,utRho21
rpmI,3600854,3600854,3599998,856,8726,utRho21
rpoB,8362126,8362490,8362126,364,364,utRho21
rpoD,6424946,6426094,6424946,1148,32706,utRho21
rpoE,5420372,5420372,5420024,348,114,utRho21
rpoH,7202006,7202006,7201566,440,5524,utRho21
rpoN,6689324,6689434,6689324,110,158,utRho21
rpoS,5736236,5736236,5735102,1134,16920,utRho21
rpoZ,7644154,7644212,7644154,58,908,utRho21
rppH,5937986,5937986,5937954,32,0,utRho21
rprA,3540744,3540744,3540744,0,0,utRho21
rpsA,1923434,1923990,1923434,556,64858,utRho21
rpsF,8850050,8850236,8850050,186,7078,utRho21
rpsI,6756580,6756580,6756414,166,3482,utRho21
rpsJ,6906884,6906884,6906540,344,2012,utRho21
rpsL,6949242,6949242,6949104,138,126,utRho21
rpsM,6885130,6885130,6884942,188,588,utRho21
rpsO,13247144,13247144,13246736,408,16,utRho21
rpsP,5492508,5492508,5492370,138,18,utRho21
rpsT,42420,42420,42156,264,178,utRho21
rpsU,12842584,12843124,12842584,540,184,utRho21
rraA,8238716,8238716,8238660,56,8,utRho21
rraB,8956768,8956946,8956768,178,0,utRho21
rrsA,8070478,8071062,8070478,584,7902,utRho21
rrsB,16665468,16666636,16665468,1168,15492,utRho21
rrsC,7883032,7883616,7883032,584,6782,utRho21
rrsD,6858094,6858094,6857524,570,584,utRho21
rrsE,8415726,8416294,8415726,568,1274,utRho21
rrsG,5462896,5462896,5462314,582,7570,utRho21
rrsH,446970,447542,446970,572,1308,utRho21
rsd,8393908,8393908,8393616,292,168,utRho21
rseA,5419264,5419264,5418808,456,1380,utRho21
rseP,392940,393092,392940,152,0,utRho21
rseX,4067298,4067298,4067298,0,0,utRho21
rsfS,1338144,1338144,1338072,72,64,utRho21
rsgA,8783132,8783132,8783018,114,132,utRho21
rsmA,105176,105176,104860,316,3332,utRho21
rsmB,6869982,6870414,6869982,432,314,utRho21
rsmC,9215736,9215736,9215400,336,480,utRho21
rsmD,7208594,7208786,7208594,192,138,utRho21
rsmE,6182036,6182268,6182036,232,170,utRho21
rsmG,7847512,7847512,7847360,152,126,utRho21
rsmH,180020,180188,180020,168,482,utRho21
rsmI,6587106,6587106,6586670,436,1566,utRho21
rssA,2578212,2578412,2578212,200,198,utRho21
rssB,2580440,2580484,2580440,44,274,utRho21
rstA,3364276,3364300,3364276,24,0,utRho21
rsuA,4561096,4561096,4560966,130,208,utRho21
rsxA,3411510,3411534,3411510,24,18,utRho21
rtcA,7114004,7114004,7113698,306,4,utRho21
rtcB,7116214,7116214,7116158,56,20,utRho21
rtn,4541356,4541452,4541356,96,0,utRho21
rutA,2148052,2148052,2148022,30,0,utRho21
rutG,2140090,2140090,2139678,412,46,utRho21
rutR,2148226,2148484,2148226,258,2,utRho21
ruvA,7784096,7784096,7783904,192,40,utRho21
ruvB,7782176,7782176,7781424,752,812,utRho21
ruvC,3894878,3894878,3894752,126,0,utRho21
rybB,1776114,1776114,1776114,0,0,utRho21
rydB,3529860,3529860,3529322,538,210,utRho21
rydC,2983012,2983012,2983012,0,0,utRho21
ryfA,5307398,5307710,5307398,312,0,utRho21
ryfD,5468590,5468590,5468590,0,0,utRho21
ryhB,7162032,7162032,7162032,0,0,utRho21
ryjA,8556132,8556132,8556132,0,0,utRho21
ryjB,9055954,9055954,9055954,0,0,utRho21
sad,3229598,3229598,3229406,192,268,utRho21
safA,3168056,3168056,3167918,138,2,utRho21
sanA,4465368,4465756,4465368,388,0,utRho21
sapF,2705314,2705314,2705268,46,0,utRho21
sbcB,4165456,4165512,4165456,56,18,utRho21
sbcC,831694,831694,831506,188,138,utRho21
sbcD,833954,833954,833904,50,0,utRho21
sbmA,793106,793278,793106,172,2,utRho21
sbmC,4162650,4162650,4162524,126,0,utRho21
sdaA,3793618,3793864,3793618,246,1614,utRho21
sdaC,5856070,5856458,5856070,388,1312,utRho21
sdhC,1509916,1510354,1509916,438,39990,utRho21
sdhD,1510808,1511120,1510808,312,15444,utRho21
sdiA,3993834,3993834,3993664,170,16,utRho21
secE,8354354,8354716,8354354,362,80,utRho21
secG,6645180,6645180,6645010,170,578,utRho21
selA,7522594,7522594,7522498,96,286,utRho21
selB,7519850,7519850,7519722,128,776,utRho21
selC,7672396,7672444,7672396,48,0,utRho21
selD,3696058,3696058,3696016,42,6416,utRho21
seqA,1425884,1425974,1425884,90,374,utRho21
serA,6117098,6117098,6116820,278,2,utRho21
serB,9249712,9249790,9249712,78,212,utRho21
serC,3830380,3830612,3830380,232,0,utRho21
serS,1878730,1878856,1878730,126,1062,utRho21
serT,2063438,2063438,2063424,14,0,utRho21
serU,4087124,4087124,4087114,10,106,utRho21
serV,5637394,5637394,5637290,104,2,utRho21
serW,1852014,1852014,1851942,72,346,utRho21
serX,2195352,2195352,2195304,48,60,utRho21
setB,4527426,4527726,4527426,300,0,utRho21
setC,7673488,7673906,7673488,418,14,utRho21
sfmA,1116124,1116424,1116124,300,0,utRho21
sfmC,1117606,1117948,1117606,342,34,utRho21
sfsA,323030,323030,322972,58,546,utRho21
sfsB,6669592,6669818,6669592,226,158,utRho21
sgrR,154676,154676,154598,78,0,utRho21
sgrS,154734,154734,154734,0,0,utRho21
shiA,4107068,4107286,4107068,218,0,utRho21
sibA,4306622,4306622,4306622,0,0,utRho21
sibB,4307292,4307292,4307292,0,0,utRho21
sibC,6113702,6113702,6113702,0,0,utRho21
sibD,6389730,6389730,6389730,0,0,utRho21
sibE,6390480,6390480,6390480,0,0,utRho21
sixA,4913998,4913998,4913624,374,54,utRho21
slp,7307872,7307922,7307872,50,0,utRho21
slt,9261400,9261466,9261400,66,0,utRho21
slyA,3442028,3442028,3441648,380,60,utRho21
slyB,3439496,3439752,3439496,256,44,utRho21
slyD,6957398,6957398,6956994,404,1470,utRho21
slyX,6954862,6955280,6954862,418,3524,utRho21
smf,6867372,6867372,6867120,252,26,utRho21
smpB,5509534,5509792,5509534,258,982,utRho21
smrA,2811872,2811958,2811872,86,418,utRho21
smrB,4896872,4897212,4896872,340,268,utRho21
smtA,1946808,1947074,1946808,266,0,utRho21
sodA,8201518,8201620,8201518,102,18494,utRho21
sodB,3470646,3470756,3470646,110,98,utRho21
sodC,3449358,3449358,3449310,48,176,utRho21
sohB,2658568,2658664,2658568,96,0,utRho21
sokB,2984232,2984238,2984232,6,244,utRho21
solA,2241218,2241218,2241172,46,0,utRho21
soxR,8554894,8554938,8554894,44,102,utRho21
soxS,8554846,8554846,8554766,80,0,utRho21
speA,6172096,6172096,6171822,274,4,utRho21
speB,6167892,6167892,6167594,298,26,utRho21
speC,6218350,6218350,6218310,40,0,utRho21
spf,8099798,8099798,8099798,0,0,utRho21
sppA,3697422,3697674,3697422,252,4,utRho21
spy,3651376,3651376,3651250,126,0,utRho21
sra,3112092,3112092,3111926,166,176,utRho21
sraB,2293178,2293178,2293178,0,0,utRho21
sraC,3846132,3846132,3846132,0,0,utRho21
srlA,5651582,5651664,5651582,82,52,utRho21
srlR,5657720,5658094,5657720,374,23568,utRho21
srmB,5425752,5425792,5425752,40,544,utRho21
sroA,151216,151216,151216,0,0,utRho21
sroG,6369436,6369436,6369436,0,0,utRho21
sroH,8380974,8380974,8380974,0,0,utRho21
ssb,8548022,8548250,8548022,228,0,utRho21
sseA,5304782,5304988,5304782,206,14502,utRho21
sspA,6755138,6755138,6754840,298,1056,utRho21
ssrA,5511014,5511186,5511014,172,350,utRho21
ssrS,12223036,12223932,12223036,896,2768,utRho21
sstT,6479726,6479888,6479726,162,0,utRho21
ssuB,1988282,1988282,1988088,194,66,utRho21
ssuE,1995126,1995126,1995024,102,0,utRho21
sthA,8321604,8321604,8321580,24,5390,utRho21
stpA,5597156,5597156,5596990,166,0,utRho21
sucA,3034344,3034824,3034344,480,5960,utRho21
sufA,3528836,3528836,3528772,64,728,utRho21
sufE,3518962,3518962,3518580,382,2634,utRho21
sugE,8753588,8753750,8753588,162,908,utRho21
sulA,2041894,2041894,2041838,56,38,utRho21
syd,5850738,5850738,5850560,178,116,utRho21
symE,9159834,9159834,9159680,154,2,utRho21
symR,9159670,9159670,9159670,0,0,utRho21
tabA,8949566,8949724,8949566,158,0,utRho21
talA,5157140,5157332,5157140,192,0,utRho21
talB,16382,16476,16382,94,28372,utRho21
tam,3214442,3214692,3214442,250,696,utRho21
tamA,8884540,8884764,8884540,224,52,utRho21
tar,3945432,3945432,3945382,50,0,utRho21
tas,5943138,5943194,5943138,56,346,utRho21
tatA,16087636,16087780,16087636,144,0,utRho21
tatE,1317742,1317894,1317742,152,2,utRho21
tauA,770410,770464,770410,54,0,utRho21
tdcA,6534186,6534186,6534130,56,0,utRho21
tdcG,6519652,6519652,6519298,354,166,utRho21
tdcR,6534380,6534760,6534380,380,0,utRho21
tdk,2586986,2587054,2586986,68,48,utRho21
tehA,3001072,3001146,3001072,74,0,utRho21
tesA,1039898,1039898,1039530,368,146,utRho21
tesB,950402,950402,950322,80,0,utRho21
tfaE,2418532,2418532,2418238,294,4,utRho21
tfaQ,3269912,3269912,3269770,142,0,utRho21
tff,379424,379256,379424,168,228,utRho21
tgt,852110,852274,852110,164,174,utRho21
thiD,4369346,4369346,4369032,314,0,utRho21
thiI,882936,883098,882936,162,124,utRho21
thiM,4370902,4370902,4370602,300,374,utRho21
thiQ,146170,146170,145854,316,196,utRho21
thrL,592,760,592,168,544,utRho21
thrS,7210932,7210932,7210280,652,424,utRho21
thrU,8350762,8350776,8350762,14,0,utRho21
thrV,6847414,6847414,6847310,104,332690,utRho21
thrW,525682,525742,525682,60,294,utRho21
thyA,5930696,5930696,5930310,386,2174,utRho21
tig,909986,910266,909986,280,604,utRho21
tisB,7706674,7707106,7706674,432,930,utRho21
tktA,6163414,6163414,6163270,144,176,utRho21
tktB,5158616,5159272,5158616,656,62634,utRho21
tldD,6784368,6784368,6784056,312,60,utRho21
tmcA,5191876,5191876,5191718,158,6,utRho21
tnaC,15553644,15553740,15553644,96,63912,utRho21
tolB,1555074,1555480,1555074,406,270,utRho21
tolC,6356008,6356230,6356008,222,146,utRho21
tomB,961588,961588,961416,172,698,utRho21
tonB,2622108,2622178,2622108,70,0,utRho21
topA,2661578,2662096,2661578,518,230,utRho21
torC,2116112,2116168,2116112,56,256,utRho21
torR,2115968,2115968,2115908,60,740,utRho21
torS,2112364,2112364,2112356,8,0,utRho21
torT,2112414,2112522,2112414,108,0,utRho21
tpiA,8223138,8223138,8223014,124,270,utRho21
tppB,3425342,3425538,3425342,196,1346,utRho21
tpr,2574376,2574376,2574376,0,0,utRho21
tpx,2777688,2777688,2777622,66,1112,utRho21
tqsA,3347780,3347826,3347780,46,0,utRho21
treA,2494850,2494850,2494752,98,6,utRho21
treB,8932420,8932420,8932360,60,0,utRho21
treF,7339102,7339184,7339102,82,0,utRho21
treR,8934694,8934694,8934492,202,0,utRho21
trg,2984878,2984940,2984878,62,0,utRho21
trkG,2847342,2847564,2847342,222,0,utRho21
trmA,8326590,8326590,8326540,50,128,utRho21
trpA,2634678,2634678,2634444,234,786,utRho21
trpC,2639888,2639888,2639570,318,72,utRho21
trpL,5292432,5292432,5292328,104,0,utRho21
trpR,9265408,9265520,9265408,112,524,utRho21
trpS,7027394,7027394,7027276,118,3128,utRho21
trpT,7893560,7893914,7893560,354,124984,utRho21
trxA,7931294,7931522,7931294,228,724,utRho21
trxB,1864156,1864156,1864100,56,0,utRho21
trxC,5437350,5437470,5437350,120,592,utRho21
tsaD,6421256,6421256,6421086,170,156,utRho21
tsgA,6985038,6985136,6985038,98,2,utRho21
tsr,9182824,9183314,9182824,490,6,utRho21
tsx,864490,864490,864026,464,518,utRho21
ttcA,2823970,2823970,2823896,74,1128,utRho21
ttdA,6412848,6412926,6412848,78,0,utRho21
ttdR,6412760,6412760,6412512,248,0,utRho21
tufA,6943448,6943448,6942658,790,102730,utRho21
tus,3368346,3368518,3368346,172,20,utRho21
tusA,7218040,7218040,7217992,48,208,utRho21
tusB,6950218,6950218,6949930,288,630,utRho21
tynA,2902996,2902996,2902698,298,0,utRho21
typA,8116460,8116814,8116460,354,2234,utRho21
tyrB,8534164,8534228,8534164,64,2068,utRho21
tyrP,3979004,3979362,3979004,358,0,utRho21
tyrR,2773384,2773440,2773384,56,66,utRho21
tyrS,3434566,3434566,3434444,122,52,utRho21
tyrT,2575330,2575330,2575244,86,170,utRho21
uacT,6062378,6062734,6062378,356,104,utRho21
ubiC,8504886,8505012,8504886,126,0,utRho21
ubiD,8049618,8049976,8049618,358,1212,utRho21
ubiE,8037494,8037710,8037494,216,2,utRho21
ubiG,4679078,4679134,4679078,56,0,utRho21
ucpA,5089342,5089342,5089246,96,0,utRho21
udp,8032782,8032862,8032782,80,180,utRho21
ugd,4199470,4199470,4199226,244,0,utRho21
ugpB,7184852,7184852,7184650,202,958,utRho21
ugpQ,7176600,7176600,7176226,374,366,utRho21
uhpT,7694396,7694396,7694334,62,0,utRho21
uidA,3392304,3392304,3392142,162,0,utRho21
uidC,3386012,3386012,3385702,310,60,utRho21
uidR,3394150,3394150,3394104,46,332,utRho21
ulaA,8839854,8839960,8839854,106,0,utRho21
ulaG,8839350,8839350,8839250,100,0,utRho21
ulaR,8837124,8837124,8836906,218,122,utRho21
umpG,5741372,5741372,5740548,824,794,utRho21
umpH,1400704,1400704,1400652,52,14,utRho21
umuD,2461476,2461534,2461476,58,0,utRho21
ung,5433476,5433508,5433476,32,0,utRho21
uof,2843316,2843316,2842900,416,7752,utRho21
upp,5241818,5241818,5241744,74,152,utRho21
usg,4873780,4873780,4873298,482,384,utRho21
ushA,1009772,1009828,1009772,56,0,utRho21
uspA,7279966,7280222,7279966,256,1958,utRho21
uspB,7279696,7279696,7279440,256,818,utRho21
uspC,3959172,3959506,3959172,334,0,utRho21
uspE,2797318,2797318,2797244,74,52,utRho21
uspF,2871282,2871282,2871238,44,0,utRho21
uspG,1283806,1283806,1283734,72,1058,utRho21
uvrA,8547872,8547872,8547742,130,352,utRho21
uvrB,1626304,1627052,1626304,748,3030,utRho21
uvrC,3989758,3989758,3989412,346,396,utRho21
uvrD,7995814,7995966,7995814,152,86,utRho21
uvrY,3990812,3990812,3990718,94,76,utRho21
uxaB,3221474,3221474,3221360,114,42,utRho21
uxaC,6489714,6489714,6489482,232,90,utRho21
uxuA,9103036,9103272,9103036,236,1130,utRho21
uxuR,9108916,9109152,9108916,236,12,utRho21
valS,8967854,8967854,8967674,180,768,utRho21
valU,5041848,5041862,5041848,14,0,utRho21
valV,3492830,3492870,3492830,40,0,utRho21
ves,3649968,3649968,3649874,94,0,utRho21
waaA,7616512,7617080,7616512,568,148,utRho21
waaH,7580298,7580298,7580162,136,0,utRho21
waaQ,7616476,7616476,7616196,280,132,utRho21
waaU,7598996,7598996,7598624,372,96,utRho21
waaY,7602272,7602272,7601930,342,2896,utRho21
wbbH,4214888,4214888,4214452,436,3878,utRho21
wbbK,4209212,4209212,4209018,194,298,utRho21
wcaM,4231868,4231868,4231792,76,0,utRho21
wrbA,2135516,2135516,2135416,100,0,utRho21
wza,4275166,4275166,4274486,680,0,utRho21
wzxC,4240674,4240674,4240316,358,0,utRho21
wzzB,4196950,4196950,4196602,348,0,utRho21
xanP,7657642,7657890,7657642,248,0,utRho21
xanQ,6048520,6048702,6048520,182,0,utRho21
xapA,5049820,5049820,5049756,64,0,utRho21
xapR,10090252,10090252,10089908,344,168,utRho21
xdhA,6000514,6000690,6000514,176,128,utRho21
xerD,6079702,6079702,6079486,216,0,utRho21
xseA,5268394,5268464,5268394,70,0,utRho21
xseB,882746,882746,882686,60,512,utRho21
xthA,3664798,3664856,3664798,58,0,utRho21
xylA,7461614,7461614,7461530,84,1532,utRho21
xylE,8484540,8484540,8484508,32,0,utRho21
xylF,7462138,7462262,7462138,124,0,utRho21
xylR,7469812,7469958,7469812,146,0,utRho21
yaaA,13230,13230,12918,312,80,utRho21
yaaI,23876,23876,23572,304,4,utRho21
yaaJ,16034,16034,15918,116,84,utRho21
yaaU,91184,91614,91184,430,4,utRho21
yaaW,23084,23084,22712,372,4,utRho21
yaaX,10060,10468,10060,408,98,utRho21
yabI,142542,142702,142542,160,436,utRho21
yacC,273880,273880,273834,46,336,utRho21
yacH,262932,262932,262520,412,136,utRho21
yacL,268678,268776,268678,98,4,utRho21
yadD,293796,293936,293796,140,0,utRho21
yadE,289930,290162,289930,232,586,utRho21
yadN,314110,314110,313766,344,0,utRho21
yadS,355572,355572,355248,324,18,utRho21
yadV,312470,312470,312402,68,248,utRho21
yaeF,434270,434270,434006,264,0,utRho21
yaeP,428374,428374,428250,124,0,utRho21
yaeQ,428176,428582,428176,406,84,utRho21
yaeR,423716,423754,423716,38,260,utRho21
yafC,462166,462166,461762,404,300,utRho21
yafD,462128,462244,462128,116,4,utRho21
yafK,491986,491986,491610,376,998,utRho21
yafL,493282,493424,493282,142,30,utRho21
yafN,503938,504010,503938,72,0,utRho21
yafS,469568,469632,469568,64,1292,utRho21
yafT,474470,474670,474470,200,0,utRho21
yafV,480432,480432,480378,54,36,utRho21
yafZ,536052,536052,536010,42,120,utRho21
yagE,564446,564556,564446,110,2,utRho21
yagG,570414,570790,570414,376,8,utRho21
yagI,578384,578384,578324,60,0,utRho21
yagK,586236,586236,585896,340,84,utRho21
yagL,588062,588062,587836,226,4,utRho21
yagN,591342,591342,591158,184,4574,utRho21
yahA,663746,664742,663746,996,364,utRho21
yahC,670136,670136,670044,92,10,utRho21
yahE,671478,671850,671478,372,0,utRho21
yahM,690504,690808,690504,304,18,utRho21
yahN,692872,692872,692674,198,78,utRho21
yahO,692864,692968,692864,104,78,utRho21
yaiE,816296,816354,816296,58,244,utRho21
yaiI,811396,811528,811396,132,0,utRho21
yaiO,761946,761946,761684,262,16,utRho21
yaiP,767970,767970,767870,100,0,utRho21
yaiS,769660,769660,769232,428,12,utRho21
yaiV,788922,788922,788922,0,0,utRho21
yaiY,799094,799094,798666,428,12,utRho21
yaiZ,798888,799186,798888,298,0,utRho21
yajC,854410,854574,854410,164,802,utRho21
yajD,860938,861210,860938,272,372,utRho21
yajI,866068,866068,865702,366,682,utRho21
yajL,887496,887496,887282,214,772,utRho21
yajQ,889316,889366,889316,50,114,utRho21
yajR,893374,893374,893332,42,0,utRho21
ybaB,987418,988152,987418,734,2348,utRho21
ybaL,1006590,1006590,1006476,114,4,utRho21
ybaM,980648,980648,980542,106,252,utRho21
ybaN,981436,981764,981436,328,1070,utRho21
ybaO,936704,936766,936704,62,0,utRho21
ybaP,1016568,1016568,1016160,408,1454,utRho21
ybaQ,1016348,1016436,1016348,88,58,utRho21
ybaS,1023146,1023282,1023146,136,446,utRho21
ybaV,927504,927874,927504,370,2,utRho21
ybaY,950490,950758,950490,268,2938,utRho21
ybbB,1062724,1062724,1062452,272,68,utRho21
ybbJ,1030154,1030154,1029718,436,560,utRho21
ybbL,1031784,1031838,1031784,54,0,utRho21
ybbN,1037136,1037136,1036558,578,2804,utRho21
ybbO,1038658,1038658,1038298,360,1486,utRho21
ybbY,1080718,1081130,1080718,412,1526,utRho21
ybcH,1176140,1176140,1175962,178,2,utRho21
ybcI,1113264,1113264,1113106,158,112,utRho21
ybcJ,1114050,1114050,1113746,304,328,utRho21
ybcK,1137502,1137804,1137502,302,2,utRho21
ybcL,1141690,1141786,1141690,96,0,utRho21
ybcN,1144628,1144932,1144628,304,0,utRho21
ybcQ,1147548,1147912,1147548,364,14,utRho21
ybcW,1159610,1159760,1159610,150,0,utRho21
ybdD,1263982,1264364,1263982,382,278,utRho21
ybdF,1212106,1212106,1211772,334,170,utRho21
ybdH,1267048,1267048,1266954,94,0,utRho21
ybdJ,1212822,1212822,1212398,424,2,utRho21
ybdK,1215122,1215122,1214766,356,4,utRho21
ybdL,1267114,1267172,1267114,58,0,utRho21
ybdM,1271110,1271110,1270752,358,10,utRho21
ybdN,1273372,1273372,1273138,234,0,utRho21
ybdR,1283844,1284176,1283844,332,1288,utRho21
ybeD,1325412,1325412,1325284,128,220,utRho21
ybeF,1323090,1323090,1322756,334,56,utRho21
ybeL,1349986,1350036,1349986,50,950,utRho21
ybeQ,1353412,1353412,1353094,318,0,utRho21
ybeR,1353120,1353422,1353120,302,0,utRho21
ybeT,1358832,1358832,1358812,20,0,utRho21
ybeU,1358924,1359016,1358924,92,0,utRho21
ybeZ,1386938,1386938,1386834,104,1142,utRho21
ybfA,1458074,1458268,1458074,194,6,utRho21
ybfE,1423878,1423878,1423796,82,20,utRho21
ybfF,1425692,1425692,1425604,88,228,utRho21
ybfH,1433282,1433282,1433194,88,0,utRho21
ybgA,1477840,1478002,1477840,162,0,utRho21
ybgC,1549288,1549504,1549288,216,0,utRho21
ybgD,1505916,1505916,1505590,326,12,utRho21
ybgI,1485238,1485654,1485238,416,0,utRho21
ybgO,1498370,1498370,1497964,406,0,utRho21
ybgS,1570992,1570992,1570634,358,1372,utRho21
ybhA,1597184,1597184,1596862,322,208,utRho21
ybhB,1616070,1616070,1615818,252,60,utRho21
ybhC,1614642,1614642,1614562,80,3112,utRho21
ybhD,1601418,1601418,1601276,142,0,utRho21
ybhH,1601104,1601518,1601104,414,0,utRho21
ybhK,1633384,1633384,1633294,90,2,utRho21
ybhM,1641556,1641586,1641556,30,0,utRho21
ybhN,1645296,1645296,1644996,300,516,utRho21
ybhQ,1649202,1649260,1649202,58,0,utRho21
ybiA,1665920,1665920,1665900,20,0,utRho21
ybiI,1676968,1676968,1676912,56,150,utRho21
ybiO,1691328,1691328,1690960,368,124,utRho21
ybiP,1705252,1705252,1705194,58,46,utRho21
ybiS,1711572,1711572,1711488,84,508,utRho21
ybiT,1711894,1711926,1711894,32,0,utRho21
ybiU,1718212,1718212,1718122,90,0,utRho21
ybiV,1720176,1720176,1720056,120,0,utRho21
ybiW,1725566,1725566,1725212,354,1456,utRho21
ybiX,1678548,1678548,1678414,134,164,utRho21
ybjC,1781784,1781826,1781784,42,0,utRho21
ybjE,1830154,1830154,1829714,440,470,utRho21
ybjG,1767016,1767016,1766776,240,1374,utRho21
ybjL,1779882,1779882,1779638,244,4,utRho21
ybjM,1779770,1780178,1779770,408,2,utRho21
ybjO,1795704,1795978,1795704,274,0,utRho21
ybjP,1809046,1809046,1808934,112,110,utRho21
ybjQ,1809034,1809186,1809034,152,410,utRho21
ybjS,1813796,1813796,1813506,290,152,utRho21
ybjX,1838206,1838206,1838168,38,0,utRho21
ycaD,1891438,1891742,1891438,304,0,utRho21
ycaI,1928210,1928640,1928210,430,0,utRho21
ycaK,1899094,1899336,1899094,242,26,utRho21
ycaL,1920264,1920528,1920264,264,0,utRho21
ycaM,1894240,1894458,1894240,218,164,utRho21
ycaR,1941284,1941346,1941284,62,648,utRho21
ycbB,1961862,1962094,1961862,232,4,utRho21
ycbJ,1943344,1943504,1943344,160,0,utRho21
ycbK,1966046,1966150,1966046,104,578,utRho21
ycbZ,2036920,2036920,2036598,322,18,utRho21
yccA,2062886,2062886,2062836,50,28,utRho21
yccF,2048730,2048730,2048696,34,0,utRho21
yccS,2047988,2047988,2047766,222,68,utRho21
yccT,2055674,2055674,2055546,128,90,utRho21
yccX,2059960,2060128,2059960,168,30,utRho21
ycdT,2185682,2185752,2185682,70,0,utRho21
ycdU,2191266,2191686,2191266,420,4,utRho21
ycdZ,2200504,2200592,2200504,88,128,utRho21
yceA,2233544,2233614,2233544,70,52,utRho21
yceD,2293298,2293588,2293298,290,1992,utRho21
yceF,2293522,2293522,2293190,332,1154,utRho21
yceH,2252154,2252314,2252154,160,6512,utRho21
yceI,2237282,2237282,2236952,330,948,utRho21
yceJ,2238142,2238142,2238092,50,0,utRho21
yceM,2253208,2253612,2253208,404,638,utRho21
yceO,2239264,2239264,2238894,370,192,utRho21
yceQ,2288760,2289004,2288760,244,9404,utRho21
ycfD,2376540,2376540,2376480,60,212,utRho21
ycfJ,2334814,2335198,2334814,384,4,utRho21
ycfS,2340834,2340834,2340748,86,28,utRho21
ycfT,2350658,2350658,2350330,328,24,utRho21
ycfZ,2362760,2362760,2362534,226,0,utRho21
ycgB,2474570,2474570,2474482,88,2,utRho21
ycgG,2434614,2434656,2434614,42,412,utRho21
ycgJ,2452956,2453200,2452956,244,4,utRho21
ycgL,2455218,2455362,2455218,144,162,utRho21
ycgN,2457366,2457660,2457366,294,92,utRho21
ycgR,2489112,2489112,2489054,58,0,utRho21
ycgV,2512222,2512222,2511904,318,338,utRho21
ycgX,2426568,2426568,2426214,354,816,utRho21
ycgY,2490166,2490320,2490166,154,4,utRho21
ycgZ,2431504,2431578,2431504,74,0,utRho21
ychE,2596904,2597196,2596904,292,0,utRho21
ychF,2515764,2515764,2515624,140,66,utRho21
ychH,2517476,2517582,2517476,106,162,utRho21
ychJ,2578354,2578354,2578264,90,0,utRho21
ychN,2547310,2547310,2547198,112,0,utRho21
ychO,2547520,2547850,2547520,330,144,utRho21
ychQ,2533798,2533848,2533798,50,0,utRho21
yciA,2624828,2624828,2624492,336,122,utRho21
yciB,2626110,2626110,2625780,330,5916,utRho21
yciC,2627396,2627396,2627326,70,0,utRho21
yciE,2630794,2630794,2630448,346,1048,utRho21
yciG,5264368,5264368,5264140,228,0,utRho21
yciI,2621784,2621784,2621730,54,0,utRho21
yciN,2661606,2661606,2661336,270,252,utRho21
yciS,2680270,2680486,2680270,216,0,utRho21
yciT,2689088,2689088,2688692,396,454,utRho21
yciU,2614718,2614718,2614300,418,566,utRho21
yciV,2646376,2646440,2646376,64,0,utRho21
yciW,2700472,2700472,2700214,258,132,utRho21
yciZ,2689276,2689276,2689218,58,160,utRho21
ycjD,2703792,2703792,2703520,272,0,utRho21
ycjG,2777748,2777860,2777748,112,150,utRho21
ycjM,2740006,2740432,2740006,426,0,utRho21
ycjW,2767982,2767982,2767922,60,24,utRho21
ycjX,2768138,2768234,2768138,96,80,utRho21
ycjY,5568288,5568288,5567460,828,96,utRho21
ydaE,2836438,2836438,2836016,422,0,utRho21
ydaN,2816048,2816100,2816048,52,114,utRho21
ydaS,2840340,2840730,2840340,390,150,utRho21
ydbC,2948376,2948442,2948376,66,0,utRho21
ydbD,2950132,2950288,2950132,156,0,utRho21
ydbH,2885800,2886102,2885800,302,254,utRho21
ydbJ,2881712,2882116,2881712,404,24,utRho21
ydbK,2881692,2881692,2881568,124,44,utRho21
ydcA,2983294,2983354,2983294,60,52,utRho21
ydcF,2974404,2974470,2974404,66,82,utRho21
ydcI,2990268,2990268,2990142,126,0,utRho21
ydcJ,2990266,2990576,2990266,310,0,utRho21
ydcK,3001280,3001280,3000898,382,0,utRho21
ydcL,3004646,3004914,3004646,268,0,utRho21
ydcN,3012308,3012344,3012308,36,72,utRho21
ydcP,3013508,3013562,3013508,54,118,utRho21
ydcR,3019956,3020006,3019956,50,78,utRho21
ydcS,3022906,3023308,3022906,402,34,utRho21
ydcX,3034442,3034778,3034442,336,0,utRho21
ydcY,3035220,3035296,3035220,76,0,utRho21
ydcZ,3036750,3036750,3036662,88,158,utRho21
yddB,3155332,3155332,3155238,94,26,utRho21
yddE,3071738,3071738,3071716,22,0,utRho21
yddG,3094410,3094410,3094338,72,0,utRho21
yddJ,3089732,3089732,3089438,294,0,utRho21
yddW,3137704,3137704,3137646,58,0,utRho21
ydeA,3233910,3234056,3233910,146,74,utRho21
ydeE,3242528,3242664,3242528,136,2,utRho21
ydeI,3249118,3249118,3248994,124,4,utRho21
ydeJ,3249376,3249546,3249376,170,30,utRho21
ydeN,3165458,3165458,3165048,410,0,utRho21
ydeP,3173328,3173328,3172972,356,48,utRho21
ydeR,3176596,3176596,3176592,4,4,utRho21
ydfA,3296872,3297016,3296872,144,62,utRho21
ydfG,3254982,3255034,3254982,52,0,utRho21
ydfH,3256652,3256704,3256652,52,18,utRho21
ydfK,3265446,3266144,3265446,698,244,utRho21
ydgA,3379588,3379704,3379588,116,232,utRho21
ydgC,3364124,3364124,3364060,64,56,utRho21
ydgD,3343906,3343920,3343906,14,0,utRho21
ydgH,3356754,3356854,3356754,100,52,utRho21
ydgJ,3408798,3408798,3408616,182,120,utRho21
ydgK,3410414,3410500,3410414,86,238,utRho21
ydhB,3479618,3479618,3479596,22,0,utRho21
ydhC,3479698,3479822,3479698,124,0,utRho21
ydhF,3451310,3451310,3451264,46,0,utRho21
ydhI,3441996,3442050,3441996,54,0,utRho21
ydhL,3451864,3451864,3451840,24,2,utRho21
ydhQ,3492404,3492404,3492254,150,0,utRho21
ydhS,3494136,3494262,3494136,126,52,utRho21
ydhT,3499138,3499138,3499118,20,0,utRho21
ydhY,3509284,3509284,3508954,330,0,utRho21
ydhZ,3510418,3510418,3510282,136,4,utRho21
ydiE,3579206,3579226,3579206,20,0,utRho21
ydiH,3530582,3530582,3530406,176,68,utRho21
ydiM,3541852,3542142,3541852,290,418,utRho21
ydiN,3544818,3545024,3544818,206,0,utRho21
ydiP,3558656,3558656,3558602,54,2,utRho21
ydiU,3582508,3582508,3582488,20,0,utRho21
ydiV,3584174,3584174,3584040,134,352,utRho21
ydiY,3612500,3612500,3612166,334,0,utRho21
ydjA,3697400,3697400,3697352,48,74,utRho21
ydjE,3708082,3708082,3707958,124,0,utRho21
ydjF,3709848,3709848,3709708,140,0,utRho21
ydjM,3620340,3620422,3620340,82,0,utRho21
ydjO,3626696,3626696,3626288,408,0,utRho21
ydjX,3666434,3666802,3666434,368,780,utRho21
yeaE,3731448,3731448,3731272,176,2,utRho21
yeaG,3733530,3733816,3733530,286,354,utRho21
yeaI,3740486,3740770,3740486,284,0,utRho21
yeaJ,3743874,3744082,3743874,208,182,utRho21
yeaL,3748646,3748704,3748646,58,514,utRho21
yeaM,3751296,3751296,3751152,144,0,utRho21
yeaN,3750926,3751346,3750926,420,316,utRho21
yeaO,3753554,3753818,3753554,264,20,utRho21
yeaP,3755314,3755430,3755314,116,1084,utRho21
yeaQ,3758780,3758780,3758510,270,144,utRho21
yeaR,3759988,3759988,3759896,92,0,utRho21
yeaY,3781122,3781122,3781064,58,228,utRho21
yebB,3892220,3892502,3892220,282,0,utRho21
yebC,3896370,3896370,3896302,68,2,utRho21
yebE,3859464,3859464,3859414,50,0,utRho21
yebG,3861530,3861530,3861494,36,0,utRho21
yebK,3873180,3873304,3873180,124,98,utRho21
yebQ,3820314,3820552,3820314,238,42,utRho21
yebS,3832238,3832516,3832238,278,0,utRho21
yebV,3843430,3843560,3843430,130,0,utRho21
yebW,3843914,3844242,3843914,328,18222,utRho21
yecC,3995646,3995646,3995628,18,0,utRho21
yecD,3901272,3901664,3901272,392,128,utRho21
yecF,3991434,3991636,3991434,202,0,utRho21
yecH,3979304,3979304,3978980,324,0,utRho21
yecJ,3975604,3975604,3975516,88,0,utRho21
yecM,3919968,3919968,3919692,276,2,utRho21
yecR,3976400,3976444,3976400,44,0,utRho21
yecT,3923862,3923944,3923862,82,0,utRho21
yedD,4016522,4016522,4016180,342,22,utRho21
yedE,4016310,4016554,4016310,244,48,utRho21
yedI,4058922,4058922,4058732,190,0,utRho21
yedJ,4066446,4066446,4066158,288,60,utRho21
yedV,4076404,4076404,4076304,100,142,utRho21
yedX,4077680,4077912,4077680,232,0,utRho21
yedY,4078572,4078956,4078572,384,0,utRho21
yeeA,4161322,4161322,4161182,140,68,utRho21
yeeE,4171104,4171104,4171050,54,0,utRho21
yeeJ,4089526,4089822,4089526,296,0,utRho21
yeeN,4113508,4113716,4113508,208,0,utRho21
yeeO,4119444,4119444,4119692,248,0,utRho21
yeeX,4158834,4158834,4158722,112,598,utRho21
yeeZ,4178422,4178422,4178256,166,0,utRho21
yefM,4179466,4179466,4179426,40,106,utRho21
yegD,4295288,4295348,4295288,60,154,utRho21
yegH,4275726,4275804,4275726,78,56,utRho21
yegI,4302154,4302154,4301970,184,0,utRho21
yegJ,4302032,4302370,4302032,338,0,utRho21
yegQ,4331182,4331336,4331182,154,94,utRho21
yegR,4336698,4336698,4336612,86,2,utRho21
yegS,4337086,4337424,4337086,338,0,utRho21
yegT,4357562,4357642,4357562,80,0,utRho21
yegX,4367640,4367640,4367302,338,0,utRho21
yehA,4376944,4376944,4376828,116,116,utRho21
yehE,4385818,4385818,4385592,226,258,utRho21
yehK,4407568,4407944,4407568,376,0,utRho21
yehL,4408804,4409192,4408804,388,0,utRho21
yeiB,4486146,4486146,4485934,212,118,utRho21
yeiE,4499422,4499422,4499236,186,0,utRho21
yeiG,4487776,4487820,4487776,44,674,utRho21
yeiH,4499332,4499434,4499332,102,154,utRho21
yeiI,4503306,4503400,4503306,94,606,utRho21
yeiL,4510580,4510710,4510580,130,0,utRho21
yeiP,4530834,4530900,4530834,66,486,utRho21
yeiQ,4532328,4532490,4532328,162,102,utRho21
yeiR,4535484,4535658,4535484,174,266,utRho21
yeiW,4530840,4530840,4530590,250,820,utRho21
yejA,4544624,4544728,4544624,104,0,utRho21
yejG,4556892,4556892,4556474,418,918,utRho21
yejH,4561244,4561264,4561244,20,0,utRho21
yejK,4568218,4568218,4567894,324,700,utRho21
yejO,4578352,4578352,4577800,552,222,utRho21
yfaD,4713380,4713808,4713380,428,0,utRho21
yfaE,4696676,4697028,4696676,352,1212,utRho21
yfaL,4688568,4688568,4688338,230,0,utRho21
yfaP,4656398,4656398,4656286,112,0,utRho21
yfaU,4717892,4717892,4717690,202,0,utRho21
yfaY,4727310,4727310,4727266,44,0,utRho21
yfaZ,4728744,4728744,4728550,194,62,utRho21
yfbK,4771810,4771810,4771444,366,6,utRho21
yfbL,4771500,4771720,4771500,220,4,utRho21
yfbN,4777174,4777174,4776852,322,0,utRho21
yfbO,4776916,4777162,4776916,246,0,utRho21
yfbP,4777990,4778232,4777990,242,170,utRho21
yfbR,4817662,4817724,4817662,62,22,utRho21
yfcI,4847424,4847424,4847078,346,258,utRho21
yfcJ,4880482,4880482,4880240,242,152,utRho21
yfcL,4888502,4888502,4888338,164,0,utRho21
yfcV,4911642,4911642,4911292,350,0,utRho21
yfcZ,4921958,4921958,4921868,90,436,utRho21
yfdF,4925604,4926024,4925604,420,0,utRho21
yfdG,4935474,4935710,4935474,236,0,utRho21
yfdP,4946844,4947040,4946844,196,0,utRho21
yfdX,4988866,4988866,4988804,62,0,utRho21
yfdY,4990672,4990672,4990584,88,2,utRho21
yfeA,5035784,5035784,5035664,120,13386,utRho21
yfeC,5036668,5036934,5036668,266,76,utRho21
yfeH,5053818,5053892,5053818,74,0,utRho21
yfeK,5074630,5074684,5074630,54,0,utRho21
yfeO,5018906,5019260,5018906,354,240,utRho21
yfeR,5054078,5054078,5053712,366,16,utRho21
yfeX,5101356,5101356,5101090,266,312,utRho21
yfeY,5102486,5102486,5102432,54,0,utRho21
yfeZ,5103842,5103842,5103452,390,0,utRho21
yffO,5123804,5124222,5123804,418,0,utRho21
yffQ,5126778,5127154,5126778,376,314,utRho21
yffS,5128800,5128986,5128800,186,44,utRho21
yfgC,5232052,5232188,5232052,136,314,utRho21
yfgF,5258062,5258062,5257876,186,82,utRho21
yfgG,5258170,5258580,5258170,410,82,utRho21
yfgH,5259344,5259584,5259344,240,0,utRho21
yfgM,5278866,5278866,5278566,300,662,utRho21
yfhH,5397414,5397518,5397414,104,28,utRho21
yfhM,5304648,5304648,5304574,74,0,utRho21
yfhR,5328408,5328726,5328408,318,8,utRho21
yfiC,5425610,5425610,5425528,82,0,utRho21
yfiE,5430688,5430688,5430640,48,0,utRho21
yfiL,5482630,5482720,5482630,90,2,utRho21
yfiM,5448066,5448358,5448066,292,1958,utRho21
yfiR,5483354,5483750,5483354,396,586,utRho21
yfjH,5517326,5517326,5517200,126,0,utRho21
yfjI,5517710,5517970,5517710,260,4,utRho21
yfjJ,5521014,5521094,5521014,80,0,utRho21
yfjM,5531970,5531970,5531552,418,1256,utRho21
yfjP,5535080,5535420,5535080,340,4,utRho21
yfjW,5546570,5546636,5546570,66,0,utRho21
yfjX,5551776,5551838,5551776,62,0,utRho21
ygaC,5601180,5601180,5599988,1192,310,utRho21
ygaM,5600242,5600292,5600242,50,0,utRho21
ygaU,5593628,5593628,5593572,56,378,utRho21
ygaZ,5619190,5619234,5619190,44,62,utRho21
ygbA,5713656,5713656,5713612,44,0,utRho21
ygbE,5746784,5746784,5746674,110,118,utRho21
ygbI,5722882,5722882,5722528,354,0,utRho21
ygbK,5724394,5724670,5724394,276,4354,utRho21
ygbL,5727074,5727186,5727074,112,422,utRho21
ygbN,5729814,5730202,5729814,388,1024,utRho21
ygcG,5811210,5811422,5811210,212,0,utRho21
ygcN,5785144,5785314,5785144,170,34,utRho21
ygcU,5799214,5799214,5798836,378,2,utRho21
ygcW,5800942,5800942,5800546,396,0,utRho21
ygdD,5883442,5883442,5883262,180,198,utRho21
ygdG,5861746,5861930,5861746,184,168,utRho21
ygdI,5886526,5886526,5886290,236,38,utRho21
ygdQ,5940784,5940840,5940784,56,0,utRho21
ygdR,5942494,5942542,5942494,48,0,utRho21
ygeA,5961606,5961606,5961270,336,2,utRho21
ygeH,5983758,5984188,5983758,430,4,utRho21
ygeI,5987162,5987276,5987162,114,14,utRho21
ygeR,6000078,6000078,5999782,296,0,utRho21
ygeV,6011694,6011694,6011572,122,48,utRho21
ygeW,6012234,6012524,6012234,290,0,utRho21
ygfB,6110946,6110946,6110888,58,48,utRho21
ygfK,6031984,6032120,6031984,136,0,utRho21
ygfS,6058328,6058328,6058024,304,2,utRho21
ygfZ,6082564,6082626,6082564,62,342,utRho21
yggC,6149512,6149512,6149378,134,132,utRho21
yggE,6136370,6136370,6136160,210,446,utRho21
yggI,6179176,6179510,6179176,334,358,utRho21
yggL,6204508,6204508,6204266,242,0,utRho21
yggM,6199514,6199514,6199130,384,30,utRho21
yggN,6203596,6203596,6203246,350,64,utRho21
yggX,18623958,18624558,18623958,600,816,utRho21
yghA,6298966,6299324,6298966,358,92,utRho21
yghB,6307058,6307126,6307058,68,114,utRho21
yghD,6222614,6222614,6222252,362,118,utRho21
yghF,6225798,6225798,6225840,42,0,utRho21
yghJ,6238640,6238640,6238224,416,218,utRho21
yghQ,6265186,6265186,6264816,370,2,utRho21
yghT,6267830,6268262,6267830,432,0,utRho21
yghU,6277400,6277454,6277400,54,228,utRho21
yghW,6293506,6293506,6293474,32,0,utRho21
yghZ,6295562,6295794,6295562,232,36,utRho21
ygiD,6365122,6365122,6364868,254,364,utRho21
ygiH,6409066,6409388,6409066,322,2,utRho21
ygiL,6370622,6370828,6370622,206,0,utRho21
ygiM,6402084,6402414,6402084,330,400,utRho21
ygiN,6346156,6346284,6346156,128,5298,utRho21
ygiQ,6322620,6322620,6322292,328,132,utRho21
ygiS,6335462,6335462,6335436,26,0,utRho21
ygiV,6338582,6338582,6338462,120,566,utRho21
ygiW,6339774,6339774,6339352,422,254,utRho21
ygiZ,6344506,6344506,6344422,84,0,utRho21
ygjH,6442528,6442528,6442494,34,0,utRho21
ygjI,6452140,6452468,6452140,328,0,utRho21
ygjQ,6472730,6473080,6472730,350,168,utRho21
ygjR,6474564,6474586,6474564,22,2,utRho21
ygjV,6483638,6483638,6483488,150,2,utRho21
yhaB,6535632,6535708,6535632,76,0,utRho21
yhaH,6504498,6504608,6504498,110,2,utRho21
yhaI,6505400,6505822,6505400,422,48,utRho21
yhaJ,6508560,6508560,6508428,132,8,utRho21
yhaK,6508538,6508638,6508538,100,8,utRho21
yhbQ,6599878,6599932,6599878,54,24,utRho21
yhbT,6602736,6602736,6602552,184,14,utRho21
yhbU,6602558,6602970,6602558,412,14,utRho21
yhbX,6643302,6643302,6643226,76,0,utRho21
yhbY,6655518,6655580,6655518,62,278,utRho21
yhcA,6723956,6724224,6723956,268,0,utRho21
yhcB,6760364,6760382,6760364,18,404,utRho21
yhcC,6708470,6708470,6708100,370,8,utRho21
yhcF,6733440,6733852,6733440,412,222,utRho21
yhcH,6739124,6739124,6738956,168,162,utRho21
yhcM,6760312,6760312,6759994,318,42,utRho21
yhcN,6770812,6771076,6770812,264,146,utRho21
yhcO,6772606,6772606,6772258,348,0,utRho21
yhdH,6806560,6806968,6806560,408,512,utRho21
yhdJ,6823234,6823306,6823234,72,0,utRho21
yhdN,6879092,6879092,6879018,74,514,utRho21
yhdT,6814702,6814750,6814702,48,0,utRho21
yhdU,6824994,6825242,6824994,248,258,utRho21
yhdV,6836392,6836780,6836392,388,4,utRho21
yhdW,6837944,6838298,6837944,354,0,utRho21
yheO,6953082,6953082,6952880,202,1226,utRho21
yheV,6957970,6957970,6957584,386,116,utRho21
yhfA,6971902,6971902,6971636,266,222,utRho21
yhfG,6983294,6983294,6983240,54,88,utRho21
yhfL,6998622,6998896,6998622,274,0,utRho21
yhfY,7023244,7023244,7022844,400,16,utRho21
yhgA,7086294,7086334,7086294,40,0,utRho21
yhgE,7065176,7065176,7064878,298,464,utRho21
yhgF,7074352,7074770,7074352,418,4062,utRho21
yhhA,7173458,7173886,7173458,428,10,utRho21
yhhI,7248346,7248756,7248346,410,0,utRho21
yhhJ,7253696,7253696,7253606,90,214,utRho21
yhhM,7211588,7211588,7211220,368,10,utRho21
yhhN,7211150,7211502,7211150,352,42,utRho21
yhhQ,7218238,7218434,7218238,196,368,utRho21
yhhT,7223682,7223730,7223682,48,0,utRho21
yhhX,7162032,7162032,7161610,422,0,utRho21
yhhY,7162222,7162276,7162222,54,0,utRho21
yhhZ,7163516,7163726,7163516,210,2,utRho21
yhiD,7312220,7312220,7311804,416,159546,utRho21
yhiJ,7265190,7265190,7265180,10,0,utRho21
yhiM,7269270,7269682,7269270,412,66,utRho21
yhiN,7275000,7275000,7274820,180,296,utRho21
yhjA,7338522,7338522,7338376,146,8,utRho21
yhjB,7344090,7344090,7343788,302,0,utRho21
yhjC,7344272,7344684,7344272,412,0,utRho21
yhjD,7346660,7346724,7346660,64,226,utRho21
yhjE,7349274,7349572,7349274,298,22,utRho21
yhjG,7356824,7356824,7356730,94,0,utRho21
yhjH,7358458,7358458,7358374,84,0,utRho21
yhjJ,7364032,7364032,7363880,152,0,utRho21
yhjK,7371296,7371296,7371158,138,90,utRho21
yhjR,7392750,7392750,7392370,380,4,utRho21
yhjV,7400796,7401126,7400796,330,6,utRho21
yhjX,7424194,7424194,7424014,180,0,utRho21
yhjY,7425966,7425966,7425868,98,50,utRho21
yiaB,7455654,7455654,7455496,158,0,utRho21
yiaD,7432712,7433094,7432712,382,190,utRho21
yiaF,7438194,7438194,7438088,106,4,utRho21
yiaG,7438862,7438956,7438862,94,1350,utRho21
yiaJ,7485236,7485236,7485064,172,2,utRho21
yiaK,7485348,7485466,7485348,118,92,utRho21
yiaT,7503924,7503924,7503736,188,0,utRho21
yiaU,7503792,7503984,7503792,192,0,utRho21
yiaY,7515856,7515856,7515654,202,0,utRho21
yibF,7523950,7523950,7523910,40,0,utRho21
yibG,7536128,7536354,7536128,226,0,utRho21
yibL,7553194,7553330,7553194,136,424,utRho21
yibN,7570112,7570112,7570030,82,424,utRho21
yibT,7552848,7552848,7552760,88,256,utRho21
yicC,7633290,7633352,7633290,62,48,utRho21
yicH,7660862,7660914,7660862,52,0,utRho21
yicJ,7673328,7673328,7671858,1470,732,utRho21
yicN,7685018,7685018,7684804,214,2,utRho21
yicO,7687914,7687914,7687578,336,0,utRho21
yicR,15250308,15250308,15250236,72,0,utRho21
yidB,7755230,7755230,7754930,300,24,utRho21
yidE,7732780,7732780,7732546,234,0,utRho21
yidF,7711580,7711580,7711222,358,126,utRho21
yidQ,7735088,7735456,7735088,368,3268,utRho21
yidR,7738824,7738824,7738618,206,0,utRho21
yieE,7787658,7787738,7787658,80,130,utRho21
yieH,7793314,7793548,7793314,234,0,utRho21
yieK,7798928,7798928,7798786,142,0,utRho21
yifB,7900350,7900350,7899998,352,26,utRho21
yifL,7988984,7989044,7988984,60,28,utRho21
yigF,8005750,8005750,8005598,152,84,utRho21
yigI,8009448,8009448,8009394,54,2,utRho21
yigM,8022100,8022152,8022100,52,112,utRho21
yihA,8101970,8101970,8101458,512,0,utRho21
yihD,8084098,8084138,8084098,40,0,utRho21
yihF,8088110,8088398,8088110,288,88,utRho21
yihG,8093304,8093304,8093204,100,0,utRho21
yihI,8102616,8102694,8102616,78,22,utRho21
yihL,8120506,8120894,8120506,388,0,utRho21
yihN,8124332,8124494,8124332,162,0,utRho21
yihO,8131942,8131942,8131532,410,0,utRho21
yihQ,8138892,8138892,8138552,340,0,utRho21
yihV,8147064,8147478,8147064,414,0,utRho21
yihX,8151096,8151106,8151096,10,266,utRho21
yiiE,8158192,8158582,8158192,390,46,utRho21
yiiF,8159124,8159502,8159124,378,0,utRho21
yiiG,8173762,8174004,8173762,242,0,utRho21
yiiM,8205506,8205644,8205506,138,16,utRho21
yiiQ,8224624,8224624,8224428,196,0,utRho21
yiiS,8225738,8225934,8225738,196,0,utRho21
yijE,8272178,8272216,8272178,38,72,utRho21
yijF,8275728,8275728,8275314,414,88,utRho21
yijO,8296858,8296858,8296634,224,0,utRho21
yjaA,8426240,8426468,8426240,228,118820,utRho21
yjaB,8428312,8428312,8428246,66,0,utRho21
yjaG,8398746,8399008,8398746,262,2348,utRho21
yjaH,8401022,8401132,8401022,110,568,utRho21
yjaZ,8379506,8379572,8379506,66,0,utRho21
yjbB,8455204,8455462,8455204,258,0,utRho21
yjbE,16943432,16943624,16943432,192,112,utRho21
yjbL,8520318,8520642,8520318,324,0,utRho21
yjbQ,8540428,8540476,8540428,48,136,utRho21
yjcB,8550328,8550328,8550082,246,102,utRho21
yjcC,8550836,8550942,8550836,106,340,utRho21
yjcD,8556628,8556958,8556628,330,0,utRho21
yjcE,8559658,8559960,8559658,302,2,utRho21
yjcF,8566212,8566212,8566150,62,0,utRho21
yjcO,8594660,8594660,8594250,410,68,utRho21
yjdA,8654128,8654270,8654128,142,8,utRho21
yjdC,8726660,8726660,8726616,44,30,utRho21
yjdK,8704780,8705168,8704780,388,672,utRho21
yjdL,8713034,8713034,8712822,212,0,utRho21
yjdM,8653672,8653672,8653468,204,2090,utRho21
yjeF,8787354,8788132,8787354,778,13478,utRho21
yjeI,8745522,8745618,8745522,96,0,utRho21
yjeJ,8748806,8748806,8748468,338,62,utRho21
yjeV,8785472,8785784,8785472,312,28,utRho21
yjfP,8833512,8833904,8833512,392,0,utRho21
yjfY,8849656,8849656,8849582,74,0,utRho21
yjfZ,8855052,8855052,8854844,208,0,utRho21
yjgA,8916162,8916162,8915730,432,70,utRho21
yjgL,8950802,8950874,8950802,72,0,utRho21
yjgM,8959342,8959342,8959074,268,0,utRho21
yjgN,8959132,8959460,8959132,328,0,utRho21
yjgR,8980170,8980170,8980126,44,222,utRho21
yjgZ,9002116,9002520,9002116,404,6,utRho21
yjhB,9007764,9008116,9007764,352,134,utRho21
yjhG,9048452,9048452,9048188,264,4080,utRho21
yjhU,9041080,9041080,9040648,432,1082,utRho21
yjiA,9178096,9178096,9177730,366,1070,utRho21
yjiJ,9125364,9125364,9125350,14,0,utRho21
yjiK,9127270,9127270,9127422,152,44,utRho21
yjiL,9129604,9129604,9129378,226,0,utRho21
yjiS,9143410,9143502,9143410,92,0,utRho21
yjiY,9182734,9182734,9182558,176,4,utRho21
yjjA,9200674,9200674,9200378,296,126,utRho21
yjjB,18408708,18408708,18407800,908,132,utRho21
yjjJ,9243314,9243538,9243314,224,62,utRho21
yjjK,9261132,9261132,9261044,88,156,utRho21
yjjL,9189764,9189764,9189444,320,24,utRho21
yjjM,9191894,9191894,9191702,192,4,utRho21
yjjP,9206068,9206068,9205716,352,12,utRho21
yjjQ,9206638,9206954,9206638,316,16,utRho21
yjjX,9267798,9267798,9267490,308,632,utRho21
yjjY,9280716,9280804,9280716,88,1914,utRho21
yjjZ,9211554,9211608,9211554,54,50,utRho21
yjtD,9281676,9281884,9281676,208,8,utRho21
ykfB,532454,532454,532174,280,280,utRho21
ykfI,527636,527636,527338,298,14,utRho21
ykgB,637050,637050,636638,412,0,utRho21
ykgC,640430,640430,640002,428,0,utRho21
ykgD,640232,640454,640232,222,0,utRho21
ykgE,642962,643216,642962,254,60,utRho21
ykgJ,608524,608524,608364,160,1250,utRho21
ykgL,623878,624224,623878,346,2,utRho21
ykgM,625610,625610,625554,56,68,utRho21
ykgR,626570,626570,626484,86,0,utRho21
ylaC,958576,958576,958502,74,852,utRho21
yliE,1745938,1745958,1745938,20,0,utRho21
ymcE,2103660,2103694,2103660,34,0,utRho21
ymdA,2210450,2210828,2210450,378,2,utRho21
ymdB,2211428,2211640,2211428,212,0,utRho21
ymfD,2395322,2395322,2395064,258,724,utRho21
ymfI,2402880,2402994,2402880,114,0,utRho21
ymfJ,2404518,2404518,2404168,350,392,utRho21
ymfK,2406176,2406176,2405866,310,0,utRho21
ymfT,2405766,2406048,2405766,282,122,utRho21
ymgE,2489110,2489456,2489110,346,244,utRho21
ymgF,2437628,2437966,2437628,338,0,utRho21
ymiA,2670112,2670320,2670112,208,48,utRho21
ymjA,2715620,2715620,2715336,284,342,utRho21
ynaI,2791946,2791946,2791844,102,0,utRho21
ynaK,2850438,2850754,2850438,316,72,utRho21
ynbA,2954924,2955242,2954924,318,0,utRho21
yncD,3046552,3046552,3046130,422,30,utRho21
yncE,3046454,3046614,3046454,160,68,utRho21
yncG,3052456,3052494,3052456,38,52,utRho21
yncL,3034492,3034492,3034388,104,18,utRho21
yneE,3218364,3218364,3218044,320,0,utRho21
yneF,3223748,3223748,3223708,40,0,utRho21
yneJ,3229560,3229608,3229560,48,122,utRho21
yneK,3231100,3231526,3231100,426,0,utRho21
yneM,3245176,3245292,3245176,116,0,utRho21
ynfA,3311398,3311398,3311346,52,0,utRho21
ynfB,3311418,3311616,3311418,198,152,utRho21
ynfC,3315094,3315094,3314914,180,36,utRho21
ynfD,3314828,3315130,3314828,302,96,utRho21
ynfE,3316006,3316138,3316006,132,0,utRho21
ynfK,3334670,3334670,3334438,232,228,utRho21
ynfL,3339304,3339304,3339184,120,0,utRho21
ynfM,3339260,3339398,3339260,138,0,utRho21
ynfN,3276598,3276598,3276218,380,4,utRho21
ynfO,3273454,3273512,3273454,58,4,utRho21
ynhG,3517890,3517890,3517450,440,536,utRho21
yniA,3615158,3615592,3615158,434,804,utRho21
yniB,3618526,3618526,3618466,60,0,utRho21
yniC,3618652,3618760,3618652,108,6,utRho21
yniD,3610202,3610330,3610202,128,0,utRho21
ynjE,3678880,3678934,3678880,54,0,utRho21
ynjF,3683222,3683222,3682806,416,88,utRho21
ynjH,3684376,3684376,3684270,106,156,utRho21
ynjI,3690022,3690022,3689742,280,48,utRho21
yoaB,3786642,3786734,3786642,92,126,utRho21
yoaC,3787932,3788146,3787932,214,56,utRho21
yoaE,3803544,3803544,3803170,374,766,utRho21
yoaF,3755444,3755444,3755064,380,1140,utRho21
yoaH,3789866,3789866,3789462,404,916,utRho21
yobB,3850418,3850880,3850418,462,3142,utRho21
yobF,3815586,3815586,3815182,404,36,utRho21
yobH,3817800,3817850,3817800,50,0,utRho21
yodB,4084352,4084736,4084352,384,14,utRho21
yodC,4057008,4057008,4056740,268,0,utRho21
yohC,4451358,4451358,4451262,96,0,utRho21
yohD,4451526,4451602,4451526,76,2,utRho21
yohJ,4460986,4461248,4460986,262,0,utRho21
yohO,4431172,4431314,4431172,142,210,utRho21
yojI,4617282,4617282,4617230,52,0,utRho21
ypdI,4988988,4989396,4988988,408,54,utRho21
ypfG,5165786,5165786,5165554,232,62,utRho21
ypfM,5182140,5182140,5181732,408,872,utRho21
yphB,5349590,5349590,5349376,214,44,utRho21
ypjA,5565644,5565644,5565452,192,2,utRho21
ypjB,5569636,5569636,5568858,778,0,utRho21
ypjD,5495860,5495774,5495860,86,0,utRho21
yqaE,5594170,5594170,5594056,114,168,utRho21
yqcA,5846100,5846100,5845968,132,0,utRho21
yqcE,5800944,5801184,5800944,240,0,utRho21
yqeC,6030468,6030468,6030114,354,0,utRho21
yqeF,5971618,5971618,5971184,434,36,utRho21
yqeG,5971438,5971694,5971438,256,22,utRho21
yqeH,5975016,5975072,5975016,56,22,utRho21
yqeI,5976688,5977004,5976688,316,0,utRho21
yqeK,5981140,5981140,5980720,420,4,utRho21
yqfA,6086728,6086728,6086296,432,1560,utRho21
yqgA,6219042,6219106,6219042,64,0,utRho21
yqgB,6172500,6172500,6172102,398,560,utRho21
yqgE,6185768,6185874,6185768,106,64,utRho21
yqhA,6299150,6299150,6298942,208,0,utRho21
yqhC,6310768,6310768,6310436,332,520,utRho21
yqhD,6310604,6310710,6310604,106,284,utRho21
yqhH,6316842,6317254,6316842,412,258,utRho21
yqiC,6369662,6369680,6369662,18,160,utRho21
yqiJ,6384108,6384416,6384108,308,0,utRho21
yqjA,6495096,6495546,6495096,450,1534,utRho21
yqjF,6500932,6501124,6500932,192,1694,utRho21
yqjG,6501948,6502048,6501948,100,0,utRho21
yqjH,6433078,6433078,6432982,96,0,utRho21
yqjI,6433506,6433558,6433506,52,0,utRho21
yraH,6574552,6574852,6574552,300,0,utRho21
yraP,6592144,6592818,6592144,674,726,utRho21
yraQ,6596414,6596414,6596276,138,0,utRho21
yraR,6598024,6598024,6597692,332,538,utRho21
yrbG,13360844,13361100,13360844,256,0,utRho21
yrbL,6696842,6696904,6696842,62,50,utRho21
yrbN,6616172,6616172,6615866,306,142,utRho21
yrdB,6860176,6860176,6860046,130,0,utRho21
yrfF,7052548,7052938,7052548,390,766,utRho21
yrhB,7169440,7169518,7169440,78,0,utRho21
ysaB,7451804,7451804,7451424,380,0,utRho21
ysgA,8032686,8032686,8032338,348,84,utRho21
ytfB,8857638,8857638,8857434,204,0,utRho21
ytfE,8864018,8864018,8863966,52,0,utRho21
ytfF,8866296,8866296,8866130,166,56,utRho21
ytfH,8868164,8868226,8868164,62,0,utRho21
ytfI,8875234,8875414,8875234,180,60,utRho21
ytfJ,8878572,8878572,8878524,48,74,utRho21
ytfK,8879022,8879174,8879022,152,492,utRho21
ytfL,8882642,8882642,8882430,212,64,utRho21
ytfQ,8899634,8899924,8899634,290,1692,utRho21
ytjB,9249598,9249598,9249578,20,0,utRho21
yzfA,8896588,8896588,8896490,98,2,utRho21
zapA,6111102,6111224,6111102,122,1424,utRho21
zapB,8236772,8237030,8236772,258,1080,utRho21
zapC,2011700,2011904,2011700,204,0,utRho21
zinT,4082692,4082750,4082692,58,2,utRho21
zipA,5062814,5062814,5062466,348,194,utRho21
zitB,1569716,1569716,1569646,70,0,utRho21
zntA,7212844,7212902,7212844,58,0,utRho21
zntR,6878336,6878336,6878260,76,0,utRho21
znuA,3885322,3885322,3885166,156,0,utRho21
znuC,3885268,3885324,3885268,56,0,utRho21
zraP,8403424,8403424,8403376,48,0,utRho21
zraS,8403810,8403852,8403810,42,0,utRho21
zupT,6364866,6365100,6364866,234,364,utRho21
zur,8520282,8520282,8520006,276,686,utRho21
zwf,3872752,3872752,3872628,124,222,utRho21
C0343,2818676,2818728,2818676,52,0,utRho22
aaeB,6776526,6776526,6776376,150,218,utRho22
aaeR,6778762,6779040,6778762,278,948,utRho22
aaeX,6778860,6778860,6778674,186,1152,utRho22
aat,1854920,1854920,1854864,56,10,utRho22
accA,416822,417242,416822,420,1358,utRho22
accB,6810280,6810872,6810280,592,2414,utRho22
accD,4868030,4868030,4867852,178,236,utRho22
aceB,8430804,8430956,8430804,152,1682,utRho22
aceE,245938,246034,245938,96,156,utRho22
ackA,4826918,4826940,4826918,22,270,utRho22
acnA,2670848,2671662,2670848,814,1510,utRho22
acnB,263038,263230,263038,192,508,utRho22
acpP,2303148,2303230,2303148,82,76,utRho22
acpS,5402324,5402324,5401996,328,314,utRho22
acrA,971396,971396,971238,158,106,utRho22
acrB,969370,969370,968806,564,1776,utRho22
acrD,5174950,5175190,5174950,240,330,utRho22
acrE,6827404,6827728,6827404,324,460,utRho22
acrR,971398,971522,971398,124,176,utRho22
acrZ,1589502,1589546,1589502,44,234,utRho22
acs,8575190,8575190,8574742,448,4268,utRho22
actP,8569870,8569870,8569804,66,0,utRho22
ada,4620854,4620854,4620810,44,0,utRho22
add,3404404,3404466,3404404,62,114,utRho22
ade,7687802,7687928,7687802,126,212,utRho22
adhE,2596826,2596826,2596242,584,0,utRho22
adhP,3107988,3107988,3107676,312,882,utRho22
adiA,8681112,8681112,8681042,70,66,utRho22
adiC,8674404,8674404,8674062,342,264,utRho22
adiY,8676084,8676084,8675858,226,124,utRho22
adk,994278,994350,994278,72,1082,utRho22
adrA,807374,807406,807374,32,164,utRho22
aer,6438240,6438240,6438152,88,2,utRho22
aes,1000102,1000102,999946,156,4212,utRho22
agaR,6557406,6557406,6557330,76,66,utRho22
agaS,6563778,6563952,6563778,174,88,utRho22
agp,2131118,2131170,2131118,52,98,utRho22
agrA,7296126,7296126,7296126,0,0,utRho22
agrB,7296588,7296588,7296588,0,0,utRho22
ahpC,1277386,1277890,1277386,504,698,utRho22
ahpF,1278004,1279506,1278004,1502,71142,utRho22
ahr,8992698,8992698,8992418,280,1224,utRho22
aidB,8828494,8828550,8828494,56,40,utRho22
ais,4731512,4731512,4731240,272,304,utRho22
alaA,4814816,4815122,4814816,306,350,utRho22
alaC,4996798,4996798,4996590,208,150,utRho22
alaE,5598140,5598328,5598140,188,458,utRho22
alaS,5644180,5644180,5644022,158,1030,utRho22
alaW,5036612,5036612,5036462,150,0,utRho22
aldA,2976380,2976464,2976380,84,442,utRho22
aldB,7513070,7513070,7513022,48,560,utRho22
alkA,4295118,4295118,4295080,38,534,utRho22
alkB,4618890,4618890,4618682,208,228,utRho22
allA,1064780,1064902,1064780,122,216,utRho22
allD,1092822,1092822,1092726,96,48,utRho22
allE,1088112,1088112,1088092,20,288,utRho22
allS,1064600,1064600,1064442,158,718,utRho22
alr,8531178,8531564,8531178,386,1340,utRho22
alsE,8617334,8617334,8616956,378,716,utRho22
alsK,8615990,8615990,8615598,392,2026,utRho22
alx,6476740,6477160,6476740,420,122,utRho22
amiA,5104482,5104704,5104482,222,44,utRho22
amiC,5898378,5898378,5898020,358,358,utRho22
amn,4110062,4110122,4110062,60,0,utRho22
ampC,8758006,8758006,8757888,118,148,utRho22
ampD,237362,237466,237362,104,202,utRho22
ampG,907372,907372,907090,282,174,utRho22
ampH,792726,792726,792574,152,168,utRho22
amyA,4012230,4012312,4012230,82,266,utRho22
anmK,3439346,3439346,3439204,142,150,utRho22
ansB,6201580,6201580,6201456,124,1530,utRho22
ansP,3052040,3052040,3051960,80,522,utRho22
apaG,104068,104068,103212,856,3044,utRho22
apaH,102586,102586,102444,142,5540,utRho22
apbE,4623188,4623188,4623068,120,0,utRho22
appA,2081198,2081234,2081198,36,0,utRho22
appC,2075420,2075480,2075420,60,6,utRho22
appY,1167134,1167362,1167134,228,76,utRho22
apt,982620,982824,982620,204,46,utRho22
aqpZ,1832424,1832424,1832094,330,284,utRho22
araB,140150,140150,140096,54,0,utRho22
araC,140482,140774,140482,292,724,utRho22
araE,5964416,5964416,5964364,52,62,utRho22
araF,3972476,3972476,3972256,220,708,utRho22
araH,3967120,3967120,3967086,34,1346,utRho22
araJ,825058,825058,824962,96,7374,utRho22
arcA,9281602,9281602,9280612,990,1934,utRho22
arcB,6706098,6706098,6706050,48,410,utRho22
arcZ,6701154,6701154,6701154,0,0,utRho22
arfA,6877346,6877346,6877298,48,1110,utRho22
argA,5898312,5898484,5898312,172,192,utRho22
argC,8309770,8310002,8309770,232,208,utRho22
argD,6980442,6980442,6980360,82,210,utRho22
argE,8310156,8310156,8309694,462,436,utRho22
argF,580680,580680,580610,70,134,utRho22
argG,6637124,6637274,6637124,150,396,utRho22
argI,8956688,8956688,8956622,66,218,utRho22
argO,6137672,6137672,6137616,56,170,utRho22
argP,6119460,6119506,6119460,46,510,utRho22
argR,6769204,6769406,6769204,202,110,utRho22
argS,3920002,3920124,3920002,122,172,utRho22
argT,4855698,4855698,4855582,116,308,utRho22
argU,1129406,1129446,1129406,40,0,utRho22
argW,4932616,4932618,4932616,2,0,utRho22
argX,7964728,7964750,7964728,22,16,utRho22
aroF,5482402,5482402,5482300,102,78,utRho22
aroG,1571182,1571266,1571182,84,170,utRho22
aroH,3576636,3576870,3576636,234,386,utRho22
aroK,7038760,7038760,7038128,632,1084,utRho22
aroL,812560,812810,812560,250,2698,utRho22
aroP,243342,243342,243102,240,92,utRho22
arpA,8445382,8445382,8444974,408,464,utRho22
arrS,7316108,7316108,7316108,0,0,utRho22
arsR,7297024,7297056,7297024,32,260,utRho22
artJ,1801252,1801252,1801150,102,0,utRho22
artP,1807686,1807686,1807468,218,7872,utRho22
ascF,5678858,5679048,5678858,190,186,utRho22
ascG,5678574,5678574,5678528,46,266,utRho22
aslB,7965562,7965916,7965562,354,662,utRho22
asnA,7854258,7854310,7854258,52,1588,utRho22
asnB,1398444,1398444,1398354,90,2422,utRho22
asnC,23562186,23562186,23562018,168,960,utRho22
asnS,1978088,1978088,1977970,118,1812,utRho22
asnT,4089082,4089098,4089082,16,130,utRho22
asnU,4119690,4119702,4119690,12,10,utRho22
asnV,4124504,4124520,4124504,16,94,utRho22
aspA,17473728,17473728,17473308,420,348,utRho22
aspC,1971486,1971486,1971418,68,246,utRho22
aspS,3901402,3901402,3901044,358,304,utRho22
aspT,7893560,7893744,7893560,184,66590,utRho22
aspV,473826,473862,473826,36,22,utRho22
asr,3342654,3342752,3342654,98,96,utRho22
astC,3664088,3664088,3663964,124,142,utRho22
astE,3654138,3654138,3653846,292,374,utRho22
atoD,4646824,4646894,4646824,70,1622,utRho22
atpB,7844540,7844540,7844102,438,30,utRho22
atpC,7832118,7832118,7831944,174,378,utRho22
atpI,7845050,7845050,7844880,170,0,utRho22
avtA,7479348,7479410,7479348,62,938,utRho22
azoR,2965982,2965982,2965720,262,508,utRho22
azuC,3976002,3976002,3975918,84,0,utRho22
bacA,6408350,6408350,6408262,88,818,utRho22
bamA,394052,395856,394052,1804,860,utRho22
bamB,5277950,5277950,5277304,646,258,utRho22
bamC,5198028,5198028,5197730,298,758,utRho22
bamD,5471922,5472292,5471922,370,2554,utRho22
bamE,5506972,5507210,5506972,238,86,utRho22
basS,8666954,8666954,8666544,410,2008,utRho22
bax,7474468,7474468,7474354,114,328,utRho22
bcp,5200874,5200956,5200874,82,1042,utRho22
bcsB,7385346,7385346,7385214,132,152,utRho22
bcsE,7392644,7392916,7392644,272,56,utRho22
bdcA,8948128,8948128,8948106,22,984,utRho22
bdcR,8948192,8948248,8948192,56,546,utRho22
bdm,3112680,3112680,3112560,120,136,utRho22
betA,654522,654522,654494,28,116,utRho22
betI,658722,658722,658668,54,174,utRho22
betT,658842,658926,658842,84,292,utRho22
bfr,6933498,6933498,6933450,48,116,utRho22
bglG,23440182,23440182,23439402,780,2370,utRho22
bglX,4444240,4444240,4443978,262,64,utRho22
bhsA,2337962,2338146,2337962,184,470,utRho22
bioA,1618584,1618584,1618514,70,0,utRho22
bioB,1618604,1618688,1618604,84,0,utRho22
bioH,7089716,7089716,7089688,28,86,utRho22
bisC,7433026,7433026,7432788,238,310,utRho22
blc,8755490,8755490,8755444,46,16,utRho22
blr,3409024,3409102,3409024,78,398,utRho22
bluF,2431226,2431226,2430950,276,138,utRho22
bluR,2428226,2428226,2428118,108,38,utRho22
bolA,908698,908944,908698,246,134,utRho22
borD,1157842,1157842,1157786,56,702,utRho22
brnQ,838976,839182,838976,206,860,utRho22
bssR,1756492,1756496,1756492,4,0,utRho22
bssS,2242116,2242116,2241910,206,706,utRho22
btuB,8326798,8327278,8326798,480,3504,utRho22
cadB,8720212,8720212,8720062,150,116,utRho22
cadC,8723926,8723926,8723868,58,0,utRho22
caiE,70998,70998,70742,256,758,utRho22
caiF,68436,68600,68436,164,2970,utRho22
caiT,84074,84074,83862,212,266,utRho22
can,285406,285406,285340,66,248,utRho22
carA,59102,59302,59102,200,998,utRho22
carB,61550,61634,61550,84,196,utRho22
cas2,5757830,5757830,5757706,124,604,utRho22
casA,5768638,5768638,5768276,362,210,utRho22
cbl,4121882,4121882,4121828,54,2234,utRho22
cbpA,2128074,2128074,2127550,524,912,utRho22
cbrA,7738628,7738754,7738628,126,16,utRho22
cbrB,7794958,7795012,7794958,54,674,utRho22
ccmH,4585242,4585242,4584820,422,222,utRho22
cdaR,364894,364926,364894,32,168,utRho22
cdd,4463638,4463688,4463638,50,42,utRho22
cdh,8219814,8219860,8219814,46,1418,utRho22
cdsA,391110,391354,391110,244,340,utRho22
cedA,3627484,3627484,3627326,158,702,utRho22
cfa,3482402,3482826,3482402,424,446,utRho22
chaC,2544844,2544972,2544844,128,1410,utRho22
chbB,3643452,3643452,3643238,214,276,utRho22
chbG,3634624,3634624,3634270,354,208,utRho22
cheW,3946924,3946924,3946678,246,278,utRho22
chiA,6939792,6939792,6939706,86,390,utRho22
chiP,1416472,1416668,1416472,196,124,utRho22
cho,3646984,3647030,3646984,46,36,utRho22
chpS,8896804,8896894,8896804,90,140,utRho22
cirA,4493884,4493884,4493538,346,398,utRho22
citC,1304078,1304078,1303712,366,2642,utRho22
citT,1293264,1293264,1293160,104,100,utRho22
clcA,350104,350214,350104,110,32,utRho22
clpA,1846160,1846528,1846160,368,26,utRho22
clpB,5468410,5468410,5468346,64,296,utRho22
clpP,913154,913354,913154,200,120,utRho22
clpS,1845500,1845826,1845500,326,120,utRho22
clpX,914404,914852,914404,448,882,utRho22
clsA,2617346,2617346,2617290,56,364,utRho22
clsC,2212584,2212710,2212584,126,212,utRho22
cmk,1922330,1922402,1922330,72,66,utRho22
cnu,3409522,3409898,3409522,376,2464,utRho22
coaA,8350214,8350214,8350052,162,872,utRho22
cobC,1340092,1340092,1339814,278,810,utRho22
cobT,4129202,4129202,4128934,268,92,utRho22
cobU,4131944,4131944,4131528,416,138,utRho22
codB,709768,709844,709768,76,818,utRho22
comR,2337726,2337726,2337664,62,12,utRho22
copA,1022822,1022822,1022758,64,250,utRho22
corA,8002388,8002852,8002388,464,29076,utRho22
cpdB,8873258,8873258,8873130,128,820,utRho22
cptB,6082198,6082198,6082140,58,66,utRho22
cpxA,8210202,8210202,8209950,252,772,utRho22
cpxP,8211570,8211640,8211570,70,218,utRho22
cpxR,8211372,8211372,8211340,32,76,utRho22
cra,175894,176056,175894,162,64,utRho22
crcB,1316016,1316016,1315876,140,94,utRho22
creA,9270486,9271042,9270486,556,856,utRho22
creD,9276320,9276356,9276320,36,276,utRho22
crl,515620,515658,515620,38,2048,utRho22
crp,6971906,6972240,6971906,334,2144,utRho22
crr,5070960,5071668,5070960,708,1718,utRho22
csdA,5886414,5886674,5886414,260,140,utRho22
csgB,2207718,2207902,2207718,184,136,utRho22
csgD,2206688,2206688,2206392,296,966,utRho22
csgG,2203510,2203510,2203368,142,952,utRho22
csiD,5577854,5577970,5577854,116,78,utRho22
csiE,5330802,5330870,5330802,68,248,utRho22
csiR,5590942,5591348,5590942,406,268,utRho22
cspA,7439778,7440098,7439778,320,4108,utRho22
cspB,3283430,3283430,3283108,322,4,utRho22
cspC,3815018,3815018,3814870,148,52,utRho22
cspD,1845352,1845352,1845180,172,2182,utRho22
cspE,1314294,1314584,1314294,290,198,utRho22
cspF,3283380,3283710,3283380,330,546,utRho22
cspG,2102610,2102922,2102610,312,710,utRho22
cspH,2102746,2102746,2102350,396,446,utRho22
cspI,3277624,3277624,3277334,290,36,utRho22
csrA,5638746,5638746,5638292,454,452,utRho22
csrB,5849048,5849048,5849048,0,0,utRho22
csrC,8102072,8102072,8102072,0,0,utRho22
csrD,6806850,6806850,6806664,186,160,utRho22
cstA,1259710,1259788,1259710,78,158,utRho22
cueO,274090,274166,274090,76,0,utRho22
cueR,1027948,1027986,1027948,38,12,utRho22
curA,3037784,3038054,3037784,270,2146,utRho22
cusC,1191146,1191200,1191146,54,378,utRho22
cusR,1190924,1190924,1190886,38,318,utRho22
cutA,8730784,8730784,8730712,72,526,utRho22
cutC,3918534,3918534,3917920,614,2086,utRho22
cvpA,4861600,4861600,4861526,74,0,utRho22
cvrA,2484328,2484328,2484142,186,154,utRho22
cyaA,7981548,7982306,7981548,758,884,utRho22
cyaR,4334228,4334224,4334228,4,0,utRho22
cyaY,7988166,7988166,7988118,48,236,utRho22
cybB,2981522,2981804,2981522,282,920,utRho22
cycA,8859560,8859728,8859560,168,424,utRho22
cydA,1542340,1542916,1542340,576,1128,utRho22
cydC,1858800,1858800,1858390,410,214,utRho22
cydD,1862062,1862062,1861924,138,78,utRho22
cydX,1548300,1548392,1548300,92,140,utRho22
cynR,717418,717418,717380,38,190,utRho22
cynT,1435092,1435196,1435092,104,68,utRho22
cyoA,903306,903306,903220,86,1828,utRho22
cyoE,895540,895540,895410,130,80,utRho22
cysB,2667576,2667710,2667576,134,460,utRho22
cysC,5748056,5748056,5747984,72,348,utRho22
cysD,5752736,5752736,5752658,78,270,utRho22
cysE,7565362,7565362,7565124,238,520,utRho22
cysG,6995508,6995656,6995508,148,3516,utRho22
cysJ,5783928,5783928,5783796,132,6184,utRho22
cysK,5064688,5064818,5064688,130,108,utRho22
cysP,5087114,5087114,5087056,58,766,utRho22
cysS,1109154,1109222,1109154,68,14,utRho22
cysT,3984100,3984100,3983974,126,2,utRho22
cysZ,5062766,5062926,5062766,160,450,utRho22
cytR,8249018,8249018,8248912,106,220,utRho22
dacA,1328002,1328002,1327926,76,74,utRho22
dacB,6657714,6657926,6657714,212,32,utRho22
dacC,1761306,1761454,1761306,148,722,utRho22
dadA,2475018,2475142,2475018,124,66,utRho22
dam,7032504,7032504,7031826,678,1510,utRho22
damX,7035200,7035200,7034612,588,808,utRho22
dapA,5199568,5199568,5199520,48,40,utRho22
dapB,56576,56748,56576,172,1102,utRho22
dapD,371954,371954,371894,60,240,utRho22
dapE,5183120,5183214,5183120,94,880,utRho22
dcp,3254844,3254844,3254760,84,276,utRho22
dcrB,7219534,7219910,7219534,376,1830,utRho22
dctA,7366996,7366996,7366894,102,368,utRho22
dcuA,8733686,8733686,8733546,140,114,utRho22
dcuB,8698182,8698182,8697488,694,5588,utRho22
dcuC,1312166,1312166,1311936,230,2122,utRho22
dcuD,6749166,6749738,6749166,572,1686,utRho22
dcuR,8701130,8701130,8700068,1062,2418,utRho22
dcuS,8703370,8703370,8703324,46,1412,utRho22
dcyD,3999016,3999016,3998960,56,0,utRho22
ddpX,3126498,3126498,3126152,346,272,utRho22
deaD,6615818,6615818,6615720,98,514,utRho22
dedA,4869880,4869880,4869482,398,5318,utRho22
dedD,4863750,4863750,4863368,382,80,utRho22
def,6867300,6867380,6867300,80,528,utRho22
degP,361690,361768,361690,78,100,utRho22
degQ,6761308,6761486,6761308,178,5884,utRho22
deoB,9239134,9239206,9239134,72,0,utRho22
deoC,9233358,9234646,9233358,1288,2014,utRho22
dfp,7625406,7625462,7625406,56,26,utRho22
dgcZ,3247758,3247758,3247700,58,82,utRho22
dgkA,8512914,8513274,8512914,360,156,utRho22
dgt,358392,358474,358392,82,1764,utRho22
dhaK,2501888,2501888,2501676,212,322,utRho22
dhaR,2502006,2502132,2502006,126,370,utRho22
dicB,3299194,3299218,3299194,24,20,utRho22
dicC,3295752,3295752,3295700,52,0,utRho22
dinB,501760,501796,501760,36,0,utRho22
dinD,7635398,7635520,7635398,122,330,utRho22
dinG,1666146,1666140,1666146,6,20,utRho22
dinI,2243018,2243018,2242974,44,336,utRho22
dinJ,493230,493230,493004,226,292,utRho22
dinQ,7295964,7295964,7295576,388,486,utRho22
djlA,114536,114728,114536,192,676,utRho22
dkgA,6313142,6313246,6313142,104,350,utRho22
dkgB,458196,458334,458196,138,0,utRho22
dksA,321502,321502,321208,294,448,utRho22
dld,4444164,4444370,4444164,206,110,utRho22
dmlA,3763424,3763824,3763424,400,1556,utRho22
dmlR,3763710,3763710,3763618,92,534,utRho22
dmsA,1881646,1881918,1881646,272,0,utRho22
dnaA,7767922,7767922,7767458,464,718,utRho22
dnaB,8528566,8528628,8528566,62,64,utRho22
dnaK,24096,24326,24096,230,8256,utRho22
dnaN,7765466,7765466,7764642,824,352,utRho22
dnaQ,471868,472134,471868,266,4462,utRho22
dnaT,18406460,18406460,18406068,392,5268,utRho22
dnaX,984112,984184,984112,72,240,utRho22
dosP,3131486,3131486,3131466,20,166,utRho22
dpiB,1303968,1304470,1303968,502,1682,utRho22
dppA,7415740,7415740,7415410,330,2700,utRho22
dps,1697900,1697900,1697822,78,82,utRho22
dsbA,8086754,8086836,8086754,82,1222,utRho22
dsbB,2466294,2466294,2466060,234,316,utRho22
dsbC,6079266,6079266,6077644,1622,2042,utRho22
dsbG,1277600,1277600,1277146,454,458,utRho22
dsdA,4958242,4958404,4958242,162,208,utRho22
dsdC,4955492,4955492,4955258,234,342,utRho22
dsdX,4955642,4955694,4955642,52,852,utRho22
dsrA,4050626,4050626,4050626,0,0,utRho22
dsrB,4049686,4049686,4049646,40,946,utRho22
dtpD,1485340,1485340,1485112,228,750,utRho22
dusA,8523200,8523338,8523200,138,2274,utRho22
dusB,6820492,6820560,6820492,68,26,utRho22
dusC,4460790,4460790,4460770,20,0,utRho22
dut,7627704,7627864,7627704,160,560,utRho22
dxr,386670,387042,386670,372,94,utRho22
ebgA,6445102,6445266,6445102,164,4,utRho22
ebgR,6442874,6442932,6442874,58,144,utRho22
ecnB,8753018,8753106,8753018,88,342,utRho22
eco,4607594,4607810,4607594,216,6,utRho22
ecpA,621594,621594,621342,252,826,utRho22
ecpB,620238,620238,620052,186,852,utRho22
ecpR,622964,622964,622672,292,316,utRho22
eda,3866218,3866218,3865512,706,270,utRho22
edd,3869426,3869426,3869208,218,76,utRho22
efeO,2164308,2164486,2164308,178,38,utRho22
efeU_1,2162614,2162712,2162614,98,122,utRho22
efp,8751134,8751398,8751134,264,1958,utRho22
elaA,4763372,4763372,4763086,286,368,utRho22
elaD,4765308,4765426,4765308,118,146,utRho22
elfA,1995530,1995736,1995530,206,136,utRho22
elfD,1996642,1996980,1996642,338,232,utRho22
emrD,7707690,7707844,7707690,154,202,utRho22
emrK,4966896,4966896,4966678,218,102,utRho22
emrY,4964668,4964668,4964352,316,738,utRho22
emtA,2486250,2486360,2486250,110,232,utRho22
endA,12361100,12361388,12361100,288,140,utRho22
eno,5817692,5817692,5815882,1810,1740,utRho22
entC,1249662,1249770,1249662,108,300,utRho22
entD,1220508,1220508,1220158,350,312,utRho22
entH,1258584,1258600,1258584,16,26,utRho22
entS,1244506,1244600,1244506,94,156,utRho22
envR,6827266,6827266,6826930,336,0,utRho22
epd,12295292,12295292,12294764,528,468,utRho22
epmA,8765236,8765286,8765236,50,452,utRho22
epmB,8751406,8751406,8751314,92,524,utRho22
eptB,7421162,7421162,7420950,212,84,utRho22
eptC,8300622,8300622,8300530,92,1348,utRho22
erfK,4126708,4126708,4126646,62,326,utRho22
erpA,353122,353220,353122,98,60,utRho22
esrE,8039956,8039956,8039956,0,0,utRho22
essD,1153746,1154796,1153746,1050,3578,utRho22
etk,2088606,2088606,2088420,186,1838,utRho22
evgA,4967262,4967510,4967262,248,212,utRho22
exbB,6304028,6304028,6303968,60,132,utRho22
exbD,6302780,6302780,6302486,294,60,utRho22
exuR,6493016,6493304,6493016,288,168,utRho22
exuT,6490004,6490208,6490004,204,50,utRho22
fabA,2032996,2032996,2032940,56,0,utRho22
fabB,4883282,4883282,4883210,72,94,utRho22
fabH,2297032,2297518,2297032,486,384,utRho22
fabI,2702236,2702236,2702078,158,258,utRho22
fadB,8062026,8062026,8061942,84,104,utRho22
fadD,3779614,3779614,3779492,122,148,utRho22
fadE,486812,486812,486606,206,132,utRho22
fadH,6463248,6463330,6463248,82,258,utRho22
fadI,4921022,4921022,4920938,84,424,utRho22
fadL,4922410,4922600,4922410,190,260,utRho22
fadM,928720,928804,928720,84,0,utRho22
fadR,2469810,2469876,2469810,66,0,utRho22
fbaB,4357334,4357334,4357128,206,280,utRho22
fdhE,8162722,8162722,8162456,266,490,utRho22
fdhF,8598814,8598814,8598732,82,126,utRho22
fdnG,3094744,3094802,3094744,58,194,utRho22
fdrA,1093012,1093360,1093012,348,362,utRho22
feaB,2894994,2895038,2894994,44,0,utRho22
feaR,2894734,2894734,2894566,168,80,utRho22
fecA,9033454,9033454,9033354,100,228,utRho22
fecE,9023288,9023288,9022914,374,1900,utRho22
fecI,9036564,9036564,9036470,94,1438,utRho22
feoA,7080114,7080326,7080114,212,838,utRho22
fepA,1225334,1225334,1224988,346,760,utRho22
fepB,1249454,1249454,1249020,434,418,utRho22
fepD,1244468,1244468,1244378,90,4,utRho22
fes,1225374,1225630,1225374,256,930,utRho22
ffh,5495706,5495706,5495590,116,504,utRho22
ffs,952576,952848,952576,272,7686,utRho22
fhuA,334884,334968,334884,84,408,utRho22
fhuE,2323294,2323294,2323102,192,734,utRho22
fhuF,9211504,9211504,9211326,178,66918,utRho22
fic,6983296,6983296,6982926,370,3356,utRho22
fieF,8212864,8212938,8212864,74,584,utRho22
fimA,9085388,9086230,9085388,842,1790,utRho22
fimB,9081334,9081914,9081334,580,7958,utRho22
fimE,9083742,9084074,9083742,332,3026,utRho22
fimZ,1129214,1129214,1128960,254,0,utRho22
fiu,1683296,1683296,1683062,234,326,utRho22
fixA,84650,84806,84650,156,208,utRho22
fkpA,6955050,6955050,6954838,212,1448,utRho22
fldA,2846084,2846084,2845860,224,2464,utRho22
fldB,6079644,6079710,6079644,66,180,utRho22
flgA,2261770,2261770,2261726,44,2742,utRho22
flgB,2261986,2262036,2261986,50,444,utRho22
flgK,2276702,2276756,2276702,54,404,utRho22
flgM,2260330,2260330,2260256,74,192,utRho22
flgN,2259828,2259828,2259660,168,168,utRho22
flhB,3932432,3932432,3932382,50,770,utRho22
flhC,3955864,3955864,3955688,176,86,utRho22
flhD,3957154,3957154,3956394,760,4252,utRho22
fliA,4003638,4003638,4003578,60,16,utRho22
fliC,4007352,4007352,4007212,140,136,utRho22
fliD,4007634,4007744,4007634,110,1898,utRho22
fliE,4026186,4026186,4026028,158,2504,utRho22
fliF,4026292,4026458,4026292,166,1966,utRho22
fliL,4039168,4039236,4039168,68,154,utRho22
flk,4875824,4875900,4875824,76,146,utRho22
flu,4142634,4143078,4142634,444,386,utRho22
flxA,3292776,3292810,3292776,34,396,utRho22
fnr,2799104,2799104,2799052,52,214,utRho22
fnrS,2818258,2818258,2818258,0,0,utRho22
focA,1909628,1909628,1908932,696,812,utRho22
folA,99598,99646,99598,48,190,utRho22
folB,6409296,6409296,6409178,118,18,utRho22
folD,1115562,1115562,1115482,80,54,utRho22
folE,4487696,4487696,4487304,392,1858,utRho22
fpr,8228998,8228998,8228944,54,120,utRho22
frc,4986878,4986878,4986508,370,858,utRho22
frdA,8764824,8764824,8764636,188,1600,utRho22
frdD,8758948,8758948,8758732,216,6862,utRho22
fre,8052886,8053054,8052886,168,862,utRho22
frlA,6999518,6999820,6999518,302,512,utRho22
frr,385624,385744,385624,120,218,utRho22
frsA,513004,513054,513004,50,4,utRho22
fruB,4527194,4527194,4526990,204,10,utRho22
frvR,8179804,8179804,8179710,94,38,utRho22
fryA,5008986,5008986,5008970,16,528,utRho22
fsaA,1727060,1727284,1727060,224,944,utRho22
fsr,1009710,1009710,1009392,318,532,utRho22
ftnA,3977364,3977432,3977364,68,58,utRho22
ftnB,3973550,3973850,3973550,300,588,utRho22
ftsA,207122,207964,207122,842,510,utRho22
ftsB,5745802,5745802,5745640,162,384,utRho22
ftsH,6654204,6654204,6653870,334,194,utRho22
ftsK,1865858,1866448,1865858,590,1088,utRho22
ftsL,181376,182064,181376,688,2034,utRho22
ftsP,6325732,6325732,6325338,394,600,utRho22
ftsQ,205484,206310,205484,826,174,utRho22
ftsX,7204512,7204512,7204172,340,956,utRho22
ftsZ,209272,210610,209272,1338,2,utRho22
fucA,5867708,5867708,5867376,332,6192,utRho22
fucP,5868238,5868470,5868238,232,610,utRho22
fumA,6753760,6753760,6753508,252,1324,utRho22
fumB,8694696,8694696,8694652,44,92,utRho22
fumC,3373418,3373418,3373176,242,62,utRho22
fur,2842892,2842892,2842584,308,2460,utRho22
fusA,6947370,6947370,6947028,342,4628,utRho22
fxsA,8737206,8737328,8737206,122,162,utRho22
gabD,5581824,5582546,5581824,722,6972,utRho22
gadA,7335214,7335214,7335160,54,0,utRho22
gadB,3144144,3144144,3144090,54,748,utRho22
gadC,3141168,3141168,3140978,190,452,utRho22
gadE,7315600,7316732,7315600,1132,4596,utRho22
gadW,7329562,7329562,7329236,326,56,utRho22
gadX,14663356,14663356,14663240,116,1316,utRho22
gadY,7329728,7329728,7329728,0,0,utRho22
galE,1584354,1584354,1584110,244,322,utRho22
galF,4228702,4228702,4228654,48,208,utRho22
galM,1577796,1577796,1577674,122,1264,utRho22
galP,6176510,6176568,6176510,58,22,utRho22
galR,5953138,5953198,5953138,60,228,utRho22
galS,4483420,4483420,4483336,84,60,utRho22
galU,2582810,2582914,2582810,104,194,utRho22
gapA,3724480,3725542,3724480,1062,1422,utRho22
garP,6549868,6549868,6549814,54,1428,utRho22
gatY,4354468,4354468,4354408,60,0,utRho22
gatZ,4352864,4352864,4352642,222,9376,utRho22
gcd,282558,282558,282450,108,2,utRho22
gcl,1067814,1067832,1067814,18,0,utRho22
gcvA,5885278,5885278,5885134,144,76,utRho22
gcvB,5885392,5885392,5885392,0,0,utRho22
gcvR,5199758,5199812,5199758,54,26,utRho22
gcvT,6101544,6101544,6101334,210,586,utRho22
gdhA,3684616,3684742,3684616,126,38,utRho22
gfcA,2099668,2099668,2099488,180,1936,utRho22
gfcD,2096236,2096236,2095890,346,3770,utRho22
ghrA,2195648,2195772,2195648,124,242,utRho22
ghrB,7434378,7434620,7434378,242,2448,utRho22
glcA,6242728,6242728,6242558,170,1516,utRho22
glcC,6256412,6256544,6256412,132,106,utRho22
glcD,6256152,6256152,6256042,110,274,utRho22
gldA,8278092,8278092,8278070,22,222,utRho22
glgA,7136784,7136784,7136066,718,1976,utRho22
glgB,7147314,7147314,7147004,310,142,utRho22
glgC,7139142,7139142,7138656,486,596,utRho22
glgP,7133546,7133546,7133162,384,518,utRho22
glgS,6384024,6384024,6383878,146,188,utRho22
glgX,7142838,7142838,7142638,200,154,utRho22
glk,5018922,5018922,5018852,70,140,utRho22
glmS,7827622,7827622,7827336,286,1200,utRho22
glmU,7830652,7830652,7830400,252,20,utRho22
glmY,10765360,10765360,10765360,0,0,utRho22
glmZ,7972864,7972864,7972864,0,0,utRho22
glnA,16232888,16232888,16232136,752,28,utRho22
glnB,5375052,5375052,5374816,236,366,utRho22
glnD,377310,377310,377300,10,148,utRho22
glnE,6399602,6399602,6399282,320,150,utRho22
glnH,1696396,1696396,1696008,388,1746,utRho22
glnK,945112,945196,945112,84,1430,utRho22
glnL,8112742,8112742,8112678,64,0,utRho22
glnQ,1693262,1693262,1692926,336,348,utRho22
glnS,1411998,1412186,1411998,188,1872,utRho22
gloA,3455602,3455674,3455602,72,34,utRho22
gloB,469852,469852,469564,288,1004,utRho22
glpA,4705166,4705294,4705166,128,66,utRho22
glpD,7123942,7124026,7123942,84,548,utRho22
glpE,7123698,7123698,7123646,52,98,utRho22
glpF,8236322,8236322,8236180,142,1742,utRho22
glpG,7122960,7122960,7122904,56,82,utRho22
glpR,7121782,7121782,7121210,572,5140,utRho22
glpT,4704902,4704902,4704748,154,1320,utRho22
glpX,8231212,8231212,8231158,54,448,utRho22
glrK,5382246,5382246,5382196,50,226,utRho22
gltA,1509534,1509534,1508936,598,15200,utRho22
gltB,6709018,6709264,6709018,246,1290,utRho22
gltI,1375792,1375792,1375494,298,3170,utRho22
gltP,8588536,8588962,8588536,426,1446,utRho22
gltS,7657382,7657382,7657330,52,1932,utRho22
gltX,5041568,5041568,5041344,224,70,utRho22
gluQ,320286,320286,320224,62,0,utRho22
glyA,5371148,5371148,5371014,134,130,utRho22
glyQ,7450708,7450708,7450636,72,992,utRho22
glyS,7448990,7448990,7448794,196,974,utRho22
glyU,5998128,5998128,5998114,14,0,utRho22
glyV,8784626,8784720,8784626,94,264,utRho22
glyW,3984360,3984360,3984234,126,18,utRho22
gmhB,445612,445666,445612,54,256,utRho22
gmk,7642776,7642856,7642776,80,162,utRho22
gmr,2693686,2693686,2693484,202,756,utRho22
gnd,4202648,4202648,4202536,112,562,utRho22
gnsB,3275692,3275692,3275564,128,88,utRho22
gntK,14310580,14310580,14310368,212,1076,utRho22
gntP,9102668,9102668,9102592,76,448,utRho22
gntR,7157760,7157760,7157452,308,354,utRho22
gntT,7092810,7093118,7092810,308,3090,utRho22
gntU,7154170,7154170,7154122,48,362,utRho22
gntX,7089334,7089764,7089334,430,180,utRho22
gor,7292224,7292598,7292224,374,270,utRho22
gpmA,1575340,1575340,1575190,150,156,utRho22
gpmM,7570374,7570520,7570374,146,20,utRho22
gpsA,7567620,7567620,7567322,298,1512,utRho22
gpt,511828,511954,511828,126,336,utRho22
grcA,5433046,5433046,5432898,148,1618,utRho22
greA,6657728,6657728,6657430,298,256,utRho22
greB,7073488,7073624,7073488,136,0,utRho22
groL,8741566,8742050,8741566,484,9142,utRho22
groS,8741232,8741376,8741232,144,8356,utRho22
grpE,5501494,5501494,5501416,78,364,utRho22
grxA,1781552,1781552,1781506,46,60,utRho22
grxB,2248206,2248206,2248108,98,1040,utRho22
grxC,7569152,7569152,7568884,268,860,utRho22
grxD,3468324,3468324,3468202,122,500,utRho22
gspA,6911268,6911268,6910796,472,1126,utRho22
gspC,6910964,6911156,6910964,192,198,utRho22
gss,6277220,6277220,6277044,176,350,utRho22
gstA,3428654,3428754,3428654,100,0,utRho22
gstB,1761038,1761038,1760960,78,670,utRho22
guaB,5268214,5268214,5268140,74,8,utRho22
gudD,5839026,5839026,5838770,256,176,utRho22
gyrA,4678914,4678914,4678840,74,528,utRho22
gyrB,7760300,7760300,7760238,62,182,utRho22
hcaE,5337964,5338064,5337964,100,11190,utRho22
hcaR,5337928,5337928,5337792,136,14432,utRho22
hcaT,5336106,5336106,5335692,414,944,utRho22
hchA,4071260,4071670,4071260,410,44,utRho22
hcp,1828258,1828258,1827628,630,2252,utRho22
hcr,1824400,1824400,1824300,100,40,utRho22
hdeA,7313582,7313582,7313480,102,2,utRho22
hdeD,7313920,7313990,7313920,70,4240,utRho22
hdfR,7896320,7896320,7895934,386,44,utRho22
hdhA,3396244,3396244,3396080,164,180,utRho22
helD,2048876,2048942,2048876,66,248,utRho22
hemA,2527166,2527428,2527166,262,190,utRho22
hemB,779722,779722,779454,268,4820,utRho22
hemF,5106410,5106450,5106410,40,2,utRho22
hemH,996062,996110,996062,48,1372,utRho22
hemL,349882,349882,349764,118,22,utRho22
hemN,8103886,8104090,8103886,204,400,utRho22
hepA,127176,127176,126528,648,3714,utRho22
hflD,2385372,2385372,2385262,110,26,utRho22
hfq,8799602,8800576,8799602,974,4506,utRho22
hha,961006,961006,960616,390,352,utRho22
hicA,3018442,3018572,3018442,130,118,utRho22
higA,6468682,6468682,6468288,394,3736,utRho22
higB,6468960,6468960,6468910,50,224,utRho22
hinT,2323642,2323770,2323642,128,0,utRho22
hipB,3184964,3184964,3184884,80,92,utRho22
hisB,4186720,4186936,4186720,216,264,utRho22
hisJ,4853674,4853674,4853576,98,128,utRho22
hisL,8359856,8359984,8359856,128,1176,utRho22
hisS,5281284,5281284,5281150,134,0,utRho22
hlpA,400910,400964,400910,54,10,utRho22
hlyE,2460932,2460932,2460788,144,1734,utRho22
hmp,5371594,5371670,5371594,76,0,utRho22
hns,2585916,2585916,2585844,72,802,utRho22
hofM,7045856,7045856,7045502,354,168,utRho22
hokA,7441620,7441620,7441200,420,844,utRho22
hokC,33902,33902,33806,96,262,utRho22
hokE,1215462,1215672,1215462,210,116,utRho22
holC,8968546,8968546,8968560,14,370,utRho22
holD,9215562,9215606,9215562,44,34,utRho22
holE,3850040,3850216,3850040,176,3368,utRho22
hpt,282720,282862,282720,142,1752,utRho22
hrpB,324150,324210,324150,60,100,utRho22
hscB,5319048,5319048,5318934,114,492,utRho22
hscC,1367188,1367188,1366786,402,492,utRho22
hsdS,9163004,9163004,9162924,80,542,utRho22
hslJ,2883560,2883560,2883486,74,728,utRho22
hslO,7059344,7059548,7059344,204,10640,utRho22
hslR,7058220,7058696,7058220,476,1936,utRho22
hslV,8244708,8244708,8244574,134,140,utRho22
hsrA,7881412,7881412,7881224,188,218,utRho22
htgA,21286,21660,21286,374,21858,utRho22
htpG,989634,990240,989634,606,24248,utRho22
htpX,3825236,3825236,3825152,84,4,utRho22
htrE,311036,311036,310852,184,1194,utRho22
htrL,7587668,7587668,7587366,302,294,utRho22
hupA,8400352,8400562,8400352,210,0,utRho22
hupB,1845220,1845804,1845220,584,1272,utRho22
hyaA,2063968,2064278,2063968,310,144,utRho22
hybO,6292726,6292726,6292522,204,12826,utRho22
hycA,5700922,5700922,5700870,52,228,utRho22
hycI,5686204,5686204,5686086,118,3490,utRho22
hydN,5676264,5676264,5676210,54,58,utRho22
hyfA,5202342,5202402,5202342,60,314,utRho22
hypA,11402508,11402588,11402508,80,1060,utRho22
hypB,11403356,11404004,11403356,648,1176,utRho22
hypF,5676210,5676210,5674850,1360,7196,utRho22
hypT,9116634,9116634,9116578,56,0,utRho22
hyuA,6019660,6020056,6019660,396,1124,utRho22
iaaA,1733074,1733136,1733074,62,148,utRho22
iadA,9119074,9119074,9119052,22,420,utRho22
iap,5753072,5753162,5753072,90,180,utRho22
ibaG,6673966,6673966,6673606,360,86,utRho22
ibpA,7735036,7735036,7734844,192,2192,utRho22
ibpB,7733962,7733962,7733794,168,15204,utRho22
icd,2389922,2390246,2389922,324,188,utRho22
iclR,8447304,8447304,8447256,48,242,utRho22
idi,6065876,6066130,6065876,254,60,utRho22
idnD,8988870,8988870,8988812,58,198,utRho22
idnK,8989194,8989246,8989194,52,598,utRho22
ihfA,3591442,3591442,3591104,338,334,utRho22
ihfB,1927498,1927656,1927498,158,162,utRho22
ileS,43666,44782,43666,1116,2898,utRho22
ileX,6431194,6431196,6431194,2,0,utRho22
ilvA,15820940,15821324,15820940,384,932,utRho22
ilvC,7915824,7915940,7915824,116,206,utRho22
ilvE,15809552,15809936,15809552,384,1192,utRho22
ilvI,170840,171260,170840,420,716,utRho22
ilvL,23701308,23701932,23701308,624,90,utRho22
ilvY,7915734,7915734,7915640,94,148,utRho22
inaA,4698998,4698998,4698944,54,1698,utRho22
infA,1853370,1853370,1852886,484,328,utRho22
infC,3602692,3602692,3601276,1416,1384,utRho22
insA-5,3958452,3958452,3958430,22,142,utRho22
insA-7,9036758,9037054,9036758,296,2374,utRho22
insC-5,6372080,6372284,6372080,204,6966,utRho22
insEF-2,785238,785238,785820,582,3470,utRho22
insEF-4,2190310,2190310,2190892,582,3432,utRho22
insG,9007098,9007098,9006862,236,192,utRho22
insH-1,550596,550596,550234,362,35130,utRho22
insH-11,7306538,7306538,7306396,142,300,utRho22
insH-2,1151548,1151548,1151506,42,670,utRho22
insH-3,1378444,1378444,1378026,418,664,utRho22
insH-4,2791942,2792152,2791942,210,412,utRho22
insH-5,2857852,2857852,2857452,400,896,utRho22
insH-6,4135022,4135022,4134642,380,1748,utRho22
insH-7,4206186,4206186,4205822,364,2642,utRho22
insH-9,6260050,6260356,6260050,306,1912,utRho22
insI-3,9017372,9017372,9017234,138,696,utRho22
insJ,7441188,7441360,7441188,172,406,utRho22
insK,7442130,7442308,7442130,178,34,utRho22
insL-1,30760,30890,30760,130,2634,utRho22
insL-2,1216112,1216130,1216112,18,210,utRho22
insL-3,5028644,5028662,5028644,18,244,utRho22
insN-1,540452,540484,540452,32,190,utRho22
intD,1132202,1132202,1131956,246,18078,utRho22
intR,2826520,2826520,2826470,50,36,utRho22
intS,4933026,4933090,4933026,64,3248,utRho22
intZ,5117386,5117542,5117386,156,8536,utRho22
iraD,9113152,9113986,9113152,834,1066,utRho22
iraM,2424246,2424246,2424006,240,232,utRho22
iraP,802638,802772,802638,134,0,utRho22
iscA,5319924,5319924,5319772,152,384,utRho22
iscR,5324398,5324398,5324262,136,5048,utRho22
iscX,5313834,5313834,5313472,362,1544,utRho22
ispF,5743968,5743968,5743560,408,2778,utRho22
ispG,5283908,5283908,5283608,300,156,utRho22
ispU,389568,389806,389568,238,190,utRho22
isrA,2811502,2811502,2811618,116,4,utRho22
istr-1,7706384,7706384,7706384,0,0,utRho22
istr-2,7706514,7706514,7706514,0,0,utRho22
ivbL,15412092,15412092,15411952,140,148,utRho22
ivy,480638,480686,480638,48,304,utRho22
katE,3627628,3627734,3627628,106,620,utRho22
katG,8267624,8267670,8267624,46,80,utRho22
kbaZ,6557732,6557828,6557732,96,78,utRho22
kbl,7585154,7585154,7585102,52,528,utRho22
kch,2621046,2621046,2620538,508,422,utRho22
kdgR,3820506,3820506,3820198,308,54,utRho22
kdpE,1443788,1443788,1443466,322,338,utRho22
kdpF,1457698,1457698,1457642,56,184,utRho22
kdsA,2535708,2536330,2535708,622,1248,utRho22
kdsC,6683438,6684546,6683438,1108,3804,utRho22
kduI,5968388,5968388,5968248,140,27412,utRho22
kefF,94160,94492,94160,332,2460,utRho22
kgtP,5451624,5451624,5451492,132,322,utRho22
kup,7862206,7862632,7862206,426,356,utRho22
lacI,735076,735076,735020,56,402,utRho22
lacZ,1465508,1465508,1465220,288,1604,utRho22
ldcA,2486394,2486394,2486160,234,512,utRho22
ldhA,2885830,2885830,2885686,144,66,utRho22
ldrA,2538954,2538954,2538550,404,1724,utRho22
ldrB,2540024,2540024,2539620,404,620,utRho22
ldrC,2541092,2541092,2540690,402,560,utRho22
ldrD,7400544,7400544,7400174,370,516,utRho22
lepA,5414392,5414392,5414248,144,64,utRho22
lepB,5410928,5410928,5410618,310,302,utRho22
leuD,159188,159188,158906,282,460,utRho22
leuE,3761600,3761600,3761518,82,270,utRho22
leuL,168048,168048,167416,632,202,utRho22
leuO,168308,168736,168308,428,292,utRho22
leuQ,9212864,9212864,9212802,62,0,utRho22
leuU,6644556,6644556,6644316,240,290,utRho22
leuV,9212546,9212546,9212330,216,560,utRho22
leuX,8992772,8992810,8992772,38,28,utRho22
lexA,8514174,8514230,8514174,56,498,utRho22
lhr,3456706,3458174,3456706,1468,4918,utRho22
ligA,5060402,5060402,5060352,50,8,utRho22
ligB,7642576,7642576,7642340,236,558,utRho22
lipA,1320602,1320602,1320432,170,554,utRho22
lipB,1324802,1324802,1324556,246,9460,utRho22
lit,2397032,2397390,2397032,358,4362,utRho22
livJ,7199524,7199524,7199316,208,2112,utRho22
livK,7195510,7195510,7195120,390,1362,utRho22
lldP,7554578,7554798,7554578,220,4438,utRho22
lnt,1381968,1381968,1381762,206,292,utRho22
loiP,6163784,6163826,6163784,42,24,utRho22
lolA,1874656,1874738,1874656,82,156,utRho22
lolB,2527112,2527112,2527000,112,162,utRho22
lolC,2350748,2350854,2350748,106,58,utRho22
lon,917630,917776,917630,146,66,utRho22
lpcA,486936,487086,486936,150,244,utRho22
lpd,255434,255824,255434,390,1230,utRho22
lplA,9248476,9248476,9248234,242,914,utRho22
lplT,5947878,5947878,5947724,154,58,utRho22
lpoA,6586422,6586800,6586422,378,1430,utRho22
lpp,3514592,3514842,3514592,250,100,utRho22
lptA,6686598,6686760,6686598,162,680,utRho22
lptB,6686792,6687888,6686792,1096,1620,utRho22
lptD,114672,114672,114218,454,1302,utRho22
lptF,8972244,8972436,8972244,192,198,utRho22
lpxC,213016,213114,213016,98,1192,utRho22
lpxD,401920,401942,401920,22,0,utRho22
lpxL,2233418,2233418,2233164,254,0,utRho22
lpxM,3880456,3880456,3880386,70,60,utRho22
lpxP,4991156,4991290,4991156,134,432,utRho22
lrhA,4813312,4813312,4813282,30,0,utRho22
lrp,1864656,1865190,1864656,534,936,utRho22
lspA,50028,50414,50028,386,296,utRho22
lsrA,3202920,3202980,3202920,60,54,utRho22
lsrR,3202514,3202514,3202482,32,64,utRho22
ltaE,1818640,1818640,1818588,52,0,utRho22
luxS,5630130,5630130,5629466,664,5080,utRho22
lysA,5957902,5957902,5957798,104,72,utRho22
lysC,8467232,8467232,8466466,766,1978,utRho22
lysP,4497120,4497120,4497064,56,310,utRho22
lysR,5957900,5958042,5957900,142,62,utRho22
lysT,1561028,1561108,1561028,80,138,utRho22
lysU,8709610,8709610,8709434,176,94,utRho22
macB,1840188,1840694,1840188,506,1526,utRho22
maeA,3111484,3111484,3111338,146,2148,utRho22
mak,820236,820288,820236,52,220,utRho22
malE,8492928,8492928,8492838,90,4,utRho22
malI,3398456,3398456,3398360,96,22,utRho22
malK,8493472,8493568,8493472,96,252,utRho22
malP,7105020,7105020,7104946,74,1380,utRho22
malQ,7100798,7100798,7100140,658,640,utRho22
malS,14949880,14949988,14949880,108,168,utRho22
malT,7106048,7106170,7106048,122,48,utRho22
malX,3398626,3398710,3398626,84,4,utRho22
malZ,1689980,1690072,1689980,92,1268,utRho22
manA,3377102,3377152,3377102,50,100,utRho22
manX,3803866,3804096,3803866,230,602,utRho22
marC,3237882,3237882,3237816,66,424,utRho22
marR,3238186,3238240,3238186,54,328,utRho22
matP,2036918,2036970,2036918,52,46,utRho22
mazE,5822736,5822736,5822678,58,204,utRho22
mazG,5821720,5821720,5821370,350,4910,utRho22
mcbA,1684306,1684306,1684112,194,28,utRho22
mcbR,3040192,3040524,3040192,332,26,utRho22
mcrA,2420278,2420692,2420278,414,572,utRho22
mcrC,9156124,9156124,9155916,208,1410,utRho22
mdaB,6344814,6345060,6344814,246,322,utRho22
mdfA,1767138,1767346,1767138,208,4,utRho22
mdh,6768940,6768940,6768536,404,204,utRho22
mdoB,9198988,9198988,9198882,106,8000,utRho22
mdoD,2993290,2993712,2993290,422,302,utRho22
mdoG,2218514,2218670,2218514,156,96,utRho22
mdtA,4307958,4308032,4307958,74,174,utRho22
mdtE,7318168,7318464,7318168,296,5352,utRho22
mdtK,3486538,3486914,3486538,376,4250,utRho22
mdtP,8602472,8602472,8602060,412,3246,utRho22
melA,8683774,8683822,8683774,48,12,utRho22
melR,8683300,8683300,8683256,44,1144,utRho22
menA,8240812,8240812,8240698,114,158,utRho22
menB,4753774,4753774,4753638,136,842,utRho22
mepH,3468714,3468870,3468714,156,60,utRho22
mepM,3883666,3883666,3883270,396,276,utRho22
mepS,4539840,4539958,4539840,118,162,utRho22
metA,8428318,8428560,8428318,242,138,utRho22
metB,8257272,8257344,8257272,72,1194,utRho22
metC,6304150,6304472,6304150,322,560,utRho22
metE,8025768,8026106,8025768,338,3202,utRho22
metF,8265092,8265232,8265092,140,158,utRho22
metG,4388538,4388600,4388538,62,70,utRho22
metH,8447010,8447656,8447010,646,4742,utRho22
metJ,8257116,8257116,8256790,326,776,utRho22
metK,6173154,6173412,6173154,258,92,utRho22
metN,445428,445428,445290,138,22,utRho22
metR,8025710,8025710,8025632,78,0,utRho22
metT,1394326,1394326,1394266,60,168,utRho22
metY,19910250,19910250,19909734,516,678,utRho22
metZ,11789528,11789548,11789528,20,264,utRho22
mfd,2348056,2348056,2347928,128,218,utRho22
mglA,4478782,4478782,4478578,204,458,utRho22
mglB,4481132,4481132,4480696,436,9906,utRho22
mglC,4475918,4475918,4475506,412,536,utRho22
mgrB,3817584,3817584,3817532,52,14,utRho22
mgrR,3245828,3245828,3245828,0,0,utRho22
mgsA,2054082,2054082,2054030,52,42,utRho22
mgtL,8934560,8934862,8934560,302,62,utRho22
mhpA,737038,737222,737038,184,912,utRho22
mhpR,737072,737072,736840,232,342,utRho22
mhpT,750772,750918,750772,146,64,utRho22
miaA,8797964,8798504,8797964,540,2282,utRho22
micA,5629604,5629604,5629604,0,0,utRho22
micC,2874242,2874238,2874242,4,0,utRho22
micF,4626168,4626168,4626168,0,0,utRho22
micM,1014408,1014408,1014408,0,0,utRho22
minE,2449422,2449422,2449090,332,1434,utRho22
mioC,7852950,7852950,7852910,40,122,utRho22
mipA,3733012,3733012,3732944,68,932,utRho22
mlaA,4930270,4930270,4930014,256,8,utRho22
mlc,3337206,3337206,3337128,78,140,utRho22
mlrA,4429498,4429732,4429498,234,314,utRho22
mltA,5894546,5894546,5894356,190,554,utRho22
mltD,468050,468050,467910,140,268,utRho22
mltF,5391534,5391602,5391534,68,0,utRho22
mmuP,550238,550650,550238,412,42458,utRho22
mngA,1531622,1531968,1531622,346,206,utRho22
mngR,1531852,1531852,1531750,102,200,utRho22
mnmG,7851348,7851348,7851266,82,2880,utRho22
mntH,5025470,5025470,5025412,58,40,utRho22
mntP,3810918,3811376,3810918,458,2390,utRho22
mntR,1706160,1706366,1706160,206,16,utRho22
mntS,1706128,1706128,1705994,134,60,utRho22
moaA,1633654,1634088,1633654,434,2616,utRho22
moaB,1635954,1636110,1635954,156,1678,utRho22
mobA,8084242,8084242,8083998,244,56,utRho22
mocA,6030112,6030320,6030112,208,340,utRho22
modA,1589990,1590178,1589990,188,180,utRho22
moeA,1732788,1732788,1732728,60,0,utRho22
mokB,2984610,2984610,2984258,352,406,utRho22
molR_1,4392888,4392948,4392888,60,286,utRho22
motA,3954604,3954604,3954278,326,74,utRho22
mpaA,2781278,2781278,2781196,82,1242,utRho22
mpl,8911456,8911570,8911456,114,318,utRho22
mppA,2786108,2786454,2786108,346,376,utRho22
mprA,5621494,5621540,5621494,46,674,utRho22
mqo,4613848,4613848,4613508,340,684,utRho22
mqsA,6336742,6336742,6336492,250,356,utRho22
mqsR,6337306,6337306,6337088,218,1388,utRho22
mraZ,179192,179268,179192,76,152,utRho22
mrcA,7045652,7045742,7045652,90,88,utRho22
mrcB,329442,329460,329442,18,0,utRho22
mreB,13605424,13605424,13604348,1076,964,utRho22
mreD,6798166,6798166,6797750,416,94,utRho22
mrp,4388360,4388360,4388336,24,116,utRho22
mscK,972984,973072,972984,88,116,utRho22
mscL,6876002,6876048,6876002,46,938,utRho22
mscS,6139742,6139742,6139614,128,218,utRho22
msrA,8884522,8884522,8884352,170,2024,utRho22
msrB,3725168,3725168,3724858,310,0,utRho22
msyB,2228426,2228426,2228362,64,336,utRho22
mtfA,4087236,4087302,4087236,66,752,utRho22
mtgA,6699662,6699662,6699618,44,1750,utRho22
mtlA,30177504,30178248,30177504,744,9056,utRho22
mtn,358366,358366,358306,60,3340,utRho22
mtr,6611864,6611864,6611634,230,216,utRho22
mug,6430992,6430992,6430946,46,132,utRho22
murQ,5091466,5091546,5091466,80,142,utRho22
murR,5091586,5091586,5091218,368,592,utRho22
mutH,5939164,5939324,5939164,160,250,utRho22
mutL,8794092,8794824,8794092,732,5880,utRho22
mutM,7622554,7622554,7622304,250,200,utRho22
mutS,5714038,5714186,5714038,148,2284,utRho22
mutY,18617466,18618078,18617466,612,1404,utRho22
nac,4123956,4123956,4123866,90,1528,utRho22
nadA,1564122,1564170,1564122,48,0,utRho22
nadB,5420714,5420840,5420714,126,126,utRho22
nadC,237326,237326,237290,36,320,utRho22
nadE,3644604,3644916,3644604,312,622,utRho22
nadK,5501526,5501662,5501526,136,406,utRho22
nagA,1406350,1406350,1405502,848,3756,utRho22
nagB,1407416,1407416,1407222,194,212,utRho22
nagC,1404016,1404016,1403188,828,162,utRho22
nagE,1407680,1407888,1407680,208,732,utRho22
nagK,2357080,2357186,2357080,106,106,utRho22
nanA,6747240,6747240,6747152,88,1194,utRho22
nanC,9079856,9079856,9079002,854,1372,utRho22
nanR,6749406,6749406,6748978,428,2032,utRho22
nanS,9075406,9075406,9075188,218,240,utRho22
napF,4607390,4607390,4606994,396,362,utRho22
narG,2559614,2559728,2559614,114,1294,utRho22
narK,2555642,2555914,2555642,272,618,utRho22
narP,4580844,4581000,4580844,156,494,utRho22
narQ,5171154,5171462,5171154,308,790,utRho22
narU,3088326,3088326,3088120,206,680,utRho22
narW,3077374,3077374,3074618,2756,4880,utRho22
narX,2555554,2555554,2555236,318,170,utRho22
narZ,3085380,3085380,3085180,200,0,utRho22
ndh,2331984,2332170,2331984,186,1036,utRho22
ndk,5289920,5289920,5289728,192,182,utRho22
nemR,6904084,6904092,6904084,8,4120,utRho22
nepI,7683542,7683542,7683478,64,214,utRho22
nfo,4501612,4501680,4501612,68,230,utRho22
nfsB,1210906,1210906,1210848,58,32,utRho22
nfuA,7090916,7091248,7090916,332,368,utRho22
nhaA,34634,34978,34634,344,714,utRho22
nhaB,2469534,2469534,2469434,100,316,utRho22
nhoA,3067926,3068048,3067926,122,108,utRho22
nikA,7226878,7227334,7226878,456,6374,utRho22
nikR,7237074,7237176,7237074,102,340,utRho22
nirB,6987974,6988022,6987974,48,134,utRho22
nlpA,7680034,7680034,7679986,48,74,utRho22
nlpC,3585654,3585654,3585462,192,56,utRho22
nlpD,5737658,5737658,5737506,152,16,utRho22
nlpI,6618080,6618080,6617848,232,68,utRho22
nmpC,1153740,1153740,1153650,90,16,utRho22
nohA,3273206,3273206,3272734,472,1290,utRho22
norR,5664614,5664614,5664578,36,100,utRho22
norV,5664878,5664952,5664878,74,0,utRho22
nrdA,4689510,4689730,4689510,220,7598,utRho22
nrdD,8925676,8925676,8925320,356,2878,utRho22
nrdH,5601312,5601446,5601312,134,618,utRho22
nrdR,865954,866004,865954,50,50,utRho22
nrfA,8575342,8575528,8575342,186,218,utRho22
nsrR,8812088,8812380,8812088,292,5194,utRho22
nudB,3897348,3897348,3897264,84,0,utRho22
nudC,8393428,8393806,8393428,378,458,utRho22
nudE,7052658,7052658,7052298,360,2074,utRho22
nudG,3682876,3682980,3682876,104,0,utRho22
nudI,4729050,4729108,4729050,58,138,utRho22
nudJ,2388874,2388874,2388576,298,556,utRho22
nuoA,4810670,4810670,4810144,526,1144,utRho22
nuoN,4783434,4783434,4783010,424,610,utRho22
nupC,5026018,5026084,5026018,66,20,utRho22
nupG,6211302,6211428,6211302,126,322,utRho22
ogrK,4335096,4335096,4335040,56,94,utRho22
ogt,2800568,2800568,2800472,96,330,utRho22
ohsC,5401036,5401040,5401036,4,0,utRho22
ompA,2040382,2040382,2040106,276,10988,utRho22
ompC,4625774,4625774,4625498,276,176,utRho22
ompF,1974184,1974184,1973964,220,124,utRho22
ompL,8128958,8128958,8128590,368,848,utRho22
ompN,2874158,2874158,2873786,372,62,utRho22
ompR,7073510,7073510,7073168,342,84,utRho22
ompT,1171330,1171330,1171266,64,386,utRho22
ompW,2627982,2628040,2627982,58,66,utRho22
ompX,1700418,1700900,1700418,482,412,utRho22
omrA,5952378,5952378,5952378,0,0,utRho22
omrB,5952770,5952770,5952770,0,0,utRho22
oppA,2602170,2602364,2602170,194,3502,utRho22
orn,8783168,8783208,8783168,40,56,utRho22
osmB,2686952,2686952,2686656,296,1690,utRho22
osmC,3113192,3113250,3113192,58,288,utRho22
osmE,3644566,3644566,3644512,54,74,utRho22
osmF,4439046,4439046,4438962,84,2568,utRho22
osmY,9222306,9222792,9222306,486,368,utRho22
otsA,3963302,3963302,3963224,78,416,utRho22
otsB,3964930,3964930,3964774,156,678,utRho22
oxc,4984288,4984288,4983900,388,2478,utRho22
oxyR,8316914,8316980,8316914,66,1970,utRho22
oxyS,8316788,8316788,8316788,0,0,utRho22
paaA,2907730,2907854,2907730,124,0,utRho22
paaX,2927018,2927078,2927018,60,16,utRho22
paaZ,2907340,2907340,2907284,56,88,utRho22
pabA,6981702,6981702,6981658,44,186,utRho22
pabB,3789256,3789610,3789256,354,792,utRho22
pabC,2306186,2306600,2306186,414,376,utRho22
pagP,1313052,1313114,1313052,62,62,utRho22
panB,299260,299260,299202,58,7608,utRho22
panC,297840,297840,297590,250,526,utRho22
panD,293490,293490,293388,102,100,utRho22
panZ,7195656,7195968,7195656,312,344,utRho22
parC,6332060,6332060,6331946,114,1004,utRho22
patA,6438916,6438988,6438916,72,38,utRho22
patD,3030830,3031156,3030830,326,158,utRho22
pbpC,5294986,5294986,5294650,336,128,utRho22
pbpG,4450132,4450132,4449740,392,318,utRho22
pck,7065358,7065636,7065358,278,4398,utRho22
pcnB,318782,318782,318252,530,420,utRho22
pdhR,244068,244184,244068,116,292,utRho22
pdxB,4875768,4875768,4875702,66,140,utRho22
pdxH,3436068,3436068,3436014,54,294,utRho22
pdxJ,5403626,5403626,5403458,168,522,utRho22
pdxK,5074638,5074638,5074474,164,86,utRho22
pepA,8972278,8972278,8971902,376,312,utRho22
pepD,511618,511618,511432,186,1106,utRho22
pepN,1981182,1981244,1981182,62,406,utRho22
pepQ,8062294,8062322,8062294,28,84,utRho22
pepT,2371646,2371688,2371646,42,272,utRho22
pfkA,8214948,8215104,8214948,156,844,utRho22
pfkB,3612646,3612740,3612646,94,102,utRho22
pflA,1902456,1902456,1902160,296,56,utRho22
pflB,1907850,1907850,1907108,742,1928,utRho22
pflD,8287716,8287990,8287716,274,126,utRho22
pgaA,2185046,2185046,2184578,468,1492,utRho22
pgi,8467444,8467516,8467444,72,62,utRho22
pgk,12291428,12291428,12290488,940,4032,utRho22
pgl,1597078,1597172,1597078,94,74,utRho22
pgpB,2678324,2678660,2678324,336,616,utRho22
pgpC,5397276,5397276,5397100,176,236,utRho22
pgrR,2783744,2783982,2783744,238,968,utRho22
pheL,5475158,5475198,5475158,40,8,utRho22
pheM,7197204,7197204,7197080,124,0,utRho22
pheP,1203858,1203918,1203858,60,322,utRho22
pheU,8725254,8725254,8725252,2,0,utRho22
pheV,6220730,6220732,6220730,2,0,utRho22
phnC,8650412,8650412,8650330,82,500,utRho22
phoA,803414,803494,803414,80,204,utRho22
phoB,834202,834284,834202,82,134,utRho22
phoE,520316,520316,520200,116,2034,utRho22
phoH,2169730,2169984,2169730,254,652,utRho22
phoP,2381016,2381016,2380894,122,2822,utRho22
phoQ,2379880,2379880,2379552,328,1270,utRho22
phoU,7815330,7815330,7815156,174,164,utRho22
phr,1478842,1479014,1478842,172,710,utRho22
pinE,2419054,2419370,2419054,316,2208,utRho22
pinQ,3267168,3267244,3267168,76,424,utRho22
pinR,2867424,2867424,2867348,76,498,utRho22
pitA,7275224,7275284,7275224,60,164,utRho22
pitB,6272806,6272806,6272742,64,682,utRho22
pka,5439862,5439906,5439862,44,384,utRho22
plaP,4174476,4174476,4174124,352,356,utRho22
pldA,8009628,8009724,8009628,96,3660,utRho22
pldB,8018028,8018340,8018028,312,4606,utRho22
plsB,8513196,8513196,8512932,264,142,utRho22
pmbA,8915890,8915918,8915890,28,0,utRho22
pmrD,4747148,4747148,4747076,72,36,utRho22
pncB,1980828,1980828,1980712,116,130,utRho22
pncC,5648788,5648788,5648692,96,24,utRho22
pnp,6622652,6622652,6622336,316,90,utRho22
pntA,3355950,3355950,3355806,144,88,utRho22
pntB,3353096,3353096,3352720,376,430,utRho22
polA,8093880,8093932,8093880,52,470,utRho22
polB,131606,131606,131560,46,0,utRho22
potD,2365700,2365700,2365658,42,256,utRho22
potE,1436688,1436688,1436530,158,140,utRho22
potF,1787268,1787568,1787268,300,352,utRho22
poxB,1822152,1822152,1822098,54,958,utRho22
ppa,8899372,8899372,8899304,68,96,utRho22
ppc,8306380,8306380,8306196,184,1914,utRho22
ppdA,5928440,5928440,5928354,86,3120,utRho22
ppdD,235410,235410,235098,312,494,utRho22
pphA,3846770,3846770,3845938,832,3578,utRho22
pphB,5719474,5719520,5719474,46,46,utRho22
ppiA,6984898,6984898,6984594,304,156,utRho22
ppiC,7919682,7919682,7919626,56,20,utRho22
ppiD,923638,923830,923638,192,106,utRho22
ppk,5245748,5246088,5245748,340,666,utRho22
pppA,6228958,6228958,6228704,254,484,utRho22
ppsA,3574322,3574322,3574224,98,0,utRho22
ppsR,3574678,3574890,3574678,212,232,utRho22
pptA,3065716,3066104,3065716,388,1668,utRho22
pqiA,2023318,2024002,2023318,684,66,utRho22
prc,3830054,3830054,3829632,422,4968,utRho22
preT,4467978,4468066,4467978,88,2352,utRho22
prfC,9218688,9218828,9218688,140,606,utRho22
prkB,6968622,6968980,6968622,358,2914,utRho22
prlC,7290476,7290476,7290364,112,500,utRho22
prlF,6553944,6554004,6553944,60,638,utRho22
proB,520432,520776,520432,344,1436,utRho22
proC,811372,811372,811288,84,268,utRho22
proK,7417388,7417388,7417384,4,0,utRho22
proL,4572414,4572422,4572414,8,24,utRho22
proP,8660640,8661004,8660640,364,682,utRho22
proS,437674,437674,437550,124,534,utRho22
proV,5609126,5609630,5609126,504,1486,utRho22
prpB,697292,697364,697292,72,192,utRho22
prpR,696942,696942,696886,56,104,utRho22
prs,2524354,2524354,2523750,604,14200,utRho22
psd,8781276,8781276,8780720,556,2046,utRho22
psiE,8480600,8480650,8480600,50,66,utRho22
pspA,2736076,2736158,2736076,82,32,utRho22
pspF,2736080,2736080,2735824,256,64,utRho22
pspG,8525632,8525680,8525632,48,24,utRho22
pssA,5445156,5445454,5445156,298,4214,utRho22
pstB,7817112,7817112,7816732,380,220,utRho22
pstC,7821084,7821084,7820796,288,20,utRho22
pstS,23469408,23469408,23469150,258,294,utRho22
psuG,4517114,4517114,4516734,380,6590,utRho22
psuT,4514992,4514992,4514670,322,0,utRho22
pth,2517084,2517084,2517026,58,0,utRho22
ptrA,5918022,5918022,5917768,254,0,utRho22
ptrB,3857730,3857730,3857678,52,3612,utRho22
ptsG,2315252,2315738,2315252,486,1344,utRho22
ptsH,5066996,5067528,5066996,532,1546,utRho22
purA,8809328,8809374,8809328,46,16,utRho22
purC,5195562,5195562,5195236,326,286,utRho22
purD,8411972,8411972,8411862,110,106,utRho22
purE,1106284,1106284,1106200,84,618,utRho22
purH,8415254,8415254,8415064,190,132,utRho22
purL,5391178,5391178,5391086,92,314,utRho22
purM,5242306,5242394,5242306,88,54,utRho22
purR,3475378,3475688,3475378,310,484,utRho22
purT,3861438,3861762,3861438,324,740,utRho22
purU,2577512,2577512,2577248,264,192,utRho22
putA,2157850,2157850,2157764,86,102,utRho22
putP,2158336,2158610,2158336,274,214,utRho22
puuA,2721936,2721936,2721816,120,0,utRho22
puuC,2725456,2725486,2725456,30,4,utRho22
puuD,2722104,2722240,2722104,136,122,utRho22
puuP,2718746,2718746,2718374,372,1484,utRho22
pykA,3874988,3875298,3874988,310,572,utRho22
pykF,3510934,3511396,3510934,462,2986,utRho22
pyrC,2245286,2245286,2245214,72,0,utRho22
pyrD,2009464,2009536,2009464,72,422,utRho22
pyrE,7631970,7631970,7631536,434,878,utRho22
pyrF,2683740,2683842,2683740,102,56,utRho22
pyrG,5819594,5819594,5819332,262,1296,utRho22
pyrH,383624,383710,383624,86,378,utRho22
pyrL,8945490,8945490,8945066,424,634,utRho22
qmcA,1031646,1031646,1031546,100,922,utRho22
qor,8528608,8528608,8528462,146,100,utRho22
qseB,6339502,6339656,6339502,154,1862,utRho22
queA,849970,850022,849970,52,362,utRho22
queE,5811212,5811212,5810836,376,336,utRho22
queF,5850642,5850696,5850642,54,124,utRho22
queG,8788184,8788184,8788134,50,49492,utRho22
racC,2835630,2835630,2835526,104,0,utRho22
racR,2840898,2840898,2840482,416,376,utRho22
raiA,5474208,5474308,5474208,100,88,utRho22
rarD,8008594,8008594,8008356,238,722,utRho22
ravA,7862256,7862256,7862186,70,158,utRho22
rayT,495088,495274,495088,186,346,utRho22
rbn,4763162,4763216,4763162,54,72,utRho22
rbsD,7866644,7866702,7866644,58,0,utRho22
rcnA,4371654,4371834,4371654,180,320,utRho22
rcnB,4373768,4373920,4373768,152,254,utRho22
rcnR,4371806,4371806,4371592,214,618,utRho22
rcsA,4047672,4047936,4047672,264,7482,utRho22
rcsB,4631390,4632354,4631390,964,574,utRho22
rcsC,4640162,4640162,4639656,506,446,utRho22
rcsD,4626904,4626976,4626904,72,914,utRho22
rdgB,6193240,6193362,6193240,122,448,utRho22
rdlA,2538646,2538646,2538646,0,0,utRho22
rdlB,2539712,2539716,2539712,4,74,utRho22
rdlC,2540782,2540786,2540782,4,2,utRho22
rdlD,7400272,7400272,7400272,0,0,utRho22
rdoA,8084782,8084830,8084782,48,74,utRho22
recA,11295276,11295276,11295076,200,220,utRho22
recC,5925014,5925014,5924856,158,0,utRho22
recF,7763722,7763722,7762442,1280,3172,utRho22
recN,5503518,5503590,5503518,72,54,utRho22
recQ,8011666,8011728,8011666,62,40,utRho22
relA,5828554,5828554,5827302,1252,1344,utRho22
relB,3291806,3291806,3291744,62,0,utRho22
rem,3289950,3289950,3289804,146,12,utRho22
rep,7921294,7921354,7921294,60,218,utRho22
rfaD,7587730,7587974,7587730,244,808,utRho22
rfaE,6393852,6393852,6393506,346,184,utRho22
rfaH,8049930,8049930,8049642,288,1894,utRho22
rfbX,4219436,4219436,4219168,268,848,utRho22
rfe,7935600,7935832,7935600,232,44,utRho22
rhaB,8194944,8194944,8194896,48,114,utRho22
rhaD,8188770,8188770,8188544,226,118,utRho22
rhaS,8195422,8195472,8195422,50,158,utRho22
rhaT,8201132,8201132,8201050,82,430,utRho22
rhlE,1661566,1661744,1661566,178,182,utRho22
rhoL,47593944,47594772,47593944,828,66792,utRho22
rhsB,7238006,7238384,7238006,378,1516,utRho22
rhsC,1458758,1459166,1458758,408,0,utRho22
rhsD,1046132,1046522,1046132,390,280,utRho22
rhtA,1700608,1700608,1700194,414,716,utRho22
rhtC,8015478,8015514,8015478,36,1164,utRho22
ribA,2678468,2678468,2678320,148,298,utRho22
ribC,3486916,3486916,3486484,432,7628,utRho22
ribE,869008,869294,869008,286,2626,utRho22
ribF,42766,42814,42766,48,112,utRho22
ridA,8941892,8941892,8941826,66,2,utRho22
rihA,1369204,1369204,1368824,380,5150,utRho22
rihB,4510504,4510504,4510372,132,128,utRho22
rimJ,2251044,2251124,2251044,80,332,utRho22
rimK,1783752,1783934,1783752,182,530,utRho22
rimL,2997486,2997876,2997486,390,398,utRho22
rimO,1756140,1756140,1756070,70,94,utRho22
rimP,6636350,6636350,6636012,338,484,utRho22
rlmA,3814172,3814172,3814120,52,290,utRho22
rlmD,5830086,5830086,5830000,86,26,utRho22
rlmE,6655520,6655520,6655328,192,220,utRho22
rlmF,1684384,1684664,1684384,280,614,utRho22
rlmG,6471784,6471784,6471750,34,156,utRho22
rlmI,2060002,2060002,2059938,64,92,utRho22
rlmJ,7290700,7290770,7290700,70,30,utRho22
rlmL,2015344,2015688,2015344,344,2678,utRho22
rlpA,1330444,1330444,1330380,64,120,utRho22
rluA,120900,120900,120692,208,374,utRho22
rluF,8460324,8460708,8460324,384,254,utRho22
rmf,2031006,2031430,2031006,424,534,utRho22
rna,1290068,1290068,1290006,62,52,utRho22
rnb,2698258,2698258,2697824,434,5044,utRho22
rnc,10816892,10816892,10816252,640,6704,utRho22
rnd,3776122,3776122,3775982,140,66,utRho22
rne,2289746,2289746,2288734,1012,5510,utRho22
rnhA,472082,472082,472004,78,1260,utRho22
rnk,1288360,1288360,1287934,426,112,utRho22
rnlA,5531788,5531836,5531788,48,1926,utRho22
rnlB,5533414,5533968,5533414,554,1554,utRho22
rnpB,19623552,19623552,19623552,0,0,utRho22
rob,9270706,9270706,9270620,86,104,utRho22
rodZ,5285868,5285868,5285688,180,138,utRho22
rpe,7030306,7030306,7030118,188,116,utRho22
rph,15266320,15266320,15266196,124,148,utRho22
rpiA,6118706,6118706,6118650,56,1910,utRho22
rpiB,8626514,8626700,8626514,186,770,utRho22
rpiR,8626274,8626274,8625982,292,340,utRho22
rplJ,8359246,8359992,8359246,746,1324,utRho22
rplK,8356708,8356894,8356708,186,82,utRho22
rplM,6757344,6757344,6757302,42,692,utRho22
rplN,6896444,6896444,6896298,146,426,utRho22
rplS,5489284,5489284,5489060,224,2092,utRho22
rplT,7199052,7199052,7198996,56,52,utRho22
rplU,6667036,6667036,6666902,134,72,utRho22
rplY,4564866,4565034,4564866,168,148,utRho22
rpmA,6666450,6666450,6666238,212,152,utRho22
rpmB,15247980,15247980,15246696,1284,18212,utRho22
rpmE,8253816,8254026,8253816,210,342,utRho22
rpmF,2294676,2294734,2294676,58,4306,utRho22
rpmH,7768130,7768672,7768130,542,872,utRho22
rpmI,3600854,3600854,3599998,856,2390,utRho22
rpoB,8362126,8362490,8362126,364,58,utRho22
rpoD,6424946,6426094,6424946,1148,22266,utRho22
rpoE,5420372,5420372,5420024,348,140,utRho22
rpoH,7202006,7202006,7201566,440,5976,utRho22
rpoN,6689324,6689434,6689324,110,14,utRho22
rpoS,5736236,5736236,5735102,1134,3802,utRho22
rpoZ,7644154,7644212,7644154,58,598,utRho22
rppH,5937986,5937986,5937954,32,46,utRho22
rprA,3540744,3540744,3540744,0,0,utRho22
rpsA,1923434,1923990,1923434,556,17452,utRho22
rpsF,8850050,8850236,8850050,186,2160,utRho22
rpsI,6756580,6756580,6756414,166,638,utRho22
rpsJ,6906884,6906884,6906540,344,812,utRho22
rpsL,6949242,6949242,6949104,138,522,utRho22
rpsM,6885130,6885130,6884942,188,152,utRho22
rpsO,13247144,13247144,13246736,408,296,utRho22
rpsP,5492508,5492508,5492370,138,0,utRho22
rpsT,42420,42420,42156,264,458,utRho22
rpsU,12842584,12843124,12842584,540,596,utRho22
rraA,8238716,8238716,8238660,56,44,utRho22
rraB,8956768,8956946,8956768,178,246,utRho22
rrsA,8070478,8071062,8070478,584,2908,utRho22
rrsB,16665468,16666636,16665468,1168,5992,utRho22
rrsC,7883032,7883616,7883032,584,2532,utRho22
rrsD,6858094,6858094,6857524,570,738,utRho22
rrsE,8415726,8416294,8415726,568,294,utRho22
rrsG,5462896,5462896,5462314,582,2946,utRho22
rrsH,446970,447542,446970,572,324,utRho22
rsd,8393908,8393908,8393616,292,1058,utRho22
rseA,5419264,5419264,5418808,456,190,utRho22
rseP,392940,393092,392940,152,98,utRho22
rseX,4067298,4067298,4067298,0,0,utRho22
rsfS,1338144,1338144,1338072,72,82,utRho22
rsgA,8783132,8783132,8783018,114,190,utRho22
rsmA,105176,105176,104860,316,2406,utRho22
rsmB,6869982,6870414,6869982,432,196,utRho22
rsmC,9215736,9215736,9215400,336,248,utRho22
rsmD,7208594,7208786,7208594,192,76,utRho22
rsmE,6182036,6182268,6182036,232,1124,utRho22
rsmG,7847512,7847512,7847360,152,1318,utRho22
rsmH,180020,180188,180020,168,206,utRho22
rsmI,6587106,6587106,6586670,436,2418,utRho22
rssA,2578212,2578412,2578212,200,1058,utRho22
rssB,2580440,2580484,2580440,44,188,utRho22
rstA,3364276,3364300,3364276,24,0,utRho22
rsuA,4561096,4561096,4560966,130,104,utRho22
rsxA,3411510,3411534,3411510,24,174,utRho22
rtcA,7114004,7114004,7113698,306,3222,utRho22
rtcB,7116214,7116214,7116158,56,188,utRho22
rtn,4541356,4541452,4541356,96,4,utRho22
rutA,2148052,2148052,2148022,30,102,utRho22
rutG,2140090,2140090,2139678,412,882,utRho22
rutR,2148226,2148484,2148226,258,848,utRho22
ruvA,7784096,7784096,7783904,192,164,utRho22
ruvB,7782176,7782176,7781424,752,496,utRho22
ruvC,3894878,3894878,3894752,126,30,utRho22
rybB,1776114,1776114,1776114,0,0,utRho22
rydB,3529860,3529860,3529322,538,638,utRho22
rydC,2983012,2983012,2983012,0,0,utRho22
ryfA,5307398,5307710,5307398,312,118,utRho22
ryfD,5468590,5468590,5468590,0,0,utRho22
ryhB,7162032,7162032,7162032,0,0,utRho22
ryjA,8556132,8556132,8556132,0,0,utRho22
ryjB,9055954,9055954,9055954,0,0,utRho22
sad,3229598,3229598,3229406,192,486,utRho22
safA,3168056,3168056,3167918,138,1794,utRho22
sanA,4465368,4465756,4465368,388,222,utRho22
sapF,2705314,2705314,2705268,46,230,utRho22
sbcB,4165456,4165512,4165456,56,0,utRho22
sbcC,831694,831694,831506,188,202,utRho22
sbcD,833954,833954,833904,50,102,utRho22
sbmA,793106,793278,793106,172,3978,utRho22
sbmC,4162650,4162650,4162524,126,82,utRho22
sdaA,3793618,3793864,3793618,246,120,utRho22
sdaC,5856070,5856458,5856070,388,582,utRho22
sdhC,1509916,1510354,1509916,438,20744,utRho22
sdhD,1510808,1511120,1510808,312,8288,utRho22
sdiA,3993834,3993834,3993664,170,330,utRho22
secE,8354354,8354716,8354354,362,90,utRho22
secG,6645180,6645180,6645010,170,144,utRho22
selA,7522594,7522594,7522498,96,1050,utRho22
selB,7519850,7519850,7519722,128,494,utRho22
selC,7672396,7672444,7672396,48,0,utRho22
selD,3696058,3696058,3696016,42,3746,utRho22
seqA,1425884,1425974,1425884,90,268,utRho22
serA,6117098,6117098,6116820,278,180,utRho22
serB,9249712,9249790,9249712,78,330,utRho22
serC,3830380,3830612,3830380,232,44,utRho22
serS,1878730,1878856,1878730,126,1072,utRho22
serT,2063438,2063438,2063424,14,0,utRho22
serU,4087124,4087124,4087114,10,208,utRho22
serV,5637394,5637394,5637290,104,276,utRho22
serW,1852014,1852014,1851942,72,86,utRho22
serX,2195352,2195352,2195304,48,104,utRho22
setB,4527426,4527726,4527426,300,0,utRho22
setC,7673488,7673906,7673488,418,3054,utRho22
sfmA,1116124,1116424,1116124,300,446,utRho22
sfmC,1117606,1117948,1117606,342,66,utRho22
sfsA,323030,323030,322972,58,372,utRho22
sfsB,6669592,6669818,6669592,226,458,utRho22
sgrR,154676,154676,154598,78,390,utRho22
sgrS,154734,154734,154734,0,0,utRho22
shiA,4107068,4107286,4107068,218,362,utRho22
sibA,4306622,4306622,4306622,0,0,utRho22
sibB,4307292,4307292,4307292,0,0,utRho22
sibC,6113702,6113702,6113702,0,0,utRho22
sibD,6389730,6389730,6389730,0,0,utRho22
sibE,6390480,6390480,6390480,0,0,utRho22
sixA,4913998,4913998,4913624,374,102,utRho22
slp,7307872,7307922,7307872,50,76,utRho22
slt,9261400,9261466,9261400,66,140,utRho22
slyA,3442028,3442028,3441648,380,352,utRho22
slyB,3439496,3439752,3439496,256,130,utRho22
slyD,6957398,6957398,6956994,404,668,utRho22
slyX,6954862,6955280,6954862,418,1406,utRho22
smf,6867372,6867372,6867120,252,836,utRho22
smpB,5509534,5509792,5509534,258,1210,utRho22
smrA,2811872,2811958,2811872,86,628,utRho22
smrB,4896872,4897212,4896872,340,1996,utRho22
smtA,1946808,1947074,1946808,266,596,utRho22
sodA,8201518,8201620,8201518,102,1330,utRho22
sodB,3470646,3470756,3470646,110,556,utRho22
sodC,3449358,3449358,3449310,48,112,utRho22
sohB,2658568,2658664,2658568,96,1092,utRho22
sokB,2984232,2984238,2984232,6,178,utRho22
solA,2241218,2241218,2241172,46,18,utRho22
soxR,8554894,8554938,8554894,44,264,utRho22
soxS,8554846,8554846,8554766,80,14,utRho22
speA,6172096,6172096,6171822,274,174,utRho22
speB,6167892,6167892,6167594,298,212,utRho22
speC,6218350,6218350,6218310,40,14,utRho22
spf,8099798,8099798,8099798,0,0,utRho22
sppA,3697422,3697674,3697422,252,3258,utRho22
spy,3651376,3651376,3651250,126,338,utRho22
sra,3112092,3112092,3111926,166,0,utRho22
sraB,2293178,2293178,2293178,0,0,utRho22
sraC,3846132,3846132,3846132,0,0,utRho22
srlA,5651582,5651664,5651582,82,62,utRho22
srlR,5657720,5658094,5657720,374,12232,utRho22
srmB,5425752,5425792,5425752,40,272,utRho22
sroA,151216,151216,151216,0,0,utRho22
sroG,6369436,6369436,6369436,0,0,utRho22
sroH,8380974,8380974,8380974,0,0,utRho22
ssb,8548022,8548250,8548022,228,110,utRho22
sseA,5304782,5304988,5304782,206,3524,utRho22
sspA,6755138,6755138,6754840,298,364,utRho22
ssrA,5511014,5511186,5511014,172,100,utRho22
ssrS,12223036,12223932,12223036,896,756,utRho22
sstT,6479726,6479888,6479726,162,242,utRho22
ssuB,1988282,1988282,1988088,194,478,utRho22
ssuE,1995126,1995126,1995024,102,0,utRho22
sthA,8321604,8321604,8321580,24,1758,utRho22
stpA,5597156,5597156,5596990,166,202,utRho22
sucA,3034344,3034824,3034344,480,2500,utRho22
sufA,3528836,3528836,3528772,64,18,utRho22
sufE,3518962,3518962,3518580,382,154,utRho22
sugE,8753588,8753750,8753588,162,1048,utRho22
sulA,2041894,2041894,2041838,56,3402,utRho22
syd,5850738,5850738,5850560,178,186,utRho22
symE,9159834,9159834,9159680,154,958,utRho22
symR,9159670,9159670,9159670,0,0,utRho22
tabA,8949566,8949724,8949566,158,6,utRho22
talA,5157140,5157332,5157140,192,198,utRho22
talB,16382,16476,16382,94,6916,utRho22
tam,3214442,3214692,3214442,250,516,utRho22
tamA,8884540,8884764,8884540,224,1998,utRho22
tar,3945432,3945432,3945382,50,2,utRho22
tas,5943138,5943194,5943138,56,2884,utRho22
tatA,16087636,16087780,16087636,144,576,utRho22
tatE,1317742,1317894,1317742,152,162,utRho22
tauA,770410,770464,770410,54,268,utRho22
tdcA,6534186,6534186,6534130,56,32,utRho22
tdcG,6519652,6519652,6519298,354,1522,utRho22
tdcR,6534380,6534760,6534380,380,92,utRho22
tdk,2586986,2587054,2586986,68,94,utRho22
tehA,3001072,3001146,3001072,74,58,utRho22
tesA,1039898,1039898,1039530,368,1076,utRho22
tesB,950402,950402,950322,80,0,utRho22
tfaE,2418532,2418532,2418238,294,2408,utRho22
tfaQ,3269912,3269912,3269770,142,1138,utRho22
tff,379424,379256,379424,168,226,utRho22
tgt,852110,852274,852110,164,4,utRho22
thiD,4369346,4369346,4369032,314,158,utRho22
thiI,882936,883098,882936,162,70,utRho22
thiM,4370902,4370902,4370602,300,832,utRho22
thiQ,146170,146170,145854,316,7360,utRho22
thrL,592,760,592,168,160,utRho22
thrS,7210932,7210932,7210280,652,884,utRho22
thrU,8350762,8350776,8350762,14,2,utRho22
thrV,6847414,6847414,6847310,104,156778,utRho22
thrW,525682,525742,525682,60,7706,utRho22
thyA,5930696,5930696,5930310,386,2126,utRho22
tig,909986,910266,909986,280,68,utRho22
tisB,7706674,7707106,7706674,432,322,utRho22
tktA,6163414,6163414,6163270,144,98,utRho22
tktB,5158616,5159272,5158616,656,5772,utRho22
tldD,6784368,6784368,6784056,312,0,utRho22
tmcA,5191876,5191876,5191718,158,1606,utRho22
tnaC,15553644,15553740,15553644,96,8024,utRho22
tolB,1555074,1555480,1555074,406,428,utRho22
tolC,6356008,6356230,6356008,222,204,utRho22
tomB,961588,961588,961416,172,1632,utRho22
tonB,2622108,2622178,2622108,70,16,utRho22
topA,2661578,2662096,2661578,518,136,utRho22
torC,2116112,2116168,2116112,56,818,utRho22
torR,2115968,2115968,2115908,60,880,utRho22
torS,2112364,2112364,2112356,8,36,utRho22
torT,2112414,2112522,2112414,108,36,utRho22
tpiA,8223138,8223138,8223014,124,186,utRho22
tppB,3425342,3425538,3425342,196,2810,utRho22
tpr,2574376,2574376,2574376,0,0,utRho22
tpx,2777688,2777688,2777622,66,990,utRho22
tqsA,3347780,3347826,3347780,46,292,utRho22
treA,2494850,2494850,2494752,98,1168,utRho22
treB,8932420,8932420,8932360,60,128,utRho22
treF,7339102,7339184,7339102,82,72,utRho22
treR,8934694,8934694,8934492,202,0,utRho22
trg,2984878,2984940,2984878,62,42,utRho22
trkG,2847342,2847564,2847342,222,1478,utRho22
trmA,8326590,8326590,8326540,50,292,utRho22
trpA,2634678,2634678,2634444,234,626,utRho22
trpC,2639888,2639888,2639570,318,116,utRho22
trpL,5292432,5292432,5292328,104,0,utRho22
trpR,9265408,9265520,9265408,112,438,utRho22
trpS,7027394,7027394,7027276,118,1626,utRho22
trpT,7893560,7893914,7893560,354,66662,utRho22
trxA,7931294,7931522,7931294,228,608,utRho22
trxB,1864156,1864156,1864100,56,44,utRho22
trxC,5437350,5437470,5437350,120,972,utRho22
tsaD,6421256,6421256,6421086,170,350,utRho22
tsgA,6985038,6985136,6985038,98,574,utRho22
tsr,9182824,9183314,9182824,490,5694,utRho22
tsx,864490,864490,864026,464,1174,utRho22
ttcA,2823970,2823970,2823896,74,2576,utRho22
ttdA,6412848,6412926,6412848,78,32,utRho22
ttdR,6412760,6412760,6412512,248,204,utRho22
tufA,6943448,6943448,6942658,790,31586,utRho22
tus,3368346,3368518,3368346,172,100,utRho22
tusA,7218040,7218040,7217992,48,388,utRho22
tusB,6950218,6950218,6949930,288,960,utRho22
tynA,2902996,2902996,2902698,298,28,utRho22
typA,8116460,8116814,8116460,354,2934,utRho22
tyrB,8534164,8534228,8534164,64,1312,utRho22
tyrP,3979004,3979362,3979004,358,1140,utRho22
tyrR,2773384,2773440,2773384,56,160,utRho22
tyrS,3434566,3434566,3434444,122,34,utRho22
tyrT,2575330,2575330,2575244,86,44,utRho22
uacT,6062378,6062734,6062378,356,3378,utRho22
ubiC,8504886,8505012,8504886,126,320,utRho22
ubiD,8049618,8049976,8049618,358,1958,utRho22
ubiE,8037494,8037710,8037494,216,306,utRho22
ubiG,4679078,4679134,4679078,56,52,utRho22
ucpA,5089342,5089342,5089246,96,4,utRho22
udp,8032782,8032862,8032782,80,230,utRho22
ugd,4199470,4199470,4199226,244,60,utRho22
ugpB,7184852,7184852,7184650,202,4220,utRho22
ugpQ,7176600,7176600,7176226,374,338,utRho22
uhpT,7694396,7694396,7694334,62,46,utRho22
uidA,3392304,3392304,3392142,162,28,utRho22
uidC,3386012,3386012,3385702,310,2,utRho22
uidR,3394150,3394150,3394104,46,20,utRho22
ulaA,8839854,8839960,8839854,106,310,utRho22
ulaG,8839350,8839350,8839250,100,264,utRho22
ulaR,8837124,8837124,8836906,218,56,utRho22
umpG,5741372,5741372,5740548,824,204,utRho22
umpH,1400704,1400704,1400652,52,64,utRho22
umuD,2461476,2461534,2461476,58,0,utRho22
ung,5433476,5433508,5433476,32,472,utRho22
uof,2843316,2843316,2842900,416,2648,utRho22
upp,5241818,5241818,5241744,74,8,utRho22
usg,4873780,4873780,4873298,482,348,utRho22
ushA,1009772,1009828,1009772,56,164,utRho22
uspA,7279966,7280222,7279966,256,926,utRho22
uspB,7279696,7279696,7279440,256,200,utRho22
uspC,3959172,3959506,3959172,334,132,utRho22
uspE,2797318,2797318,2797244,74,0,utRho22
uspF,2871282,2871282,2871238,44,348,utRho22
uspG,1283806,1283806,1283734,72,3706,utRho22
uvrA,8547872,8547872,8547742,130,164,utRho22
uvrB,1626304,1627052,1626304,748,1452,utRho22
uvrC,3989758,3989758,3989412,346,140,utRho22
uvrD,7995814,7995966,7995814,152,626,utRho22
uvrY,3990812,3990812,3990718,94,284,utRho22
uxaB,3221474,3221474,3221360,114,14,utRho22
uxaC,6489714,6489714,6489482,232,256,utRho22
uxuA,9103036,9103272,9103036,236,3430,utRho22
uxuR,9108916,9109152,9108916,236,208,utRho22
valS,8967854,8967854,8967674,180,248,utRho22
valU,5041848,5041862,5041848,14,0,utRho22
valV,3492830,3492870,3492830,40,260,utRho22
ves,3649968,3649968,3649874,94,144,utRho22
waaA,7616512,7617080,7616512,568,1164,utRho22
waaH,7580298,7580298,7580162,136,236,utRho22
waaQ,7616476,7616476,7616196,280,1084,utRho22
waaU,7598996,7598996,7598624,372,178,utRho22
waaY,7602272,7602272,7601930,342,10274,utRho22
wbbH,4214888,4214888,4214452,436,1826,utRho22
wbbK,4209212,4209212,4209018,194,336,utRho22
wcaM,4231868,4231868,4231792,76,50,utRho22
wrbA,2135516,2135516,2135416,100,160,utRho22
wza,4275166,4275166,4274486,680,500,utRho22
wzxC,4240674,4240674,4240316,358,106,utRho22
wzzB,4196950,4196950,4196602,348,36,utRho22
xanP,7657642,7657890,7657642,248,372,utRho22
xanQ,6048520,6048702,6048520,182,158,utRho22
xapA,5049820,5049820,5049756,64,140,utRho22
xapR,10090252,10090252,10089908,344,0,utRho22
xdhA,6000514,6000690,6000514,176,2650,utRho22
xerD,6079702,6079702,6079486,216,344,utRho22
xseA,5268394,5268464,5268394,70,398,utRho22
xseB,882746,882746,882686,60,204,utRho22
xthA,3664798,3664856,3664798,58,0,utRho22
xylA,7461614,7461614,7461530,84,17218,utRho22
xylE,8484540,8484540,8484508,32,0,utRho22
xylF,7462138,7462262,7462138,124,1424,utRho22
xylR,7469812,7469958,7469812,146,122,utRho22
yaaA,13230,13230,12918,312,312,utRho22
yaaI,23876,23876,23572,304,1782,utRho22
yaaJ,16034,16034,15918,116,324,utRho22
yaaU,91184,91614,91184,430,1846,utRho22
yaaW,23084,23084,22712,372,806,utRho22
yaaX,10060,10468,10060,408,314,utRho22
yabI,142542,142702,142542,160,500,utRho22
yacC,273880,273880,273834,46,746,utRho22
yacH,262932,262932,262520,412,4,utRho22
yacL,268678,268776,268678,98,514,utRho22
yadD,293796,293936,293796,140,270,utRho22
yadE,289930,290162,289930,232,274,utRho22
yadN,314110,314110,313766,344,126,utRho22
yadS,355572,355572,355248,324,8304,utRho22
yadV,312470,312470,312402,68,666,utRho22
yaeF,434270,434270,434006,264,188,utRho22
yaeP,428374,428374,428250,124,1256,utRho22
yaeQ,428176,428582,428176,406,2320,utRho22
yaeR,423716,423754,423716,38,126,utRho22
yafC,462166,462166,461762,404,54,utRho22
yafD,462128,462244,462128,116,28,utRho22
yafK,491986,491986,491610,376,2632,utRho22
yafL,493282,493424,493282,142,290,utRho22
yafN,503938,504010,503938,72,64,utRho22
yafS,469568,469632,469568,64,498,utRho22
yafT,474470,474670,474470,200,108,utRho22
yafV,480432,480432,480378,54,182,utRho22
yafZ,536052,536052,536010,42,814,utRho22
yagE,564446,564556,564446,110,2452,utRho22
yagG,570414,570790,570414,376,2938,utRho22
yagI,578384,578384,578324,60,638,utRho22
yagK,586236,586236,585896,340,22542,utRho22
yagL,588062,588062,587836,226,4570,utRho22
yagN,591342,591342,591158,184,1824,utRho22
yahA,663746,664742,663746,996,8358,utRho22
yahC,670136,670136,670044,92,4372,utRho22
yahE,671478,671850,671478,372,776,utRho22
yahM,690504,690808,690504,304,444,utRho22
yahN,692872,692872,692674,198,2792,utRho22
yahO,692864,692968,692864,104,290,utRho22
yaiE,816296,816354,816296,58,202,utRho22
yaiI,811396,811528,811396,132,398,utRho22
yaiO,761946,761946,761684,262,632,utRho22
yaiP,767970,767970,767870,100,346,utRho22
yaiS,769660,769660,769232,428,1320,utRho22
yaiV,788922,788922,788922,0,0,utRho22
yaiY,799094,799094,798666,428,422,utRho22
yaiZ,798888,799186,798888,298,414,utRho22
yajC,854410,854574,854410,164,384,utRho22
yajD,860938,861210,860938,272,360,utRho22
yajI,866068,866068,865702,366,254,utRho22
yajL,887496,887496,887282,214,602,utRho22
yajQ,889316,889366,889316,50,60,utRho22
yajR,893374,893374,893332,42,66,utRho22
ybaB,987418,988152,987418,734,1408,utRho22
ybaL,1006590,1006590,1006476,114,360,utRho22
ybaM,980648,980648,980542,106,3024,utRho22
ybaN,981436,981764,981436,328,1258,utRho22
ybaO,936704,936766,936704,62,0,utRho22
ybaP,1016568,1016568,1016160,408,1670,utRho22
ybaQ,1016348,1016436,1016348,88,604,utRho22
ybaS,1023146,1023282,1023146,136,1488,utRho22
ybaV,927504,927874,927504,370,0,utRho22
ybaY,950490,950758,950490,268,1484,utRho22
ybbB,1062724,1062724,1062452,272,248,utRho22
ybbJ,1030154,1030154,1029718,436,2828,utRho22
ybbL,1031784,1031838,1031784,54,178,utRho22
ybbN,1037136,1037136,1036558,578,2130,utRho22
ybbO,1038658,1038658,1038298,360,806,utRho22
ybbY,1080718,1081130,1080718,412,3562,utRho22
ybcH,1176140,1176140,1175962,178,1112,utRho22
ybcI,1113264,1113264,1113106,158,2132,utRho22
ybcJ,1114050,1114050,1113746,304,10,utRho22
ybcK,1137502,1137804,1137502,302,510,utRho22
ybcL,1141690,1141786,1141690,96,0,utRho22
ybcN,1144628,1144932,1144628,304,390,utRho22
ybcQ,1147548,1147912,1147548,364,4622,utRho22
ybcW,1159610,1159760,1159610,150,330,utRho22
ybdD,1263982,1264364,1263982,382,2198,utRho22
ybdF,1212106,1212106,1211772,334,398,utRho22
ybdH,1267048,1267048,1266954,94,208,utRho22
ybdJ,1212822,1212822,1212398,424,222,utRho22
ybdK,1215122,1215122,1214766,356,3494,utRho22
ybdL,1267114,1267172,1267114,58,316,utRho22
ybdM,1271110,1271110,1270752,358,5814,utRho22
ybdN,1273372,1273372,1273138,234,264,utRho22
ybdR,1283844,1284176,1283844,332,4186,utRho22
ybeD,1325412,1325412,1325284,128,114,utRho22
ybeF,1323090,1323090,1322756,334,1448,utRho22
ybeL,1349986,1350036,1349986,50,836,utRho22
ybeQ,1353412,1353412,1353094,318,78,utRho22
ybeR,1353120,1353422,1353120,302,78,utRho22
ybeT,1358832,1358832,1358812,20,70,utRho22
ybeU,1358924,1359016,1358924,92,198,utRho22
ybeZ,1386938,1386938,1386834,104,2232,utRho22
ybfA,1458074,1458268,1458074,194,1126,utRho22
ybfE,1423878,1423878,1423796,82,316,utRho22
ybfF,1425692,1425692,1425604,88,366,utRho22
ybfH,1433282,1433282,1433194,88,64,utRho22
ybgA,1477840,1478002,1477840,162,302,utRho22
ybgC,1549288,1549504,1549288,216,68,utRho22
ybgD,1505916,1505916,1505590,326,14470,utRho22
ybgI,1485238,1485654,1485238,416,12,utRho22
ybgO,1498370,1498370,1497964,406,250,utRho22
ybgS,1570992,1570992,1570634,358,162,utRho22
ybhA,1597184,1597184,1596862,322,80,utRho22
ybhB,1616070,1616070,1615818,252,248,utRho22
ybhC,1614642,1614642,1614562,80,1134,utRho22
ybhD,1601418,1601418,1601276,142,170,utRho22
ybhH,1601104,1601518,1601104,414,456,utRho22
ybhK,1633384,1633384,1633294,90,560,utRho22
ybhM,1641556,1641586,1641556,30,90,utRho22
ybhN,1645296,1645296,1644996,300,488,utRho22
ybhQ,1649202,1649260,1649202,58,3350,utRho22
ybiA,1665920,1665920,1665900,20,0,utRho22
ybiI,1676968,1676968,1676912,56,744,utRho22
ybiO,1691328,1691328,1690960,368,1020,utRho22
ybiP,1705252,1705252,1705194,58,536,utRho22
ybiS,1711572,1711572,1711488,84,250,utRho22
ybiT,1711894,1711926,1711894,32,0,utRho22
ybiU,1718212,1718212,1718122,90,190,utRho22
ybiV,1720176,1720176,1720056,120,0,utRho22
ybiW,1725566,1725566,1725212,354,11342,utRho22
ybiX,1678548,1678548,1678414,134,256,utRho22
ybjC,1781784,1781826,1781784,42,0,utRho22
ybjE,1830154,1830154,1829714,440,430,utRho22
ybjG,1767016,1767016,1766776,240,1078,utRho22
ybjL,1779882,1779882,1779638,244,284,utRho22
ybjM,1779770,1780178,1779770,408,588,utRho22
ybjO,1795704,1795978,1795704,274,34,utRho22
ybjP,1809046,1809046,1808934,112,0,utRho22
ybjQ,1809034,1809186,1809034,152,2,utRho22
ybjS,1813796,1813796,1813506,290,210,utRho22
ybjX,1838206,1838206,1838168,38,38,utRho22
ycaD,1891438,1891742,1891438,304,78,utRho22
ycaI,1928210,1928640,1928210,430,262,utRho22
ycaK,1899094,1899336,1899094,242,256,utRho22
ycaL,1920264,1920528,1920264,264,34,utRho22
ycaM,1894240,1894458,1894240,218,260,utRho22
ycaR,1941284,1941346,1941284,62,2452,utRho22
ycbB,1961862,1962094,1961862,232,946,utRho22
ycbJ,1943344,1943504,1943344,160,0,utRho22
ycbK,1966046,1966150,1966046,104,108,utRho22
ycbZ,2036920,2036920,2036598,322,166,utRho22
yccA,2062886,2062886,2062836,50,102,utRho22
yccF,2048730,2048730,2048696,34,54,utRho22
yccS,2047988,2047988,2047766,222,794,utRho22
yccT,2055674,2055674,2055546,128,264,utRho22
yccX,2059960,2060128,2059960,168,568,utRho22
ycdT,2185682,2185752,2185682,70,12,utRho22
ycdU,2191266,2191686,2191266,420,490,utRho22
ycdZ,2200504,2200592,2200504,88,148,utRho22
yceA,2233544,2233614,2233544,70,24,utRho22
yceD,2293298,2293588,2293298,290,748,utRho22
yceF,2293522,2293522,2293190,332,420,utRho22
yceH,2252154,2252314,2252154,160,1498,utRho22
yceI,2237282,2237282,2236952,330,880,utRho22
yceJ,2238142,2238142,2238092,50,568,utRho22
yceM,2253208,2253612,2253208,404,508,utRho22
yceO,2239264,2239264,2238894,370,216,utRho22
yceQ,2288760,2289004,2288760,244,4230,utRho22
ycfD,2376540,2376540,2376480,60,214,utRho22
ycfJ,2334814,2335198,2334814,384,598,utRho22
ycfS,2340834,2340834,2340748,86,0,utRho22
ycfT,2350658,2350658,2350330,328,180,utRho22
ycfZ,2362760,2362760,2362534,226,2016,utRho22
ycgB,2474570,2474570,2474482,88,124,utRho22
ycgG,2434614,2434656,2434614,42,1924,utRho22
ycgJ,2452956,2453200,2452956,244,778,utRho22
ycgL,2455218,2455362,2455218,144,112,utRho22
ycgN,2457366,2457660,2457366,294,378,utRho22
ycgR,2489112,2489112,2489054,58,32,utRho22
ycgV,2512222,2512222,2511904,318,1380,utRho22
ycgX,2426568,2426568,2426214,354,16312,utRho22
ycgY,2490166,2490320,2490166,154,940,utRho22
ycgZ,2431504,2431578,2431504,74,120,utRho22
ychE,2596904,2597196,2596904,292,0,utRho22
ychF,2515764,2515764,2515624,140,16,utRho22
ychH,2517476,2517582,2517476,106,798,utRho22
ychJ,2578354,2578354,2578264,90,336,utRho22
ychN,2547310,2547310,2547198,112,138,utRho22
ychO,2547520,2547850,2547520,330,1120,utRho22
ychQ,2533798,2533848,2533798,50,30,utRho22
yciA,2624828,2624828,2624492,336,154,utRho22
yciB,2626110,2626110,2625780,330,952,utRho22
yciC,2627396,2627396,2627326,70,98,utRho22
yciE,2630794,2630794,2630448,346,1258,utRho22
yciG,5264368,5264368,5264140,228,0,utRho22
yciI,2621784,2621784,2621730,54,0,utRho22
yciN,2661606,2661606,2661336,270,86,utRho22
yciS,2680270,2680486,2680270,216,228,utRho22
yciT,2689088,2689088,2688692,396,1720,utRho22
yciU,2614718,2614718,2614300,418,1718,utRho22
yciV,2646376,2646440,2646376,64,0,utRho22
yciW,2700472,2700472,2700214,258,4172,utRho22
yciZ,2689276,2689276,2689218,58,1176,utRho22
ycjD,2703792,2703792,2703520,272,78,utRho22
ycjG,2777748,2777860,2777748,112,20,utRho22
ycjM,2740006,2740432,2740006,426,118,utRho22
ycjW,2767982,2767982,2767922,60,0,utRho22
ycjX,2768138,2768234,2768138,96,52,utRho22
ycjY,5568288,5568288,5567460,828,2392,utRho22
ydaE,2836438,2836438,2836016,422,736,utRho22
ydaN,2816048,2816100,2816048,52,252,utRho22
ydaS,2840340,2840730,2840340,390,242,utRho22
ydbC,2948376,2948442,2948376,66,72,utRho22
ydbD,2950132,2950288,2950132,156,0,utRho22
ydbH,2885800,2886102,2885800,302,314,utRho22
ydbJ,2881712,2882116,2881712,404,2230,utRho22
ydbK,2881692,2881692,2881568,124,650,utRho22
ydcA,2983294,2983354,2983294,60,382,utRho22
ydcF,2974404,2974470,2974404,66,8,utRho22
ydcI,2990268,2990268,2990142,126,52,utRho22
ydcJ,2990266,2990576,2990266,310,116,utRho22
ydcK,3001280,3001280,3000898,382,280,utRho22
ydcL,3004646,3004914,3004646,268,8,utRho22
ydcN,3012308,3012344,3012308,36,2216,utRho22
ydcP,3013508,3013562,3013508,54,148,utRho22
ydcR,3019956,3020006,3019956,50,0,utRho22
ydcS,3022906,3023308,3022906,402,996,utRho22
ydcX,3034442,3034778,3034442,336,826,utRho22
ydcY,3035220,3035296,3035220,76,74,utRho22
ydcZ,3036750,3036750,3036662,88,6220,utRho22
yddB,3155332,3155332,3155238,94,544,utRho22
yddE,3071738,3071738,3071716,22,14,utRho22
yddG,3094410,3094410,3094338,72,104,utRho22
yddJ,3089732,3089732,3089438,294,2556,utRho22
yddW,3137704,3137704,3137646,58,42,utRho22
ydeA,3233910,3234056,3233910,146,1714,utRho22
ydeE,3242528,3242664,3242528,136,182,utRho22
ydeI,3249118,3249118,3248994,124,134,utRho22
ydeJ,3249376,3249546,3249376,170,76,utRho22
ydeN,3165458,3165458,3165048,410,282,utRho22
ydeP,3173328,3173328,3172972,356,1144,utRho22
ydeR,3176596,3176596,3176592,4,560,utRho22
ydfA,3296872,3297016,3296872,144,4,utRho22
ydfG,3254982,3255034,3254982,52,278,utRho22
ydfH,3256652,3256704,3256652,52,122,utRho22
ydfK,3265446,3266144,3265446,698,11442,utRho22
ydgA,3379588,3379704,3379588,116,0,utRho22
ydgC,3364124,3364124,3364060,64,0,utRho22
ydgD,3343906,3343920,3343906,14,604,utRho22
ydgH,3356754,3356854,3356754,100,58,utRho22
ydgJ,3408798,3408798,3408616,182,644,utRho22
ydgK,3410414,3410500,3410414,86,1052,utRho22
ydhB,3479618,3479618,3479596,22,0,utRho22
ydhC,3479698,3479822,3479698,124,2,utRho22
ydhF,3451310,3451310,3451264,46,58,utRho22
ydhI,3441996,3442050,3441996,54,0,utRho22
ydhL,3451864,3451864,3451840,24,1318,utRho22
ydhQ,3492404,3492404,3492254,150,224,utRho22
ydhS,3494136,3494262,3494136,126,1376,utRho22
ydhT,3499138,3499138,3499118,20,174,utRho22
ydhY,3509284,3509284,3508954,330,1438,utRho22
ydhZ,3510418,3510418,3510282,136,1630,utRho22
ydiE,3579206,3579226,3579206,20,0,utRho22
ydiH,3530582,3530582,3530406,176,80,utRho22
ydiM,3541852,3542142,3541852,290,274,utRho22
ydiN,3544818,3545024,3544818,206,234,utRho22
ydiP,3558656,3558656,3558602,54,612,utRho22
ydiU,3582508,3582508,3582488,20,968,utRho22
ydiV,3584174,3584174,3584040,134,240,utRho22
ydiY,3612500,3612500,3612166,334,270,utRho22
ydjA,3697400,3697400,3697352,48,684,utRho22
ydjE,3708082,3708082,3707958,124,106,utRho22
ydjF,3709848,3709848,3709708,140,238,utRho22
ydjM,3620340,3620422,3620340,82,0,utRho22
ydjO,3626696,3626696,3626288,408,462,utRho22
ydjX,3666434,3666802,3666434,368,1714,utRho22
yeaE,3731448,3731448,3731272,176,358,utRho22
yeaG,3733530,3733816,3733530,286,114,utRho22
yeaI,3740486,3740770,3740486,284,202,utRho22
yeaJ,3743874,3744082,3743874,208,482,utRho22
yeaL,3748646,3748704,3748646,58,836,utRho22
yeaM,3751296,3751296,3751152,144,0,utRho22
yeaN,3750926,3751346,3750926,420,96,utRho22
yeaO,3753554,3753818,3753554,264,296,utRho22
yeaP,3755314,3755430,3755314,116,1170,utRho22
yeaQ,3758780,3758780,3758510,270,952,utRho22
yeaR,3759988,3759988,3759896,92,130,utRho22
yeaY,3781122,3781122,3781064,58,0,utRho22
yebB,3892220,3892502,3892220,282,298,utRho22
yebC,3896370,3896370,3896302,68,66,utRho22
yebE,3859464,3859464,3859414,50,1956,utRho22
yebG,3861530,3861530,3861494,36,280,utRho22
yebK,3873180,3873304,3873180,124,68,utRho22
yebQ,3820314,3820552,3820314,238,64,utRho22
yebS,3832238,3832516,3832238,278,36,utRho22
yebV,3843430,3843560,3843430,130,0,utRho22
yebW,3843914,3844242,3843914,328,1516,utRho22
yecC,3995646,3995646,3995628,18,0,utRho22
yecD,3901272,3901664,3901272,392,124,utRho22
yecF,3991434,3991636,3991434,202,156,utRho22
yecH,3979304,3979304,3978980,324,1630,utRho22
yecJ,3975604,3975604,3975516,88,0,utRho22
yecM,3919968,3919968,3919692,276,2510,utRho22
yecR,3976400,3976444,3976400,44,150,utRho22
yecT,3923862,3923944,3923862,82,6,utRho22
yedD,4016522,4016522,4016180,342,762,utRho22
yedE,4016310,4016554,4016310,244,786,utRho22
yedI,4058922,4058922,4058732,190,610,utRho22
yedJ,4066446,4066446,4066158,288,740,utRho22
yedV,4076404,4076404,4076304,100,312,utRho22
yedX,4077680,4077912,4077680,232,86,utRho22
yedY,4078572,4078956,4078572,384,934,utRho22
yeeA,4161322,4161322,4161182,140,76,utRho22
yeeE,4171104,4171104,4171050,54,776,utRho22
yeeJ,4089526,4089822,4089526,296,566,utRho22
yeeN,4113508,4113716,4113508,208,444,utRho22
yeeO,4119444,4119444,4119692,248,0,utRho22
yeeX,4158834,4158834,4158722,112,416,utRho22
yeeZ,4178422,4178422,4178256,166,172,utRho22
yefM,4179466,4179466,4179426,40,0,utRho22
yegD,4295288,4295348,4295288,60,432,utRho22
yegH,4275726,4275804,4275726,78,768,utRho22
yegI,4302154,4302154,4301970,184,8,utRho22
yegJ,4302032,4302370,4302032,338,88,utRho22
yegQ,4331182,4331336,4331182,154,1042,utRho22
yegR,4336698,4336698,4336612,86,1024,utRho22
yegS,4337086,4337424,4337086,338,624,utRho22
yegT,4357562,4357642,4357562,80,1006,utRho22
yegX,4367640,4367640,4367302,338,492,utRho22
yehA,4376944,4376944,4376828,116,600,utRho22
yehE,4385818,4385818,4385592,226,56,utRho22
yehK,4407568,4407944,4407568,376,574,utRho22
yehL,4408804,4409192,4408804,388,212,utRho22
yeiB,4486146,4486146,4485934,212,60,utRho22
yeiE,4499422,4499422,4499236,186,2,utRho22
yeiG,4487776,4487820,4487776,44,134,utRho22
yeiH,4499332,4499434,4499332,102,536,utRho22
yeiI,4503306,4503400,4503306,94,128,utRho22
yeiL,4510580,4510710,4510580,130,250,utRho22
yeiP,4530834,4530900,4530834,66,206,utRho22
yeiQ,4532328,4532490,4532328,162,58,utRho22
yeiR,4535484,4535658,4535484,174,430,utRho22
yeiW,4530840,4530840,4530590,250,252,utRho22
yejA,4544624,4544728,4544624,104,186,utRho22
yejG,4556892,4556892,4556474,418,8254,utRho22
yejH,4561244,4561264,4561244,20,152,utRho22
yejK,4568218,4568218,4567894,324,40,utRho22
yejO,4578352,4578352,4577800,552,3822,utRho22
yfaD,4713380,4713808,4713380,428,1094,utRho22
yfaE,4696676,4697028,4696676,352,698,utRho22
yfaL,4688568,4688568,4688338,230,164,utRho22
yfaP,4656398,4656398,4656286,112,112,utRho22
yfaU,4717892,4717892,4717690,202,0,utRho22
yfaY,4727310,4727310,4727266,44,2608,utRho22
yfaZ,4728744,4728744,4728550,194,600,utRho22
yfbK,4771810,4771810,4771444,366,1500,utRho22
yfbL,4771500,4771720,4771500,220,1182,utRho22
yfbN,4777174,4777174,4776852,322,1460,utRho22
yfbO,4776916,4777162,4776916,246,1346,utRho22
yfbP,4777990,4778232,4777990,242,17718,utRho22
yfbR,4817662,4817724,4817662,62,154,utRho22
yfcI,4847424,4847424,4847078,346,1624,utRho22
yfcJ,4880482,4880482,4880240,242,702,utRho22
yfcL,4888502,4888502,4888338,164,86,utRho22
yfcV,4911642,4911642,4911292,350,860,utRho22
yfcZ,4921958,4921958,4921868,90,54,utRho22
yfdF,4925604,4926024,4925604,420,9558,utRho22
yfdG,4935474,4935710,4935474,236,42,utRho22
yfdP,4946844,4947040,4946844,196,214,utRho22
yfdX,4988866,4988866,4988804,62,178,utRho22
yfdY,4990672,4990672,4990584,88,940,utRho22
yfeA,5035784,5035784,5035664,120,8626,utRho22
yfeC,5036668,5036934,5036668,266,4,utRho22
yfeH,5053818,5053892,5053818,74,126,utRho22
yfeK,5074630,5074684,5074630,54,0,utRho22
yfeO,5018906,5019260,5018906,354,646,utRho22
yfeR,5054078,5054078,5053712,366,250,utRho22
yfeX,5101356,5101356,5101090,266,0,utRho22
yfeY,5102486,5102486,5102432,54,18,utRho22
yfeZ,5103842,5103842,5103452,390,554,utRho22
yffO,5123804,5124222,5123804,418,680,utRho22
yffQ,5126778,5127154,5126778,376,3380,utRho22
yffS,5128800,5128986,5128800,186,28,utRho22
yfgC,5232052,5232188,5232052,136,234,utRho22
yfgF,5258062,5258062,5257876,186,3418,utRho22
yfgG,5258170,5258580,5258170,410,5572,utRho22
yfgH,5259344,5259584,5259344,240,528,utRho22
yfgM,5278866,5278866,5278566,300,908,utRho22
yfhH,5397414,5397518,5397414,104,0,utRho22
yfhM,5304648,5304648,5304574,74,320,utRho22
yfhR,5328408,5328726,5328408,318,5554,utRho22
yfiC,5425610,5425610,5425528,82,66,utRho22
yfiE,5430688,5430688,5430640,48,1354,utRho22
yfiL,5482630,5482720,5482630,90,54,utRho22
yfiM,5448066,5448358,5448066,292,9208,utRho22
yfiR,5483354,5483750,5483354,396,662,utRho22
yfjH,5517326,5517326,5517200,126,188,utRho22
yfjI,5517710,5517970,5517710,260,620,utRho22
yfjJ,5521014,5521094,5521014,80,288,utRho22
yfjM,5531970,5531970,5531552,418,12348,utRho22
yfjP,5535080,5535420,5535080,340,2026,utRho22
yfjW,5546570,5546636,5546570,66,160,utRho22
yfjX,5551776,5551838,5551776,62,0,utRho22
ygaC,5601180,5601180,5599988,1192,3182,utRho22
ygaM,5600242,5600292,5600242,50,594,utRho22
ygaU,5593628,5593628,5593572,56,342,utRho22
ygaZ,5619190,5619234,5619190,44,26,utRho22
ygbA,5713656,5713656,5713612,44,408,utRho22
ygbE,5746784,5746784,5746674,110,822,utRho22
ygbI,5722882,5722882,5722528,354,1310,utRho22
ygbK,5724394,5724670,5724394,276,492,utRho22
ygbL,5727074,5727186,5727074,112,144,utRho22
ygbN,5729814,5730202,5729814,388,2190,utRho22
ygcG,5811210,5811422,5811210,212,150,utRho22
ygcN,5785144,5785314,5785144,170,528,utRho22
ygcU,5799214,5799214,5798836,378,798,utRho22
ygcW,5800942,5800942,5800546,396,22,utRho22
ygdD,5883442,5883442,5883262,180,450,utRho22
ygdG,5861746,5861930,5861746,184,166,utRho22
ygdI,5886526,5886526,5886290,236,22,utRho22
ygdQ,5940784,5940840,5940784,56,72,utRho22
ygdR,5942494,5942542,5942494,48,108,utRho22
ygeA,5961606,5961606,5961270,336,596,utRho22
ygeH,5983758,5984188,5983758,430,3054,utRho22
ygeI,5987162,5987276,5987162,114,13736,utRho22
ygeR,6000078,6000078,5999782,296,776,utRho22
ygeV,6011694,6011694,6011572,122,64,utRho22
ygeW,6012234,6012524,6012234,290,1386,utRho22
ygfB,6110946,6110946,6110888,58,58,utRho22
ygfK,6031984,6032120,6031984,136,8,utRho22
ygfS,6058328,6058328,6058024,304,178,utRho22
ygfZ,6082564,6082626,6082564,62,846,utRho22
yggC,6149512,6149512,6149378,134,148,utRho22
yggE,6136370,6136370,6136160,210,1032,utRho22
yggI,6179176,6179510,6179176,334,1056,utRho22
yggL,6204508,6204508,6204266,242,480,utRho22
yggM,6199514,6199514,6199130,384,234,utRho22
yggN,6203596,6203596,6203246,350,1094,utRho22
yggX,18623958,18624558,18623958,600,738,utRho22
yghA,6298966,6299324,6298966,358,186,utRho22
yghB,6307058,6307126,6307058,68,1154,utRho22
yghD,6222614,6222614,6222252,362,372,utRho22
yghF,6225798,6225798,6225840,42,64,utRho22
yghJ,6238640,6238640,6238224,416,340,utRho22
yghQ,6265186,6265186,6264816,370,604,utRho22
yghT,6267830,6268262,6267830,432,1094,utRho22
yghU,6277400,6277454,6277400,54,412,utRho22
yghW,6293506,6293506,6293474,32,128,utRho22
yghZ,6295562,6295794,6295562,232,554,utRho22
ygiD,6365122,6365122,6364868,254,3888,utRho22
ygiH,6409066,6409388,6409066,322,350,utRho22
ygiL,6370622,6370828,6370622,206,370,utRho22
ygiM,6402084,6402414,6402084,330,230,utRho22
ygiN,6346156,6346284,6346156,128,716,utRho22
ygiQ,6322620,6322620,6322292,328,1588,utRho22
ygiS,6335462,6335462,6335436,26,32,utRho22
ygiV,6338582,6338582,6338462,120,212,utRho22
ygiW,6339774,6339774,6339352,422,3888,utRho22
ygiZ,6344506,6344506,6344422,84,34,utRho22
ygjH,6442528,6442528,6442494,34,354,utRho22
ygjI,6452140,6452468,6452140,328,36,utRho22
ygjQ,6472730,6473080,6472730,350,2554,utRho22
ygjR,6474564,6474586,6474564,22,38,utRho22
ygjV,6483638,6483638,6483488,150,14,utRho22
yhaB,6535632,6535708,6535632,76,78,utRho22
yhaH,6504498,6504608,6504498,110,1070,utRho22
yhaI,6505400,6505822,6505400,422,578,utRho22
yhaJ,6508560,6508560,6508428,132,628,utRho22
yhaK,6508538,6508638,6508538,100,792,utRho22
yhbQ,6599878,6599932,6599878,54,716,utRho22
yhbT,6602736,6602736,6602552,184,1912,utRho22
yhbU,6602558,6602970,6602558,412,2638,utRho22
yhbX,6643302,6643302,6643226,76,168,utRho22
yhbY,6655518,6655580,6655518,62,36,utRho22
yhcA,6723956,6724224,6723956,268,2402,utRho22
yhcB,6760364,6760382,6760364,18,110,utRho22
yhcC,6708470,6708470,6708100,370,1422,utRho22
yhcF,6733440,6733852,6733440,412,3284,utRho22
yhcH,6739124,6739124,6738956,168,4396,utRho22
yhcM,6760312,6760312,6759994,318,102,utRho22
yhcN,6770812,6771076,6770812,264,482,utRho22
yhcO,6772606,6772606,6772258,348,48,utRho22
yhdH,6806560,6806968,6806560,408,444,utRho22
yhdJ,6823234,6823306,6823234,72,12,utRho22
yhdN,6879092,6879092,6879018,74,198,utRho22
yhdT,6814702,6814750,6814702,48,40,utRho22
yhdU,6824994,6825242,6824994,248,410,utRho22
yhdV,6836392,6836780,6836392,388,1820,utRho22
yhdW,6837944,6838298,6837944,354,188,utRho22
yheO,6953082,6953082,6952880,202,278,utRho22
yheV,6957970,6957970,6957584,386,0,utRho22
yhfA,6971902,6971902,6971636,266,2388,utRho22
yhfG,6983294,6983294,6983240,54,1758,utRho22
yhfL,6998622,6998896,6998622,274,216,utRho22
yhfY,7023244,7023244,7022844,400,12,utRho22
yhgA,7086294,7086334,7086294,40,0,utRho22
yhgE,7065176,7065176,7064878,298,1922,utRho22
yhgF,7074352,7074770,7074352,418,6084,utRho22
yhhA,7173458,7173886,7173458,428,1414,utRho22
yhhI,7248346,7248756,7248346,410,284,utRho22
yhhJ,7253696,7253696,7253606,90,208,utRho22
yhhM,7211588,7211588,7211220,368,2360,utRho22
yhhN,7211150,7211502,7211150,352,1500,utRho22
yhhQ,7218238,7218434,7218238,196,1674,utRho22
yhhT,7223682,7223730,7223682,48,166,utRho22
yhhX,7162032,7162032,7161610,422,130,utRho22
yhhY,7162222,7162276,7162222,54,160,utRho22
yhhZ,7163516,7163726,7163516,210,1774,utRho22
yhiD,7312220,7312220,7311804,416,20426,utRho22
yhiJ,7265190,7265190,7265180,10,8,utRho22
yhiM,7269270,7269682,7269270,412,4272,utRho22
yhiN,7275000,7275000,7274820,180,930,utRho22
yhjA,7338522,7338522,7338376,146,258,utRho22
yhjB,7344090,7344090,7343788,302,1626,utRho22
yhjC,7344272,7344684,7344272,412,250,utRho22
yhjD,7346660,7346724,7346660,64,100,utRho22
yhjE,7349274,7349572,7349274,298,3792,utRho22
yhjG,7356824,7356824,7356730,94,174,utRho22
yhjH,7358458,7358458,7358374,84,350,utRho22
yhjJ,7364032,7364032,7363880,152,458,utRho22
yhjK,7371296,7371296,7371158,138,174,utRho22
yhjR,7392750,7392750,7392370,380,60,utRho22
yhjV,7400796,7401126,7400796,330,2036,utRho22
yhjX,7424194,7424194,7424014,180,284,utRho22
yhjY,7425966,7425966,7425868,98,98,utRho22
yiaB,7455654,7455654,7455496,158,112,utRho22
yiaD,7432712,7433094,7432712,382,812,utRho22
yiaF,7438194,7438194,7438088,106,1062,utRho22
yiaG,7438862,7438956,7438862,94,836,utRho22
yiaJ,7485236,7485236,7485064,172,1634,utRho22
yiaK,7485348,7485466,7485348,118,106,utRho22
yiaT,7503924,7503924,7503736,188,32,utRho22
yiaU,7503792,7503984,7503792,192,18,utRho22
yiaY,7515856,7515856,7515654,202,698,utRho22
yibF,7523950,7523950,7523910,40,188,utRho22
yibG,7536128,7536354,7536128,226,1032,utRho22
yibL,7553194,7553330,7553194,136,312,utRho22
yibN,7570112,7570112,7570030,82,196,utRho22
yibT,7552848,7552848,7552760,88,768,utRho22
yicC,7633290,7633352,7633290,62,142,utRho22
yicH,7660862,7660914,7660862,52,26,utRho22
yicJ,7673328,7673328,7671858,1470,7070,utRho22
yicN,7685018,7685018,7684804,214,1542,utRho22
yicO,7687914,7687914,7687578,336,426,utRho22
yicR,15250308,15250308,15250236,72,0,utRho22
yidB,7755230,7755230,7754930,300,328,utRho22
yidE,7732780,7732780,7732546,234,130,utRho22
yidF,7711580,7711580,7711222,358,548,utRho22
yidQ,7735088,7735456,7735088,368,802,utRho22
yidR,7738824,7738824,7738618,206,32,utRho22
yieE,7787658,7787738,7787658,80,1738,utRho22
yieH,7793314,7793548,7793314,234,568,utRho22
yieK,7798928,7798928,7798786,142,10,utRho22
yifB,7900350,7900350,7899998,352,288,utRho22
yifL,7988984,7989044,7988984,60,12054,utRho22
yigF,8005750,8005750,8005598,152,42708,utRho22
yigI,8009448,8009448,8009394,54,1776,utRho22
yigM,8022100,8022152,8022100,52,158,utRho22
yihA,8101970,8101970,8101458,512,722,utRho22
yihD,8084098,8084138,8084098,40,40,utRho22
yihF,8088110,8088398,8088110,288,272,utRho22
yihG,8093304,8093304,8093204,100,324,utRho22
yihI,8102616,8102694,8102616,78,106,utRho22
yihL,8120506,8120894,8120506,388,976,utRho22
yihN,8124332,8124494,8124332,162,1666,utRho22
yihO,8131942,8131942,8131532,410,728,utRho22
yihQ,8138892,8138892,8138552,340,276,utRho22
yihV,8147064,8147478,8147064,414,1196,utRho22
yihX,8151096,8151106,8151096,10,370,utRho22
yiiE,8158192,8158582,8158192,390,2750,utRho22
yiiF,8159124,8159502,8159124,378,534,utRho22
yiiG,8173762,8174004,8173762,242,58,utRho22
yiiM,8205506,8205644,8205506,138,6138,utRho22
yiiQ,8224624,8224624,8224428,196,86,utRho22
yiiS,8225738,8225934,8225738,196,202,utRho22
yijE,8272178,8272216,8272178,38,2,utRho22
yijF,8275728,8275728,8275314,414,4090,utRho22
yijO,8296858,8296858,8296634,224,234,utRho22
yjaA,8426240,8426468,8426240,228,62890,utRho22
yjaB,8428312,8428312,8428246,66,172,utRho22
yjaG,8398746,8399008,8398746,262,934,utRho22
yjaH,8401022,8401132,8401022,110,176,utRho22
yjaZ,8379506,8379572,8379506,66,0,utRho22
yjbB,8455204,8455462,8455204,258,284,utRho22
yjbE,16943432,16943624,16943432,192,552,utRho22
yjbL,8520318,8520642,8520318,324,476,utRho22
yjbQ,8540428,8540476,8540428,48,68,utRho22
yjcB,8550328,8550328,8550082,246,526,utRho22
yjcC,8550836,8550942,8550836,106,254,utRho22
yjcD,8556628,8556958,8556628,330,1064,utRho22
yjcE,8559658,8559960,8559658,302,966,utRho22
yjcF,8566212,8566212,8566150,62,0,utRho22
yjcO,8594660,8594660,8594250,410,336,utRho22
yjdA,8654128,8654270,8654128,142,0,utRho22
yjdC,8726660,8726660,8726616,44,0,utRho22
yjdK,8704780,8705168,8704780,388,5106,utRho22
yjdL,8713034,8713034,8712822,212,14,utRho22
yjdM,8653672,8653672,8653468,204,1218,utRho22
yjeF,8787354,8788132,8787354,778,80662,utRho22
yjeI,8745522,8745618,8745522,96,64,utRho22
yjeJ,8748806,8748806,8748468,338,788,utRho22
yjeV,8785472,8785784,8785472,312,2240,utRho22
yjfP,8833512,8833904,8833512,392,162,utRho22
yjfY,8849656,8849656,8849582,74,860,utRho22
yjfZ,8855052,8855052,8854844,208,658,utRho22
yjgA,8916162,8916162,8915730,432,336,utRho22
yjgL,8950802,8950874,8950802,72,198,utRho22
yjgM,8959342,8959342,8959074,268,0,utRho22
yjgN,8959132,8959460,8959132,328,62,utRho22
yjgR,8980170,8980170,8980126,44,928,utRho22
yjgZ,9002116,9002520,9002116,404,5420,utRho22
yjhB,9007764,9008116,9007764,352,414,utRho22
yjhG,9048452,9048452,9048188,264,39474,utRho22
yjhU,9041080,9041080,9040648,432,1248,utRho22
yjiA,9178096,9178096,9177730,366,1034,utRho22
yjiJ,9125364,9125364,9125350,14,18,utRho22
yjiK,9127270,9127270,9127422,152,322,utRho22
yjiL,9129604,9129604,9129378,226,326,utRho22
yjiS,9143410,9143502,9143410,92,1124,utRho22
yjiY,9182734,9182734,9182558,176,1820,utRho22
yjjA,9200674,9200674,9200378,296,1384,utRho22
yjjB,18408708,18408708,18407800,908,1168,utRho22
yjjJ,9243314,9243538,9243314,224,0,utRho22
yjjK,9261132,9261132,9261044,88,1524,utRho22
yjjL,9189764,9189764,9189444,320,4330,utRho22
yjjM,9191894,9191894,9191702,192,264,utRho22
yjjP,9206068,9206068,9205716,352,14858,utRho22
yjjQ,9206638,9206954,9206638,316,15006,utRho22
yjjX,9267798,9267798,9267490,308,2516,utRho22
yjjY,9280716,9280804,9280716,88,250,utRho22
yjjZ,9211554,9211608,9211554,54,49850,utRho22
yjtD,9281676,9281884,9281676,208,230,utRho22
ykfB,532454,532454,532174,280,16408,utRho22
ykfI,527636,527636,527338,298,1458,utRho22
ykgB,637050,637050,636638,412,282,utRho22
ykgC,640430,640430,640002,428,446,utRho22
ykgD,640232,640454,640232,222,424,utRho22
ykgE,642962,643216,642962,254,2676,utRho22
ykgJ,608524,608524,608364,160,592,utRho22
ykgL,623878,624224,623878,346,4866,utRho22
ykgM,625610,625610,625554,56,950,utRho22
ykgR,626570,626570,626484,86,238,utRho22
ylaC,958576,958576,958502,74,3520,utRho22
yliE,1745938,1745958,1745938,20,0,utRho22
ymcE,2103660,2103694,2103660,34,0,utRho22
ymdA,2210450,2210828,2210450,378,344,utRho22
ymdB,2211428,2211640,2211428,212,160,utRho22
ymfD,2395322,2395322,2395064,258,1248,utRho22
ymfI,2402880,2402994,2402880,114,0,utRho22
ymfJ,2404518,2404518,2404168,350,856,utRho22
ymfK,2406176,2406176,2405866,310,384,utRho22
ymfT,2405766,2406048,2405766,282,572,utRho22
ymgE,2489110,2489456,2489110,346,1774,utRho22
ymgF,2437628,2437966,2437628,338,486,utRho22
ymiA,2670112,2670320,2670112,208,434,utRho22
ymjA,2715620,2715620,2715336,284,548,utRho22
ynaI,2791946,2791946,2791844,102,338,utRho22
ynaK,2850438,2850754,2850438,316,548,utRho22
ynbA,2954924,2955242,2954924,318,0,utRho22
yncD,3046552,3046552,3046130,422,414,utRho22
yncE,3046454,3046614,3046454,160,130,utRho22
yncG,3052456,3052494,3052456,38,1650,utRho22
yncL,3034492,3034492,3034388,104,520,utRho22
yneE,3218364,3218364,3218044,320,60,utRho22
yneF,3223748,3223748,3223708,40,18,utRho22
yneJ,3229560,3229608,3229560,48,84,utRho22
yneK,3231100,3231526,3231100,426,1084,utRho22
yneM,3245176,3245292,3245176,116,174,utRho22
ynfA,3311398,3311398,3311346,52,90,utRho22
ynfB,3311418,3311616,3311418,198,288,utRho22
ynfC,3315094,3315094,3314914,180,0,utRho22
ynfD,3314828,3315130,3314828,302,16,utRho22
ynfE,3316006,3316138,3316006,132,378,utRho22
ynfK,3334670,3334670,3334438,232,230,utRho22
ynfL,3339304,3339304,3339184,120,0,utRho22
ynfM,3339260,3339398,3339260,138,32,utRho22
ynfN,3276598,3276598,3276218,380,126,utRho22
ynfO,3273454,3273512,3273454,58,296,utRho22
ynhG,3517890,3517890,3517450,440,120,utRho22
yniA,3615158,3615592,3615158,434,1424,utRho22
yniB,3618526,3618526,3618466,60,30,utRho22
yniC,3618652,3618760,3618652,108,170,utRho22
yniD,3610202,3610330,3610202,128,40,utRho22
ynjE,3678880,3678934,3678880,54,44,utRho22
ynjF,3683222,3683222,3682806,416,466,utRho22
ynjH,3684376,3684376,3684270,106,180,utRho22
ynjI,3690022,3690022,3689742,280,1022,utRho22
yoaB,3786642,3786734,3786642,92,366,utRho22
yoaC,3787932,3788146,3787932,214,774,utRho22
yoaE,3803544,3803544,3803170,374,964,utRho22
yoaF,3755444,3755444,3755064,380,1782,utRho22
yoaH,3789866,3789866,3789462,404,1520,utRho22
yobB,3850418,3850880,3850418,462,966,utRho22
yobF,3815586,3815586,3815182,404,422,utRho22
yobH,3817800,3817850,3817800,50,1532,utRho22
yodB,4084352,4084736,4084352,384,1634,utRho22
yodC,4057008,4057008,4056740,268,112,utRho22
yohC,4451358,4451358,4451262,96,474,utRho22
yohD,4451526,4451602,4451526,76,414,utRho22
yohJ,4460986,4461248,4460986,262,1280,utRho22
yohO,4431172,4431314,4431172,142,500,utRho22
yojI,4617282,4617282,4617230,52,0,utRho22
ypdI,4988988,4989396,4988988,408,562,utRho22
ypfG,5165786,5165786,5165554,232,314,utRho22
ypfM,5182140,5182140,5181732,408,640,utRho22
yphB,5349590,5349590,5349376,214,486,utRho22
ypjA,5565644,5565644,5565452,192,3126,utRho22
ypjB,5569636,5569636,5568858,778,440,utRho22
ypjD,5495860,5495774,5495860,86,22,utRho22
yqaE,5594170,5594170,5594056,114,324,utRho22
yqcA,5846100,5846100,5845968,132,546,utRho22
yqcE,5800944,5801184,5800944,240,6,utRho22
yqeC,6030468,6030468,6030114,354,774,utRho22
yqeF,5971618,5971618,5971184,434,6592,utRho22
yqeG,5971438,5971694,5971438,256,11102,utRho22
yqeH,5975016,5975072,5975016,56,20696,utRho22
yqeI,5976688,5977004,5976688,316,220,utRho22
yqeK,5981140,5981140,5980720,420,7286,utRho22
yqfA,6086728,6086728,6086296,432,1554,utRho22
yqgA,6219042,6219106,6219042,64,48,utRho22
yqgB,6172500,6172500,6172102,398,872,utRho22
yqgE,6185768,6185874,6185768,106,346,utRho22
yqhA,6299150,6299150,6298942,208,84,utRho22
yqhC,6310768,6310768,6310436,332,430,utRho22
yqhD,6310604,6310710,6310604,106,276,utRho22
yqhH,6316842,6317254,6316842,412,930,utRho22
yqiC,6369662,6369680,6369662,18,784,utRho22
yqiJ,6384108,6384416,6384108,308,530,utRho22
yqjA,6495096,6495546,6495096,450,14672,utRho22
yqjF,6500932,6501124,6500932,192,1764,utRho22
yqjG,6501948,6502048,6501948,100,58,utRho22
yqjH,6433078,6433078,6432982,96,4,utRho22
yqjI,6433506,6433558,6433506,52,48,utRho22
yraH,6574552,6574852,6574552,300,332,utRho22
yraP,6592144,6592818,6592144,674,630,utRho22
yraQ,6596414,6596414,6596276,138,0,utRho22
yraR,6598024,6598024,6597692,332,1208,utRho22
yrbG,13360844,13361100,13360844,256,84,utRho22
yrbL,6696842,6696904,6696842,62,3176,utRho22
yrbN,6616172,6616172,6615866,306,1300,utRho22
yrdB,6860176,6860176,6860046,130,66,utRho22
yrfF,7052548,7052938,7052548,390,1090,utRho22
yrhB,7169440,7169518,7169440,78,70,utRho22
ysaB,7451804,7451804,7451424,380,378,utRho22
ysgA,8032686,8032686,8032338,348,1404,utRho22
ytfB,8857638,8857638,8857434,204,1002,utRho22
ytfE,8864018,8864018,8863966,52,388,utRho22
ytfF,8866296,8866296,8866130,166,482,utRho22
ytfH,8868164,8868226,8868164,62,836,utRho22
ytfI,8875234,8875414,8875234,180,240,utRho22
ytfJ,8878572,8878572,8878524,48,52,utRho22
ytfK,8879022,8879174,8879022,152,176,utRho22
ytfL,8882642,8882642,8882430,212,92,utRho22
ytfQ,8899634,8899924,8899634,290,960,utRho22
ytjB,9249598,9249598,9249578,20,174,utRho22
yzfA,8896588,8896588,8896490,98,0,utRho22
zapA,6111102,6111224,6111102,122,782,utRho22
zapB,8236772,8237030,8236772,258,384,utRho22
zapC,2011700,2011904,2011700,204,116,utRho22
zinT,4082692,4082750,4082692,58,678,utRho22
zipA,5062814,5062814,5062466,348,436,utRho22
zitB,1569716,1569716,1569646,70,66,utRho22
zntA,7212844,7212902,7212844,58,84,utRho22
zntR,6878336,6878336,6878260,76,292,utRho22
znuA,3885322,3885322,3885166,156,12,utRho22
znuC,3885268,3885324,3885268,56,12,utRho22
zraP,8403424,8403424,8403376,48,108,utRho22
zraS,8403810,8403852,8403810,42,0,utRho22
zupT,6364866,6365100,6364866,234,3882,utRho22
zur,8520282,8520282,8520006,276,576,utRho22
zwf,3872752,3872752,3872628,124,122,utRho22
C0343,2818676,2818728,2818676,52,26,utRho23
aaeB,6776526,6776526,6776376,150,164,utRho23
aaeR,6778762,6779040,6778762,278,1282,utRho23
aaeX,6778860,6778860,6778674,186,1330,utRho23
aat,1854920,1854920,1854864,56,66,utRho23
accA,416822,417242,416822,420,1996,utRho23
accB,6810280,6810872,6810280,592,2006,utRho23
accD,4868030,4868030,4867852,178,214,utRho23
aceB,8430804,8430956,8430804,152,1386,utRho23
aceE,245938,246034,245938,96,96,utRho23
ackA,4826918,4826940,4826918,22,238,utRho23
acnA,2670848,2671662,2670848,814,866,utRho23
acnB,263038,263230,263038,192,560,utRho23
acpP,2303148,2303230,2303148,82,42,utRho23
acpS,5402324,5402324,5401996,328,448,utRho23
acrA,971396,971396,971238,158,78,utRho23
acrB,969370,969370,968806,564,2052,utRho23
acrD,5174950,5175190,5174950,240,502,utRho23
acrE,6827404,6827728,6827404,324,668,utRho23
acrR,971398,971522,971398,124,28,utRho23
acrZ,1589502,1589546,1589502,44,350,utRho23
acs,8575190,8575190,8574742,448,4696,utRho23
actP,8569870,8569870,8569804,66,44,utRho23
ada,4620854,4620854,4620810,44,38,utRho23
add,3404404,3404466,3404404,62,304,utRho23
ade,7687802,7687928,7687802,126,216,utRho23
adhE,2596826,2596826,2596242,584,78,utRho23
adhP,3107988,3107988,3107676,312,702,utRho23
adiA,8681112,8681112,8681042,70,38,utRho23
adiC,8674404,8674404,8674062,342,544,utRho23
adiY,8676084,8676084,8675858,226,158,utRho23
adk,994278,994350,994278,72,1016,utRho23
adrA,807374,807406,807374,32,172,utRho23
aer,6438240,6438240,6438152,88,42,utRho23
aes,1000102,1000102,999946,156,4736,utRho23
agaR,6557406,6557406,6557330,76,92,utRho23
agaS,6563778,6563952,6563778,174,142,utRho23
agp,2131118,2131170,2131118,52,28,utRho23
agrA,7296126,7296126,7296126,0,0,utRho23
agrB,7296588,7296588,7296588,0,0,utRho23
ahpC,1277386,1277890,1277386,504,1200,utRho23
ahpF,1278004,1279506,1278004,1502,78392,utRho23
ahr,8992698,8992698,8992418,280,1564,utRho23
aidB,8828494,8828550,8828494,56,108,utRho23
ais,4731512,4731512,4731240,272,278,utRho23
alaA,4814816,4815122,4814816,306,562,utRho23
alaC,4996798,4996798,4996590,208,90,utRho23
alaE,5598140,5598328,5598140,188,694,utRho23
alaS,5644180,5644180,5644022,158,1134,utRho23
alaW,5036612,5036612,5036462,150,0,utRho23
aldA,2976380,2976464,2976380,84,670,utRho23
aldB,7513070,7513070,7513022,48,1112,utRho23
alkA,4295118,4295118,4295080,38,124,utRho23
alkB,4618890,4618890,4618682,208,194,utRho23
allA,1064780,1064902,1064780,122,116,utRho23
allD,1092822,1092822,1092726,96,156,utRho23
allE,1088112,1088112,1088092,20,150,utRho23
allS,1064600,1064600,1064442,158,874,utRho23
alr,8531178,8531564,8531178,386,1254,utRho23
alsE,8617334,8617334,8616956,378,906,utRho23
alsK,8615990,8615990,8615598,392,1832,utRho23
alx,6476740,6477160,6476740,420,312,utRho23
amiA,5104482,5104704,5104482,222,6,utRho23
amiC,5898378,5898378,5898020,358,290,utRho23
amn,4110062,4110122,4110062,60,50,utRho23
ampC,8758006,8758006,8757888,118,58,utRho23
ampD,237362,237466,237362,104,318,utRho23
ampG,907372,907372,907090,282,46,utRho23
ampH,792726,792726,792574,152,212,utRho23
amyA,4012230,4012312,4012230,82,188,utRho23
anmK,3439346,3439346,3439204,142,64,utRho23
ansB,6201580,6201580,6201456,124,1156,utRho23
ansP,3052040,3052040,3051960,80,616,utRho23
apaG,104068,104068,103212,856,2926,utRho23
apaH,102586,102586,102444,142,4418,utRho23
apbE,4623188,4623188,4623068,120,0,utRho23
appA,2081198,2081234,2081198,36,44,utRho23
appC,2075420,2075480,2075420,60,36,utRho23
appY,1167134,1167362,1167134,228,130,utRho23
apt,982620,982824,982620,204,34,utRho23
aqpZ,1832424,1832424,1832094,330,354,utRho23
araB,140150,140150,140096,54,4,utRho23
araC,140482,140774,140482,292,752,utRho23
araE,5964416,5964416,5964364,52,0,utRho23
araF,3972476,3972476,3972256,220,324,utRho23
araH,3967120,3967120,3967086,34,1282,utRho23
araJ,825058,825058,824962,96,7226,utRho23
arcA,9281602,9281602,9280612,990,2654,utRho23
arcB,6706098,6706098,6706050,48,856,utRho23
arcZ,6701154,6701154,6701154,0,0,utRho23
arfA,6877346,6877346,6877298,48,830,utRho23
argA,5898312,5898484,5898312,172,100,utRho23
argC,8309770,8310002,8309770,232,242,utRho23
argD,6980442,6980442,6980360,82,148,utRho23
argE,8310156,8310156,8309694,462,392,utRho23
argF,580680,580680,580610,70,180,utRho23
argG,6637124,6637274,6637124,150,520,utRho23
argI,8956688,8956688,8956622,66,546,utRho23
argO,6137672,6137672,6137616,56,322,utRho23
argP,6119460,6119506,6119460,46,722,utRho23
argR,6769204,6769406,6769204,202,140,utRho23
argS,3920002,3920124,3920002,122,256,utRho23
argT,4855698,4855698,4855582,116,262,utRho23
argU,1129406,1129446,1129406,40,0,utRho23
argW,4932616,4932618,4932616,2,14,utRho23
argX,7964728,7964750,7964728,22,0,utRho23
aroF,5482402,5482402,5482300,102,0,utRho23
aroG,1571182,1571266,1571182,84,224,utRho23
aroH,3576636,3576870,3576636,234,238,utRho23
aroK,7038760,7038760,7038128,632,1496,utRho23
aroL,812560,812810,812560,250,2904,utRho23
aroP,243342,243342,243102,240,178,utRho23
arpA,8445382,8445382,8444974,408,506,utRho23
arrS,7316108,7316108,7316108,0,0,utRho23
arsR,7297024,7297056,7297024,32,104,utRho23
artJ,1801252,1801252,1801150,102,24,utRho23
artP,1807686,1807686,1807468,218,8800,utRho23
ascF,5678858,5679048,5678858,190,18,utRho23
ascG,5678574,5678574,5678528,46,336,utRho23
aslB,7965562,7965916,7965562,354,702,utRho23
asnA,7854258,7854310,7854258,52,1686,utRho23
asnB,1398444,1398444,1398354,90,2728,utRho23
asnC,23562186,23562186,23562018,168,816,utRho23
asnS,1978088,1978088,1977970,118,2862,utRho23
asnT,4089082,4089098,4089082,16,308,utRho23
asnU,4119690,4119702,4119690,12,0,utRho23
asnV,4124504,4124520,4124504,16,224,utRho23
aspA,17473728,17473728,17473308,420,536,utRho23
aspC,1971486,1971486,1971418,68,62,utRho23
aspS,3901402,3901402,3901044,358,238,utRho23
aspT,7893560,7893744,7893560,184,59168,utRho23
aspV,473826,473862,473826,36,0,utRho23
asr,3342654,3342752,3342654,98,358,utRho23
astC,3664088,3664088,3663964,124,54,utRho23
astE,3654138,3654138,3653846,292,390,utRho23
atoD,4646824,4646894,4646824,70,2104,utRho23
atpB,7844540,7844540,7844102,438,70,utRho23
atpC,7832118,7832118,7831944,174,464,utRho23
atpI,7845050,7845050,7844880,170,216,utRho23
avtA,7479348,7479410,7479348,62,1282,utRho23
azoR,2965982,2965982,2965720,262,486,utRho23
azuC,3976002,3976002,3975918,84,56,utRho23
bacA,6408350,6408350,6408262,88,1086,utRho23
bamA,394052,395856,394052,1804,688,utRho23
bamB,5277950,5277950,5277304,646,264,utRho23
bamC,5198028,5198028,5197730,298,762,utRho23
bamD,5471922,5472292,5471922,370,2822,utRho23
bamE,5506972,5507210,5506972,238,274,utRho23
basS,8666954,8666954,8666544,410,2216,utRho23
bax,7474468,7474468,7474354,114,380,utRho23
bcp,5200874,5200956,5200874,82,1588,utRho23
bcsB,7385346,7385346,7385214,132,48,utRho23
bcsE,7392644,7392916,7392644,272,72,utRho23
bdcA,8948128,8948128,8948106,22,1240,utRho23
bdcR,8948192,8948248,8948192,56,858,utRho23
bdm,3112680,3112680,3112560,120,46,utRho23
betA,654522,654522,654494,28,262,utRho23
betI,658722,658722,658668,54,150,utRho23
betT,658842,658926,658842,84,352,utRho23
bfr,6933498,6933498,6933450,48,110,utRho23
bglG,23440182,23440182,23439402,780,2382,utRho23
bglX,4444240,4444240,4443978,262,130,utRho23
bhsA,2337962,2338146,2337962,184,548,utRho23
bioA,1618584,1618584,1618514,70,18,utRho23
bioB,1618604,1618688,1618604,84,0,utRho23
bioH,7089716,7089716,7089688,28,4,utRho23
bisC,7433026,7433026,7432788,238,342,utRho23
blc,8755490,8755490,8755444,46,0,utRho23
blr,3409024,3409102,3409024,78,256,utRho23
bluF,2431226,2431226,2430950,276,204,utRho23
bluR,2428226,2428226,2428118,108,22,utRho23
bolA,908698,908944,908698,246,18,utRho23
borD,1157842,1157842,1157786,56,1114,utRho23
brnQ,838976,839182,838976,206,784,utRho23
bssR,1756492,1756496,1756492,4,8,utRho23
bssS,2242116,2242116,2241910,206,402,utRho23
btuB,8326798,8327278,8326798,480,3776,utRho23
cadB,8720212,8720212,8720062,150,184,utRho23
cadC,8723926,8723926,8723868,58,58,utRho23
caiE,70998,70998,70742,256,610,utRho23
caiF,68436,68600,68436,164,3812,utRho23
caiT,84074,84074,83862,212,242,utRho23
can,285406,285406,285340,66,238,utRho23
carA,59102,59302,59102,200,860,utRho23
carB,61550,61634,61550,84,226,utRho23
cas2,5757830,5757830,5757706,124,618,utRho23
casA,5768638,5768638,5768276,362,60,utRho23
cbl,4121882,4121882,4121828,54,2416,utRho23
cbpA,2128074,2128074,2127550,524,720,utRho23
cbrA,7738628,7738754,7738628,126,0,utRho23
cbrB,7794958,7795012,7794958,54,696,utRho23
ccmH,4585242,4585242,4584820,422,380,utRho23
cdaR,364894,364926,364894,32,260,utRho23
cdd,4463638,4463688,4463638,50,64,utRho23
cdh,8219814,8219860,8219814,46,1126,utRho23
cdsA,391110,391354,391110,244,290,utRho23
cedA,3627484,3627484,3627326,158,1662,utRho23
cfa,3482402,3482826,3482402,424,980,utRho23
chaC,2544844,2544972,2544844,128,1282,utRho23
chbB,3643452,3643452,3643238,214,178,utRho23
chbG,3634624,3634624,3634270,354,148,utRho23
cheW,3946924,3946924,3946678,246,410,utRho23
chiA,6939792,6939792,6939706,86,304,utRho23
chiP,1416472,1416668,1416472,196,0,utRho23
cho,3646984,3647030,3646984,46,158,utRho23
chpS,8896804,8896894,8896804,90,136,utRho23
cirA,4493884,4493884,4493538,346,388,utRho23
citC,1304078,1304078,1303712,366,1858,utRho23
citT,1293264,1293264,1293160,104,136,utRho23
clcA,350104,350214,350104,110,0,utRho23
clpA,1846160,1846528,1846160,368,54,utRho23
clpB,5468410,5468410,5468346,64,198,utRho23
clpP,913154,913354,913154,200,102,utRho23
clpS,1845500,1845826,1845500,326,150,utRho23
clpX,914404,914852,914404,448,574,utRho23
clsA,2617346,2617346,2617290,56,266,utRho23
clsC,2212584,2212710,2212584,126,208,utRho23
cmk,1922330,1922402,1922330,72,0,utRho23
cnu,3409522,3409898,3409522,376,1484,utRho23
coaA,8350214,8350214,8350052,162,698,utRho23
cobC,1340092,1340092,1339814,278,698,utRho23
cobT,4129202,4129202,4128934,268,254,utRho23
cobU,4131944,4131944,4131528,416,340,utRho23
codB,709768,709844,709768,76,892,utRho23
comR,2337726,2337726,2337664,62,110,utRho23
copA,1022822,1022822,1022758,64,38,utRho23
corA,8002388,8002852,8002388,464,29590,utRho23
cpdB,8873258,8873258,8873130,128,646,utRho23
cptB,6082198,6082198,6082140,58,218,utRho23
cpxA,8210202,8210202,8209950,252,674,utRho23
cpxP,8211570,8211640,8211570,70,148,utRho23
cpxR,8211372,8211372,8211340,32,10,utRho23
cra,175894,176056,175894,162,0,utRho23
crcB,1316016,1316016,1315876,140,46,utRho23
creA,9270486,9271042,9270486,556,840,utRho23
creD,9276320,9276356,9276320,36,542,utRho23
crl,515620,515658,515620,38,2792,utRho23
crp,6971906,6972240,6971906,334,2378,utRho23
crr,5070960,5071668,5070960,708,2242,utRho23
csdA,5886414,5886674,5886414,260,120,utRho23
csgB,2207718,2207902,2207718,184,0,utRho23
csgD,2206688,2206688,2206392,296,890,utRho23
csgG,2203510,2203510,2203368,142,458,utRho23
csiD,5577854,5577970,5577854,116,438,utRho23
csiE,5330802,5330870,5330802,68,470,utRho23
csiR,5590942,5591348,5590942,406,912,utRho23
cspA,7439778,7440098,7439778,320,2566,utRho23
cspB,3283430,3283430,3283108,322,136,utRho23
cspC,3815018,3815018,3814870,148,38,utRho23
cspD,1845352,1845352,1845180,172,2890,utRho23
cspE,1314294,1314584,1314294,290,216,utRho23
cspF,3283380,3283710,3283380,330,528,utRho23
cspG,2102610,2102922,2102610,312,922,utRho23
cspH,2102746,2102746,2102350,396,230,utRho23
cspI,3277624,3277624,3277334,290,100,utRho23
csrA,5638746,5638746,5638292,454,364,utRho23
csrB,5849048,5849048,5849048,0,0,utRho23
csrC,8102072,8102072,8102072,0,0,utRho23
csrD,6806850,6806850,6806664,186,152,utRho23
cstA,1259710,1259788,1259710,78,92,utRho23
cueO,274090,274166,274090,76,4,utRho23
cueR,1027948,1027986,1027948,38,64,utRho23
curA,3037784,3038054,3037784,270,1782,utRho23
cusC,1191146,1191200,1191146,54,158,utRho23
cusR,1190924,1190924,1190886,38,282,utRho23
cutA,8730784,8730784,8730712,72,928,utRho23
cutC,3918534,3918534,3917920,614,2098,utRho23
cvpA,4861600,4861600,4861526,74,52,utRho23
cvrA,2484328,2484328,2484142,186,104,utRho23
cyaA,7981548,7982306,7981548,758,1462,utRho23
cyaR,4334228,4334224,4334228,4,0,utRho23
cyaY,7988166,7988166,7988118,48,342,utRho23
cybB,2981522,2981804,2981522,282,696,utRho23
cycA,8859560,8859728,8859560,168,452,utRho23
cydA,1542340,1542916,1542340,576,456,utRho23
cydC,1858800,1858800,1858390,410,174,utRho23
cydD,1862062,1862062,1861924,138,12,utRho23
cydX,1548300,1548392,1548300,92,112,utRho23
cynR,717418,717418,717380,38,396,utRho23
cynT,1435092,1435196,1435092,104,72,utRho23
cyoA,903306,903306,903220,86,2638,utRho23
cyoE,895540,895540,895410,130,116,utRho23
cysB,2667576,2667710,2667576,134,314,utRho23
cysC,5748056,5748056,5747984,72,148,utRho23
cysD,5752736,5752736,5752658,78,382,utRho23
cysE,7565362,7565362,7565124,238,1022,utRho23
cysG,6995508,6995656,6995508,148,3802,utRho23
cysJ,5783928,5783928,5783796,132,5788,utRho23
cysK,5064688,5064818,5064688,130,0,utRho23
cysP,5087114,5087114,5087056,58,606,utRho23
cysS,1109154,1109222,1109154,68,18,utRho23
cysT,3984100,3984100,3983974,126,2,utRho23
cysZ,5062766,5062926,5062766,160,750,utRho23
cytR,8249018,8249018,8248912,106,530,utRho23
dacA,1328002,1328002,1327926,76,282,utRho23
dacB,6657714,6657926,6657714,212,120,utRho23
dacC,1761306,1761454,1761306,148,766,utRho23
dadA,2475018,2475142,2475018,124,42,utRho23
dam,7032504,7032504,7031826,678,1358,utRho23
damX,7035200,7035200,7034612,588,484,utRho23
dapA,5199568,5199568,5199520,48,2,utRho23
dapB,56576,56748,56576,172,1078,utRho23
dapD,371954,371954,371894,60,184,utRho23
dapE,5183120,5183214,5183120,94,1054,utRho23
dcp,3254844,3254844,3254760,84,184,utRho23
dcrB,7219534,7219910,7219534,376,1406,utRho23
dctA,7366996,7366996,7366894,102,594,utRho23
dcuA,8733686,8733686,8733546,140,102,utRho23
dcuB,8698182,8698182,8697488,694,6212,utRho23
dcuC,1312166,1312166,1311936,230,1932,utRho23
dcuD,6749166,6749738,6749166,572,1376,utRho23
dcuR,8701130,8701130,8700068,1062,1762,utRho23
dcuS,8703370,8703370,8703324,46,1616,utRho23
dcyD,3999016,3999016,3998960,56,78,utRho23
ddpX,3126498,3126498,3126152,346,288,utRho23
deaD,6615818,6615818,6615720,98,514,utRho23
dedA,4869880,4869880,4869482,398,4298,utRho23
dedD,4863750,4863750,4863368,382,0,utRho23
def,6867300,6867380,6867300,80,398,utRho23
degP,361690,361768,361690,78,58,utRho23
degQ,6761308,6761486,6761308,178,5910,utRho23
deoB,9239134,9239206,9239134,72,6,utRho23
deoC,9233358,9234646,9233358,1288,1584,utRho23
dfp,7625406,7625462,7625406,56,32,utRho23
dgcZ,3247758,3247758,3247700,58,0,utRho23
dgkA,8512914,8513274,8512914,360,474,utRho23
dgt,358392,358474,358392,82,1094,utRho23
dhaK,2501888,2501888,2501676,212,692,utRho23
dhaR,2502006,2502132,2502006,126,584,utRho23
dicB,3299194,3299218,3299194,24,60,utRho23
dicC,3295752,3295752,3295700,52,34,utRho23
dinB,501760,501796,501760,36,132,utRho23
dinD,7635398,7635520,7635398,122,170,utRho23
dinG,1666146,1666140,1666146,6,8,utRho23
dinI,2243018,2243018,2242974,44,308,utRho23
dinJ,493230,493230,493004,226,300,utRho23
dinQ,7295964,7295964,7295576,388,746,utRho23
djlA,114536,114728,114536,192,882,utRho23
dkgA,6313142,6313246,6313142,104,382,utRho23
dkgB,458196,458334,458196,138,0,utRho23
dksA,321502,321502,321208,294,410,utRho23
dld,4444164,4444370,4444164,206,130,utRho23
dmlA,3763424,3763824,3763424,400,2178,utRho23
dmlR,3763710,3763710,3763618,92,464,utRho23
dmsA,1881646,1881918,1881646,272,58,utRho23
dnaA,7767922,7767922,7767458,464,650,utRho23
dnaB,8528566,8528628,8528566,62,120,utRho23
dnaK,24096,24326,24096,230,8054,utRho23
dnaN,7765466,7765466,7764642,824,328,utRho23
dnaQ,471868,472134,471868,266,4248,utRho23
dnaT,18406460,18406460,18406068,392,3852,utRho23
dnaX,984112,984184,984112,72,292,utRho23
dosP,3131486,3131486,3131466,20,62,utRho23
dpiB,1303968,1304470,1303968,502,1154,utRho23
dppA,7415740,7415740,7415410,330,2130,utRho23
dps,1697900,1697900,1697822,78,66,utRho23
dsbA,8086754,8086836,8086754,82,654,utRho23
dsbB,2466294,2466294,2466060,234,346,utRho23
dsbC,6079266,6079266,6077644,1622,1632,utRho23
dsbG,1277600,1277600,1277146,454,724,utRho23
dsdA,4958242,4958404,4958242,162,674,utRho23
dsdC,4955492,4955492,4955258,234,802,utRho23
dsdX,4955642,4955694,4955642,52,524,utRho23
dsrA,4050626,4050626,4050626,0,0,utRho23
dsrB,4049686,4049686,4049646,40,1006,utRho23
dtpD,1485340,1485340,1485112,228,1228,utRho23
dusA,8523200,8523338,8523200,138,2254,utRho23
dusB,6820492,6820560,6820492,68,16,utRho23
dusC,4460790,4460790,4460770,20,0,utRho23
dut,7627704,7627864,7627704,160,606,utRho23
dxr,386670,387042,386670,372,380,utRho23
ebgA,6445102,6445266,6445102,164,174,utRho23
ebgR,6442874,6442932,6442874,58,72,utRho23
ecnB,8753018,8753106,8753018,88,188,utRho23
eco,4607594,4607810,4607594,216,0,utRho23
ecpA,621594,621594,621342,252,564,utRho23
ecpB,620238,620238,620052,186,764,utRho23
ecpR,622964,622964,622672,292,504,utRho23
eda,3866218,3866218,3865512,706,484,utRho23
edd,3869426,3869426,3869208,218,84,utRho23
efeO,2164308,2164486,2164308,178,62,utRho23
efeU_1,2162614,2162712,2162614,98,158,utRho23
efp,8751134,8751398,8751134,264,2490,utRho23
elaA,4763372,4763372,4763086,286,228,utRho23
elaD,4765308,4765426,4765308,118,176,utRho23
elfA,1995530,1995736,1995530,206,122,utRho23
elfD,1996642,1996980,1996642,338,262,utRho23
emrD,7707690,7707844,7707690,154,56,utRho23
emrK,4966896,4966896,4966678,218,258,utRho23
emrY,4964668,4964668,4964352,316,368,utRho23
emtA,2486250,2486360,2486250,110,62,utRho23
endA,12361100,12361388,12361100,288,128,utRho23
eno,5817692,5817692,5815882,1810,1704,utRho23
entC,1249662,1249770,1249662,108,96,utRho23
entD,1220508,1220508,1220158,350,212,utRho23
entH,1258584,1258600,1258584,16,0,utRho23
entS,1244506,1244600,1244506,94,66,utRho23
envR,6827266,6827266,6826930,336,194,utRho23
epd,12295292,12295292,12294764,528,668,utRho23
epmA,8765236,8765286,8765236,50,188,utRho23
epmB,8751406,8751406,8751314,92,1034,utRho23
eptB,7421162,7421162,7420950,212,108,utRho23
eptC,8300622,8300622,8300530,92,1124,utRho23
erfK,4126708,4126708,4126646,62,178,utRho23
erpA,353122,353220,353122,98,38,utRho23
esrE,8039956,8039956,8039956,0,0,utRho23
essD,1153746,1154796,1153746,1050,4252,utRho23
etk,2088606,2088606,2088420,186,1506,utRho23
evgA,4967262,4967510,4967262,248,146,utRho23
exbB,6304028,6304028,6303968,60,160,utRho23
exbD,6302780,6302780,6302486,294,242,utRho23
exuR,6493016,6493304,6493016,288,74,utRho23
exuT,6490004,6490208,6490004,204,102,utRho23
fabA,2032996,2032996,2032940,56,84,utRho23
fabB,4883282,4883282,4883210,72,28,utRho23
fabH,2297032,2297518,2297032,486,758,utRho23
fabI,2702236,2702236,2702078,158,140,utRho23
fadB,8062026,8062026,8061942,84,274,utRho23
fadD,3779614,3779614,3779492,122,52,utRho23
fadE,486812,486812,486606,206,214,utRho23
fadH,6463248,6463330,6463248,82,542,utRho23
fadI,4921022,4921022,4920938,84,654,utRho23
fadL,4922410,4922600,4922410,190,478,utRho23
fadM,928720,928804,928720,84,22,utRho23
fadR,2469810,2469876,2469810,66,12,utRho23
fbaB,4357334,4357334,4357128,206,142,utRho23
fdhE,8162722,8162722,8162456,266,994,utRho23
fdhF,8598814,8598814,8598732,82,384,utRho23
fdnG,3094744,3094802,3094744,58,94,utRho23
fdrA,1093012,1093360,1093012,348,380,utRho23
feaB,2894994,2895038,2894994,44,0,utRho23
feaR,2894734,2894734,2894566,168,16,utRho23
fecA,9033454,9033454,9033354,100,158,utRho23
fecE,9023288,9023288,9022914,374,1796,utRho23
fecI,9036564,9036564,9036470,94,1732,utRho23
feoA,7080114,7080326,7080114,212,1040,utRho23
fepA,1225334,1225334,1224988,346,970,utRho23
fepB,1249454,1249454,1249020,434,50,utRho23
fepD,1244468,1244468,1244378,90,44,utRho23
fes,1225374,1225630,1225374,256,1430,utRho23
ffh,5495706,5495706,5495590,116,452,utRho23
ffs,952576,952848,952576,272,8594,utRho23
fhuA,334884,334968,334884,84,528,utRho23
fhuE,2323294,2323294,2323102,192,718,utRho23
fhuF,9211504,9211504,9211326,178,65350,utRho23
fic,6983296,6983296,6982926,370,2940,utRho23
fieF,8212864,8212938,8212864,74,740,utRho23
fimA,9085388,9086230,9085388,842,1648,utRho23
fimB,9081334,9081914,9081334,580,6150,utRho23
fimE,9083742,9084074,9083742,332,2294,utRho23
fimZ,1129214,1129214,1128960,254,116,utRho23
fiu,1683296,1683296,1683062,234,454,utRho23
fixA,84650,84806,84650,156,396,utRho23
fkpA,6955050,6955050,6954838,212,1746,utRho23
fldA,2846084,2846084,2845860,224,1892,utRho23
fldB,6079644,6079710,6079644,66,252,utRho23
flgA,2261770,2261770,2261726,44,2568,utRho23
flgB,2261986,2262036,2261986,50,168,utRho23
flgK,2276702,2276756,2276702,54,430,utRho23
flgM,2260330,2260330,2260256,74,164,utRho23
flgN,2259828,2259828,2259660,168,206,utRho23
flhB,3932432,3932432,3932382,50,664,utRho23
flhC,3955864,3955864,3955688,176,54,utRho23
flhD,3957154,3957154,3956394,760,4920,utRho23
fliA,4003638,4003638,4003578,60,82,utRho23
fliC,4007352,4007352,4007212,140,76,utRho23
fliD,4007634,4007744,4007634,110,1800,utRho23
fliE,4026186,4026186,4026028,158,2310,utRho23
fliF,4026292,4026458,4026292,166,1658,utRho23
fliL,4039168,4039236,4039168,68,14,utRho23
flk,4875824,4875900,4875824,76,192,utRho23
flu,4142634,4143078,4142634,444,382,utRho23
flxA,3292776,3292810,3292776,34,374,utRho23
fnr,2799104,2799104,2799052,52,186,utRho23
fnrS,2818258,2818258,2818258,0,0,utRho23
focA,1909628,1909628,1908932,696,738,utRho23
folA,99598,99646,99598,48,290,utRho23
folB,6409296,6409296,6409178,118,182,utRho23
folD,1115562,1115562,1115482,80,296,utRho23
folE,4487696,4487696,4487304,392,1726,utRho23
fpr,8228998,8228998,8228944,54,146,utRho23
frc,4986878,4986878,4986508,370,348,utRho23
frdA,8764824,8764824,8764636,188,1866,utRho23
frdD,8758948,8758948,8758732,216,6412,utRho23
fre,8052886,8053054,8052886,168,1504,utRho23
frlA,6999518,6999820,6999518,302,566,utRho23
frr,385624,385744,385624,120,368,utRho23
frsA,513004,513054,513004,50,36,utRho23
fruB,4527194,4527194,4526990,204,0,utRho23
frvR,8179804,8179804,8179710,94,84,utRho23
fryA,5008986,5008986,5008970,16,566,utRho23
fsaA,1727060,1727284,1727060,224,1746,utRho23
fsr,1009710,1009710,1009392,318,592,utRho23
ftnA,3977364,3977432,3977364,68,18,utRho23
ftnB,3973550,3973850,3973550,300,496,utRho23
ftsA,207122,207964,207122,842,596,utRho23
ftsB,5745802,5745802,5745640,162,174,utRho23
ftsH,6654204,6654204,6653870,334,798,utRho23
ftsK,1865858,1866448,1865858,590,650,utRho23
ftsL,181376,182064,181376,688,2148,utRho23
ftsP,6325732,6325732,6325338,394,378,utRho23
ftsQ,205484,206310,205484,826,410,utRho23
ftsX,7204512,7204512,7204172,340,758,utRho23
ftsZ,209272,210610,209272,1338,90,utRho23
fucA,5867708,5867708,5867376,332,5172,utRho23
fucP,5868238,5868470,5868238,232,656,utRho23
fumA,6753760,6753760,6753508,252,2220,utRho23
fumB,8694696,8694696,8694652,44,298,utRho23
fumC,3373418,3373418,3373176,242,118,utRho23
fur,2842892,2842892,2842584,308,1996,utRho23
fusA,6947370,6947370,6947028,342,5010,utRho23
fxsA,8737206,8737328,8737206,122,38,utRho23
gabD,5581824,5582546,5581824,722,7348,utRho23
gadA,7335214,7335214,7335160,54,0,utRho23
gadB,3144144,3144144,3144090,54,830,utRho23
gadC,3141168,3141168,3140978,190,698,utRho23
gadE,7315600,7316732,7315600,1132,4614,utRho23
gadW,7329562,7329562,7329236,326,162,utRho23
gadX,14663356,14663356,14663240,116,1196,utRho23
gadY,7329728,7329728,7329728,0,0,utRho23
galE,1584354,1584354,1584110,244,146,utRho23
galF,4228702,4228702,4228654,48,254,utRho23
galM,1577796,1577796,1577674,122,806,utRho23
galP,6176510,6176568,6176510,58,136,utRho23
galR,5953138,5953198,5953138,60,312,utRho23
galS,4483420,4483420,4483336,84,48,utRho23
galU,2582810,2582914,2582810,104,260,utRho23
gapA,3724480,3725542,3724480,1062,1192,utRho23
garP,6549868,6549868,6549814,54,1638,utRho23
gatY,4354468,4354468,4354408,60,26,utRho23
gatZ,4352864,4352864,4352642,222,5658,utRho23
gcd,282558,282558,282450,108,140,utRho23
gcl,1067814,1067832,1067814,18,6,utRho23
gcvA,5885278,5885278,5885134,144,76,utRho23
gcvB,5885392,5885392,5885392,0,0,utRho23
gcvR,5199758,5199812,5199758,54,104,utRho23
gcvT,6101544,6101544,6101334,210,776,utRho23
gdhA,3684616,3684742,3684616,126,118,utRho23
gfcA,2099668,2099668,2099488,180,1786,utRho23
gfcD,2096236,2096236,2095890,346,4400,utRho23
ghrA,2195648,2195772,2195648,124,142,utRho23
ghrB,7434378,7434620,7434378,242,2970,utRho23
glcA,6242728,6242728,6242558,170,1582,utRho23
glcC,6256412,6256544,6256412,132,138,utRho23
glcD,6256152,6256152,6256042,110,678,utRho23
gldA,8278092,8278092,8278070,22,482,utRho23
glgA,7136784,7136784,7136066,718,1402,utRho23
glgB,7147314,7147314,7147004,310,314,utRho23
glgC,7139142,7139142,7138656,486,458,utRho23
glgP,7133546,7133546,7133162,384,680,utRho23
glgS,6384024,6384024,6383878,146,140,utRho23
glgX,7142838,7142838,7142638,200,164,utRho23
glk,5018922,5018922,5018852,70,230,utRho23
glmS,7827622,7827622,7827336,286,1222,utRho23
glmU,7830652,7830652,7830400,252,148,utRho23
glmY,10765360,10765360,10765360,0,0,utRho23
glmZ,7972864,7972864,7972864,0,0,utRho23
glnA,16232888,16232888,16232136,752,312,utRho23
glnB,5375052,5375052,5374816,236,362,utRho23
glnD,377310,377310,377300,10,110,utRho23
glnE,6399602,6399602,6399282,320,130,utRho23
glnH,1696396,1696396,1696008,388,1700,utRho23
glnK,945112,945196,945112,84,1010,utRho23
glnL,8112742,8112742,8112678,64,12,utRho23
glnQ,1693262,1693262,1692926,336,454,utRho23
glnS,1411998,1412186,1411998,188,1878,utRho23
gloA,3455602,3455674,3455602,72,110,utRho23
gloB,469852,469852,469564,288,1526,utRho23
glpA,4705166,4705294,4705166,128,120,utRho23
glpD,7123942,7124026,7123942,84,784,utRho23
glpE,7123698,7123698,7123646,52,32,utRho23
glpF,8236322,8236322,8236180,142,1586,utRho23
glpG,7122960,7122960,7122904,56,158,utRho23
glpR,7121782,7121782,7121210,572,7312,utRho23
glpT,4704902,4704902,4704748,154,1164,utRho23
glpX,8231212,8231212,8231158,54,428,utRho23
glrK,5382246,5382246,5382196,50,466,utRho23
gltA,1509534,1509534,1508936,598,13786,utRho23
gltB,6709018,6709264,6709018,246,1152,utRho23
gltI,1375792,1375792,1375494,298,3502,utRho23
gltP,8588536,8588962,8588536,426,1898,utRho23
gltS,7657382,7657382,7657330,52,1644,utRho23
gltX,5041568,5041568,5041344,224,406,utRho23
gluQ,320286,320286,320224,62,70,utRho23
glyA,5371148,5371148,5371014,134,250,utRho23
glyQ,7450708,7450708,7450636,72,608,utRho23
glyS,7448990,7448990,7448794,196,770,utRho23
glyU,5998128,5998128,5998114,14,0,utRho23
glyV,8784626,8784720,8784626,94,224,utRho23
glyW,3984360,3984360,3984234,126,2,utRho23
gmhB,445612,445666,445612,54,136,utRho23
gmk,7642776,7642856,7642776,80,80,utRho23
gmr,2693686,2693686,2693484,202,516,utRho23
gnd,4202648,4202648,4202536,112,326,utRho23
gnsB,3275692,3275692,3275564,128,48,utRho23
gntK,14310580,14310580,14310368,212,1876,utRho23
gntP,9102668,9102668,9102592,76,462,utRho23
gntR,7157760,7157760,7157452,308,336,utRho23
gntT,7092810,7093118,7092810,308,3104,utRho23
gntU,7154170,7154170,7154122,48,56,utRho23
gntX,7089334,7089764,7089334,430,116,utRho23
gor,7292224,7292598,7292224,374,472,utRho23
gpmA,1575340,1575340,1575190,150,8,utRho23
gpmM,7570374,7570520,7570374,146,208,utRho23
gpsA,7567620,7567620,7567322,298,1272,utRho23
gpt,511828,511954,511828,126,292,utRho23
grcA,5433046,5433046,5432898,148,1242,utRho23
greA,6657728,6657728,6657430,298,506,utRho23
greB,7073488,7073624,7073488,136,84,utRho23
groL,8741566,8742050,8741566,484,10932,utRho23
groS,8741232,8741376,8741232,144,7910,utRho23
grpE,5501494,5501494,5501416,78,354,utRho23
grxA,1781552,1781552,1781506,46,180,utRho23
grxB,2248206,2248206,2248108,98,1260,utRho23
grxC,7569152,7569152,7568884,268,1350,utRho23
grxD,3468324,3468324,3468202,122,626,utRho23
gspA,6911268,6911268,6910796,472,1556,utRho23
gspC,6910964,6911156,6910964,192,432,utRho23
gss,6277220,6277220,6277044,176,494,utRho23
gstA,3428654,3428754,3428654,100,0,utRho23
gstB,1761038,1761038,1760960,78,960,utRho23
guaB,5268214,5268214,5268140,74,72,utRho23
gudD,5839026,5839026,5838770,256,190,utRho23
gyrA,4678914,4678914,4678840,74,306,utRho23
gyrB,7760300,7760300,7760238,62,102,utRho23
hcaE,5337964,5338064,5337964,100,12298,utRho23
hcaR,5337928,5337928,5337792,136,15842,utRho23
hcaT,5336106,5336106,5335692,414,1476,utRho23
hchA,4071260,4071670,4071260,410,380,utRho23
hcp,1828258,1828258,1827628,630,2652,utRho23
hcr,1824400,1824400,1824300,100,276,utRho23
hdeA,7313582,7313582,7313480,102,16,utRho23
hdeD,7313920,7313990,7313920,70,4924,utRho23
hdfR,7896320,7896320,7895934,386,156,utRho23
hdhA,3396244,3396244,3396080,164,70,utRho23
helD,2048876,2048942,2048876,66,0,utRho23
hemA,2527166,2527428,2527166,262,214,utRho23
hemB,779722,779722,779454,268,5336,utRho23
hemF,5106410,5106450,5106410,40,124,utRho23
hemH,996062,996110,996062,48,1212,utRho23
hemL,349882,349882,349764,118,48,utRho23
hemN,8103886,8104090,8103886,204,306,utRho23
hepA,127176,127176,126528,648,4502,utRho23
hflD,2385372,2385372,2385262,110,162,utRho23
hfq,8799602,8800576,8799602,974,3774,utRho23
hha,961006,961006,960616,390,290,utRho23
hicA,3018442,3018572,3018442,130,260,utRho23
higA,6468682,6468682,6468288,394,3372,utRho23
higB,6468960,6468960,6468910,50,108,utRho23
hinT,2323642,2323770,2323642,128,12,utRho23
hipB,3184964,3184964,3184884,80,66,utRho23
hisB,4186720,4186936,4186720,216,308,utRho23
hisJ,4853674,4853674,4853576,98,134,utRho23
hisL,8359856,8359984,8359856,128,1276,utRho23
hisS,5281284,5281284,5281150,134,114,utRho23
hlpA,400910,400964,400910,54,8,utRho23
hlyE,2460932,2460932,2460788,144,1482,utRho23
hmp,5371594,5371670,5371594,76,40,utRho23
hns,2585916,2585916,2585844,72,728,utRho23
hofM,7045856,7045856,7045502,354,338,utRho23
hokA,7441620,7441620,7441200,420,1164,utRho23
hokC,33902,33902,33806,96,156,utRho23
hokE,1215462,1215672,1215462,210,58,utRho23
holC,8968546,8968546,8968560,14,592,utRho23
holD,9215562,9215606,9215562,44,8,utRho23
holE,3850040,3850216,3850040,176,2894,utRho23
hpt,282720,282862,282720,142,1872,utRho23
hrpB,324150,324210,324150,60,100,utRho23
hscB,5319048,5319048,5318934,114,462,utRho23
hscC,1367188,1367188,1366786,402,414,utRho23
hsdS,9163004,9163004,9162924,80,600,utRho23
hslJ,2883560,2883560,2883486,74,790,utRho23
hslO,7059344,7059548,7059344,204,12208,utRho23
hslR,7058220,7058696,7058220,476,1582,utRho23
hslV,8244708,8244708,8244574,134,302,utRho23
hsrA,7881412,7881412,7881224,188,364,utRho23
htgA,21286,21660,21286,374,23642,utRho23
htpG,989634,990240,989634,606,27084,utRho23
htpX,3825236,3825236,3825152,84,108,utRho23
htrE,311036,311036,310852,184,1610,utRho23
htrL,7587668,7587668,7587366,302,258,utRho23
hupA,8400352,8400562,8400352,210,4,utRho23
hupB,1845220,1845804,1845220,584,1036,utRho23
hyaA,2063968,2064278,2063968,310,40,utRho23
hybO,6292726,6292726,6292522,204,13244,utRho23
hycA,5700922,5700922,5700870,52,220,utRho23
hycI,5686204,5686204,5686086,118,2884,utRho23
hydN,5676264,5676264,5676210,54,60,utRho23
hyfA,5202342,5202402,5202342,60,182,utRho23
hypA,11402508,11402588,11402508,80,612,utRho23
hypB,11403356,11404004,11403356,648,148,utRho23
hypF,5676210,5676210,5674850,1360,8240,utRho23
hypT,9116634,9116634,9116578,56,28,utRho23
hyuA,6019660,6020056,6019660,396,1010,utRho23
iaaA,1733074,1733136,1733074,62,30,utRho23
iadA,9119074,9119074,9119052,22,814,utRho23
iap,5753072,5753162,5753072,90,114,utRho23
ibaG,6673966,6673966,6673606,360,76,utRho23
ibpA,7735036,7735036,7734844,192,2278,utRho23
ibpB,7733962,7733962,7733794,168,14798,utRho23
icd,2389922,2390246,2389922,324,178,utRho23
iclR,8447304,8447304,8447256,48,270,utRho23
idi,6065876,6066130,6065876,254,164,utRho23
idnD,8988870,8988870,8988812,58,64,utRho23
idnK,8989194,8989246,8989194,52,956,utRho23
ihfA,3591442,3591442,3591104,338,152,utRho23
ihfB,1927498,1927656,1927498,158,314,utRho23
ileS,43666,44782,43666,1116,2456,utRho23
ileX,6431194,6431196,6431194,2,10,utRho23
ilvA,15820940,15821324,15820940,384,1940,utRho23
ilvC,7915824,7915940,7915824,116,298,utRho23
ilvE,15809552,15809936,15809552,384,812,utRho23
ilvI,170840,171260,170840,420,570,utRho23
ilvL,23701308,23701932,23701308,624,462,utRho23
ilvY,7915734,7915734,7915640,94,154,utRho23
inaA,4698998,4698998,4698944,54,1370,utRho23
infA,1853370,1853370,1852886,484,722,utRho23
infC,3602692,3602692,3601276,1416,1176,utRho23
insA-5,3958452,3958452,3958430,22,162,utRho23
insA-7,9036758,9037054,9036758,296,2688,utRho23
insC-5,6372080,6372284,6372080,204,7028,utRho23
insEF-2,785238,785238,785820,582,3704,utRho23
insEF-4,2190310,2190310,2190892,582,3424,utRho23
insG,9007098,9007098,9006862,236,6,utRho23
insH-1,550596,550596,550234,362,37904,utRho23
insH-11,7306538,7306538,7306396,142,326,utRho23
insH-2,1151548,1151548,1151506,42,578,utRho23
insH-3,1378444,1378444,1378026,418,828,utRho23
insH-4,2791942,2792152,2791942,210,314,utRho23
insH-5,2857852,2857852,2857452,400,790,utRho23
insH-6,4135022,4135022,4134642,380,1712,utRho23
insH-7,4206186,4206186,4205822,364,2436,utRho23
insH-9,6260050,6260356,6260050,306,1950,utRho23
insI-3,9017372,9017372,9017234,138,1034,utRho23
insJ,7441188,7441360,7441188,172,358,utRho23
insK,7442130,7442308,7442130,178,2,utRho23
insL-1,30760,30890,30760,130,2216,utRho23
insL-2,1216112,1216130,1216112,18,172,utRho23
insL-3,5028644,5028662,5028644,18,180,utRho23
insN-1,540452,540484,540452,32,218,utRho23
intD,1132202,1132202,1131956,246,20490,utRho23
intR,2826520,2826520,2826470,50,86,utRho23
intS,4933026,4933090,4933026,64,3282,utRho23
intZ,5117386,5117542,5117386,156,10818,utRho23
iraD,9113152,9113986,9113152,834,1016,utRho23
iraM,2424246,2424246,2424006,240,344,utRho23
iraP,802638,802772,802638,134,0,utRho23
iscA,5319924,5319924,5319772,152,416,utRho23
iscR,5324398,5324398,5324262,136,5510,utRho23
iscX,5313834,5313834,5313472,362,1168,utRho23
ispF,5743968,5743968,5743560,408,2168,utRho23
ispG,5283908,5283908,5283608,300,228,utRho23
ispU,389568,389806,389568,238,18,utRho23
isrA,2811502,2811502,2811618,116,148,utRho23
istr-1,7706384,7706384,7706384,0,0,utRho23
istr-2,7706514,7706514,7706514,0,0,utRho23
ivbL,15412092,15412092,15411952,140,180,utRho23
ivy,480638,480686,480638,48,562,utRho23
katE,3627628,3627734,3627628,106,1174,utRho23
katG,8267624,8267670,8267624,46,60,utRho23
kbaZ,6557732,6557828,6557732,96,112,utRho23
kbl,7585154,7585154,7585102,52,664,utRho23
kch,2621046,2621046,2620538,508,434,utRho23
kdgR,3820506,3820506,3820198,308,142,utRho23
kdpE,1443788,1443788,1443466,322,136,utRho23
kdpF,1457698,1457698,1457642,56,206,utRho23
kdsA,2535708,2536330,2535708,622,928,utRho23
kdsC,6683438,6684546,6683438,1108,4350,utRho23
kduI,5968388,5968388,5968248,140,24338,utRho23
kefF,94160,94492,94160,332,3494,utRho23
kgtP,5451624,5451624,5451492,132,240,utRho23
kup,7862206,7862632,7862206,426,518,utRho23
lacI,735076,735076,735020,56,172,utRho23
lacZ,1465508,1465508,1465220,288,1932,utRho23
ldcA,2486394,2486394,2486160,234,310,utRho23
ldhA,2885830,2885830,2885686,144,138,utRho23
ldrA,2538954,2538954,2538550,404,2366,utRho23
ldrB,2540024,2540024,2539620,404,560,utRho23
ldrC,2541092,2541092,2540690,402,352,utRho23
ldrD,7400544,7400544,7400174,370,860,utRho23
lepA,5414392,5414392,5414248,144,26,utRho23
lepB,5410928,5410928,5410618,310,426,utRho23
leuD,159188,159188,158906,282,246,utRho23
leuE,3761600,3761600,3761518,82,190,utRho23
leuL,168048,168048,167416,632,252,utRho23
leuO,168308,168736,168308,428,154,utRho23
leuQ,9212864,9212864,9212802,62,58,utRho23
leuU,6644556,6644556,6644316,240,400,utRho23
leuV,9212546,9212546,9212330,216,612,utRho23
leuX,8992772,8992810,8992772,38,62,utRho23
lexA,8514174,8514230,8514174,56,940,utRho23
lhr,3456706,3458174,3456706,1468,6586,utRho23
ligA,5060402,5060402,5060352,50,0,utRho23
ligB,7642576,7642576,7642340,236,926,utRho23
lipA,1320602,1320602,1320432,170,702,utRho23
lipB,1324802,1324802,1324556,246,9822,utRho23
lit,2397032,2397390,2397032,358,3014,utRho23
livJ,7199524,7199524,7199316,208,2116,utRho23
livK,7195510,7195510,7195120,390,1030,utRho23
lldP,7554578,7554798,7554578,220,3370,utRho23
lnt,1381968,1381968,1381762,206,214,utRho23
loiP,6163784,6163826,6163784,42,36,utRho23
lolA,1874656,1874738,1874656,82,200,utRho23
lolB,2527112,2527112,2527000,112,156,utRho23
lolC,2350748,2350854,2350748,106,62,utRho23
lon,917630,917776,917630,146,292,utRho23
lpcA,486936,487086,486936,150,124,utRho23
lpd,255434,255824,255434,390,782,utRho23
lplA,9248476,9248476,9248234,242,1140,utRho23
lplT,5947878,5947878,5947724,154,48,utRho23
lpoA,6586422,6586800,6586422,378,1390,utRho23
lpp,3514592,3514842,3514592,250,274,utRho23
lptA,6686598,6686760,6686598,162,696,utRho23
lptB,6686792,6687888,6686792,1096,1682,utRho23
lptD,114672,114672,114218,454,2452,utRho23
lptF,8972244,8972436,8972244,192,54,utRho23
lpxC,213016,213114,213016,98,1526,utRho23
lpxD,401920,401942,401920,22,0,utRho23
lpxL,2233418,2233418,2233164,254,56,utRho23
lpxM,3880456,3880456,3880386,70,58,utRho23
lpxP,4991156,4991290,4991156,134,502,utRho23
lrhA,4813312,4813312,4813282,30,70,utRho23
lrp,1864656,1865190,1864656,534,772,utRho23
lspA,50028,50414,50028,386,742,utRho23
lsrA,3202920,3202980,3202920,60,58,utRho23
lsrR,3202514,3202514,3202482,32,2,utRho23
ltaE,1818640,1818640,1818588,52,14,utRho23
luxS,5630130,5630130,5629466,664,4564,utRho23
lysA,5957902,5957902,5957798,104,164,utRho23
lysC,8467232,8467232,8466466,766,2116,utRho23
lysP,4497120,4497120,4497064,56,82,utRho23
lysR,5957900,5958042,5957900,142,76,utRho23
lysT,1561028,1561108,1561028,80,0,utRho23
lysU,8709610,8709610,8709434,176,262,utRho23
macB,1840188,1840694,1840188,506,1636,utRho23
maeA,3111484,3111484,3111338,146,2332,utRho23
mak,820236,820288,820236,52,96,utRho23
malE,8492928,8492928,8492838,90,44,utRho23
malI,3398456,3398456,3398360,96,32,utRho23
malK,8493472,8493568,8493472,96,336,utRho23
malP,7105020,7105020,7104946,74,1134,utRho23
malQ,7100798,7100798,7100140,658,946,utRho23
malS,14949880,14949988,14949880,108,36,utRho23
malT,7106048,7106170,7106048,122,222,utRho23
malX,3398626,3398710,3398626,84,0,utRho23
malZ,1689980,1690072,1689980,92,904,utRho23
manA,3377102,3377152,3377102,50,8,utRho23
manX,3803866,3804096,3803866,230,476,utRho23
marC,3237882,3237882,3237816,66,670,utRho23
marR,3238186,3238240,3238186,54,546,utRho23
matP,2036918,2036970,2036918,52,54,utRho23
mazE,5822736,5822736,5822678,58,80,utRho23
mazG,5821720,5821720,5821370,350,4350,utRho23
mcbA,1684306,1684306,1684112,194,122,utRho23
mcbR,3040192,3040524,3040192,332,112,utRho23
mcrA,2420278,2420692,2420278,414,668,utRho23
mcrC,9156124,9156124,9155916,208,1296,utRho23
mdaB,6344814,6345060,6344814,246,534,utRho23
mdfA,1767138,1767346,1767138,208,0,utRho23
mdh,6768940,6768940,6768536,404,202,utRho23
mdoB,9198988,9198988,9198882,106,7568,utRho23
mdoD,2993290,2993712,2993290,422,56,utRho23
mdoG,2218514,2218670,2218514,156,42,utRho23
mdtA,4307958,4308032,4307958,74,178,utRho23
mdtE,7318168,7318464,7318168,296,4482,utRho23
mdtK,3486538,3486914,3486538,376,4250,utRho23
mdtP,8602472,8602472,8602060,412,4370,utRho23
melA,8683774,8683822,8683774,48,0,utRho23
melR,8683300,8683300,8683256,44,1752,utRho23
menA,8240812,8240812,8240698,114,120,utRho23
menB,4753774,4753774,4753638,136,746,utRho23
mepH,3468714,3468870,3468714,156,14,utRho23
mepM,3883666,3883666,3883270,396,184,utRho23
mepS,4539840,4539958,4539840,118,74,utRho23
metA,8428318,8428560,8428318,242,278,utRho23
metB,8257272,8257344,8257272,72,706,utRho23
metC,6304150,6304472,6304150,322,246,utRho23
metE,8025768,8026106,8025768,338,2646,utRho23
metF,8265092,8265232,8265092,140,190,utRho23
metG,4388538,4388600,4388538,62,92,utRho23
metH,8447010,8447656,8447010,646,4800,utRho23
metJ,8257116,8257116,8256790,326,472,utRho23
metK,6173154,6173412,6173154,258,50,utRho23
metN,445428,445428,445290,138,84,utRho23
metR,8025710,8025710,8025632,78,22,utRho23
metT,1394326,1394326,1394266,60,132,utRho23
metY,19910250,19910250,19909734,516,282,utRho23
metZ,11789528,11789548,11789528,20,52,utRho23
mfd,2348056,2348056,2347928,128,336,utRho23
mglA,4478782,4478782,4478578,204,292,utRho23
mglB,4481132,4481132,4480696,436,10200,utRho23
mglC,4475918,4475918,4475506,412,920,utRho23
mgrB,3817584,3817584,3817532,52,122,utRho23
mgrR,3245828,3245828,3245828,0,0,utRho23
mgsA,2054082,2054082,2054030,52,206,utRho23
mgtL,8934560,8934862,8934560,302,80,utRho23
mhpA,737038,737222,737038,184,792,utRho23
mhpR,737072,737072,736840,232,506,utRho23
mhpT,750772,750918,750772,146,102,utRho23
miaA,8797964,8798504,8797964,540,2026,utRho23
micA,5629604,5629604,5629604,0,0,utRho23
micC,2874242,2874238,2874242,4,0,utRho23
micF,4626168,4626168,4626168,0,0,utRho23
micM,1014408,1014408,1014408,0,0,utRho23
minE,2449422,2449422,2449090,332,1194,utRho23
mioC,7852950,7852950,7852910,40,42,utRho23
mipA,3733012,3733012,3732944,68,1138,utRho23
mlaA,4930270,4930270,4930014,256,0,utRho23
mlc,3337206,3337206,3337128,78,54,utRho23
mlrA,4429498,4429732,4429498,234,744,utRho23
mltA,5894546,5894546,5894356,190,274,utRho23
mltD,468050,468050,467910,140,108,utRho23
mltF,5391534,5391602,5391534,68,0,utRho23
mmuP,550238,550650,550238,412,45606,utRho23
mngA,1531622,1531968,1531622,346,688,utRho23
mngR,1531852,1531852,1531750,102,426,utRho23
mnmG,7851348,7851348,7851266,82,2830,utRho23
mntH,5025470,5025470,5025412,58,60,utRho23
mntP,3810918,3811376,3810918,458,2492,utRho23
mntR,1706160,1706366,1706160,206,20,utRho23
mntS,1706128,1706128,1705994,134,32,utRho23
moaA,1633654,1634088,1633654,434,2960,utRho23
moaB,1635954,1636110,1635954,156,1438,utRho23
mobA,8084242,8084242,8083998,244,280,utRho23
mocA,6030112,6030320,6030112,208,306,utRho23
modA,1589990,1590178,1589990,188,388,utRho23
moeA,1732788,1732788,1732728,60,116,utRho23
mokB,2984610,2984610,2984258,352,844,utRho23
molR_1,4392888,4392948,4392888,60,362,utRho23
motA,3954604,3954604,3954278,326,240,utRho23
mpaA,2781278,2781278,2781196,82,1006,utRho23
mpl,8911456,8911570,8911456,114,388,utRho23
mppA,2786108,2786454,2786108,346,68,utRho23
mprA,5621494,5621540,5621494,46,632,utRho23
mqo,4613848,4613848,4613508,340,750,utRho23
mqsA,6336742,6336742,6336492,250,640,utRho23
mqsR,6337306,6337306,6337088,218,1560,utRho23
mraZ,179192,179268,179192,76,22,utRho23
mrcA,7045652,7045742,7045652,90,54,utRho23
mrcB,329442,329460,329442,18,14,utRho23
mreB,13605424,13605424,13604348,1076,496,utRho23
mreD,6798166,6798166,6797750,416,296,utRho23
mrp,4388360,4388360,4388336,24,90,utRho23
mscK,972984,973072,972984,88,290,utRho23
mscL,6876002,6876048,6876002,46,676,utRho23
mscS,6139742,6139742,6139614,128,290,utRho23
msrA,8884522,8884522,8884352,170,1694,utRho23
msrB,3725168,3725168,3724858,310,0,utRho23
msyB,2228426,2228426,2228362,64,426,utRho23
mtfA,4087236,4087302,4087236,66,920,utRho23
mtgA,6699662,6699662,6699618,44,1572,utRho23
mtlA,30177504,30178248,30177504,744,10704,utRho23
mtn,358366,358366,358306,60,2454,utRho23
mtr,6611864,6611864,6611634,230,112,utRho23
mug,6430992,6430992,6430946,46,62,utRho23
murQ,5091466,5091546,5091466,80,232,utRho23
murR,5091586,5091586,5091218,368,1190,utRho23
mutH,5939164,5939324,5939164,160,600,utRho23
mutL,8794092,8794824,8794092,732,5160,utRho23
mutM,7622554,7622554,7622304,250,338,utRho23
mutS,5714038,5714186,5714038,148,2404,utRho23
mutY,18617466,18618078,18617466,612,1116,utRho23
nac,4123956,4123956,4123866,90,1120,utRho23
nadA,1564122,1564170,1564122,48,28,utRho23
nadB,5420714,5420840,5420714,126,228,utRho23
nadC,237326,237326,237290,36,430,utRho23
nadE,3644604,3644916,3644604,312,558,utRho23
nadK,5501526,5501662,5501526,136,272,utRho23
nagA,1406350,1406350,1405502,848,4344,utRho23
nagB,1407416,1407416,1407222,194,116,utRho23
nagC,1404016,1404016,1403188,828,168,utRho23
nagE,1407680,1407888,1407680,208,700,utRho23
nagK,2357080,2357186,2357080,106,118,utRho23
nanA,6747240,6747240,6747152,88,982,utRho23
nanC,9079856,9079856,9079002,854,836,utRho23
nanR,6749406,6749406,6748978,428,2340,utRho23
nanS,9075406,9075406,9075188,218,216,utRho23
napF,4607390,4607390,4606994,396,260,utRho23
narG,2559614,2559728,2559614,114,1110,utRho23
narK,2555642,2555914,2555642,272,798,utRho23
narP,4580844,4581000,4580844,156,320,utRho23
narQ,5171154,5171462,5171154,308,470,utRho23
narU,3088326,3088326,3088120,206,1018,utRho23
narW,3077374,3077374,3074618,2756,3894,utRho23
narX,2555554,2555554,2555236,318,788,utRho23
narZ,3085380,3085380,3085180,200,12,utRho23
ndh,2331984,2332170,2331984,186,1094,utRho23
ndk,5289920,5289920,5289728,192,310,utRho23
nemR,6904084,6904092,6904084,8,2600,utRho23
nepI,7683542,7683542,7683478,64,252,utRho23
nfo,4501612,4501680,4501612,68,306,utRho23
nfsB,1210906,1210906,1210848,58,226,utRho23
nfuA,7090916,7091248,7090916,332,510,utRho23
nhaA,34634,34978,34634,344,1028,utRho23
nhaB,2469534,2469534,2469434,100,74,utRho23
nhoA,3067926,3068048,3067926,122,188,utRho23
nikA,7226878,7227334,7226878,456,5884,utRho23
nikR,7237074,7237176,7237074,102,384,utRho23
nirB,6987974,6988022,6987974,48,108,utRho23
nlpA,7680034,7680034,7679986,48,34,utRho23
nlpC,3585654,3585654,3585462,192,70,utRho23
nlpD,5737658,5737658,5737506,152,82,utRho23
nlpI,6618080,6618080,6617848,232,16,utRho23
nmpC,1153740,1153740,1153650,90,82,utRho23
nohA,3273206,3273206,3272734,472,1880,utRho23
norR,5664614,5664614,5664578,36,130,utRho23
norV,5664878,5664952,5664878,74,70,utRho23
nrdA,4689510,4689730,4689510,220,8642,utRho23
nrdD,8925676,8925676,8925320,356,3756,utRho23
nrdH,5601312,5601446,5601312,134,576,utRho23
nrdR,865954,866004,865954,50,148,utRho23
nrfA,8575342,8575528,8575342,186,32,utRho23
nsrR,8812088,8812380,8812088,292,6328,utRho23
nudB,3897348,3897348,3897264,84,0,utRho23
nudC,8393428,8393806,8393428,378,610,utRho23
nudE,7052658,7052658,7052298,360,2382,utRho23
nudG,3682876,3682980,3682876,104,98,utRho23
nudI,4729050,4729108,4729050,58,168,utRho23
nudJ,2388874,2388874,2388576,298,660,utRho23
nuoA,4810670,4810670,4810144,526,896,utRho23
nuoN,4783434,4783434,4783010,424,778,utRho23
nupC,5026018,5026084,5026018,66,0,utRho23
nupG,6211302,6211428,6211302,126,242,utRho23
ogrK,4335096,4335096,4335040,56,0,utRho23
ogt,2800568,2800568,2800472,96,250,utRho23
ohsC,5401036,5401040,5401036,4,18,utRho23
ompA,2040382,2040382,2040106,276,10288,utRho23
ompC,4625774,4625774,4625498,276,36,utRho23
ompF,1974184,1974184,1973964,220,42,utRho23
ompL,8128958,8128958,8128590,368,644,utRho23
ompN,2874158,2874158,2873786,372,48,utRho23
ompR,7073510,7073510,7073168,342,166,utRho23
ompT,1171330,1171330,1171266,64,178,utRho23
ompW,2627982,2628040,2627982,58,142,utRho23
ompX,1700418,1700900,1700418,482,846,utRho23
omrA,5952378,5952378,5952378,0,0,utRho23
omrB,5952770,5952770,5952770,0,0,utRho23
oppA,2602170,2602364,2602170,194,3618,utRho23
orn,8783168,8783208,8783168,40,434,utRho23
osmB,2686952,2686952,2686656,296,2034,utRho23
osmC,3113192,3113250,3113192,58,524,utRho23
osmE,3644566,3644566,3644512,54,224,utRho23
osmF,4439046,4439046,4438962,84,3062,utRho23
osmY,9222306,9222792,9222306,486,532,utRho23
otsA,3963302,3963302,3963224,78,832,utRho23
otsB,3964930,3964930,3964774,156,492,utRho23
oxc,4984288,4984288,4983900,388,2490,utRho23
oxyR,8316914,8316980,8316914,66,3220,utRho23
oxyS,8316788,8316788,8316788,0,0,utRho23
paaA,2907730,2907854,2907730,124,54,utRho23
paaX,2927018,2927078,2927018,60,0,utRho23
paaZ,2907340,2907340,2907284,56,8,utRho23
pabA,6981702,6981702,6981658,44,178,utRho23
pabB,3789256,3789610,3789256,354,1634,utRho23
pabC,2306186,2306600,2306186,414,538,utRho23
pagP,1313052,1313114,1313052,62,142,utRho23
panB,299260,299260,299202,58,8150,utRho23
panC,297840,297840,297590,250,322,utRho23
panD,293490,293490,293388,102,74,utRho23
panZ,7195656,7195968,7195656,312,452,utRho23
parC,6332060,6332060,6331946,114,506,utRho23
patA,6438916,6438988,6438916,72,214,utRho23
patD,3030830,3031156,3030830,326,442,utRho23
pbpC,5294986,5294986,5294650,336,182,utRho23
pbpG,4450132,4450132,4449740,392,50,utRho23
pck,7065358,7065636,7065358,278,4292,utRho23
pcnB,318782,318782,318252,530,626,utRho23
pdhR,244068,244184,244068,116,248,utRho23
pdxB,4875768,4875768,4875702,66,132,utRho23
pdxH,3436068,3436068,3436014,54,118,utRho23
pdxJ,5403626,5403626,5403458,168,126,utRho23
pdxK,5074638,5074638,5074474,164,46,utRho23
pepA,8972278,8972278,8971902,376,220,utRho23
pepD,511618,511618,511432,186,1368,utRho23
pepN,1981182,1981244,1981182,62,630,utRho23
pepQ,8062294,8062322,8062294,28,178,utRho23
pepT,2371646,2371688,2371646,42,272,utRho23
pfkA,8214948,8215104,8214948,156,694,utRho23
pfkB,3612646,3612740,3612646,94,282,utRho23
pflA,1902456,1902456,1902160,296,0,utRho23
pflB,1907850,1907850,1907108,742,1762,utRho23
pflD,8287716,8287990,8287716,274,36,utRho23
pgaA,2185046,2185046,2184578,468,810,utRho23
pgi,8467444,8467516,8467444,72,62,utRho23
pgk,12291428,12291428,12290488,940,4316,utRho23
pgl,1597078,1597172,1597078,94,64,utRho23
pgpB,2678324,2678660,2678324,336,686,utRho23
pgpC,5397276,5397276,5397100,176,452,utRho23
pgrR,2783744,2783982,2783744,238,988,utRho23
pheL,5475158,5475198,5475158,40,0,utRho23
pheM,7197204,7197204,7197080,124,0,utRho23
pheP,1203858,1203918,1203858,60,280,utRho23
pheU,8725254,8725254,8725252,2,64,utRho23
pheV,6220730,6220732,6220730,2,0,utRho23
phnC,8650412,8650412,8650330,82,490,utRho23
phoA,803414,803494,803414,80,178,utRho23
phoB,834202,834284,834202,82,44,utRho23
phoE,520316,520316,520200,116,2076,utRho23
phoH,2169730,2169984,2169730,254,828,utRho23
phoP,2381016,2381016,2380894,122,2536,utRho23
phoQ,2379880,2379880,2379552,328,1156,utRho23
phoU,7815330,7815330,7815156,174,254,utRho23
phr,1478842,1479014,1478842,172,480,utRho23
pinE,2419054,2419370,2419054,316,2202,utRho23
pinQ,3267168,3267244,3267168,76,490,utRho23
pinR,2867424,2867424,2867348,76,330,utRho23
pitA,7275224,7275284,7275224,60,72,utRho23
pitB,6272806,6272806,6272742,64,680,utRho23
pka,5439862,5439906,5439862,44,568,utRho23
plaP,4174476,4174476,4174124,352,44,utRho23
pldA,8009628,8009724,8009628,96,6076,utRho23
pldB,8018028,8018340,8018028,312,4092,utRho23
plsB,8513196,8513196,8512932,264,376,utRho23
pmbA,8915890,8915918,8915890,28,60,utRho23
pmrD,4747148,4747148,4747076,72,92,utRho23
pncB,1980828,1980828,1980712,116,16,utRho23
pncC,5648788,5648788,5648692,96,6,utRho23
pnp,6622652,6622652,6622336,316,46,utRho23
pntA,3355950,3355950,3355806,144,212,utRho23
pntB,3353096,3353096,3352720,376,422,utRho23
polA,8093880,8093932,8093880,52,520,utRho23
polB,131606,131606,131560,46,50,utRho23
potD,2365700,2365700,2365658,42,258,utRho23
potE,1436688,1436688,1436530,158,54,utRho23
potF,1787268,1787568,1787268,300,768,utRho23
poxB,1822152,1822152,1822098,54,722,utRho23
ppa,8899372,8899372,8899304,68,208,utRho23
ppc,8306380,8306380,8306196,184,2370,utRho23
ppdA,5928440,5928440,5928354,86,2978,utRho23
ppdD,235410,235410,235098,312,490,utRho23
pphA,3846770,3846770,3845938,832,3756,utRho23
pphB,5719474,5719520,5719474,46,162,utRho23
ppiA,6984898,6984898,6984594,304,118,utRho23
ppiC,7919682,7919682,7919626,56,72,utRho23
ppiD,923638,923830,923638,192,132,utRho23
ppk,5245748,5246088,5245748,340,778,utRho23
pppA,6228958,6228958,6228704,254,502,utRho23
ppsA,3574322,3574322,3574224,98,42,utRho23
ppsR,3574678,3574890,3574678,212,204,utRho23
pptA,3065716,3066104,3065716,388,1952,utRho23
pqiA,2023318,2024002,2023318,684,38,utRho23
prc,3830054,3830054,3829632,422,4014,utRho23
preT,4467978,4468066,4467978,88,2008,utRho23
prfC,9218688,9218828,9218688,140,858,utRho23
prkB,6968622,6968980,6968622,358,2324,utRho23
prlC,7290476,7290476,7290364,112,790,utRho23
prlF,6553944,6554004,6553944,60,1294,utRho23
proB,520432,520776,520432,344,1964,utRho23
proC,811372,811372,811288,84,54,utRho23
proK,7417388,7417388,7417384,4,6,utRho23
proL,4572414,4572422,4572414,8,12,utRho23
proP,8660640,8661004,8660640,364,920,utRho23
proS,437674,437674,437550,124,440,utRho23
proV,5609126,5609630,5609126,504,1952,utRho23
prpB,697292,697364,697292,72,140,utRho23
prpR,696942,696942,696886,56,76,utRho23
prs,2524354,2524354,2523750,604,15590,utRho23
psd,8781276,8781276,8780720,556,2482,utRho23
psiE,8480600,8480650,8480600,50,60,utRho23
pspA,2736076,2736158,2736076,82,0,utRho23
pspF,2736080,2736080,2735824,256,4,utRho23
pspG,8525632,8525680,8525632,48,6,utRho23
pssA,5445156,5445454,5445156,298,4548,utRho23
pstB,7817112,7817112,7816732,380,88,utRho23
pstC,7821084,7821084,7820796,288,132,utRho23
pstS,23469408,23469408,23469150,258,384,utRho23
psuG,4517114,4517114,4516734,380,6526,utRho23
psuT,4514992,4514992,4514670,322,150,utRho23
pth,2517084,2517084,2517026,58,0,utRho23
ptrA,5918022,5918022,5917768,254,80,utRho23
ptrB,3857730,3857730,3857678,52,3804,utRho23
ptsG,2315252,2315738,2315252,486,1166,utRho23
ptsH,5066996,5067528,5066996,532,1260,utRho23
purA,8809328,8809374,8809328,46,40,utRho23
purC,5195562,5195562,5195236,326,250,utRho23
purD,8411972,8411972,8411862,110,142,utRho23
purE,1106284,1106284,1106200,84,752,utRho23
purH,8415254,8415254,8415064,190,0,utRho23
purL,5391178,5391178,5391086,92,134,utRho23
purM,5242306,5242394,5242306,88,168,utRho23
purR,3475378,3475688,3475378,310,412,utRho23
purT,3861438,3861762,3861438,324,718,utRho23
purU,2577512,2577512,2577248,264,390,utRho23
putA,2157850,2157850,2157764,86,124,utRho23
putP,2158336,2158610,2158336,274,526,utRho23
puuA,2721936,2721936,2721816,120,38,utRho23
puuC,2725456,2725486,2725456,30,0,utRho23
puuD,2722104,2722240,2722104,136,38,utRho23
puuP,2718746,2718746,2718374,372,1484,utRho23
pykA,3874988,3875298,3874988,310,234,utRho23
pykF,3510934,3511396,3510934,462,2834,utRho23
pyrC,2245286,2245286,2245214,72,50,utRho23
pyrD,2009464,2009536,2009464,72,478,utRho23
pyrE,7631970,7631970,7631536,434,710,utRho23
pyrF,2683740,2683842,2683740,102,106,utRho23
pyrG,5819594,5819594,5819332,262,1130,utRho23
pyrH,383624,383710,383624,86,306,utRho23
pyrL,8945490,8945490,8945066,424,876,utRho23
qmcA,1031646,1031646,1031546,100,1018,utRho23
qor,8528608,8528608,8528462,146,220,utRho23
qseB,6339502,6339656,6339502,154,1320,utRho23
queA,849970,850022,849970,52,244,utRho23
queE,5811212,5811212,5810836,376,138,utRho23
queF,5850642,5850696,5850642,54,66,utRho23
queG,8788184,8788184,8788134,50,47056,utRho23
racC,2835630,2835630,2835526,104,58,utRho23
racR,2840898,2840898,2840482,416,586,utRho23
raiA,5474208,5474308,5474208,100,42,utRho23
rarD,8008594,8008594,8008356,238,1190,utRho23
ravA,7862256,7862256,7862186,70,106,utRho23
rayT,495088,495274,495088,186,742,utRho23
rbn,4763162,4763216,4763162,54,40,utRho23
rbsD,7866644,7866702,7866644,58,20,utRho23
rcnA,4371654,4371834,4371654,180,552,utRho23
rcnB,4373768,4373920,4373768,152,92,utRho23
rcnR,4371806,4371806,4371592,214,738,utRho23
rcsA,4047672,4047936,4047672,264,6838,utRho23
rcsB,4631390,4632354,4631390,964,1346,utRho23
rcsC,4640162,4640162,4639656,506,134,utRho23
rcsD,4626904,4626976,4626904,72,410,utRho23
rdgB,6193240,6193362,6193240,122,658,utRho23
rdlA,2538646,2538646,2538646,0,0,utRho23
rdlB,2539712,2539716,2539712,4,0,utRho23
rdlC,2540782,2540786,2540782,4,4,utRho23
rdlD,7400272,7400272,7400272,0,0,utRho23
rdoA,8084782,8084830,8084782,48,62,utRho23
recA,11295276,11295276,11295076,200,296,utRho23
recC,5925014,5925014,5924856,158,58,utRho23
recF,7763722,7763722,7762442,1280,3000,utRho23
recN,5503518,5503590,5503518,72,0,utRho23
recQ,8011666,8011728,8011666,62,154,utRho23
relA,5828554,5828554,5827302,1252,892,utRho23
relB,3291806,3291806,3291744,62,32,utRho23
rem,3289950,3289950,3289804,146,280,utRho23
rep,7921294,7921354,7921294,60,394,utRho23
rfaD,7587730,7587974,7587730,244,1030,utRho23
rfaE,6393852,6393852,6393506,346,152,utRho23
rfaH,8049930,8049930,8049642,288,1822,utRho23
rfbX,4219436,4219436,4219168,268,594,utRho23
rfe,7935600,7935832,7935600,232,62,utRho23
rhaB,8194944,8194944,8194896,48,28,utRho23
rhaD,8188770,8188770,8188544,226,80,utRho23
rhaS,8195422,8195472,8195422,50,276,utRho23
rhaT,8201132,8201132,8201050,82,232,utRho23
rhlE,1661566,1661744,1661566,178,586,utRho23
rhoL,47593944,47594772,47593944,828,79704,utRho23
rhsB,7238006,7238384,7238006,378,1662,utRho23
rhsC,1458758,1459166,1458758,408,2,utRho23
rhsD,1046132,1046522,1046132,390,54,utRho23
rhtA,1700608,1700608,1700194,414,848,utRho23
rhtC,8015478,8015514,8015478,36,1542,utRho23
ribA,2678468,2678468,2678320,148,416,utRho23
ribC,3486916,3486916,3486484,432,7752,utRho23
ribE,869008,869294,869008,286,2242,utRho23
ribF,42766,42814,42766,48,158,utRho23
ridA,8941892,8941892,8941826,66,150,utRho23
rihA,1369204,1369204,1368824,380,6664,utRho23
rihB,4510504,4510504,4510372,132,420,utRho23
rimJ,2251044,2251124,2251044,80,354,utRho23
rimK,1783752,1783934,1783752,182,444,utRho23
rimL,2997486,2997876,2997486,390,138,utRho23
rimO,1756140,1756140,1756070,70,274,utRho23
rimP,6636350,6636350,6636012,338,266,utRho23
rlmA,3814172,3814172,3814120,52,414,utRho23
rlmD,5830086,5830086,5830000,86,126,utRho23
rlmE,6655520,6655520,6655328,192,618,utRho23
rlmF,1684384,1684664,1684384,280,376,utRho23
rlmG,6471784,6471784,6471750,34,94,utRho23
rlmI,2060002,2060002,2059938,64,162,utRho23
rlmJ,7290700,7290770,7290700,70,32,utRho23
rlmL,2015344,2015688,2015344,344,2230,utRho23
rlpA,1330444,1330444,1330380,64,422,utRho23
rluA,120900,120900,120692,208,418,utRho23
rluF,8460324,8460708,8460324,384,162,utRho23
rmf,2031006,2031430,2031006,424,270,utRho23
rna,1290068,1290068,1290006,62,4,utRho23
rnb,2698258,2698258,2697824,434,4716,utRho23
rnc,10816892,10816892,10816252,640,7948,utRho23
rnd,3776122,3776122,3775982,140,46,utRho23
rne,2289746,2289746,2288734,1012,5230,utRho23
rnhA,472082,472082,472004,78,1336,utRho23
rnk,1288360,1288360,1287934,426,0,utRho23
rnlA,5531788,5531836,5531788,48,2292,utRho23
rnlB,5533414,5533968,5533414,554,1868,utRho23
rnpB,19623552,19623552,19623552,0,0,utRho23
rob,9270706,9270706,9270620,86,134,utRho23
rodZ,5285868,5285868,5285688,180,140,utRho23
rpe,7030306,7030306,7030118,188,40,utRho23
rph,15266320,15266320,15266196,124,448,utRho23
rpiA,6118706,6118706,6118650,56,1966,utRho23
rpiB,8626514,8626700,8626514,186,572,utRho23
rpiR,8626274,8626274,8625982,292,102,utRho23
rplJ,8359246,8359992,8359246,746,2220,utRho23
rplK,8356708,8356894,8356708,186,22,utRho23
rplM,6757344,6757344,6757302,42,558,utRho23
rplN,6896444,6896444,6896298,146,282,utRho23
rplS,5489284,5489284,5489060,224,2198,utRho23
rplT,7199052,7199052,7198996,56,76,utRho23
rplU,6667036,6667036,6666902,134,194,utRho23
rplY,4564866,4565034,4564866,168,144,utRho23
rpmA,6666450,6666450,6666238,212,78,utRho23
rpmB,15247980,15247980,15246696,1284,18196,utRho23
rpmE,8253816,8254026,8253816,210,286,utRho23
rpmF,2294676,2294734,2294676,58,3248,utRho23
rpmH,7768130,7768672,7768130,542,1158,utRho23
rpmI,3600854,3600854,3599998,856,1856,utRho23
rpoB,8362126,8362490,8362126,364,326,utRho23
rpoD,6424946,6426094,6424946,1148,18722,utRho23
rpoE,5420372,5420372,5420024,348,52,utRho23
rpoH,7202006,7202006,7201566,440,6484,utRho23
rpoN,6689324,6689434,6689324,110,128,utRho23
rpoS,5736236,5736236,5735102,1134,2784,utRho23
rpoZ,7644154,7644212,7644154,58,466,utRho23
rppH,5937986,5937986,5937954,32,234,utRho23
rprA,3540744,3540744,3540744,0,0,utRho23
rpsA,1923434,1923990,1923434,556,15274,utRho23
rpsF,8850050,8850236,8850050,186,2356,utRho23
rpsI,6756580,6756580,6756414,166,828,utRho23
rpsJ,6906884,6906884,6906540,344,1176,utRho23
rpsL,6949242,6949242,6949104,138,796,utRho23
rpsM,6885130,6885130,6884942,188,222,utRho23
rpsO,13247144,13247144,13246736,408,672,utRho23
rpsP,5492508,5492508,5492370,138,46,utRho23
rpsT,42420,42420,42156,264,80,utRho23
rpsU,12842584,12843124,12842584,540,1384,utRho23
rraA,8238716,8238716,8238660,56,222,utRho23
rraB,8956768,8956946,8956768,178,762,utRho23
rrsA,8070478,8071062,8070478,584,2772,utRho23
rrsB,16665468,16666636,16665468,1168,5856,utRho23
rrsC,7883032,7883616,7883032,584,2098,utRho23
rrsD,6858094,6858094,6857524,570,418,utRho23
rrsE,8415726,8416294,8415726,568,160,utRho23
rrsG,5462896,5462896,5462314,582,2966,utRho23
rrsH,446970,447542,446970,572,150,utRho23
rsd,8393908,8393908,8393616,292,1140,utRho23
rseA,5419264,5419264,5418808,456,342,utRho23
rseP,392940,393092,392940,152,26,utRho23
rseX,4067298,4067298,4067298,0,0,utRho23
rsfS,1338144,1338144,1338072,72,304,utRho23
rsgA,8783132,8783132,8783018,114,138,utRho23
rsmA,105176,105176,104860,316,1694,utRho23
rsmB,6869982,6870414,6869982,432,126,utRho23
rsmC,9215736,9215736,9215400,336,284,utRho23
rsmD,7208594,7208786,7208594,192,148,utRho23
rsmE,6182036,6182268,6182036,232,1212,utRho23
rsmG,7847512,7847512,7847360,152,2360,utRho23
rsmH,180020,180188,180020,168,64,utRho23
rsmI,6587106,6587106,6586670,436,2722,utRho23
rssA,2578212,2578412,2578212,200,1158,utRho23
rssB,2580440,2580484,2580440,44,420,utRho23
rstA,3364276,3364300,3364276,24,14,utRho23
rsuA,4561096,4561096,4560966,130,56,utRho23
rsxA,3411510,3411534,3411510,24,34,utRho23
rtcA,7114004,7114004,7113698,306,3368,utRho23
rtcB,7116214,7116214,7116158,56,142,utRho23
rtn,4541356,4541452,4541356,96,90,utRho23
rutA,2148052,2148052,2148022,30,324,utRho23
rutG,2140090,2140090,2139678,412,688,utRho23
rutR,2148226,2148484,2148226,258,1474,utRho23
ruvA,7784096,7784096,7783904,192,68,utRho23
ruvB,7782176,7782176,7781424,752,844,utRho23
ruvC,3894878,3894878,3894752,126,102,utRho23
rybB,1776114,1776114,1776114,0,0,utRho23
rydB,3529860,3529860,3529322,538,668,utRho23
rydC,2983012,2983012,2983012,0,0,utRho23
ryfA,5307398,5307710,5307398,312,46,utRho23
ryfD,5468590,5468590,5468590,0,0,utRho23
ryhB,7162032,7162032,7162032,0,0,utRho23
ryjA,8556132,8556132,8556132,0,0,utRho23
ryjB,9055954,9055954,9055954,0,0,utRho23
sad,3229598,3229598,3229406,192,388,utRho23
safA,3168056,3168056,3167918,138,1532,utRho23
sanA,4465368,4465756,4465368,388,314,utRho23
sapF,2705314,2705314,2705268,46,202,utRho23
sbcB,4165456,4165512,4165456,56,54,utRho23
sbcC,831694,831694,831506,188,356,utRho23
sbcD,833954,833954,833904,50,62,utRho23
sbmA,793106,793278,793106,172,4462,utRho23
sbmC,4162650,4162650,4162524,126,80,utRho23
sdaA,3793618,3793864,3793618,246,468,utRho23
sdaC,5856070,5856458,5856070,388,456,utRho23
sdhC,1509916,1510354,1509916,438,23510,utRho23
sdhD,1510808,1511120,1510808,312,9980,utRho23
sdiA,3993834,3993834,3993664,170,124,utRho23
secE,8354354,8354716,8354354,362,118,utRho23
secG,6645180,6645180,6645010,170,292,utRho23
selA,7522594,7522594,7522498,96,866,utRho23
selB,7519850,7519850,7519722,128,490,utRho23
selC,7672396,7672444,7672396,48,32,utRho23
selD,3696058,3696058,3696016,42,3498,utRho23
seqA,1425884,1425974,1425884,90,60,utRho23
serA,6117098,6117098,6116820,278,492,utRho23
serB,9249712,9249790,9249712,78,442,utRho23
serC,3830380,3830612,3830380,232,0,utRho23
serS,1878730,1878856,1878730,126,828,utRho23
serT,2063438,2063438,2063424,14,42,utRho23
serU,4087124,4087124,4087114,10,60,utRho23
serV,5637394,5637394,5637290,104,190,utRho23
serW,1852014,1852014,1851942,72,124,utRho23
serX,2195352,2195352,2195304,48,56,utRho23
setB,4527426,4527726,4527426,300,0,utRho23
setC,7673488,7673906,7673488,418,2954,utRho23
sfmA,1116124,1116424,1116124,300,392,utRho23
sfmC,1117606,1117948,1117606,342,350,utRho23
sfsA,323030,323030,322972,58,480,utRho23
sfsB,6669592,6669818,6669592,226,688,utRho23
sgrR,154676,154676,154598,78,278,utRho23
sgrS,154734,154734,154734,0,0,utRho23
shiA,4107068,4107286,4107068,218,522,utRho23
sibA,4306622,4306622,4306622,0,0,utRho23
sibB,4307292,4307292,4307292,0,0,utRho23
sibC,6113702,6113702,6113702,0,0,utRho23
sibD,6389730,6389730,6389730,0,0,utRho23
sibE,6390480,6390480,6390480,0,0,utRho23
sixA,4913998,4913998,4913624,374,54,utRho23
slp,7307872,7307922,7307872,50,34,utRho23
slt,9261400,9261466,9261400,66,136,utRho23
slyA,3442028,3442028,3441648,380,246,utRho23
slyB,3439496,3439752,3439496,256,54,utRho23
slyD,6957398,6957398,6956994,404,872,utRho23
slyX,6954862,6955280,6954862,418,1840,utRho23
smf,6867372,6867372,6867120,252,672,utRho23
smpB,5509534,5509792,5509534,258,1004,utRho23
smrA,2811872,2811958,2811872,86,842,utRho23
smrB,4896872,4897212,4896872,340,2188,utRho23
smtA,1946808,1947074,1946808,266,244,utRho23
sodA,8201518,8201620,8201518,102,1574,utRho23
sodB,3470646,3470756,3470646,110,378,utRho23
sodC,3449358,3449358,3449310,48,198,utRho23
sohB,2658568,2658664,2658568,96,1170,utRho23
sokB,2984232,2984238,2984232,6,108,utRho23
solA,2241218,2241218,2241172,46,16,utRho23
soxR,8554894,8554938,8554894,44,42,utRho23
soxS,8554846,8554846,8554766,80,66,utRho23
speA,6172096,6172096,6171822,274,180,utRho23
speB,6167892,6167892,6167594,298,30,utRho23
speC,6218350,6218350,6218310,40,6,utRho23
spf,8099798,8099798,8099798,0,0,utRho23
sppA,3697422,3697674,3697422,252,3512,utRho23
spy,3651376,3651376,3651250,126,112,utRho23
sra,3112092,3112092,3111926,166,52,utRho23
sraB,2293178,2293178,2293178,0,0,utRho23
sraC,3846132,3846132,3846132,0,0,utRho23
srlA,5651582,5651664,5651582,82,66,utRho23
srlR,5657720,5658094,5657720,374,12520,utRho23
srmB,5425752,5425792,5425752,40,424,utRho23
sroA,151216,151216,151216,0,0,utRho23
sroG,6369436,6369436,6369436,0,0,utRho23
sroH,8380974,8380974,8380974,0,0,utRho23
ssb,8548022,8548250,8548022,228,290,utRho23
sseA,5304782,5304988,5304782,206,3868,utRho23
sspA,6755138,6755138,6754840,298,16,utRho23
ssrA,5511014,5511186,5511014,172,154,utRho23
ssrS,12223036,12223932,12223036,896,1196,utRho23
sstT,6479726,6479888,6479726,162,230,utRho23
ssuB,1988282,1988282,1988088,194,538,utRho23
ssuE,1995126,1995126,1995024,102,62,utRho23
sthA,8321604,8321604,8321580,24,2818,utRho23
stpA,5597156,5597156,5596990,166,78,utRho23
sucA,3034344,3034824,3034344,480,2200,utRho23
sufA,3528836,3528836,3528772,64,12,utRho23
sufE,3518962,3518962,3518580,382,240,utRho23
sugE,8753588,8753750,8753588,162,1392,utRho23
sulA,2041894,2041894,2041838,56,2950,utRho23
syd,5850738,5850738,5850560,178,142,utRho23
symE,9159834,9159834,9159680,154,988,utRho23
symR,9159670,9159670,9159670,0,0,utRho23
tabA,8949566,8949724,8949566,158,50,utRho23
talA,5157140,5157332,5157140,192,278,utRho23
talB,16382,16476,16382,94,7176,utRho23
tam,3214442,3214692,3214442,250,760,utRho23
tamA,8884540,8884764,8884540,224,1752,utRho23
tar,3945432,3945432,3945382,50,4,utRho23
tas,5943138,5943194,5943138,56,3864,utRho23
tatA,16087636,16087780,16087636,144,308,utRho23
tatE,1317742,1317894,1317742,152,184,utRho23
tauA,770410,770464,770410,54,276,utRho23
tdcA,6534186,6534186,6534130,56,10,utRho23
tdcG,6519652,6519652,6519298,354,1798,utRho23
tdcR,6534380,6534760,6534380,380,208,utRho23
tdk,2586986,2587054,2586986,68,154,utRho23
tehA,3001072,3001146,3001072,74,2,utRho23
tesA,1039898,1039898,1039530,368,1164,utRho23
tesB,950402,950402,950322,80,154,utRho23
tfaE,2418532,2418532,2418238,294,1952,utRho23
tfaQ,3269912,3269912,3269770,142,650,utRho23
tff,379424,379256,379424,168,62,utRho23
tgt,852110,852274,852110,164,158,utRho23
thiD,4369346,4369346,4369032,314,244,utRho23
thiI,882936,883098,882936,162,136,utRho23
thiM,4370902,4370902,4370602,300,1006,utRho23
thiQ,146170,146170,145854,316,9104,utRho23
thrL,592,760,592,168,396,utRho23
thrS,7210932,7210932,7210280,652,260,utRho23
thrU,8350762,8350776,8350762,14,0,utRho23
thrV,6847414,6847414,6847310,104,132392,utRho23
thrW,525682,525742,525682,60,7574,utRho23
thyA,5930696,5930696,5930310,386,2684,utRho23
tig,909986,910266,909986,280,200,utRho23
tisB,7706674,7707106,7706674,432,454,utRho23
tktA,6163414,6163414,6163270,144,146,utRho23
tktB,5158616,5159272,5158616,656,7138,utRho23
tldD,6784368,6784368,6784056,312,0,utRho23
tmcA,5191876,5191876,5191718,158,1660,utRho23
tnaC,15553644,15553740,15553644,96,5160,utRho23
tolB,1555074,1555480,1555074,406,600,utRho23
tolC,6356008,6356230,6356008,222,212,utRho23
tomB,961588,961588,961416,172,1350,utRho23
tonB,2622108,2622178,2622108,70,60,utRho23
topA,2661578,2662096,2661578,518,118,utRho23
torC,2116112,2116168,2116112,56,726,utRho23
torR,2115968,2115968,2115908,60,738,utRho23
torS,2112364,2112364,2112356,8,88,utRho23
torT,2112414,2112522,2112414,108,40,utRho23
tpiA,8223138,8223138,8223014,124,106,utRho23
tppB,3425342,3425538,3425342,196,2260,utRho23
tpr,2574376,2574376,2574376,0,0,utRho23
tpx,2777688,2777688,2777622,66,720,utRho23
tqsA,3347780,3347826,3347780,46,98,utRho23
treA,2494850,2494850,2494752,98,636,utRho23
treB,8932420,8932420,8932360,60,134,utRho23
treF,7339102,7339184,7339102,82,334,utRho23
treR,8934694,8934694,8934492,202,48,utRho23
trg,2984878,2984940,2984878,62,172,utRho23
trkG,2847342,2847564,2847342,222,1348,utRho23
trmA,8326590,8326590,8326540,50,230,utRho23
trpA,2634678,2634678,2634444,234,338,utRho23
trpC,2639888,2639888,2639570,318,28,utRho23
trpL,5292432,5292432,5292328,104,12,utRho23
trpR,9265408,9265520,9265408,112,432,utRho23
trpS,7027394,7027394,7027276,118,1924,utRho23
trpT,7893560,7893914,7893560,354,59294,utRho23
trxA,7931294,7931522,7931294,228,506,utRho23
trxB,1864156,1864156,1864100,56,136,utRho23
trxC,5437350,5437470,5437350,120,764,utRho23
tsaD,6421256,6421256,6421086,170,530,utRho23
tsgA,6985038,6985136,6985038,98,466,utRho23
tsr,9182824,9183314,9182824,490,5402,utRho23
tsx,864490,864490,864026,464,1456,utRho23
ttcA,2823970,2823970,2823896,74,3138,utRho23
ttdA,6412848,6412926,6412848,78,246,utRho23
ttdR,6412760,6412760,6412512,248,114,utRho23
tufA,6943448,6943448,6942658,790,32780,utRho23
tus,3368346,3368518,3368346,172,128,utRho23
tusA,7218040,7218040,7217992,48,322,utRho23
tusB,6950218,6950218,6949930,288,878,utRho23
tynA,2902996,2902996,2902698,298,18,utRho23
typA,8116460,8116814,8116460,354,2972,utRho23
tyrB,8534164,8534228,8534164,64,1522,utRho23
tyrP,3979004,3979362,3979004,358,640,utRho23
tyrR,2773384,2773440,2773384,56,64,utRho23
tyrS,3434566,3434566,3434444,122,60,utRho23
tyrT,2575330,2575330,2575244,86,42,utRho23
uacT,6062378,6062734,6062378,356,3824,utRho23
ubiC,8504886,8505012,8504886,126,158,utRho23
ubiD,8049618,8049976,8049618,358,1900,utRho23
ubiE,8037494,8037710,8037494,216,434,utRho23
ubiG,4679078,4679134,4679078,56,72,utRho23
ucpA,5089342,5089342,5089246,96,30,utRho23
udp,8032782,8032862,8032782,80,384,utRho23
ugd,4199470,4199470,4199226,244,42,utRho23
ugpB,7184852,7184852,7184650,202,4266,utRho23
ugpQ,7176600,7176600,7176226,374,340,utRho23
uhpT,7694396,7694396,7694334,62,94,utRho23
uidA,3392304,3392304,3392142,162,148,utRho23
uidC,3386012,3386012,3385702,310,84,utRho23
uidR,3394150,3394150,3394104,46,164,utRho23
ulaA,8839854,8839960,8839854,106,434,utRho23
ulaG,8839350,8839350,8839250,100,310,utRho23
ulaR,8837124,8837124,8836906,218,150,utRho23
umpG,5741372,5741372,5740548,824,64,utRho23
umpH,1400704,1400704,1400652,52,118,utRho23
umuD,2461476,2461534,2461476,58,52,utRho23
ung,5433476,5433508,5433476,32,412,utRho23
uof,2843316,2843316,2842900,416,2144,utRho23
upp,5241818,5241818,5241744,74,48,utRho23
usg,4873780,4873780,4873298,482,372,utRho23
ushA,1009772,1009828,1009772,56,272,utRho23
uspA,7279966,7280222,7279966,256,802,utRho23
uspB,7279696,7279696,7279440,256,568,utRho23
uspC,3959172,3959506,3959172,334,158,utRho23
uspE,2797318,2797318,2797244,74,152,utRho23
uspF,2871282,2871282,2871238,44,230,utRho23
uspG,1283806,1283806,1283734,72,3024,utRho23
uvrA,8547872,8547872,8547742,130,570,utRho23
uvrB,1626304,1627052,1626304,748,1148,utRho23
uvrC,3989758,3989758,3989412,346,218,utRho23
uvrD,7995814,7995966,7995814,152,882,utRho23
uvrY,3990812,3990812,3990718,94,362,utRho23
uxaB,3221474,3221474,3221360,114,12,utRho23
uxaC,6489714,6489714,6489482,232,222,utRho23
uxuA,9103036,9103272,9103036,236,3892,utRho23
uxuR,9108916,9109152,9108916,236,412,utRho23
valS,8967854,8967854,8967674,180,310,utRho23
valU,5041848,5041862,5041848,14,76,utRho23
valV,3492830,3492870,3492830,40,502,utRho23
ves,3649968,3649968,3649874,94,250,utRho23
waaA,7616512,7617080,7616512,568,1852,utRho23
waaH,7580298,7580298,7580162,136,252,utRho23
waaQ,7616476,7616476,7616196,280,1146,utRho23
waaU,7598996,7598996,7598624,372,130,utRho23
waaY,7602272,7602272,7601930,342,10076,utRho23
wbbH,4214888,4214888,4214452,436,2500,utRho23
wbbK,4209212,4209212,4209018,194,136,utRho23
wcaM,4231868,4231868,4231792,76,50,utRho23
wrbA,2135516,2135516,2135416,100,136,utRho23
wza,4275166,4275166,4274486,680,478,utRho23
wzxC,4240674,4240674,4240316,358,38,utRho23
wzzB,4196950,4196950,4196602,348,186,utRho23
xanP,7657642,7657890,7657642,248,340,utRho23
xanQ,6048520,6048702,6048520,182,176,utRho23
xapA,5049820,5049820,5049756,64,10,utRho23
xapR,10090252,10090252,10089908,344,180,utRho23
xdhA,6000514,6000690,6000514,176,4078,utRho23
xerD,6079702,6079702,6079486,216,608,utRho23
xseA,5268394,5268464,5268394,70,718,utRho23
xseB,882746,882746,882686,60,142,utRho23
xthA,3664798,3664856,3664798,58,0,utRho23
xylA,7461614,7461614,7461530,84,16308,utRho23
xylE,8484540,8484540,8484508,32,0,utRho23
xylF,7462138,7462262,7462138,124,1504,utRho23
xylR,7469812,7469958,7469812,146,156,utRho23
yaaA,13230,13230,12918,312,108,utRho23
yaaI,23876,23876,23572,304,2504,utRho23
yaaJ,16034,16034,15918,116,336,utRho23
yaaU,91184,91614,91184,430,1702,utRho23
yaaW,23084,23084,22712,372,872,utRho23
yaaX,10060,10468,10060,408,324,utRho23
yabI,142542,142702,142542,160,420,utRho23
yacC,273880,273880,273834,46,1588,utRho23
yacH,262932,262932,262520,412,272,utRho23
yacL,268678,268776,268678,98,698,utRho23
yadD,293796,293936,293796,140,298,utRho23
yadE,289930,290162,289930,232,318,utRho23
yadN,314110,314110,313766,344,296,utRho23
yadS,355572,355572,355248,324,9508,utRho23
yadV,312470,312470,312402,68,388,utRho23
yaeF,434270,434270,434006,264,136,utRho23
yaeP,428374,428374,428250,124,1064,utRho23
yaeQ,428176,428582,428176,406,1720,utRho23
yaeR,423716,423754,423716,38,40,utRho23
yafC,462166,462166,461762,404,234,utRho23
yafD,462128,462244,462128,116,136,utRho23
yafK,491986,491986,491610,376,2400,utRho23
yafL,493282,493424,493282,142,246,utRho23
yafN,503938,504010,503938,72,104,utRho23
yafS,469568,469632,469568,64,638,utRho23
yafT,474470,474670,474470,200,260,utRho23
yafV,480432,480432,480378,54,46,utRho23
yafZ,536052,536052,536010,42,340,utRho23
yagE,564446,564556,564446,110,2964,utRho23
yagG,570414,570790,570414,376,4036,utRho23
yagI,578384,578384,578324,60,570,utRho23
yagK,586236,586236,585896,340,22126,utRho23
yagL,588062,588062,587836,226,4100,utRho23
yagN,591342,591342,591158,184,1720,utRho23
yahA,663746,664742,663746,996,8490,utRho23
yahC,670136,670136,670044,92,5812,utRho23
yahE,671478,671850,671478,372,506,utRho23
yahM,690504,690808,690504,304,248,utRho23
yahN,692872,692872,692674,198,3430,utRho23
yahO,692864,692968,692864,104,436,utRho23
yaiE,816296,816354,816296,58,260,utRho23
yaiI,811396,811528,811396,132,58,utRho23
yaiO,761946,761946,761684,262,706,utRho23
yaiP,767970,767970,767870,100,206,utRho23
yaiS,769660,769660,769232,428,1078,utRho23
yaiV,788922,788922,788922,0,0,utRho23
yaiY,799094,799094,798666,428,746,utRho23
yaiZ,798888,799186,798888,298,680,utRho23
yajC,854410,854574,854410,164,534,utRho23
yajD,860938,861210,860938,272,598,utRho23
yajI,866068,866068,865702,366,446,utRho23
yajL,887496,887496,887282,214,450,utRho23
yajQ,889316,889366,889316,50,202,utRho23
yajR,893374,893374,893332,42,88,utRho23
ybaB,987418,988152,987418,734,1142,utRho23
ybaL,1006590,1006590,1006476,114,574,utRho23
ybaM,980648,980648,980542,106,3748,utRho23
ybaN,981436,981764,981436,328,1374,utRho23
ybaO,936704,936766,936704,62,50,utRho23
ybaP,1016568,1016568,1016160,408,1548,utRho23
ybaQ,1016348,1016436,1016348,88,310,utRho23
ybaS,1023146,1023282,1023146,136,1438,utRho23
ybaV,927504,927874,927504,370,148,utRho23
ybaY,950490,950758,950490,268,1248,utRho23
ybbB,1062724,1062724,1062452,272,204,utRho23
ybbJ,1030154,1030154,1029718,436,3220,utRho23
ybbL,1031784,1031838,1031784,54,224,utRho23
ybbN,1037136,1037136,1036558,578,2010,utRho23
ybbO,1038658,1038658,1038298,360,716,utRho23
ybbY,1080718,1081130,1080718,412,2868,utRho23
ybcH,1176140,1176140,1175962,178,942,utRho23
ybcI,1113264,1113264,1113106,158,2236,utRho23
ybcJ,1114050,1114050,1113746,304,266,utRho23
ybcK,1137502,1137804,1137502,302,342,utRho23
ybcL,1141690,1141786,1141690,96,8,utRho23
ybcN,1144628,1144932,1144628,304,212,utRho23
ybcQ,1147548,1147912,1147548,364,5864,utRho23
ybcW,1159610,1159760,1159610,150,280,utRho23
ybdD,1263982,1264364,1263982,382,2182,utRho23
ybdF,1212106,1212106,1211772,334,348,utRho23
ybdH,1267048,1267048,1266954,94,106,utRho23
ybdJ,1212822,1212822,1212398,424,434,utRho23
ybdK,1215122,1215122,1214766,356,4174,utRho23
ybdL,1267114,1267172,1267114,58,298,utRho23
ybdM,1271110,1271110,1270752,358,5186,utRho23
ybdN,1273372,1273372,1273138,234,192,utRho23
ybdR,1283844,1284176,1283844,332,3620,utRho23
ybeD,1325412,1325412,1325284,128,146,utRho23
ybeF,1323090,1323090,1322756,334,1980,utRho23
ybeL,1349986,1350036,1349986,50,1606,utRho23
ybeQ,1353412,1353412,1353094,318,258,utRho23
ybeR,1353120,1353422,1353120,302,258,utRho23
ybeT,1358832,1358832,1358812,20,48,utRho23
ybeU,1358924,1359016,1358924,92,42,utRho23
ybeZ,1386938,1386938,1386834,104,2114,utRho23
ybfA,1458074,1458268,1458074,194,644,utRho23
ybfE,1423878,1423878,1423796,82,312,utRho23
ybfF,1425692,1425692,1425604,88,154,utRho23
ybfH,1433282,1433282,1433194,88,82,utRho23
ybgA,1477840,1478002,1477840,162,698,utRho23
ybgC,1549288,1549504,1549288,216,112,utRho23
ybgD,1505916,1505916,1505590,326,16824,utRho23
ybgI,1485238,1485654,1485238,416,112,utRho23
ybgO,1498370,1498370,1497964,406,486,utRho23
ybgS,1570992,1570992,1570634,358,146,utRho23
ybhA,1597184,1597184,1596862,322,130,utRho23
ybhB,1616070,1616070,1615818,252,628,utRho23
ybhC,1614642,1614642,1614562,80,838,utRho23
ybhD,1601418,1601418,1601276,142,138,utRho23
ybhH,1601104,1601518,1601104,414,214,utRho23
ybhK,1633384,1633384,1633294,90,472,utRho23
ybhM,1641556,1641586,1641556,30,74,utRho23
ybhN,1645296,1645296,1644996,300,638,utRho23
ybhQ,1649202,1649260,1649202,58,2296,utRho23
ybiA,1665920,1665920,1665900,20,26,utRho23
ybiI,1676968,1676968,1676912,56,942,utRho23
ybiO,1691328,1691328,1690960,368,1050,utRho23
ybiP,1705252,1705252,1705194,58,298,utRho23
ybiS,1711572,1711572,1711488,84,2,utRho23
ybiT,1711894,1711926,1711894,32,0,utRho23
ybiU,1718212,1718212,1718122,90,238,utRho23
ybiV,1720176,1720176,1720056,120,0,utRho23
ybiW,1725566,1725566,1725212,354,10288,utRho23
ybiX,1678548,1678548,1678414,134,176,utRho23
ybjC,1781784,1781826,1781784,42,0,utRho23
ybjE,1830154,1830154,1829714,440,806,utRho23
ybjG,1767016,1767016,1766776,240,1042,utRho23
ybjL,1779882,1779882,1779638,244,146,utRho23
ybjM,1779770,1780178,1779770,408,770,utRho23
ybjO,1795704,1795978,1795704,274,42,utRho23
ybjP,1809046,1809046,1808934,112,96,utRho23
ybjQ,1809034,1809186,1809034,152,154,utRho23
ybjS,1813796,1813796,1813506,290,398,utRho23
ybjX,1838206,1838206,1838168,38,58,utRho23
ycaD,1891438,1891742,1891438,304,136,utRho23
ycaI,1928210,1928640,1928210,430,100,utRho23
ycaK,1899094,1899336,1899094,242,470,utRho23
ycaL,1920264,1920528,1920264,264,0,utRho23
ycaM,1894240,1894458,1894240,218,254,utRho23
ycaR,1941284,1941346,1941284,62,2236,utRho23
ycbB,1961862,1962094,1961862,232,916,utRho23
ycbJ,1943344,1943504,1943344,160,150,utRho23
ycbK,1966046,1966150,1966046,104,116,utRho23
ycbZ,2036920,2036920,2036598,322,110,utRho23
yccA,2062886,2062886,2062836,50,50,utRho23
yccF,2048730,2048730,2048696,34,74,utRho23
yccS,2047988,2047988,2047766,222,622,utRho23
yccT,2055674,2055674,2055546,128,174,utRho23
yccX,2059960,2060128,2059960,168,766,utRho23
ycdT,2185682,2185752,2185682,70,64,utRho23
ycdU,2191266,2191686,2191266,420,846,utRho23
ycdZ,2200504,2200592,2200504,88,290,utRho23
yceA,2233544,2233614,2233544,70,20,utRho23
yceD,2293298,2293588,2293298,290,390,utRho23
yceF,2293522,2293522,2293190,332,244,utRho23
yceH,2252154,2252314,2252154,160,832,utRho23
yceI,2237282,2237282,2236952,330,804,utRho23
yceJ,2238142,2238142,2238092,50,534,utRho23
yceM,2253208,2253612,2253208,404,474,utRho23
yceO,2239264,2239264,2238894,370,514,utRho23
yceQ,2288760,2289004,2288760,244,4240,utRho23
ycfD,2376540,2376540,2376480,60,268,utRho23
ycfJ,2334814,2335198,2334814,384,302,utRho23
ycfS,2340834,2340834,2340748,86,84,utRho23
ycfT,2350658,2350658,2350330,328,226,utRho23
ycfZ,2362760,2362760,2362534,226,2018,utRho23
ycgB,2474570,2474570,2474482,88,40,utRho23
ycgG,2434614,2434656,2434614,42,1908,utRho23
ycgJ,2452956,2453200,2452956,244,298,utRho23
ycgL,2455218,2455362,2455218,144,72,utRho23
ycgN,2457366,2457660,2457366,294,186,utRho23
ycgR,2489112,2489112,2489054,58,66,utRho23
ycgV,2512222,2512222,2511904,318,1420,utRho23
ycgX,2426568,2426568,2426214,354,13752,utRho23
ycgY,2490166,2490320,2490166,154,956,utRho23
ycgZ,2431504,2431578,2431504,74,272,utRho23
ychE,2596904,2597196,2596904,292,0,utRho23
ychF,2515764,2515764,2515624,140,2,utRho23
ychH,2517476,2517582,2517476,106,638,utRho23
ychJ,2578354,2578354,2578264,90,434,utRho23
ychN,2547310,2547310,2547198,112,174,utRho23
ychO,2547520,2547850,2547520,330,952,utRho23
ychQ,2533798,2533848,2533798,50,2,utRho23
yciA,2624828,2624828,2624492,336,318,utRho23
yciB,2626110,2626110,2625780,330,716,utRho23
yciC,2627396,2627396,2627326,70,28,utRho23
yciE,2630794,2630794,2630448,346,848,utRho23
yciG,5264368,5264368,5264140,228,296,utRho23
yciI,2621784,2621784,2621730,54,64,utRho23
yciN,2661606,2661606,2661336,270,30,utRho23
yciS,2680270,2680486,2680270,216,86,utRho23
yciT,2689088,2689088,2688692,396,1850,utRho23
yciU,2614718,2614718,2614300,418,1322,utRho23
yciV,2646376,2646440,2646376,64,6,utRho23
yciW,2700472,2700472,2700214,258,4428,utRho23
yciZ,2689276,2689276,2689218,58,1944,utRho23
ycjD,2703792,2703792,2703520,272,62,utRho23
ycjG,2777748,2777860,2777748,112,260,utRho23
ycjM,2740006,2740432,2740006,426,298,utRho23
ycjW,2767982,2767982,2767922,60,0,utRho23
ycjX,2768138,2768234,2768138,96,114,utRho23
ycjY,5568288,5568288,5567460,828,2096,utRho23
ydaE,2836438,2836438,2836016,422,346,utRho23
ydaN,2816048,2816100,2816048,52,484,utRho23
ydaS,2840340,2840730,2840340,390,480,utRho23
ydbC,2948376,2948442,2948376,66,28,utRho23
ydbD,2950132,2950288,2950132,156,126,utRho23
ydbH,2885800,2886102,2885800,302,368,utRho23
ydbJ,2881712,2882116,2881712,404,2028,utRho23
ydbK,2881692,2881692,2881568,124,536,utRho23
ydcA,2983294,2983354,2983294,60,140,utRho23
ydcF,2974404,2974470,2974404,66,48,utRho23
ydcI,2990268,2990268,2990142,126,12,utRho23
ydcJ,2990266,2990576,2990266,310,34,utRho23
ydcK,3001280,3001280,3000898,382,384,utRho23
ydcL,3004646,3004914,3004646,268,100,utRho23
ydcN,3012308,3012344,3012308,36,2758,utRho23
ydcP,3013508,3013562,3013508,54,222,utRho23
ydcR,3019956,3020006,3019956,50,42,utRho23
ydcS,3022906,3023308,3022906,402,726,utRho23
ydcX,3034442,3034778,3034442,336,1530,utRho23
ydcY,3035220,3035296,3035220,76,156,utRho23
ydcZ,3036750,3036750,3036662,88,6820,utRho23
yddB,3155332,3155332,3155238,94,230,utRho23
yddE,3071738,3071738,3071716,22,2,utRho23
yddG,3094410,3094410,3094338,72,116,utRho23
yddJ,3089732,3089732,3089438,294,2510,utRho23
yddW,3137704,3137704,3137646,58,0,utRho23
ydeA,3233910,3234056,3233910,146,2800,utRho23
ydeE,3242528,3242664,3242528,136,818,utRho23
ydeI,3249118,3249118,3248994,124,60,utRho23
ydeJ,3249376,3249546,3249376,170,88,utRho23
ydeN,3165458,3165458,3165048,410,170,utRho23
ydeP,3173328,3173328,3172972,356,452,utRho23
ydeR,3176596,3176596,3176592,4,436,utRho23
ydfA,3296872,3297016,3296872,144,26,utRho23
ydfG,3254982,3255034,3254982,52,100,utRho23
ydfH,3256652,3256704,3256652,52,52,utRho23
ydfK,3265446,3266144,3265446,698,9462,utRho23
ydgA,3379588,3379704,3379588,116,0,utRho23
ydgC,3364124,3364124,3364060,64,14,utRho23
ydgD,3343906,3343920,3343906,14,370,utRho23
ydgH,3356754,3356854,3356754,100,0,utRho23
ydgJ,3408798,3408798,3408616,182,824,utRho23
ydgK,3410414,3410500,3410414,86,1170,utRho23
ydhB,3479618,3479618,3479596,22,0,utRho23
ydhC,3479698,3479822,3479698,124,88,utRho23
ydhF,3451310,3451310,3451264,46,66,utRho23
ydhI,3441996,3442050,3441996,54,0,utRho23
ydhL,3451864,3451864,3451840,24,786,utRho23
ydhQ,3492404,3492404,3492254,150,668,utRho23
ydhS,3494136,3494262,3494136,126,1294,utRho23
ydhT,3499138,3499138,3499118,20,370,utRho23
ydhY,3509284,3509284,3508954,330,1282,utRho23
ydhZ,3510418,3510418,3510282,136,2074,utRho23
ydiE,3579206,3579226,3579206,20,0,utRho23
ydiH,3530582,3530582,3530406,176,172,utRho23
ydiM,3541852,3542142,3541852,290,114,utRho23
ydiN,3544818,3545024,3544818,206,34,utRho23
ydiP,3558656,3558656,3558602,54,594,utRho23
ydiU,3582508,3582508,3582488,20,1262,utRho23
ydiV,3584174,3584174,3584040,134,266,utRho23
ydiY,3612500,3612500,3612166,334,238,utRho23
ydjA,3697400,3697400,3697352,48,946,utRho23
ydjE,3708082,3708082,3707958,124,22,utRho23
ydjF,3709848,3709848,3709708,140,218,utRho23
ydjM,3620340,3620422,3620340,82,0,utRho23
ydjO,3626696,3626696,3626288,408,216,utRho23
ydjX,3666434,3666802,3666434,368,2440,utRho23
yeaE,3731448,3731448,3731272,176,268,utRho23
yeaG,3733530,3733816,3733530,286,122,utRho23
yeaI,3740486,3740770,3740486,284,318,utRho23
yeaJ,3743874,3744082,3743874,208,326,utRho23
yeaL,3748646,3748704,3748646,58,1152,utRho23
yeaM,3751296,3751296,3751152,144,34,utRho23
yeaN,3750926,3751346,3750926,420,312,utRho23
yeaO,3753554,3753818,3753554,264,340,utRho23
yeaP,3755314,3755430,3755314,116,620,utRho23
yeaQ,3758780,3758780,3758510,270,520,utRho23
yeaR,3759988,3759988,3759896,92,182,utRho23
yeaY,3781122,3781122,3781064,58,0,utRho23
yebB,3892220,3892502,3892220,282,484,utRho23
yebC,3896370,3896370,3896302,68,120,utRho23
yebE,3859464,3859464,3859414,50,2186,utRho23
yebG,3861530,3861530,3861494,36,198,utRho23
yebK,3873180,3873304,3873180,124,0,utRho23
yebQ,3820314,3820552,3820314,238,144,utRho23
yebS,3832238,3832516,3832238,278,42,utRho23
yebV,3843430,3843560,3843430,130,0,utRho23
yebW,3843914,3844242,3843914,328,2080,utRho23
yecC,3995646,3995646,3995628,18,10,utRho23
yecD,3901272,3901664,3901272,392,64,utRho23
yecF,3991434,3991636,3991434,202,586,utRho23
yecH,3979304,3979304,3978980,324,1102,utRho23
yecJ,3975604,3975604,3975516,88,0,utRho23
yecM,3919968,3919968,3919692,276,2308,utRho23
yecR,3976400,3976444,3976400,44,170,utRho23
yecT,3923862,3923944,3923862,82,40,utRho23
yedD,4016522,4016522,4016180,342,842,utRho23
yedE,4016310,4016554,4016310,244,798,utRho23
yedI,4058922,4058922,4058732,190,730,utRho23
yedJ,4066446,4066446,4066158,288,566,utRho23
yedV,4076404,4076404,4076304,100,554,utRho23
yedX,4077680,4077912,4077680,232,126,utRho23
yedY,4078572,4078956,4078572,384,874,utRho23
yeeA,4161322,4161322,4161182,140,46,utRho23
yeeE,4171104,4171104,4171050,54,288,utRho23
yeeJ,4089526,4089822,4089526,296,530,utRho23
yeeN,4113508,4113716,4113508,208,78,utRho23
yeeO,4119444,4119444,4119692,248,82,utRho23
yeeX,4158834,4158834,4158722,112,138,utRho23
yeeZ,4178422,4178422,4178256,166,204,utRho23
yefM,4179466,4179466,4179426,40,124,utRho23
yegD,4295288,4295348,4295288,60,44,utRho23
yegH,4275726,4275804,4275726,78,588,utRho23
yegI,4302154,4302154,4301970,184,16,utRho23
yegJ,4302032,4302370,4302032,338,138,utRho23
yegQ,4331182,4331336,4331182,154,1332,utRho23
yegR,4336698,4336698,4336612,86,1056,utRho23
yegS,4337086,4337424,4337086,338,564,utRho23
yegT,4357562,4357642,4357562,80,1432,utRho23
yegX,4367640,4367640,4367302,338,470,utRho23
yehA,4376944,4376944,4376828,116,916,utRho23
yehE,4385818,4385818,4385592,226,20,utRho23
yehK,4407568,4407944,4407568,376,804,utRho23
yehL,4408804,4409192,4408804,388,218,utRho23
yeiB,4486146,4486146,4485934,212,114,utRho23
yeiE,4499422,4499422,4499236,186,104,utRho23
yeiG,4487776,4487820,4487776,44,244,utRho23
yeiH,4499332,4499434,4499332,102,448,utRho23
yeiI,4503306,4503400,4503306,94,258,utRho23
yeiL,4510580,4510710,4510580,130,98,utRho23
yeiP,4530834,4530900,4530834,66,636,utRho23
yeiQ,4532328,4532490,4532328,162,464,utRho23
yeiR,4535484,4535658,4535484,174,454,utRho23
yeiW,4530840,4530840,4530590,250,824,utRho23
yejA,4544624,4544728,4544624,104,130,utRho23
yejG,4556892,4556892,4556474,418,6758,utRho23
yejH,4561244,4561264,4561244,20,142,utRho23
yejK,4568218,4568218,4567894,324,56,utRho23
yejO,4578352,4578352,4577800,552,3318,utRho23
yfaD,4713380,4713808,4713380,428,2150,utRho23
yfaE,4696676,4697028,4696676,352,1108,utRho23
yfaL,4688568,4688568,4688338,230,362,utRho23
yfaP,4656398,4656398,4656286,112,206,utRho23
yfaU,4717892,4717892,4717690,202,0,utRho23
yfaY,4727310,4727310,4727266,44,2190,utRho23
yfaZ,4728744,4728744,4728550,194,1120,utRho23
yfbK,4771810,4771810,4771444,366,1698,utRho23
yfbL,4771500,4771720,4771500,220,1328,utRho23
yfbN,4777174,4777174,4776852,322,1490,utRho23
yfbO,4776916,4777162,4776916,246,1478,utRho23
yfbP,4777990,4778232,4777990,242,19098,utRho23
yfbR,4817662,4817724,4817662,62,112,utRho23
yfcI,4847424,4847424,4847078,346,1524,utRho23
yfcJ,4880482,4880482,4880240,242,636,utRho23
yfcL,4888502,4888502,4888338,164,338,utRho23
yfcV,4911642,4911642,4911292,350,646,utRho23
yfcZ,4921958,4921958,4921868,90,50,utRho23
yfdF,4925604,4926024,4925604,420,11876,utRho23
yfdG,4935474,4935710,4935474,236,142,utRho23
yfdP,4946844,4947040,4946844,196,130,utRho23
yfdX,4988866,4988866,4988804,62,86,utRho23
yfdY,4990672,4990672,4990584,88,640,utRho23
yfeA,5035784,5035784,5035664,120,9644,utRho23
yfeC,5036668,5036934,5036668,266,108,utRho23
yfeH,5053818,5053892,5053818,74,174,utRho23
yfeK,5074630,5074684,5074630,54,40,utRho23
yfeO,5018906,5019260,5018906,354,774,utRho23
yfeR,5054078,5054078,5053712,366,368,utRho23
yfeX,5101356,5101356,5101090,266,54,utRho23
yfeY,5102486,5102486,5102432,54,72,utRho23
yfeZ,5103842,5103842,5103452,390,432,utRho23
yffO,5123804,5124222,5123804,418,848,utRho23
yffQ,5126778,5127154,5126778,376,3382,utRho23
yffS,5128800,5128986,5128800,186,24,utRho23
yfgC,5232052,5232188,5232052,136,518,utRho23
yfgF,5258062,5258062,5257876,186,3252,utRho23
yfgG,5258170,5258580,5258170,410,5516,utRho23
yfgH,5259344,5259584,5259344,240,200,utRho23
yfgM,5278866,5278866,5278566,300,548,utRho23
yfhH,5397414,5397518,5397414,104,286,utRho23
yfhM,5304648,5304648,5304574,74,166,utRho23
yfhR,5328408,5328726,5328408,318,9160,utRho23
yfiC,5425610,5425610,5425528,82,60,utRho23
yfiE,5430688,5430688,5430640,48,1478,utRho23
yfiL,5482630,5482720,5482630,90,40,utRho23
yfiM,5448066,5448358,5448066,292,9990,utRho23
yfiR,5483354,5483750,5483354,396,440,utRho23
yfjH,5517326,5517326,5517200,126,154,utRho23
yfjI,5517710,5517970,5517710,260,1142,utRho23
yfjJ,5521014,5521094,5521014,80,112,utRho23
yfjM,5531970,5531970,5531552,418,14252,utRho23
yfjP,5535080,5535420,5535080,340,1892,utRho23
yfjW,5546570,5546636,5546570,66,42,utRho23
yfjX,5551776,5551838,5551776,62,0,utRho23
ygaC,5601180,5601180,5599988,1192,3082,utRho23
ygaM,5600242,5600292,5600242,50,636,utRho23
ygaU,5593628,5593628,5593572,56,236,utRho23
ygaZ,5619190,5619234,5619190,44,210,utRho23
ygbA,5713656,5713656,5713612,44,322,utRho23
ygbE,5746784,5746784,5746674,110,602,utRho23
ygbI,5722882,5722882,5722528,354,1180,utRho23
ygbK,5724394,5724670,5724394,276,1034,utRho23
ygbL,5727074,5727186,5727074,112,134,utRho23
ygbN,5729814,5730202,5729814,388,1940,utRho23
ygcG,5811210,5811422,5811210,212,210,utRho23
ygcN,5785144,5785314,5785144,170,780,utRho23
ygcU,5799214,5799214,5798836,378,486,utRho23
ygcW,5800942,5800942,5800546,396,128,utRho23
ygdD,5883442,5883442,5883262,180,554,utRho23
ygdG,5861746,5861930,5861746,184,250,utRho23
ygdI,5886526,5886526,5886290,236,170,utRho23
ygdQ,5940784,5940840,5940784,56,84,utRho23
ygdR,5942494,5942542,5942494,48,76,utRho23
ygeA,5961606,5961606,5961270,336,504,utRho23
ygeH,5983758,5984188,5983758,430,2526,utRho23
ygeI,5987162,5987276,5987162,114,14178,utRho23
ygeR,6000078,6000078,5999782,296,768,utRho23
ygeV,6011694,6011694,6011572,122,242,utRho23
ygeW,6012234,6012524,6012234,290,1246,utRho23
ygfB,6110946,6110946,6110888,58,42,utRho23
ygfK,6031984,6032120,6031984,136,230,utRho23
ygfS,6058328,6058328,6058024,304,334,utRho23
ygfZ,6082564,6082626,6082564,62,932,utRho23
yggC,6149512,6149512,6149378,134,144,utRho23
yggE,6136370,6136370,6136160,210,1382,utRho23
yggI,6179176,6179510,6179176,334,662,utRho23
yggL,6204508,6204508,6204266,242,614,utRho23
yggM,6199514,6199514,6199130,384,200,utRho23
yggN,6203596,6203596,6203246,350,1028,utRho23
yggX,18623958,18624558,18623958,600,516,utRho23
yghA,6298966,6299324,6298966,358,342,utRho23
yghB,6307058,6307126,6307058,68,1394,utRho23
yghD,6222614,6222614,6222252,362,452,utRho23
yghF,6225798,6225798,6225840,42,34,utRho23
yghJ,6238640,6238640,6238224,416,140,utRho23
yghQ,6265186,6265186,6264816,370,1104,utRho23
yghT,6267830,6268262,6267830,432,1072,utRho23
yghU,6277400,6277454,6277400,54,394,utRho23
yghW,6293506,6293506,6293474,32,96,utRho23
yghZ,6295562,6295794,6295562,232,338,utRho23
ygiD,6365122,6365122,6364868,254,3362,utRho23
ygiH,6409066,6409388,6409066,322,638,utRho23
ygiL,6370622,6370828,6370622,206,286,utRho23
ygiM,6402084,6402414,6402084,330,262,utRho23
ygiN,6346156,6346284,6346156,128,518,utRho23
ygiQ,6322620,6322620,6322292,328,1614,utRho23
ygiS,6335462,6335462,6335436,26,74,utRho23
ygiV,6338582,6338582,6338462,120,174,utRho23
ygiW,6339774,6339774,6339352,422,3466,utRho23
ygiZ,6344506,6344506,6344422,84,44,utRho23
ygjH,6442528,6442528,6442494,34,142,utRho23
ygjI,6452140,6452468,6452140,328,88,utRho23
ygjQ,6472730,6473080,6472730,350,2072,utRho23
ygjR,6474564,6474586,6474564,22,80,utRho23
ygjV,6483638,6483638,6483488,150,12,utRho23
yhaB,6535632,6535708,6535632,76,0,utRho23
yhaH,6504498,6504608,6504498,110,932,utRho23
yhaI,6505400,6505822,6505400,422,520,utRho23
yhaJ,6508560,6508560,6508428,132,378,utRho23
yhaK,6508538,6508638,6508538,100,402,utRho23
yhbQ,6599878,6599932,6599878,54,710,utRho23
yhbT,6602736,6602736,6602552,184,3084,utRho23
yhbU,6602558,6602970,6602558,412,3882,utRho23
yhbX,6643302,6643302,6643226,76,44,utRho23
yhbY,6655518,6655580,6655518,62,496,utRho23
yhcA,6723956,6724224,6723956,268,2596,utRho23
yhcB,6760364,6760382,6760364,18,36,utRho23
yhcC,6708470,6708470,6708100,370,1434,utRho23
yhcF,6733440,6733852,6733440,412,2708,utRho23
yhcH,6739124,6739124,6738956,168,5332,utRho23
yhcM,6760312,6760312,6759994,318,230,utRho23
yhcN,6770812,6771076,6770812,264,524,utRho23
yhcO,6772606,6772606,6772258,348,48,utRho23
yhdH,6806560,6806968,6806560,408,444,utRho23
yhdJ,6823234,6823306,6823234,72,12,utRho23
yhdN,6879092,6879092,6879018,74,300,utRho23
yhdT,6814702,6814750,6814702,48,60,utRho23
yhdU,6824994,6825242,6824994,248,346,utRho23
yhdV,6836392,6836780,6836392,388,2416,utRho23
yhdW,6837944,6838298,6837944,354,444,utRho23
yheO,6953082,6953082,6952880,202,264,utRho23
yheV,6957970,6957970,6957584,386,264,utRho23
yhfA,6971902,6971902,6971636,266,2552,utRho23
yhfG,6983294,6983294,6983240,54,1506,utRho23
yhfL,6998622,6998896,6998622,274,238,utRho23
yhfY,7023244,7023244,7022844,400,0,utRho23
yhgA,7086294,7086334,7086294,40,0,utRho23
yhgE,7065176,7065176,7064878,298,2254,utRho23
yhgF,7074352,7074770,7074352,418,8684,utRho23
yhhA,7173458,7173886,7173458,428,1308,utRho23
yhhI,7248346,7248756,7248346,410,72,utRho23
yhhJ,7253696,7253696,7253606,90,292,utRho23
yhhM,7211588,7211588,7211220,368,3034,utRho23
yhhN,7211150,7211502,7211150,352,1890,utRho23
yhhQ,7218238,7218434,7218238,196,1160,utRho23
yhhT,7223682,7223730,7223682,48,26,utRho23
yhhX,7162032,7162032,7161610,422,92,utRho23
yhhY,7162222,7162276,7162222,54,36,utRho23
yhhZ,7163516,7163726,7163516,210,992,utRho23
yhiD,7312220,7312220,7311804,416,22108,utRho23
yhiJ,7265190,7265190,7265180,10,118,utRho23
yhiM,7269270,7269682,7269270,412,4938,utRho23
yhiN,7275000,7275000,7274820,180,752,utRho23
yhjA,7338522,7338522,7338376,146,496,utRho23
yhjB,7344090,7344090,7343788,302,1292,utRho23
yhjC,7344272,7344684,7344272,412,388,utRho23
yhjD,7346660,7346724,7346660,64,210,utRho23
yhjE,7349274,7349572,7349274,298,4366,utRho23
yhjG,7356824,7356824,7356730,94,80,utRho23
yhjH,7358458,7358458,7358374,84,312,utRho23
yhjJ,7364032,7364032,7363880,152,436,utRho23
yhjK,7371296,7371296,7371158,138,268,utRho23
yhjR,7392750,7392750,7392370,380,144,utRho23
yhjV,7400796,7401126,7400796,330,1842,utRho23
yhjX,7424194,7424194,7424014,180,184,utRho23
yhjY,7425966,7425966,7425868,98,248,utRho23
yiaB,7455654,7455654,7455496,158,184,utRho23
yiaD,7432712,7433094,7432712,382,944,utRho23
yiaF,7438194,7438194,7438088,106,806,utRho23
yiaG,7438862,7438956,7438862,94,530,utRho23
yiaJ,7485236,7485236,7485064,172,2314,utRho23
yiaK,7485348,7485466,7485348,118,276,utRho23
yiaT,7503924,7503924,7503736,188,14,utRho23
yiaU,7503792,7503984,7503792,192,0,utRho23
yiaY,7515856,7515856,7515654,202,1104,utRho23
yibF,7523950,7523950,7523910,40,28,utRho23
yibG,7536128,7536354,7536128,226,616,utRho23
yibL,7553194,7553330,7553194,136,412,utRho23
yibN,7570112,7570112,7570030,82,122,utRho23
yibT,7552848,7552848,7552760,88,1266,utRho23
yicC,7633290,7633352,7633290,62,200,utRho23
yicH,7660862,7660914,7660862,52,16,utRho23
yicJ,7673328,7673328,7671858,1470,7400,utRho23
yicN,7685018,7685018,7684804,214,2348,utRho23
yicO,7687914,7687914,7687578,336,282,utRho23
yicR,15250308,15250308,15250236,72,0,utRho23
yidB,7755230,7755230,7754930,300,354,utRho23
yidE,7732780,7732780,7732546,234,140,utRho23
yidF,7711580,7711580,7711222,358,408,utRho23
yidQ,7735088,7735456,7735088,368,630,utRho23
yidR,7738824,7738824,7738618,206,0,utRho23
yieE,7787658,7787738,7787658,80,1916,utRho23
yieH,7793314,7793548,7793314,234,606,utRho23
yieK,7798928,7798928,7798786,142,74,utRho23
yifB,7900350,7900350,7899998,352,440,utRho23
yifL,7988984,7989044,7988984,60,12068,utRho23
yigF,8005750,8005750,8005598,152,41218,utRho23
yigI,8009448,8009448,8009394,54,1946,utRho23
yigM,8022100,8022152,8022100,52,230,utRho23
yihA,8101970,8101970,8101458,512,838,utRho23
yihD,8084098,8084138,8084098,40,134,utRho23
yihF,8088110,8088398,8088110,288,278,utRho23
yihG,8093304,8093304,8093204,100,212,utRho23
yihI,8102616,8102694,8102616,78,6,utRho23
yihL,8120506,8120894,8120506,388,1172,utRho23
yihN,8124332,8124494,8124332,162,1990,utRho23
yihO,8131942,8131942,8131532,410,426,utRho23
yihQ,8138892,8138892,8138552,340,38,utRho23
yihV,8147064,8147478,8147064,414,682,utRho23
yihX,8151096,8151106,8151096,10,322,utRho23
yiiE,8158192,8158582,8158192,390,2928,utRho23
yiiF,8159124,8159502,8159124,378,928,utRho23
yiiG,8173762,8174004,8173762,242,2,utRho23
yiiM,8205506,8205644,8205506,138,6836,utRho23
yiiQ,8224624,8224624,8224428,196,92,utRho23
yiiS,8225738,8225934,8225738,196,180,utRho23
yijE,8272178,8272216,8272178,38,60,utRho23
yijF,8275728,8275728,8275314,414,3818,utRho23
yijO,8296858,8296858,8296634,224,234,utRho23
yjaA,8426240,8426468,8426240,228,56494,utRho23
yjaB,8428312,8428312,8428246,66,350,utRho23
yjaG,8398746,8399008,8398746,262,902,utRho23
yjaH,8401022,8401132,8401022,110,208,utRho23
yjaZ,8379506,8379572,8379506,66,46,utRho23
yjbB,8455204,8455462,8455204,258,292,utRho23
yjbE,16943432,16943624,16943432,192,660,utRho23
yjbL,8520318,8520642,8520318,324,312,utRho23
yjbQ,8540428,8540476,8540428,48,100,utRho23
yjcB,8550328,8550328,8550082,246,646,utRho23
yjcC,8550836,8550942,8550836,106,376,utRho23
yjcD,8556628,8556958,8556628,330,1244,utRho23
yjcE,8559658,8559960,8559658,302,1604,utRho23
yjcF,8566212,8566212,8566150,62,82,utRho23
yjcO,8594660,8594660,8594250,410,110,utRho23
yjdA,8654128,8654270,8654128,142,6,utRho23
yjdC,8726660,8726660,8726616,44,38,utRho23
yjdK,8704780,8705168,8704780,388,6458,utRho23
yjdL,8713034,8713034,8712822,212,76,utRho23
yjdM,8653672,8653672,8653468,204,1296,utRho23
yjeF,8787354,8788132,8787354,778,76728,utRho23
yjeI,8745522,8745618,8745522,96,18,utRho23
yjeJ,8748806,8748806,8748468,338,1024,utRho23
yjeV,8785472,8785784,8785472,312,1984,utRho23
yjfP,8833512,8833904,8833512,392,522,utRho23
yjfY,8849656,8849656,8849582,74,204,utRho23
yjfZ,8855052,8855052,8854844,208,810,utRho23
yjgA,8916162,8916162,8915730,432,828,utRho23
yjgL,8950802,8950874,8950802,72,250,utRho23
yjgM,8959342,8959342,8959074,268,34,utRho23
yjgN,8959132,8959460,8959132,328,60,utRho23
yjgR,8980170,8980170,8980126,44,1136,utRho23
yjgZ,9002116,9002520,9002116,404,5198,utRho23
yjhB,9007764,9008116,9007764,352,456,utRho23
yjhG,9048452,9048452,9048188,264,49034,utRho23
yjhU,9041080,9041080,9040648,432,1278,utRho23
yjiA,9178096,9178096,9177730,366,1126,utRho23
yjiJ,9125364,9125364,9125350,14,12,utRho23
yjiK,9127270,9127270,9127422,152,544,utRho23
yjiL,9129604,9129604,9129378,226,68,utRho23
yjiS,9143410,9143502,9143410,92,694,utRho23
yjiY,9182734,9182734,9182558,176,1832,utRho23
yjjA,9200674,9200674,9200378,296,1624,utRho23
yjjB,18408708,18408708,18407800,908,904,utRho23
yjjJ,9243314,9243538,9243314,224,0,utRho23
yjjK,9261132,9261132,9261044,88,2280,utRho23
yjjL,9189764,9189764,9189444,320,4914,utRho23
yjjM,9191894,9191894,9191702,192,242,utRho23
yjjP,9206068,9206068,9205716,352,15414,utRho23
yjjQ,9206638,9206954,9206638,316,15962,utRho23
yjjX,9267798,9267798,9267490,308,2624,utRho23
yjjY,9280716,9280804,9280716,88,184,utRho23
yjjZ,9211554,9211608,9211554,54,49458,utRho23
yjtD,9281676,9281884,9281676,208,610,utRho23
ykfB,532454,532454,532174,280,19284,utRho23
ykfI,527636,527636,527338,298,1222,utRho23
ykgB,637050,637050,636638,412,370,utRho23
ykgC,640430,640430,640002,428,706,utRho23
ykgD,640232,640454,640232,222,674,utRho23
ykgE,642962,643216,642962,254,3110,utRho23
ykgJ,608524,608524,608364,160,884,utRho23
ykgL,623878,624224,623878,346,6156,utRho23
ykgM,625610,625610,625554,56,1068,utRho23
ykgR,626570,626570,626484,86,146,utRho23
ylaC,958576,958576,958502,74,3780,utRho23
yliE,1745938,1745958,1745938,20,0,utRho23
ymcE,2103660,2103694,2103660,34,30,utRho23
ymdA,2210450,2210828,2210450,378,246,utRho23
ymdB,2211428,2211640,2211428,212,188,utRho23
ymfD,2395322,2395322,2395064,258,788,utRho23
ymfI,2402880,2402994,2402880,114,0,utRho23
ymfJ,2404518,2404518,2404168,350,966,utRho23
ymfK,2406176,2406176,2405866,310,174,utRho23
ymfT,2405766,2406048,2405766,282,234,utRho23
ymgE,2489110,2489456,2489110,346,1886,utRho23
ymgF,2437628,2437966,2437628,338,472,utRho23
ymiA,2670112,2670320,2670112,208,890,utRho23
ymjA,2715620,2715620,2715336,284,844,utRho23
ynaI,2791946,2791946,2791844,102,96,utRho23
ynaK,2850438,2850754,2850438,316,424,utRho23
ynbA,2954924,2955242,2954924,318,30,utRho23
yncD,3046552,3046552,3046130,422,396,utRho23
yncE,3046454,3046614,3046454,160,330,utRho23
yncG,3052456,3052494,3052456,38,1890,utRho23
yncL,3034492,3034492,3034388,104,1156,utRho23
yneE,3218364,3218364,3218044,320,38,utRho23
yneF,3223748,3223748,3223708,40,14,utRho23
yneJ,3229560,3229608,3229560,48,136,utRho23
yneK,3231100,3231526,3231100,426,812,utRho23
yneM,3245176,3245292,3245176,116,208,utRho23
ynfA,3311398,3311398,3311346,52,72,utRho23
ynfB,3311418,3311616,3311418,198,594,utRho23
ynfC,3315094,3315094,3314914,180,0,utRho23
ynfD,3314828,3315130,3314828,302,8,utRho23
ynfE,3316006,3316138,3316006,132,350,utRho23
ynfK,3334670,3334670,3334438,232,752,utRho23
ynfL,3339304,3339304,3339184,120,94,utRho23
ynfM,3339260,3339398,3339260,138,118,utRho23
ynfN,3276598,3276598,3276218,380,174,utRho23
ynfO,3273454,3273512,3273454,58,722,utRho23
ynhG,3517890,3517890,3517450,440,226,utRho23
yniA,3615158,3615592,3615158,434,1224,utRho23
yniB,3618526,3618526,3618466,60,38,utRho23
yniC,3618652,3618760,3618652,108,310,utRho23
yniD,3610202,3610330,3610202,128,118,utRho23
ynjE,3678880,3678934,3678880,54,110,utRho23
ynjF,3683222,3683222,3682806,416,678,utRho23
ynjH,3684376,3684376,3684270,106,200,utRho23
ynjI,3690022,3690022,3689742,280,556,utRho23
yoaB,3786642,3786734,3786642,92,556,utRho23
yoaC,3787932,3788146,3787932,214,654,utRho23
yoaE,3803544,3803544,3803170,374,688,utRho23
yoaF,3755444,3755444,3755064,380,1038,utRho23
yoaH,3789866,3789866,3789462,404,2602,utRho23
yobB,3850418,3850880,3850418,462,1338,utRho23
yobF,3815586,3815586,3815182,404,380,utRho23
yobH,3817800,3817850,3817800,50,1058,utRho23
yodB,4084352,4084736,4084352,384,2352,utRho23
yodC,4057008,4057008,4056740,268,108,utRho23
yohC,4451358,4451358,4451262,96,272,utRho23
yohD,4451526,4451602,4451526,76,256,utRho23
yohJ,4460986,4461248,4460986,262,1138,utRho23
yohO,4431172,4431314,4431172,142,404,utRho23
yojI,4617282,4617282,4617230,52,50,utRho23
ypdI,4988988,4989396,4988988,408,840,utRho23
ypfG,5165786,5165786,5165554,232,204,utRho23
ypfM,5182140,5182140,5181732,408,402,utRho23
yphB,5349590,5349590,5349376,214,444,utRho23
ypjA,5565644,5565644,5565452,192,3278,utRho23
ypjB,5569636,5569636,5568858,778,304,utRho23
ypjD,5495860,5495774,5495860,86,6,utRho23
yqaE,5594170,5594170,5594056,114,270,utRho23
yqcA,5846100,5846100,5845968,132,558,utRho23
yqcE,5800944,5801184,5800944,240,4,utRho23
yqeC,6030468,6030468,6030114,354,644,utRho23
yqeF,5971618,5971618,5971184,434,6858,utRho23
yqeG,5971438,5971694,5971438,256,10934,utRho23
yqeH,5975016,5975072,5975016,56,23800,utRho23
yqeI,5976688,5977004,5976688,316,284,utRho23
yqeK,5981140,5981140,5980720,420,5724,utRho23
yqfA,6086728,6086728,6086296,432,1260,utRho23
yqgA,6219042,6219106,6219042,64,250,utRho23
yqgB,6172500,6172500,6172102,398,594,utRho23
yqgE,6185768,6185874,6185768,106,318,utRho23
yqhA,6299150,6299150,6298942,208,196,utRho23
yqhC,6310768,6310768,6310436,332,460,utRho23
yqhD,6310604,6310710,6310604,106,146,utRho23
yqhH,6316842,6317254,6316842,412,1492,utRho23
yqiC,6369662,6369680,6369662,18,810,utRho23
yqiJ,6384108,6384416,6384108,308,198,utRho23
yqjA,6495096,6495546,6495096,450,14326,utRho23
yqjF,6500932,6501124,6500932,192,1608,utRho23
yqjG,6501948,6502048,6501948,100,4,utRho23
yqjH,6433078,6433078,6432982,96,116,utRho23
yqjI,6433506,6433558,6433506,52,52,utRho23
yraH,6574552,6574852,6574552,300,396,utRho23
yraP,6592144,6592818,6592144,674,718,utRho23
yraQ,6596414,6596414,6596276,138,0,utRho23
yraR,6598024,6598024,6597692,332,842,utRho23
yrbG,13360844,13361100,13360844,256,0,utRho23
yrbL,6696842,6696904,6696842,62,3162,utRho23
yrbN,6616172,6616172,6615866,306,1696,utRho23
yrdB,6860176,6860176,6860046,130,184,utRho23
yrfF,7052548,7052938,7052548,390,1486,utRho23
yrhB,7169440,7169518,7169440,78,68,utRho23
ysaB,7451804,7451804,7451424,380,52,utRho23
ysgA,8032686,8032686,8032338,348,1248,utRho23
ytfB,8857638,8857638,8857434,204,340,utRho23
ytfE,8864018,8864018,8863966,52,270,utRho23
ytfF,8866296,8866296,8866130,166,684,utRho23
ytfH,8868164,8868226,8868164,62,932,utRho23
ytfI,8875234,8875414,8875234,180,324,utRho23
ytfJ,8878572,8878572,8878524,48,372,utRho23
ytfK,8879022,8879174,8879022,152,186,utRho23
ytfL,8882642,8882642,8882430,212,90,utRho23
ytfQ,8899634,8899924,8899634,290,504,utRho23
ytjB,9249598,9249598,9249578,20,236,utRho23
yzfA,8896588,8896588,8896490,98,36,utRho23
zapA,6111102,6111224,6111102,122,552,utRho23
zapB,8236772,8237030,8236772,258,280,utRho23
zapC,2011700,2011904,2011700,204,50,utRho23
zinT,4082692,4082750,4082692,58,822,utRho23
zipA,5062814,5062814,5062466,348,584,utRho23
zitB,1569716,1569716,1569646,70,96,utRho23
zntA,7212844,7212902,7212844,58,172,utRho23
zntR,6878336,6878336,6878260,76,128,utRho23
znuA,3885322,3885322,3885166,156,252,utRho23
znuC,3885268,3885324,3885268,56,244,utRho23
zraP,8403424,8403424,8403376,48,106,utRho23
zraS,8403810,8403852,8403810,42,10,utRho23
zupT,6364866,6365100,6364866,234,3348,utRho23
zur,8520282,8520282,8520006,276,516,utRho23
zwf,3872752,3872752,3872628,124,96,utRho23
C0343,2818676,2818728,2818676,52,0,utRho24
aaeB,6776526,6776526,6776376,150,138,utRho24
aaeR,6778762,6779040,6778762,278,1124,utRho24
aaeX,6778860,6778860,6778674,186,1256,utRho24
aat,1854920,1854920,1854864,56,0,utRho24
accA,416822,417242,416822,420,592,utRho24
accB,6810280,6810872,6810280,592,1464,utRho24
accD,4868030,4868030,4867852,178,272,utRho24
aceB,8430804,8430956,8430804,152,1234,utRho24
aceE,245938,246034,245938,96,220,utRho24
ackA,4826918,4826940,4826918,22,100,utRho24
acnA,2670848,2671662,2670848,814,844,utRho24
acnB,263038,263230,263038,192,458,utRho24
acpP,2303148,2303230,2303148,82,78,utRho24
acpS,5402324,5402324,5401996,328,368,utRho24
acrA,971396,971396,971238,158,30,utRho24
acrB,969370,969370,968806,564,1108,utRho24
acrD,5174950,5175190,5174950,240,326,utRho24
acrE,6827404,6827728,6827404,324,398,utRho24
acrR,971398,971522,971398,124,12,utRho24
acrZ,1589502,1589546,1589502,44,322,utRho24
acs,8575190,8575190,8574742,448,4004,utRho24
actP,8569870,8569870,8569804,66,86,utRho24
ada,4620854,4620854,4620810,44,0,utRho24
add,3404404,3404466,3404404,62,166,utRho24
ade,7687802,7687928,7687802,126,144,utRho24
adhE,2596826,2596826,2596242,584,18,utRho24
adhP,3107988,3107988,3107676,312,590,utRho24
adiA,8681112,8681112,8681042,70,180,utRho24
adiC,8674404,8674404,8674062,342,362,utRho24
adiY,8676084,8676084,8675858,226,34,utRho24
adk,994278,994350,994278,72,1152,utRho24
adrA,807374,807406,807374,32,286,utRho24
aer,6438240,6438240,6438152,88,190,utRho24
aes,1000102,1000102,999946,156,4486,utRho24
agaR,6557406,6557406,6557330,76,24,utRho24
agaS,6563778,6563952,6563778,174,34,utRho24
agp,2131118,2131170,2131118,52,46,utRho24
agrA,7296126,7296126,7296126,0,0,utRho24
agrB,7296588,7296588,7296588,0,0,utRho24
ahpC,1277386,1277890,1277386,504,512,utRho24
ahpF,1278004,1279506,1278004,1502,70378,utRho24
ahr,8992698,8992698,8992418,280,2076,utRho24
aidB,8828494,8828550,8828494,56,34,utRho24
ais,4731512,4731512,4731240,272,404,utRho24
alaA,4814816,4815122,4814816,306,218,utRho24
alaC,4996798,4996798,4996590,208,48,utRho24
alaE,5598140,5598328,5598140,188,344,utRho24
alaS,5644180,5644180,5644022,158,778,utRho24
alaW,5036612,5036612,5036462,150,0,utRho24
aldA,2976380,2976464,2976380,84,416,utRho24
aldB,7513070,7513070,7513022,48,740,utRho24
alkA,4295118,4295118,4295080,38,226,utRho24
alkB,4618890,4618890,4618682,208,142,utRho24
allA,1064780,1064902,1064780,122,256,utRho24
allD,1092822,1092822,1092726,96,128,utRho24
allE,1088112,1088112,1088092,20,222,utRho24
allS,1064600,1064600,1064442,158,790,utRho24
alr,8531178,8531564,8531178,386,1154,utRho24
alsE,8617334,8617334,8616956,378,812,utRho24
alsK,8615990,8615990,8615598,392,1582,utRho24
alx,6476740,6477160,6476740,420,92,utRho24
amiA,5104482,5104704,5104482,222,80,utRho24
amiC,5898378,5898378,5898020,358,334,utRho24
amn,4110062,4110122,4110062,60,22,utRho24
ampC,8758006,8758006,8757888,118,72,utRho24
ampD,237362,237466,237362,104,428,utRho24
ampG,907372,907372,907090,282,168,utRho24
ampH,792726,792726,792574,152,104,utRho24
amyA,4012230,4012312,4012230,82,16,utRho24
anmK,3439346,3439346,3439204,142,92,utRho24
ansB,6201580,6201580,6201456,124,1248,utRho24
ansP,3052040,3052040,3051960,80,282,utRho24
apaG,104068,104068,103212,856,2864,utRho24
apaH,102586,102586,102444,142,5704,utRho24
apbE,4623188,4623188,4623068,120,18,utRho24
appA,2081198,2081234,2081198,36,18,utRho24
appC,2075420,2075480,2075420,60,8,utRho24
appY,1167134,1167362,1167134,228,68,utRho24
apt,982620,982824,982620,204,24,utRho24
aqpZ,1832424,1832424,1832094,330,160,utRho24
araB,140150,140150,140096,54,40,utRho24
araC,140482,140774,140482,292,764,utRho24
araE,5964416,5964416,5964364,52,16,utRho24
araF,3972476,3972476,3972256,220,260,utRho24
araH,3967120,3967120,3967086,34,940,utRho24
araJ,825058,825058,824962,96,6044,utRho24
arcA,9281602,9281602,9280612,990,1410,utRho24
arcB,6706098,6706098,6706050,48,380,utRho24
arcZ,6701154,6701154,6701154,0,0,utRho24
arfA,6877346,6877346,6877298,48,808,utRho24
argA,5898312,5898484,5898312,172,256,utRho24
argC,8309770,8310002,8309770,232,266,utRho24
argD,6980442,6980442,6980360,82,216,utRho24
argE,8310156,8310156,8309694,462,478,utRho24
argF,580680,580680,580610,70,38,utRho24
argG,6637124,6637274,6637124,150,462,utRho24
argI,8956688,8956688,8956622,66,346,utRho24
argO,6137672,6137672,6137616,56,468,utRho24
argP,6119460,6119506,6119460,46,548,utRho24
argR,6769204,6769406,6769204,202,256,utRho24
argS,3920002,3920124,3920002,122,156,utRho24
argT,4855698,4855698,4855582,116,146,utRho24
argU,1129406,1129446,1129406,40,0,utRho24
argW,4932616,4932618,4932616,2,34,utRho24
argX,7964728,7964750,7964728,22,54,utRho24
aroF,5482402,5482402,5482300,102,78,utRho24
aroG,1571182,1571266,1571182,84,212,utRho24
aroH,3576636,3576870,3576636,234,324,utRho24
aroK,7038760,7038760,7038128,632,1806,utRho24
aroL,812560,812810,812560,250,2458,utRho24
aroP,243342,243342,243102,240,106,utRho24
arpA,8445382,8445382,8444974,408,616,utRho24
arrS,7316108,7316108,7316108,0,0,utRho24
arsR,7297024,7297056,7297024,32,214,utRho24
artJ,1801252,1801252,1801150,102,26,utRho24
artP,1807686,1807686,1807468,218,7516,utRho24
ascF,5678858,5679048,5678858,190,118,utRho24
ascG,5678574,5678574,5678528,46,266,utRho24
aslB,7965562,7965916,7965562,354,606,utRho24
asnA,7854258,7854310,7854258,52,1522,utRho24
asnB,1398444,1398444,1398354,90,2210,utRho24
asnC,23562186,23562186,23562018,168,1584,utRho24
asnS,1978088,1978088,1977970,118,1620,utRho24
asnT,4089082,4089098,4089082,16,274,utRho24
asnU,4119690,4119702,4119690,12,0,utRho24
asnV,4124504,4124520,4124504,16,164,utRho24
aspA,17473728,17473728,17473308,420,120,utRho24
aspC,1971486,1971486,1971418,68,62,utRho24
aspS,3901402,3901402,3901044,358,528,utRho24
aspT,7893560,7893744,7893560,184,67726,utRho24
aspV,473826,473862,473826,36,48,utRho24
asr,3342654,3342752,3342654,98,126,utRho24
astC,3664088,3664088,3663964,124,142,utRho24
astE,3654138,3654138,3653846,292,314,utRho24
atoD,4646824,4646894,4646824,70,1428,utRho24
atpB,7844540,7844540,7844102,438,98,utRho24
atpC,7832118,7832118,7831944,174,308,utRho24
atpI,7845050,7845050,7844880,170,64,utRho24
avtA,7479348,7479410,7479348,62,1364,utRho24
azoR,2965982,2965982,2965720,262,528,utRho24
azuC,3976002,3976002,3975918,84,0,utRho24
bacA,6408350,6408350,6408262,88,956,utRho24
bamA,394052,395856,394052,1804,886,utRho24
bamB,5277950,5277950,5277304,646,660,utRho24
bamC,5198028,5198028,5197730,298,506,utRho24
bamD,5471922,5472292,5471922,370,1940,utRho24
bamE,5506972,5507210,5506972,238,64,utRho24
basS,8666954,8666954,8666544,410,1798,utRho24
bax,7474468,7474468,7474354,114,204,utRho24
bcp,5200874,5200956,5200874,82,1096,utRho24
bcsB,7385346,7385346,7385214,132,42,utRho24
bcsE,7392644,7392916,7392644,272,216,utRho24
bdcA,8948128,8948128,8948106,22,1372,utRho24
bdcR,8948192,8948248,8948192,56,698,utRho24
bdm,3112680,3112680,3112560,120,240,utRho24
betA,654522,654522,654494,28,192,utRho24
betI,658722,658722,658668,54,200,utRho24
betT,658842,658926,658842,84,382,utRho24
bfr,6933498,6933498,6933450,48,128,utRho24
bglG,23440182,23440182,23439402,780,2184,utRho24
bglX,4444240,4444240,4443978,262,58,utRho24
bhsA,2337962,2338146,2337962,184,342,utRho24
bioA,1618584,1618584,1618514,70,16,utRho24
bioB,1618604,1618688,1618604,84,0,utRho24
bioH,7089716,7089716,7089688,28,60,utRho24
bisC,7433026,7433026,7432788,238,320,utRho24
blc,8755490,8755490,8755444,46,52,utRho24
blr,3409024,3409102,3409024,78,374,utRho24
bluF,2431226,2431226,2430950,276,532,utRho24
bluR,2428226,2428226,2428118,108,0,utRho24
bolA,908698,908944,908698,246,78,utRho24
borD,1157842,1157842,1157786,56,840,utRho24
brnQ,838976,839182,838976,206,762,utRho24
bssR,1756492,1756496,1756492,4,0,utRho24
bssS,2242116,2242116,2241910,206,158,utRho24
btuB,8326798,8327278,8326798,480,2538,utRho24
cadB,8720212,8720212,8720062,150,472,utRho24
cadC,8723926,8723926,8723868,58,94,utRho24
caiE,70998,70998,70742,256,734,utRho24
caiF,68436,68600,68436,164,2544,utRho24
caiT,84074,84074,83862,212,406,utRho24
can,285406,285406,285340,66,308,utRho24
carA,59102,59302,59102,200,1296,utRho24
carB,61550,61634,61550,84,462,utRho24
cas2,5757830,5757830,5757706,124,440,utRho24
casA,5768638,5768638,5768276,362,130,utRho24
cbl,4121882,4121882,4121828,54,1944,utRho24
cbpA,2128074,2128074,2127550,524,648,utRho24
cbrA,7738628,7738754,7738628,126,110,utRho24
cbrB,7794958,7795012,7794958,54,934,utRho24
ccmH,4585242,4585242,4584820,422,490,utRho24
cdaR,364894,364926,364894,32,80,utRho24
cdd,4463638,4463688,4463638,50,38,utRho24
cdh,8219814,8219860,8219814,46,1360,utRho24
cdsA,391110,391354,391110,244,470,utRho24
cedA,3627484,3627484,3627326,158,690,utRho24
cfa,3482402,3482826,3482402,424,346,utRho24
chaC,2544844,2544972,2544844,128,1412,utRho24
chbB,3643452,3643452,3643238,214,420,utRho24
chbG,3634624,3634624,3634270,354,48,utRho24
cheW,3946924,3946924,3946678,246,178,utRho24
chiA,6939792,6939792,6939706,86,400,utRho24
chiP,1416472,1416668,1416472,196,32,utRho24
cho,3646984,3647030,3646984,46,418,utRho24
chpS,8896804,8896894,8896804,90,8,utRho24
cirA,4493884,4493884,4493538,346,488,utRho24
citC,1304078,1304078,1303712,366,1302,utRho24
citT,1293264,1293264,1293160,104,90,utRho24
clcA,350104,350214,350104,110,46,utRho24
clpA,1846160,1846528,1846160,368,112,utRho24
clpB,5468410,5468410,5468346,64,72,utRho24
clpP,913154,913354,913154,200,178,utRho24
clpS,1845500,1845826,1845500,326,164,utRho24
clpX,914404,914852,914404,448,308,utRho24
clsA,2617346,2617346,2617290,56,372,utRho24
clsC,2212584,2212710,2212584,126,192,utRho24
cmk,1922330,1922402,1922330,72,0,utRho24
cnu,3409522,3409898,3409522,376,1858,utRho24
coaA,8350214,8350214,8350052,162,780,utRho24
cobC,1340092,1340092,1339814,278,580,utRho24
cobT,4129202,4129202,4128934,268,90,utRho24
cobU,4131944,4131944,4131528,416,474,utRho24
codB,709768,709844,709768,76,888,utRho24
comR,2337726,2337726,2337664,62,0,utRho24
copA,1022822,1022822,1022758,64,186,utRho24
corA,8002388,8002852,8002388,464,28730,utRho24
cpdB,8873258,8873258,8873130,128,1014,utRho24
cptB,6082198,6082198,6082140,58,20,utRho24
cpxA,8210202,8210202,8209950,252,712,utRho24
cpxP,8211570,8211640,8211570,70,262,utRho24
cpxR,8211372,8211372,8211340,32,48,utRho24
cra,175894,176056,175894,162,68,utRho24
crcB,1316016,1316016,1315876,140,100,utRho24
creA,9270486,9271042,9270486,556,512,utRho24
creD,9276320,9276356,9276320,36,318,utRho24
crl,515620,515658,515620,38,1918,utRho24
crp,6971906,6972240,6971906,334,1706,utRho24
crr,5070960,5071668,5070960,708,1356,utRho24
csdA,5886414,5886674,5886414,260,92,utRho24
csgB,2207718,2207902,2207718,184,108,utRho24
csgD,2206688,2206688,2206392,296,736,utRho24
csgG,2203510,2203510,2203368,142,600,utRho24
csiD,5577854,5577970,5577854,116,308,utRho24
csiE,5330802,5330870,5330802,68,358,utRho24
csiR,5590942,5591348,5590942,406,364,utRho24
cspA,7439778,7440098,7439778,320,1674,utRho24
cspB,3283430,3283430,3283108,322,68,utRho24
cspC,3815018,3815018,3814870,148,86,utRho24
cspD,1845352,1845352,1845180,172,1982,utRho24
cspE,1314294,1314584,1314294,290,62,utRho24
cspF,3283380,3283710,3283380,330,330,utRho24
cspG,2102610,2102922,2102610,312,304,utRho24
cspH,2102746,2102746,2102350,396,128,utRho24
cspI,3277624,3277624,3277334,290,8,utRho24
csrA,5638746,5638746,5638292,454,450,utRho24
csrB,5849048,5849048,5849048,0,0,utRho24
csrC,8102072,8102072,8102072,0,0,utRho24
csrD,6806850,6806850,6806664,186,174,utRho24
cstA,1259710,1259788,1259710,78,78,utRho24
cueO,274090,274166,274090,76,46,utRho24
cueR,1027948,1027986,1027948,38,14,utRho24
curA,3037784,3038054,3037784,270,1870,utRho24
cusC,1191146,1191200,1191146,54,254,utRho24
cusR,1190924,1190924,1190886,38,276,utRho24
cutA,8730784,8730784,8730712,72,706,utRho24
cutC,3918534,3918534,3917920,614,2272,utRho24
cvpA,4861600,4861600,4861526,74,0,utRho24
cvrA,2484328,2484328,2484142,186,198,utRho24
cyaA,7981548,7982306,7981548,758,624,utRho24
cyaR,4334228,4334224,4334228,4,0,utRho24
cyaY,7988166,7988166,7988118,48,170,utRho24
cybB,2981522,2981804,2981522,282,396,utRho24
cycA,8859560,8859728,8859560,168,496,utRho24
cydA,1542340,1542916,1542340,576,676,utRho24
cydC,1858800,1858800,1858390,410,476,utRho24
cydD,1862062,1862062,1861924,138,4,utRho24
cydX,1548300,1548392,1548300,92,112,utRho24
cynR,717418,717418,717380,38,556,utRho24
cynT,1435092,1435196,1435092,104,112,utRho24
cyoA,903306,903306,903220,86,992,utRho24
cyoE,895540,895540,895410,130,60,utRho24
cysB,2667576,2667710,2667576,134,240,utRho24
cysC,5748056,5748056,5747984,72,234,utRho24
cysD,5752736,5752736,5752658,78,98,utRho24
cysE,7565362,7565362,7565124,238,666,utRho24
cysG,6995508,6995656,6995508,148,4472,utRho24
cysJ,5783928,5783928,5783796,132,5800,utRho24
cysK,5064688,5064818,5064688,130,20,utRho24
cysP,5087114,5087114,5087056,58,616,utRho24
cysS,1109154,1109222,1109154,68,178,utRho24
cysT,3984100,3984100,3983974,126,26,utRho24
cysZ,5062766,5062926,5062766,160,576,utRho24
cytR,8249018,8249018,8248912,106,68,utRho24
dacA,1328002,1328002,1327926,76,28,utRho24
dacB,6657714,6657926,6657714,212,42,utRho24
dacC,1761306,1761454,1761306,148,832,utRho24
dadA,2475018,2475142,2475018,124,92,utRho24
dam,7032504,7032504,7031826,678,1132,utRho24
damX,7035200,7035200,7034612,588,778,utRho24
dapA,5199568,5199568,5199520,48,20,utRho24
dapB,56576,56748,56576,172,948,utRho24
dapD,371954,371954,371894,60,162,utRho24
dapE,5183120,5183214,5183120,94,1010,utRho24
dcp,3254844,3254844,3254760,84,152,utRho24
dcrB,7219534,7219910,7219534,376,1704,utRho24
dctA,7366996,7366996,7366894,102,428,utRho24
dcuA,8733686,8733686,8733546,140,36,utRho24
dcuB,8698182,8698182,8697488,694,4606,utRho24
dcuC,1312166,1312166,1311936,230,2048,utRho24
dcuD,6749166,6749738,6749166,572,870,utRho24
dcuR,8701130,8701130,8700068,1062,1708,utRho24
dcuS,8703370,8703370,8703324,46,1158,utRho24
dcyD,3999016,3999016,3998960,56,0,utRho24
ddpX,3126498,3126498,3126152,346,370,utRho24
deaD,6615818,6615818,6615720,98,636,utRho24
dedA,4869880,4869880,4869482,398,5236,utRho24
dedD,4863750,4863750,4863368,382,172,utRho24
def,6867300,6867380,6867300,80,390,utRho24
degP,361690,361768,361690,78,4,utRho24
degQ,6761308,6761486,6761308,178,4838,utRho24
deoB,9239134,9239206,9239134,72,104,utRho24
deoC,9233358,9234646,9233358,1288,1340,utRho24
dfp,7625406,7625462,7625406,56,0,utRho24
dgcZ,3247758,3247758,3247700,58,8,utRho24
dgkA,8512914,8513274,8512914,360,462,utRho24
dgt,358392,358474,358392,82,1548,utRho24
dhaK,2501888,2501888,2501676,212,394,utRho24
dhaR,2502006,2502132,2502006,126,382,utRho24
dicB,3299194,3299218,3299194,24,60,utRho24
dicC,3295752,3295752,3295700,52,4,utRho24
dinB,501760,501796,501760,36,152,utRho24
dinD,7635398,7635520,7635398,122,464,utRho24
dinG,1666146,1666140,1666146,6,32,utRho24
dinI,2243018,2243018,2242974,44,246,utRho24
dinJ,493230,493230,493004,226,190,utRho24
dinQ,7295964,7295964,7295576,388,932,utRho24
djlA,114536,114728,114536,192,504,utRho24
dkgA,6313142,6313246,6313142,104,424,utRho24
dkgB,458196,458334,458196,138,0,utRho24
dksA,321502,321502,321208,294,322,utRho24
dld,4444164,4444370,4444164,206,32,utRho24
dmlA,3763424,3763824,3763424,400,1486,utRho24
dmlR,3763710,3763710,3763618,92,272,utRho24
dmsA,1881646,1881918,1881646,272,0,utRho24
dnaA,7767922,7767922,7767458,464,352,utRho24
dnaB,8528566,8528628,8528566,62,88,utRho24
dnaK,24096,24326,24096,230,7514,utRho24
dnaN,7765466,7765466,7764642,824,628,utRho24
dnaQ,471868,472134,471868,266,4082,utRho24
dnaT,18406460,18406460,18406068,392,3012,utRho24
dnaX,984112,984184,984112,72,374,utRho24
dosP,3131486,3131486,3131466,20,42,utRho24
dpiB,1303968,1304470,1303968,502,1220,utRho24
dppA,7415740,7415740,7415410,330,2164,utRho24
dps,1697900,1697900,1697822,78,64,utRho24
dsbA,8086754,8086836,8086754,82,640,utRho24
dsbB,2466294,2466294,2466060,234,168,utRho24
dsbC,6079266,6079266,6077644,1622,1182,utRho24
dsbG,1277600,1277600,1277146,454,266,utRho24
dsdA,4958242,4958404,4958242,162,402,utRho24
dsdC,4955492,4955492,4955258,234,372,utRho24
dsdX,4955642,4955694,4955642,52,762,utRho24
dsrA,4050626,4050626,4050626,0,0,utRho24
dsrB,4049686,4049686,4049646,40,442,utRho24
dtpD,1485340,1485340,1485112,228,630,utRho24
dusA,8523200,8523338,8523200,138,2496,utRho24
dusB,6820492,6820560,6820492,68,0,utRho24
dusC,4460790,4460790,4460770,20,0,utRho24
dut,7627704,7627864,7627704,160,708,utRho24
dxr,386670,387042,386670,372,170,utRho24
ebgA,6445102,6445266,6445102,164,148,utRho24
ebgR,6442874,6442932,6442874,58,48,utRho24
ecnB,8753018,8753106,8753018,88,98,utRho24
eco,4607594,4607810,4607594,216,20,utRho24
ecpA,621594,621594,621342,252,768,utRho24
ecpB,620238,620238,620052,186,762,utRho24
ecpR,622964,622964,622672,292,260,utRho24
eda,3866218,3866218,3865512,706,18,utRho24
edd,3869426,3869426,3869208,218,0,utRho24
efeO,2164308,2164486,2164308,178,288,utRho24
efeU_1,2162614,2162712,2162614,98,160,utRho24
efp,8751134,8751398,8751134,264,1842,utRho24
elaA,4763372,4763372,4763086,286,108,utRho24
elaD,4765308,4765426,4765308,118,212,utRho24
elfA,1995530,1995736,1995530,206,130,utRho24
elfD,1996642,1996980,1996642,338,126,utRho24
emrD,7707690,7707844,7707690,154,224,utRho24
emrK,4966896,4966896,4966678,218,334,utRho24
emrY,4964668,4964668,4964352,316,638,utRho24
emtA,2486250,2486360,2486250,110,82,utRho24
endA,12361100,12361388,12361100,288,220,utRho24
eno,5817692,5817692,5815882,1810,2306,utRho24
entC,1249662,1249770,1249662,108,84,utRho24
entD,1220508,1220508,1220158,350,112,utRho24
entH,1258584,1258600,1258584,16,30,utRho24
entS,1244506,1244600,1244506,94,190,utRho24
envR,6827266,6827266,6826930,336,22,utRho24
epd,12295292,12295292,12294764,528,572,utRho24
epmA,8765236,8765286,8765236,50,410,utRho24
epmB,8751406,8751406,8751314,92,872,utRho24
eptB,7421162,7421162,7420950,212,4,utRho24
eptC,8300622,8300622,8300530,92,1676,utRho24
erfK,4126708,4126708,4126646,62,76,utRho24
erpA,353122,353220,353122,98,34,utRho24
esrE,8039956,8039956,8039956,0,0,utRho24
essD,1153746,1154796,1153746,1050,3072,utRho24
etk,2088606,2088606,2088420,186,2250,utRho24
evgA,4967262,4967510,4967262,248,48,utRho24
exbB,6304028,6304028,6303968,60,192,utRho24
exbD,6302780,6302780,6302486,294,124,utRho24
exuR,6493016,6493304,6493016,288,122,utRho24
exuT,6490004,6490208,6490004,204,18,utRho24
fabA,2032996,2032996,2032940,56,128,utRho24
fabB,4883282,4883282,4883210,72,10,utRho24
fabH,2297032,2297518,2297032,486,570,utRho24
fabI,2702236,2702236,2702078,158,218,utRho24
fadB,8062026,8062026,8061942,84,8,utRho24
fadD,3779614,3779614,3779492,122,2,utRho24
fadE,486812,486812,486606,206,160,utRho24
fadH,6463248,6463330,6463248,82,454,utRho24
fadI,4921022,4921022,4920938,84,186,utRho24
fadL,4922410,4922600,4922410,190,382,utRho24
fadM,928720,928804,928720,84,0,utRho24
fadR,2469810,2469876,2469810,66,0,utRho24
fbaB,4357334,4357334,4357128,206,228,utRho24
fdhE,8162722,8162722,8162456,266,830,utRho24
fdhF,8598814,8598814,8598732,82,260,utRho24
fdnG,3094744,3094802,3094744,58,56,utRho24
fdrA,1093012,1093360,1093012,348,402,utRho24
feaB,2894994,2895038,2894994,44,0,utRho24
feaR,2894734,2894734,2894566,168,30,utRho24
fecA,9033454,9033454,9033354,100,230,utRho24
fecE,9023288,9023288,9022914,374,1500,utRho24
fecI,9036564,9036564,9036470,94,838,utRho24
feoA,7080114,7080326,7080114,212,474,utRho24
fepA,1225334,1225334,1224988,346,1484,utRho24
fepB,1249454,1249454,1249020,434,548,utRho24
fepD,1244468,1244468,1244378,90,60,utRho24
fes,1225374,1225630,1225374,256,1648,utRho24
ffh,5495706,5495706,5495590,116,424,utRho24
ffs,952576,952848,952576,272,7634,utRho24
fhuA,334884,334968,334884,84,770,utRho24
fhuE,2323294,2323294,2323102,192,430,utRho24
fhuF,9211504,9211504,9211326,178,48866,utRho24
fic,6983296,6983296,6982926,370,2996,utRho24
fieF,8212864,8212938,8212864,74,454,utRho24
fimA,9085388,9086230,9085388,842,1730,utRho24
fimB,9081334,9081914,9081334,580,5120,utRho24
fimE,9083742,9084074,9083742,332,3222,utRho24
fimZ,1129214,1129214,1128960,254,0,utRho24
fiu,1683296,1683296,1683062,234,70,utRho24
fixA,84650,84806,84650,156,390,utRho24
fkpA,6955050,6955050,6954838,212,1470,utRho24
fldA,2846084,2846084,2845860,224,1196,utRho24
fldB,6079644,6079710,6079644,66,214,utRho24
flgA,2261770,2261770,2261726,44,1926,utRho24
flgB,2261986,2262036,2261986,50,392,utRho24
flgK,2276702,2276756,2276702,54,804,utRho24
flgM,2260330,2260330,2260256,74,74,utRho24
flgN,2259828,2259828,2259660,168,184,utRho24
flhB,3932432,3932432,3932382,50,764,utRho24
flhC,3955864,3955864,3955688,176,306,utRho24
flhD,3957154,3957154,3956394,760,3836,utRho24
fliA,4003638,4003638,4003578,60,60,utRho24
fliC,4007352,4007352,4007212,140,308,utRho24
fliD,4007634,4007744,4007634,110,1858,utRho24
fliE,4026186,4026186,4026028,158,1818,utRho24
fliF,4026292,4026458,4026292,166,1080,utRho24
fliL,4039168,4039236,4039168,68,110,utRho24
flk,4875824,4875900,4875824,76,164,utRho24
flu,4142634,4143078,4142634,444,296,utRho24
flxA,3292776,3292810,3292776,34,398,utRho24
fnr,2799104,2799104,2799052,52,4,utRho24
fnrS,2818258,2818258,2818258,0,0,utRho24
focA,1909628,1909628,1908932,696,516,utRho24
folA,99598,99646,99598,48,170,utRho24
folB,6409296,6409296,6409178,118,208,utRho24
folD,1115562,1115562,1115482,80,138,utRho24
folE,4487696,4487696,4487304,392,1546,utRho24
fpr,8228998,8228998,8228944,54,0,utRho24
frc,4986878,4986878,4986508,370,528,utRho24
frdA,8764824,8764824,8764636,188,1170,utRho24
frdD,8758948,8758948,8758732,216,6848,utRho24
fre,8052886,8053054,8052886,168,568,utRho24
frlA,6999518,6999820,6999518,302,462,utRho24
frr,385624,385744,385624,120,312,utRho24
frsA,513004,513054,513004,50,46,utRho24
fruB,4527194,4527194,4526990,204,0,utRho24
frvR,8179804,8179804,8179710,94,86,utRho24
fryA,5008986,5008986,5008970,16,542,utRho24
fsaA,1727060,1727284,1727060,224,1052,utRho24
fsr,1009710,1009710,1009392,318,292,utRho24
ftnA,3977364,3977432,3977364,68,16,utRho24
ftnB,3973550,3973850,3973550,300,594,utRho24
ftsA,207122,207964,207122,842,828,utRho24
ftsB,5745802,5745802,5745640,162,370,utRho24
ftsH,6654204,6654204,6653870,334,382,utRho24
ftsK,1865858,1866448,1865858,590,650,utRho24
ftsL,181376,182064,181376,688,1844,utRho24
ftsP,6325732,6325732,6325338,394,412,utRho24
ftsQ,205484,206310,205484,826,378,utRho24
ftsX,7204512,7204512,7204172,340,204,utRho24
ftsZ,209272,210610,209272,1338,82,utRho24
fucA,5867708,5867708,5867376,332,4254,utRho24
fucP,5868238,5868470,5868238,232,268,utRho24
fumA,6753760,6753760,6753508,252,1580,utRho24
fumB,8694696,8694696,8694652,44,150,utRho24
fumC,3373418,3373418,3373176,242,90,utRho24
fur,2842892,2842892,2842584,308,1852,utRho24
fusA,6947370,6947370,6947028,342,4758,utRho24
fxsA,8737206,8737328,8737206,122,142,utRho24
gabD,5581824,5582546,5581824,722,7796,utRho24
gadA,7335214,7335214,7335160,54,50,utRho24
gadB,3144144,3144144,3144090,54,548,utRho24
gadC,3141168,3141168,3140978,190,388,utRho24
gadE,7315600,7316732,7315600,1132,3658,utRho24
gadW,7329562,7329562,7329236,326,104,utRho24
gadX,14663356,14663356,14663240,116,1752,utRho24
gadY,7329728,7329728,7329728,0,0,utRho24
galE,1584354,1584354,1584110,244,104,utRho24
galF,4228702,4228702,4228654,48,0,utRho24
galM,1577796,1577796,1577674,122,1016,utRho24
galP,6176510,6176568,6176510,58,0,utRho24
galR,5953138,5953198,5953138,60,70,utRho24
galS,4483420,4483420,4483336,84,48,utRho24
galU,2582810,2582914,2582810,104,206,utRho24
gapA,3724480,3725542,3724480,1062,1260,utRho24
garP,6549868,6549868,6549814,54,998,utRho24
gatY,4354468,4354468,4354408,60,0,utRho24
gatZ,4352864,4352864,4352642,222,7410,utRho24
gcd,282558,282558,282450,108,52,utRho24
gcl,1067814,1067832,1067814,18,10,utRho24
gcvA,5885278,5885278,5885134,144,18,utRho24
gcvB,5885392,5885392,5885392,0,0,utRho24
gcvR,5199758,5199812,5199758,54,68,utRho24
gcvT,6101544,6101544,6101334,210,834,utRho24
gdhA,3684616,3684742,3684616,126,0,utRho24
gfcA,2099668,2099668,2099488,180,1656,utRho24
gfcD,2096236,2096236,2095890,346,3454,utRho24
ghrA,2195648,2195772,2195648,124,84,utRho24
ghrB,7434378,7434620,7434378,242,1938,utRho24
glcA,6242728,6242728,6242558,170,1722,utRho24
glcC,6256412,6256544,6256412,132,268,utRho24
glcD,6256152,6256152,6256042,110,600,utRho24
gldA,8278092,8278092,8278070,22,408,utRho24
glgA,7136784,7136784,7136066,718,1968,utRho24
glgB,7147314,7147314,7147004,310,336,utRho24
glgC,7139142,7139142,7138656,486,600,utRho24
glgP,7133546,7133546,7133162,384,222,utRho24
glgS,6384024,6384024,6383878,146,98,utRho24
glgX,7142838,7142838,7142638,200,44,utRho24
glk,5018922,5018922,5018852,70,158,utRho24
glmS,7827622,7827622,7827336,286,1164,utRho24
glmU,7830652,7830652,7830400,252,56,utRho24
glmY,10765360,10765360,10765360,0,0,utRho24
glmZ,7972864,7972864,7972864,0,0,utRho24
glnA,16232888,16232888,16232136,752,56,utRho24
glnB,5375052,5375052,5374816,236,378,utRho24
glnD,377310,377310,377300,10,78,utRho24
glnE,6399602,6399602,6399282,320,82,utRho24
glnH,1696396,1696396,1696008,388,1242,utRho24
glnK,945112,945196,945112,84,1178,utRho24
glnL,8112742,8112742,8112678,64,0,utRho24
glnQ,1693262,1693262,1692926,336,170,utRho24
glnS,1411998,1412186,1411998,188,1310,utRho24
gloA,3455602,3455674,3455602,72,28,utRho24
gloB,469852,469852,469564,288,1152,utRho24
glpA,4705166,4705294,4705166,128,130,utRho24
glpD,7123942,7124026,7123942,84,298,utRho24
glpE,7123698,7123698,7123646,52,176,utRho24
glpF,8236322,8236322,8236180,142,1492,utRho24
glpG,7122960,7122960,7122904,56,266,utRho24
glpR,7121782,7121782,7121210,572,7080,utRho24
glpT,4704902,4704902,4704748,154,1564,utRho24
glpX,8231212,8231212,8231158,54,370,utRho24
glrK,5382246,5382246,5382196,50,478,utRho24
gltA,1509534,1509534,1508936,598,11706,utRho24
gltB,6709018,6709264,6709018,246,1038,utRho24
gltI,1375792,1375792,1375494,298,2208,utRho24
gltP,8588536,8588962,8588536,426,1180,utRho24
gltS,7657382,7657382,7657330,52,1420,utRho24
gltX,5041568,5041568,5041344,224,322,utRho24
gluQ,320286,320286,320224,62,0,utRho24
glyA,5371148,5371148,5371014,134,328,utRho24
glyQ,7450708,7450708,7450636,72,976,utRho24
glyS,7448990,7448990,7448794,196,724,utRho24
glyU,5998128,5998128,5998114,14,0,utRho24
glyV,8784626,8784720,8784626,94,32,utRho24
glyW,3984360,3984360,3984234,126,0,utRho24
gmhB,445612,445666,445612,54,126,utRho24
gmk,7642776,7642856,7642776,80,34,utRho24
gmr,2693686,2693686,2693484,202,862,utRho24
gnd,4202648,4202648,4202536,112,374,utRho24
gnsB,3275692,3275692,3275564,128,70,utRho24
gntK,14310580,14310580,14310368,212,1460,utRho24
gntP,9102668,9102668,9102592,76,436,utRho24
gntR,7157760,7157760,7157452,308,336,utRho24
gntT,7092810,7093118,7092810,308,2268,utRho24
gntU,7154170,7154170,7154122,48,450,utRho24
gntX,7089334,7089764,7089334,430,164,utRho24
gor,7292224,7292598,7292224,374,286,utRho24
gpmA,1575340,1575340,1575190,150,44,utRho24
gpmM,7570374,7570520,7570374,146,30,utRho24
gpsA,7567620,7567620,7567322,298,1374,utRho24
gpt,511828,511954,511828,126,460,utRho24
grcA,5433046,5433046,5432898,148,2368,utRho24
greA,6657728,6657728,6657430,298,340,utRho24
greB,7073488,7073624,7073488,136,196,utRho24
groL,8741566,8742050,8741566,484,8588,utRho24
groS,8741232,8741376,8741232,144,8068,utRho24
grpE,5501494,5501494,5501416,78,420,utRho24
grxA,1781552,1781552,1781506,46,10,utRho24
grxB,2248206,2248206,2248108,98,1032,utRho24
grxC,7569152,7569152,7568884,268,1194,utRho24
grxD,3468324,3468324,3468202,122,612,utRho24
gspA,6911268,6911268,6910796,472,716,utRho24
gspC,6910964,6911156,6910964,192,270,utRho24
gss,6277220,6277220,6277044,176,500,utRho24
gstA,3428654,3428754,3428654,100,0,utRho24
gstB,1761038,1761038,1760960,78,1240,utRho24
guaB,5268214,5268214,5268140,74,100,utRho24
gudD,5839026,5839026,5838770,256,46,utRho24
gyrA,4678914,4678914,4678840,74,496,utRho24
gyrB,7760300,7760300,7760238,62,90,utRho24
hcaE,5337964,5338064,5337964,100,8690,utRho24
hcaR,5337928,5337928,5337792,136,11052,utRho24
hcaT,5336106,5336106,5335692,414,1056,utRho24
hchA,4071260,4071670,4071260,410,60,utRho24
hcp,1828258,1828258,1827628,630,1676,utRho24
hcr,1824400,1824400,1824300,100,78,utRho24
hdeA,7313582,7313582,7313480,102,158,utRho24
hdeD,7313920,7313990,7313920,70,3066,utRho24
hdfR,7896320,7896320,7895934,386,144,utRho24
hdhA,3396244,3396244,3396080,164,140,utRho24
helD,2048876,2048942,2048876,66,48,utRho24
hemA,2527166,2527428,2527166,262,338,utRho24
hemB,779722,779722,779454,268,4950,utRho24
hemF,5106410,5106450,5106410,40,0,utRho24
hemH,996062,996110,996062,48,1064,utRho24
hemL,349882,349882,349764,118,122,utRho24
hemN,8103886,8104090,8103886,204,394,utRho24
hepA,127176,127176,126528,648,2962,utRho24
hflD,2385372,2385372,2385262,110,200,utRho24
hfq,8799602,8800576,8799602,974,3472,utRho24
hha,961006,961006,960616,390,90,utRho24
hicA,3018442,3018572,3018442,130,38,utRho24
higA,6468682,6468682,6468288,394,2750,utRho24
higB,6468960,6468960,6468910,50,158,utRho24
hinT,2323642,2323770,2323642,128,2,utRho24
hipB,3184964,3184964,3184884,80,184,utRho24
hisB,4186720,4186936,4186720,216,280,utRho24
hisJ,4853674,4853674,4853576,98,132,utRho24
hisL,8359856,8359984,8359856,128,896,utRho24
hisS,5281284,5281284,5281150,134,26,utRho24
hlpA,400910,400964,400910,54,2,utRho24
hlyE,2460932,2460932,2460788,144,1180,utRho24
hmp,5371594,5371670,5371594,76,0,utRho24
hns,2585916,2585916,2585844,72,204,utRho24
hofM,7045856,7045856,7045502,354,128,utRho24
hokA,7441620,7441620,7441200,420,792,utRho24
hokC,33902,33902,33806,96,164,utRho24
hokE,1215462,1215672,1215462,210,88,utRho24
holC,8968546,8968546,8968560,14,272,utRho24
holD,9215562,9215606,9215562,44,38,utRho24
holE,3850040,3850216,3850040,176,2256,utRho24
hpt,282720,282862,282720,142,1614,utRho24
hrpB,324150,324210,324150,60,90,utRho24
hscB,5319048,5319048,5318934,114,730,utRho24
hscC,1367188,1367188,1366786,402,534,utRho24
hsdS,9163004,9163004,9162924,80,350,utRho24
hslJ,2883560,2883560,2883486,74,814,utRho24
hslO,7059344,7059548,7059344,204,12450,utRho24
hslR,7058220,7058696,7058220,476,2690,utRho24
hslV,8244708,8244708,8244574,134,204,utRho24
hsrA,7881412,7881412,7881224,188,282,utRho24
htgA,21286,21660,21286,374,25524,utRho24
htpG,989634,990240,989634,606,23138,utRho24
htpX,3825236,3825236,3825152,84,6,utRho24
htrE,311036,311036,310852,184,1382,utRho24
htrL,7587668,7587668,7587366,302,254,utRho24
hupA,8400352,8400562,8400352,210,22,utRho24
hupB,1845220,1845804,1845220,584,732,utRho24
hyaA,2063968,2064278,2063968,310,146,utRho24
hybO,6292726,6292726,6292522,204,10224,utRho24
hycA,5700922,5700922,5700870,52,248,utRho24
hycI,5686204,5686204,5686086,118,3230,utRho24
hydN,5676264,5676264,5676210,54,92,utRho24
hyfA,5202342,5202402,5202342,60,152,utRho24
hypA,11402508,11402588,11402508,80,624,utRho24
hypB,11403356,11404004,11403356,648,540,utRho24
hypF,5676210,5676210,5674850,1360,8836,utRho24
hypT,9116634,9116634,9116578,56,2,utRho24
hyuA,6019660,6020056,6019660,396,522,utRho24
iaaA,1733074,1733136,1733074,62,158,utRho24
iadA,9119074,9119074,9119052,22,684,utRho24
iap,5753072,5753162,5753072,90,68,utRho24
ibaG,6673966,6673966,6673606,360,164,utRho24
ibpA,7735036,7735036,7734844,192,2314,utRho24
ibpB,7733962,7733962,7733794,168,12620,utRho24
icd,2389922,2390246,2389922,324,182,utRho24
iclR,8447304,8447304,8447256,48,266,utRho24
idi,6065876,6066130,6065876,254,22,utRho24
idnD,8988870,8988870,8988812,58,116,utRho24
idnK,8989194,8989246,8989194,52,908,utRho24
ihfA,3591442,3591442,3591104,338,176,utRho24
ihfB,1927498,1927656,1927498,158,446,utRho24
ileS,43666,44782,43666,1116,2826,utRho24
ileX,6431194,6431196,6431194,2,0,utRho24
ilvA,15820940,15821324,15820940,384,1512,utRho24
ilvC,7915824,7915940,7915824,116,114,utRho24
ilvE,15809552,15809936,15809552,384,976,utRho24
ilvI,170840,171260,170840,420,468,utRho24
ilvL,23701308,23701932,23701308,624,258,utRho24
ilvY,7915734,7915734,7915640,94,132,utRho24
inaA,4698998,4698998,4698944,54,1312,utRho24
infA,1853370,1853370,1852886,484,44,utRho24
infC,3602692,3602692,3601276,1416,1756,utRho24
insA-5,3958452,3958452,3958430,22,122,utRho24
insA-7,9036758,9037054,9036758,296,2698,utRho24
insC-5,6372080,6372284,6372080,204,6470,utRho24
insEF-2,785238,785238,785820,582,3656,utRho24
insEF-4,2190310,2190310,2190892,582,3432,utRho24
insG,9007098,9007098,9006862,236,42,utRho24
insH-1,550596,550596,550234,362,38170,utRho24
insH-11,7306538,7306538,7306396,142,332,utRho24
insH-2,1151548,1151548,1151506,42,268,utRho24
insH-3,1378444,1378444,1378026,418,790,utRho24
insH-4,2791942,2792152,2791942,210,354,utRho24
insH-5,2857852,2857852,2857452,400,790,utRho24
insH-6,4135022,4135022,4134642,380,1668,utRho24
insH-7,4206186,4206186,4205822,364,2516,utRho24
insH-9,6260050,6260356,6260050,306,1944,utRho24
insI-3,9017372,9017372,9017234,138,642,utRho24
insJ,7441188,7441360,7441188,172,322,utRho24
insK,7442130,7442308,7442130,178,40,utRho24
insL-1,30760,30890,30760,130,2054,utRho24
insL-2,1216112,1216130,1216112,18,160,utRho24
insL-3,5028644,5028662,5028644,18,120,utRho24
insN-1,540452,540484,540452,32,208,utRho24
intD,1132202,1132202,1131956,246,19780,utRho24
intR,2826520,2826520,2826470,50,136,utRho24
intS,4933026,4933090,4933026,64,2996,utRho24
intZ,5117386,5117542,5117386,156,7792,utRho24
iraD,9113152,9113986,9113152,834,708,utRho24
iraM,2424246,2424246,2424006,240,56,utRho24
iraP,802638,802772,802638,134,4,utRho24
iscA,5319924,5319924,5319772,152,494,utRho24
iscR,5324398,5324398,5324262,136,4314,utRho24
iscX,5313834,5313834,5313472,362,1088,utRho24
ispF,5743968,5743968,5743560,408,2058,utRho24
ispG,5283908,5283908,5283608,300,180,utRho24
ispU,389568,389806,389568,238,28,utRho24
isrA,2811502,2811502,2811618,116,20,utRho24
istr-1,7706384,7706384,7706384,0,0,utRho24
istr-2,7706514,7706514,7706514,0,0,utRho24
ivbL,15412092,15412092,15411952,140,292,utRho24
ivy,480638,480686,480638,48,288,utRho24
katE,3627628,3627734,3627628,106,610,utRho24
katG,8267624,8267670,8267624,46,104,utRho24
kbaZ,6557732,6557828,6557732,96,0,utRho24
kbl,7585154,7585154,7585102,52,532,utRho24
kch,2621046,2621046,2620538,508,552,utRho24
kdgR,3820506,3820506,3820198,308,52,utRho24
kdpE,1443788,1443788,1443466,322,254,utRho24
kdpF,1457698,1457698,1457642,56,186,utRho24
kdsA,2535708,2536330,2535708,622,966,utRho24
kdsC,6683438,6684546,6683438,1108,3862,utRho24
kduI,5968388,5968388,5968248,140,23528,utRho24
kefF,94160,94492,94160,332,3618,utRho24
kgtP,5451624,5451624,5451492,132,214,utRho24
kup,7862206,7862632,7862206,426,408,utRho24
lacI,735076,735076,735020,56,280,utRho24
lacZ,1465508,1465508,1465220,288,2168,utRho24
ldcA,2486394,2486394,2486160,234,552,utRho24
ldhA,2885830,2885830,2885686,144,38,utRho24
ldrA,2538954,2538954,2538550,404,1612,utRho24
ldrB,2540024,2540024,2539620,404,410,utRho24
ldrC,2541092,2541092,2540690,402,564,utRho24
ldrD,7400544,7400544,7400174,370,592,utRho24
lepA,5414392,5414392,5414248,144,154,utRho24
lepB,5410928,5410928,5410618,310,156,utRho24
leuD,159188,159188,158906,282,142,utRho24
leuE,3761600,3761600,3761518,82,236,utRho24
leuL,168048,168048,167416,632,192,utRho24
leuO,168308,168736,168308,428,12,utRho24
leuQ,9212864,9212864,9212802,62,0,utRho24
leuU,6644556,6644556,6644316,240,326,utRho24
leuV,9212546,9212546,9212330,216,518,utRho24
leuX,8992772,8992810,8992772,38,22,utRho24
lexA,8514174,8514230,8514174,56,356,utRho24
lhr,3456706,3458174,3456706,1468,5094,utRho24
ligA,5060402,5060402,5060352,50,0,utRho24
ligB,7642576,7642576,7642340,236,794,utRho24
lipA,1320602,1320602,1320432,170,362,utRho24
lipB,1324802,1324802,1324556,246,7644,utRho24
lit,2397032,2397390,2397032,358,3918,utRho24
livJ,7199524,7199524,7199316,208,2100,utRho24
livK,7195510,7195510,7195120,390,990,utRho24
lldP,7554578,7554798,7554578,220,2934,utRho24
lnt,1381968,1381968,1381762,206,484,utRho24
loiP,6163784,6163826,6163784,42,28,utRho24
lolA,1874656,1874738,1874656,82,150,utRho24
lolB,2527112,2527112,2527000,112,212,utRho24
lolC,2350748,2350854,2350748,106,76,utRho24
lon,917630,917776,917630,146,56,utRho24
lpcA,486936,487086,486936,150,148,utRho24
lpd,255434,255824,255434,390,936,utRho24
lplA,9248476,9248476,9248234,242,1030,utRho24
lplT,5947878,5947878,5947724,154,104,utRho24
lpoA,6586422,6586800,6586422,378,976,utRho24
lpp,3514592,3514842,3514592,250,250,utRho24
lptA,6686598,6686760,6686598,162,792,utRho24
lptB,6686792,6687888,6686792,1096,1680,utRho24
lptD,114672,114672,114218,454,2198,utRho24
lptF,8972244,8972436,8972244,192,102,utRho24
lpxC,213016,213114,213016,98,1280,utRho24
lpxD,401920,401942,401920,22,0,utRho24
lpxL,2233418,2233418,2233164,254,30,utRho24
lpxM,3880456,3880456,3880386,70,34,utRho24
lpxP,4991156,4991290,4991156,134,630,utRho24
lrhA,4813312,4813312,4813282,30,6,utRho24
lrp,1864656,1865190,1864656,534,634,utRho24
lspA,50028,50414,50028,386,428,utRho24
lsrA,3202920,3202980,3202920,60,112,utRho24
lsrR,3202514,3202514,3202482,32,0,utRho24
ltaE,1818640,1818640,1818588,52,68,utRho24
luxS,5630130,5630130,5629466,664,5286,utRho24
lysA,5957902,5957902,5957798,104,136,utRho24
lysC,8467232,8467232,8466466,766,2084,utRho24
lysP,4497120,4497120,4497064,56,226,utRho24
lysR,5957900,5958042,5957900,142,78,utRho24
lysT,1561028,1561108,1561028,80,62,utRho24
lysU,8709610,8709610,8709434,176,198,utRho24
macB,1840188,1840694,1840188,506,884,utRho24
maeA,3111484,3111484,3111338,146,1814,utRho24
mak,820236,820288,820236,52,54,utRho24
malE,8492928,8492928,8492838,90,2,utRho24
malI,3398456,3398456,3398360,96,38,utRho24
malK,8493472,8493568,8493472,96,210,utRho24
malP,7105020,7105020,7104946,74,1192,utRho24
malQ,7100798,7100798,7100140,658,372,utRho24
malS,14949880,14949988,14949880,108,4,utRho24
malT,7106048,7106170,7106048,122,288,utRho24
malX,3398626,3398710,3398626,84,0,utRho24
malZ,1689980,1690072,1689980,92,1288,utRho24
manA,3377102,3377152,3377102,50,44,utRho24
manX,3803866,3804096,3803866,230,326,utRho24
marC,3237882,3237882,3237816,66,350,utRho24
marR,3238186,3238240,3238186,54,342,utRho24
matP,2036918,2036970,2036918,52,92,utRho24
mazE,5822736,5822736,5822678,58,60,utRho24
mazG,5821720,5821720,5821370,350,4472,utRho24
mcbA,1684306,1684306,1684112,194,210,utRho24
mcbR,3040192,3040524,3040192,332,92,utRho24
mcrA,2420278,2420692,2420278,414,430,utRho24
mcrC,9156124,9156124,9155916,208,1292,utRho24
mdaB,6344814,6345060,6344814,246,202,utRho24
mdfA,1767138,1767346,1767138,208,0,utRho24
mdh,6768940,6768940,6768536,404,324,utRho24
mdoB,9198988,9198988,9198882,106,4660,utRho24
mdoD,2993290,2993712,2993290,422,212,utRho24
mdoG,2218514,2218670,2218514,156,256,utRho24
mdtA,4307958,4308032,4307958,74,20,utRho24
mdtE,7318168,7318464,7318168,296,2784,utRho24
mdtK,3486538,3486914,3486538,376,4366,utRho24
mdtP,8602472,8602472,8602060,412,2892,utRho24
melA,8683774,8683822,8683774,48,16,utRho24
melR,8683300,8683300,8683256,44,1414,utRho24
menA,8240812,8240812,8240698,114,58,utRho24
menB,4753774,4753774,4753638,136,532,utRho24
mepH,3468714,3468870,3468714,156,0,utRho24
mepM,3883666,3883666,3883270,396,140,utRho24
mepS,4539840,4539958,4539840,118,190,utRho24
metA,8428318,8428560,8428318,242,160,utRho24
metB,8257272,8257344,8257272,72,826,utRho24
metC,6304150,6304472,6304150,322,480,utRho24
metE,8025768,8026106,8025768,338,3030,utRho24
metF,8265092,8265232,8265092,140,172,utRho24
metG,4388538,4388600,4388538,62,100,utRho24
metH,8447010,8447656,8447010,646,4450,utRho24
metJ,8257116,8257116,8256790,326,350,utRho24
metK,6173154,6173412,6173154,258,98,utRho24
metN,445428,445428,445290,138,30,utRho24
metR,8025710,8025710,8025632,78,36,utRho24
metT,1394326,1394326,1394266,60,224,utRho24
metY,19910250,19910250,19909734,516,474,utRho24
metZ,11789528,11789548,11789528,20,196,utRho24
mfd,2348056,2348056,2347928,128,136,utRho24
mglA,4478782,4478782,4478578,204,300,utRho24
mglB,4481132,4481132,4480696,436,9380,utRho24
mglC,4475918,4475918,4475506,412,310,utRho24
mgrB,3817584,3817584,3817532,52,82,utRho24
mgrR,3245828,3245828,3245828,0,0,utRho24
mgsA,2054082,2054082,2054030,52,30,utRho24
mgtL,8934560,8934862,8934560,302,122,utRho24
mhpA,737038,737222,737038,184,674,utRho24
mhpR,737072,737072,736840,232,350,utRho24
mhpT,750772,750918,750772,146,168,utRho24
miaA,8797964,8798504,8797964,540,1694,utRho24
micA,5629604,5629604,5629604,0,0,utRho24
micC,2874242,2874238,2874242,4,0,utRho24
micF,4626168,4626168,4626168,0,0,utRho24
micM,1014408,1014408,1014408,0,0,utRho24
minE,2449422,2449422,2449090,332,314,utRho24
mioC,7852950,7852950,7852910,40,0,utRho24
mipA,3733012,3733012,3732944,68,848,utRho24
mlaA,4930270,4930270,4930014,256,56,utRho24
mlc,3337206,3337206,3337128,78,292,utRho24
mlrA,4429498,4429732,4429498,234,490,utRho24
mltA,5894546,5894546,5894356,190,320,utRho24
mltD,468050,468050,467910,140,78,utRho24
mltF,5391534,5391602,5391534,68,0,utRho24
mmuP,550238,550650,550238,412,46098,utRho24
mngA,1531622,1531968,1531622,346,684,utRho24
mngR,1531852,1531852,1531750,102,448,utRho24
mnmG,7851348,7851348,7851266,82,2408,utRho24
mntH,5025470,5025470,5025412,58,16,utRho24
mntP,3810918,3811376,3810918,458,1938,utRho24
mntR,1706160,1706366,1706160,206,36,utRho24
mntS,1706128,1706128,1705994,134,36,utRho24
moaA,1633654,1634088,1633654,434,2318,utRho24
moaB,1635954,1636110,1635954,156,1796,utRho24
mobA,8084242,8084242,8083998,244,320,utRho24
mocA,6030112,6030320,6030112,208,122,utRho24
modA,1589990,1590178,1589990,188,174,utRho24
moeA,1732788,1732788,1732728,60,184,utRho24
mokB,2984610,2984610,2984258,352,688,utRho24
molR_1,4392888,4392948,4392888,60,218,utRho24
motA,3954604,3954604,3954278,326,124,utRho24
mpaA,2781278,2781278,2781196,82,750,utRho24
mpl,8911456,8911570,8911456,114,304,utRho24
mppA,2786108,2786454,2786108,346,128,utRho24
mprA,5621494,5621540,5621494,46,686,utRho24
mqo,4613848,4613848,4613508,340,988,utRho24
mqsA,6336742,6336742,6336492,250,438,utRho24
mqsR,6337306,6337306,6337088,218,1254,utRho24
mraZ,179192,179268,179192,76,100,utRho24
mrcA,7045652,7045742,7045652,90,86,utRho24
mrcB,329442,329460,329442,18,0,utRho24
mreB,13605424,13605424,13604348,1076,620,utRho24
mreD,6798166,6798166,6797750,416,168,utRho24
mrp,4388360,4388360,4388336,24,50,utRho24
mscK,972984,973072,972984,88,188,utRho24
mscL,6876002,6876048,6876002,46,772,utRho24
mscS,6139742,6139742,6139614,128,426,utRho24
msrA,8884522,8884522,8884352,170,1272,utRho24
msrB,3725168,3725168,3724858,310,0,utRho24
msyB,2228426,2228426,2228362,64,308,utRho24
mtfA,4087236,4087302,4087236,66,402,utRho24
mtgA,6699662,6699662,6699618,44,1844,utRho24
mtlA,30177504,30178248,30177504,744,8664,utRho24
mtn,358366,358366,358306,60,3036,utRho24
mtr,6611864,6611864,6611634,230,146,utRho24
mug,6430992,6430992,6430946,46,76,utRho24
murQ,5091466,5091546,5091466,80,64,utRho24
murR,5091586,5091586,5091218,368,236,utRho24
mutH,5939164,5939324,5939164,160,396,utRho24
mutL,8794092,8794824,8794092,732,4666,utRho24
mutM,7622554,7622554,7622304,250,88,utRho24
mutS,5714038,5714186,5714038,148,1864,utRho24
mutY,18617466,18618078,18617466,612,1068,utRho24
nac,4123956,4123956,4123866,90,1014,utRho24
nadA,1564122,1564170,1564122,48,26,utRho24
nadB,5420714,5420840,5420714,126,342,utRho24
nadC,237326,237326,237290,36,312,utRho24
nadE,3644604,3644916,3644604,312,826,utRho24
nadK,5501526,5501662,5501526,136,296,utRho24
nagA,1406350,1406350,1405502,848,2796,utRho24
nagB,1407416,1407416,1407222,194,250,utRho24
nagC,1404016,1404016,1403188,828,256,utRho24
nagE,1407680,1407888,1407680,208,344,utRho24
nagK,2357080,2357186,2357080,106,88,utRho24
nanA,6747240,6747240,6747152,88,1690,utRho24
nanC,9079856,9079856,9079002,854,890,utRho24
nanR,6749406,6749406,6748978,428,1524,utRho24
nanS,9075406,9075406,9075188,218,130,utRho24
napF,4607390,4607390,4606994,396,248,utRho24
narG,2559614,2559728,2559614,114,1130,utRho24
narK,2555642,2555914,2555642,272,584,utRho24
narP,4580844,4581000,4580844,156,352,utRho24
narQ,5171154,5171462,5171154,308,624,utRho24
narU,3088326,3088326,3088120,206,640,utRho24
narW,3077374,3077374,3074618,2756,4506,utRho24
narX,2555554,2555554,2555236,318,348,utRho24
narZ,3085380,3085380,3085180,200,68,utRho24
ndh,2331984,2332170,2331984,186,776,utRho24
ndk,5289920,5289920,5289728,192,694,utRho24
nemR,6904084,6904092,6904084,8,2176,utRho24
nepI,7683542,7683542,7683478,64,352,utRho24
nfo,4501612,4501680,4501612,68,114,utRho24
nfsB,1210906,1210906,1210848,58,178,utRho24
nfuA,7090916,7091248,7090916,332,526,utRho24
nhaA,34634,34978,34634,344,830,utRho24
nhaB,2469534,2469534,2469434,100,224,utRho24
nhoA,3067926,3068048,3067926,122,28,utRho24
nikA,7226878,7227334,7226878,456,5032,utRho24
nikR,7237074,7237176,7237074,102,118,utRho24
nirB,6987974,6988022,6987974,48,156,utRho24
nlpA,7680034,7680034,7679986,48,56,utRho24
nlpC,3585654,3585654,3585462,192,70,utRho24
nlpD,5737658,5737658,5737506,152,130,utRho24
nlpI,6618080,6618080,6617848,232,0,utRho24
nmpC,1153740,1153740,1153650,90,22,utRho24
nohA,3273206,3273206,3272734,472,1846,utRho24
norR,5664614,5664614,5664578,36,108,utRho24
norV,5664878,5664952,5664878,74,144,utRho24
nrdA,4689510,4689730,4689510,220,6126,utRho24
nrdD,8925676,8925676,8925320,356,3126,utRho24
nrdH,5601312,5601446,5601312,134,522,utRho24
nrdR,865954,866004,865954,50,142,utRho24
nrfA,8575342,8575528,8575342,186,0,utRho24
nsrR,8812088,8812380,8812088,292,5112,utRho24
nudB,3897348,3897348,3897264,84,0,utRho24
nudC,8393428,8393806,8393428,378,580,utRho24
nudE,7052658,7052658,7052298,360,1686,utRho24
nudG,3682876,3682980,3682876,104,68,utRho24
nudI,4729050,4729108,4729050,58,92,utRho24
nudJ,2388874,2388874,2388576,298,434,utRho24
nuoA,4810670,4810670,4810144,526,1078,utRho24
nuoN,4783434,4783434,4783010,424,734,utRho24
nupC,5026018,5026084,5026018,66,0,utRho24
nupG,6211302,6211428,6211302,126,292,utRho24
ogrK,4335096,4335096,4335040,56,0,utRho24
ogt,2800568,2800568,2800472,96,346,utRho24
ohsC,5401036,5401040,5401036,4,0,utRho24
ompA,2040382,2040382,2040106,276,9638,utRho24
ompC,4625774,4625774,4625498,276,214,utRho24
ompF,1974184,1974184,1973964,220,0,utRho24
ompL,8128958,8128958,8128590,368,604,utRho24
ompN,2874158,2874158,2873786,372,36,utRho24
ompR,7073510,7073510,7073168,342,352,utRho24
ompT,1171330,1171330,1171266,64,70,utRho24
ompW,2627982,2628040,2627982,58,34,utRho24
ompX,1700418,1700900,1700418,482,556,utRho24
omrA,5952378,5952378,5952378,0,0,utRho24
omrB,5952770,5952770,5952770,0,0,utRho24
oppA,2602170,2602364,2602170,194,4374,utRho24
orn,8783168,8783208,8783168,40,156,utRho24
osmB,2686952,2686952,2686656,296,1882,utRho24
osmC,3113192,3113250,3113192,58,196,utRho24
osmE,3644566,3644566,3644512,54,202,utRho24
osmF,4439046,4439046,4438962,84,2308,utRho24
osmY,9222306,9222792,9222306,486,328,utRho24
otsA,3963302,3963302,3963224,78,568,utRho24
otsB,3964930,3964930,3964774,156,900,utRho24
oxc,4984288,4984288,4983900,388,2700,utRho24
oxyR,8316914,8316980,8316914,66,2228,utRho24
oxyS,8316788,8316788,8316788,0,0,utRho24
paaA,2907730,2907854,2907730,124,0,utRho24
paaX,2927018,2927078,2927018,60,0,utRho24
paaZ,2907340,2907340,2907284,56,14,utRho24
pabA,6981702,6981702,6981658,44,122,utRho24
pabB,3789256,3789610,3789256,354,906,utRho24
pabC,2306186,2306600,2306186,414,300,utRho24
pagP,1313052,1313114,1313052,62,2,utRho24
panB,299260,299260,299202,58,7374,utRho24
panC,297840,297840,297590,250,434,utRho24
panD,293490,293490,293388,102,70,utRho24
panZ,7195656,7195968,7195656,312,250,utRho24
parC,6332060,6332060,6331946,114,368,utRho24
patA,6438916,6438988,6438916,72,166,utRho24
patD,3030830,3031156,3030830,326,412,utRho24
pbpC,5294986,5294986,5294650,336,106,utRho24
pbpG,4450132,4450132,4449740,392,4,utRho24
pck,7065358,7065636,7065358,278,3534,utRho24
pcnB,318782,318782,318252,530,450,utRho24
pdhR,244068,244184,244068,116,24,utRho24
pdxB,4875768,4875768,4875702,66,124,utRho24
pdxH,3436068,3436068,3436014,54,88,utRho24
pdxJ,5403626,5403626,5403458,168,134,utRho24
pdxK,5074638,5074638,5074474,164,22,utRho24
pepA,8972278,8972278,8971902,376,106,utRho24
pepD,511618,511618,511432,186,886,utRho24
pepN,1981182,1981244,1981182,62,356,utRho24
pepQ,8062294,8062322,8062294,28,2,utRho24
pepT,2371646,2371688,2371646,42,218,utRho24
pfkA,8214948,8215104,8214948,156,806,utRho24
pfkB,3612646,3612740,3612646,94,106,utRho24
pflA,1902456,1902456,1902160,296,26,utRho24
pflB,1907850,1907850,1907108,742,1160,utRho24
pflD,8287716,8287990,8287716,274,72,utRho24
pgaA,2185046,2185046,2184578,468,598,utRho24
pgi,8467444,8467516,8467444,72,32,utRho24
pgk,12291428,12291428,12290488,940,3884,utRho24
pgl,1597078,1597172,1597078,94,106,utRho24
pgpB,2678324,2678660,2678324,336,646,utRho24
pgpC,5397276,5397276,5397100,176,212,utRho24
pgrR,2783744,2783982,2783744,238,722,utRho24
pheL,5475158,5475198,5475158,40,24,utRho24
pheM,7197204,7197204,7197080,124,56,utRho24
pheP,1203858,1203918,1203858,60,586,utRho24
pheU,8725254,8725254,8725252,2,0,utRho24
pheV,6220730,6220732,6220730,2,0,utRho24
phnC,8650412,8650412,8650330,82,440,utRho24
phoA,803414,803494,803414,80,396,utRho24
phoB,834202,834284,834202,82,56,utRho24
phoE,520316,520316,520200,116,1932,utRho24
phoH,2169730,2169984,2169730,254,712,utRho24
phoP,2381016,2381016,2380894,122,2564,utRho24
phoQ,2379880,2379880,2379552,328,562,utRho24
phoU,7815330,7815330,7815156,174,244,utRho24
phr,1478842,1479014,1478842,172,432,utRho24
pinE,2419054,2419370,2419054,316,1586,utRho24
pinQ,3267168,3267244,3267168,76,572,utRho24
pinR,2867424,2867424,2867348,76,614,utRho24
pitA,7275224,7275284,7275224,60,56,utRho24
pitB,6272806,6272806,6272742,64,1110,utRho24
pka,5439862,5439906,5439862,44,566,utRho24
plaP,4174476,4174476,4174124,352,270,utRho24
pldA,8009628,8009724,8009628,96,2760,utRho24
pldB,8018028,8018340,8018028,312,4478,utRho24
plsB,8513196,8513196,8512932,264,394,utRho24
pmbA,8915890,8915918,8915890,28,52,utRho24
pmrD,4747148,4747148,4747076,72,86,utRho24
pncB,1980828,1980828,1980712,116,100,utRho24
pncC,5648788,5648788,5648692,96,0,utRho24
pnp,6622652,6622652,6622336,316,2,utRho24
pntA,3355950,3355950,3355806,144,82,utRho24
pntB,3353096,3353096,3352720,376,480,utRho24
polA,8093880,8093932,8093880,52,350,utRho24
polB,131606,131606,131560,46,0,utRho24
potD,2365700,2365700,2365658,42,78,utRho24
potE,1436688,1436688,1436530,158,118,utRho24
potF,1787268,1787568,1787268,300,816,utRho24
poxB,1822152,1822152,1822098,54,616,utRho24
ppa,8899372,8899372,8899304,68,0,utRho24
ppc,8306380,8306380,8306196,184,1678,utRho24
ppdA,5928440,5928440,5928354,86,2862,utRho24
ppdD,235410,235410,235098,312,196,utRho24
pphA,3846770,3846770,3845938,832,3326,utRho24
pphB,5719474,5719520,5719474,46,168,utRho24
ppiA,6984898,6984898,6984594,304,48,utRho24
ppiC,7919682,7919682,7919626,56,72,utRho24
ppiD,923638,923830,923638,192,156,utRho24
ppk,5245748,5246088,5245748,340,636,utRho24
pppA,6228958,6228958,6228704,254,354,utRho24
ppsA,3574322,3574322,3574224,98,0,utRho24
ppsR,3574678,3574890,3574678,212,294,utRho24
pptA,3065716,3066104,3065716,388,1604,utRho24
pqiA,2023318,2024002,2023318,684,70,utRho24
prc,3830054,3830054,3829632,422,4268,utRho24
preT,4467978,4468066,4467978,88,1728,utRho24
prfC,9218688,9218828,9218688,140,364,utRho24
prkB,6968622,6968980,6968622,358,2348,utRho24
prlC,7290476,7290476,7290364,112,720,utRho24
prlF,6553944,6554004,6553944,60,1080,utRho24
proB,520432,520776,520432,344,1482,utRho24
proC,811372,811372,811288,84,0,utRho24
proK,7417388,7417388,7417384,4,0,utRho24
proL,4572414,4572422,4572414,8,8,utRho24
proP,8660640,8661004,8660640,364,734,utRho24
proS,437674,437674,437550,124,596,utRho24
proV,5609126,5609630,5609126,504,1510,utRho24
prpB,697292,697364,697292,72,188,utRho24
prpR,696942,696942,696886,56,56,utRho24
prs,2524354,2524354,2523750,604,11914,utRho24
psd,8781276,8781276,8780720,556,1582,utRho24
psiE,8480600,8480650,8480600,50,80,utRho24
pspA,2736076,2736158,2736076,82,12,utRho24
pspF,2736080,2736080,2735824,256,76,utRho24
pspG,8525632,8525680,8525632,48,64,utRho24
pssA,5445156,5445454,5445156,298,3516,utRho24
pstB,7817112,7817112,7816732,380,60,utRho24
pstC,7821084,7821084,7820796,288,188,utRho24
pstS,23469408,23469408,23469150,258,120,utRho24
psuG,4517114,4517114,4516734,380,5642,utRho24
psuT,4514992,4514992,4514670,322,150,utRho24
pth,2517084,2517084,2517026,58,20,utRho24
ptrA,5918022,5918022,5917768,254,0,utRho24
ptrB,3857730,3857730,3857678,52,2980,utRho24
ptsG,2315252,2315738,2315252,486,1118,utRho24
ptsH,5066996,5067528,5066996,532,1540,utRho24
purA,8809328,8809374,8809328,46,8,utRho24
purC,5195562,5195562,5195236,326,286,utRho24
purD,8411972,8411972,8411862,110,310,utRho24
purE,1106284,1106284,1106200,84,512,utRho24
purH,8415254,8415254,8415064,190,146,utRho24
purL,5391178,5391178,5391086,92,416,utRho24
purM,5242306,5242394,5242306,88,168,utRho24
purR,3475378,3475688,3475378,310,34,utRho24
purT,3861438,3861762,3861438,324,432,utRho24
purU,2577512,2577512,2577248,264,154,utRho24
putA,2157850,2157850,2157764,86,88,utRho24
putP,2158336,2158610,2158336,274,116,utRho24
puuA,2721936,2721936,2721816,120,0,utRho24
puuC,2725456,2725486,2725456,30,26,utRho24
puuD,2722104,2722240,2722104,136,34,utRho24
puuP,2718746,2718746,2718374,372,1138,utRho24
pykA,3874988,3875298,3874988,310,398,utRho24
pykF,3510934,3511396,3510934,462,1654,utRho24
pyrC,2245286,2245286,2245214,72,8,utRho24
pyrD,2009464,2009536,2009464,72,472,utRho24
pyrE,7631970,7631970,7631536,434,344,utRho24
pyrF,2683740,2683842,2683740,102,210,utRho24
pyrG,5819594,5819594,5819332,262,1338,utRho24
pyrH,383624,383710,383624,86,266,utRho24
pyrL,8945490,8945490,8945066,424,440,utRho24
qmcA,1031646,1031646,1031546,100,502,utRho24
qor,8528608,8528608,8528462,146,194,utRho24
qseB,6339502,6339656,6339502,154,1680,utRho24
queA,849970,850022,849970,52,380,utRho24
queE,5811212,5811212,5810836,376,182,utRho24
queF,5850642,5850696,5850642,54,0,utRho24
queG,8788184,8788184,8788134,50,48862,utRho24
racC,2835630,2835630,2835526,104,34,utRho24
racR,2840898,2840898,2840482,416,1168,utRho24
raiA,5474208,5474308,5474208,100,84,utRho24
rarD,8008594,8008594,8008356,238,764,utRho24
ravA,7862256,7862256,7862186,70,86,utRho24
rayT,495088,495274,495088,186,350,utRho24
rbn,4763162,4763216,4763162,54,20,utRho24
rbsD,7866644,7866702,7866644,58,0,utRho24
rcnA,4371654,4371834,4371654,180,346,utRho24
rcnB,4373768,4373920,4373768,152,106,utRho24
rcnR,4371806,4371806,4371592,214,634,utRho24
rcsA,4047672,4047936,4047672,264,5606,utRho24
rcsB,4631390,4632354,4631390,964,752,utRho24
rcsC,4640162,4640162,4639656,506,244,utRho24
rcsD,4626904,4626976,4626904,72,266,utRho24
rdgB,6193240,6193362,6193240,122,586,utRho24
rdlA,2538646,2538646,2538646,0,0,utRho24
rdlB,2539712,2539716,2539712,4,34,utRho24
rdlC,2540782,2540786,2540782,4,24,utRho24
rdlD,7400272,7400272,7400272,0,0,utRho24
rdoA,8084782,8084830,8084782,48,92,utRho24
recA,11295276,11295276,11295076,200,84,utRho24
recC,5925014,5925014,5924856,158,56,utRho24
recF,7763722,7763722,7762442,1280,3990,utRho24
recN,5503518,5503590,5503518,72,28,utRho24
recQ,8011666,8011728,8011666,62,84,utRho24
relA,5828554,5828554,5827302,1252,588,utRho24
relB,3291806,3291806,3291744,62,134,utRho24
rem,3289950,3289950,3289804,146,142,utRho24
rep,7921294,7921354,7921294,60,210,utRho24
rfaD,7587730,7587974,7587730,244,1122,utRho24
rfaE,6393852,6393852,6393506,346,392,utRho24
rfaH,8049930,8049930,8049642,288,1762,utRho24
rfbX,4219436,4219436,4219168,268,890,utRho24
rfe,7935600,7935832,7935600,232,66,utRho24
rhaB,8194944,8194944,8194896,48,64,utRho24
rhaD,8188770,8188770,8188544,226,58,utRho24
rhaS,8195422,8195472,8195422,50,48,utRho24
rhaT,8201132,8201132,8201050,82,246,utRho24
rhlE,1661566,1661744,1661566,178,402,utRho24
rhoL,47593944,47594772,47593944,828,52116,utRho24
rhsB,7238006,7238384,7238006,378,1170,utRho24
rhsC,1458758,1459166,1458758,408,4,utRho24
rhsD,1046132,1046522,1046132,390,252,utRho24
rhtA,1700608,1700608,1700194,414,810,utRho24
rhtC,8015478,8015514,8015478,36,1354,utRho24
ribA,2678468,2678468,2678320,148,424,utRho24
ribC,3486916,3486916,3486484,432,7530,utRho24
ribE,869008,869294,869008,286,1880,utRho24
ribF,42766,42814,42766,48,154,utRho24
ridA,8941892,8941892,8941826,66,76,utRho24
rihA,1369204,1369204,1368824,380,5524,utRho24
rihB,4510504,4510504,4510372,132,170,utRho24
rimJ,2251044,2251124,2251044,80,160,utRho24
rimK,1783752,1783934,1783752,182,638,utRho24
rimL,2997486,2997876,2997486,390,86,utRho24
rimO,1756140,1756140,1756070,70,96,utRho24
rimP,6636350,6636350,6636012,338,298,utRho24
rlmA,3814172,3814172,3814120,52,254,utRho24
rlmD,5830086,5830086,5830000,86,42,utRho24
rlmE,6655520,6655520,6655328,192,534,utRho24
rlmF,1684384,1684664,1684384,280,896,utRho24
rlmG,6471784,6471784,6471750,34,124,utRho24
rlmI,2060002,2060002,2059938,64,100,utRho24
rlmJ,7290700,7290770,7290700,70,0,utRho24
rlmL,2015344,2015688,2015344,344,1968,utRho24
rlpA,1330444,1330444,1330380,64,210,utRho24
rluA,120900,120900,120692,208,820,utRho24
rluF,8460324,8460708,8460324,384,276,utRho24
rmf,2031006,2031430,2031006,424,638,utRho24
rna,1290068,1290068,1290006,62,0,utRho24
rnb,2698258,2698258,2697824,434,3942,utRho24
rnc,10816892,10816892,10816252,640,7100,utRho24
rnd,3776122,3776122,3775982,140,2,utRho24
rne,2289746,2289746,2288734,1012,3416,utRho24
rnhA,472082,472082,472004,78,1538,utRho24
rnk,1288360,1288360,1287934,426,60,utRho24
rnlA,5531788,5531836,5531788,48,1324,utRho24
rnlB,5533414,5533968,5533414,554,1440,utRho24
rnpB,19623552,19623552,19623552,0,0,utRho24
rob,9270706,9270706,9270620,86,130,utRho24
rodZ,5285868,5285868,5285688,180,144,utRho24
rpe,7030306,7030306,7030118,188,172,utRho24
rph,15266320,15266320,15266196,124,344,utRho24
rpiA,6118706,6118706,6118650,56,1524,utRho24
rpiB,8626514,8626700,8626514,186,742,utRho24
rpiR,8626274,8626274,8625982,292,278,utRho24
rplJ,8359246,8359992,8359246,746,1262,utRho24
rplK,8356708,8356894,8356708,186,58,utRho24
rplM,6757344,6757344,6757302,42,732,utRho24
rplN,6896444,6896444,6896298,146,342,utRho24
rplS,5489284,5489284,5489060,224,1466,utRho24
rplT,7199052,7199052,7198996,56,72,utRho24
rplU,6667036,6667036,6666902,134,126,utRho24
rplY,4564866,4565034,4564866,168,184,utRho24
rpmA,6666450,6666450,6666238,212,48,utRho24
rpmB,15247980,15247980,15246696,1284,16536,utRho24
rpmE,8253816,8254026,8253816,210,534,utRho24
rpmF,2294676,2294734,2294676,58,2584,utRho24
rpmH,7768130,7768672,7768130,542,736,utRho24
rpmI,3600854,3600854,3599998,856,1300,utRho24
rpoB,8362126,8362490,8362126,364,352,utRho24
rpoD,6424946,6426094,6424946,1148,18782,utRho24
rpoE,5420372,5420372,5420024,348,172,utRho24
rpoH,7202006,7202006,7201566,440,6482,utRho24
rpoN,6689324,6689434,6689324,110,80,utRho24
rpoS,5736236,5736236,5735102,1134,2614,utRho24
rpoZ,7644154,7644212,7644154,58,356,utRho24
rppH,5937986,5937986,5937954,32,26,utRho24
rprA,3540744,3540744,3540744,0,0,utRho24
rpsA,1923434,1923990,1923434,556,16128,utRho24
rpsF,8850050,8850236,8850050,186,1828,utRho24
rpsI,6756580,6756580,6756414,166,810,utRho24
rpsJ,6906884,6906884,6906540,344,522,utRho24
rpsL,6949242,6949242,6949104,138,326,utRho24
rpsM,6885130,6885130,6884942,188,282,utRho24
rpsO,13247144,13247144,13246736,408,264,utRho24
rpsP,5492508,5492508,5492370,138,22,utRho24
rpsT,42420,42420,42156,264,256,utRho24
rpsU,12842584,12843124,12842584,540,1092,utRho24
rraA,8238716,8238716,8238660,56,110,utRho24
rraB,8956768,8956946,8956768,178,552,utRho24
rrsA,8070478,8071062,8070478,584,2974,utRho24
rrsB,16665468,16666636,16665468,1168,5584,utRho24
rrsC,7883032,7883616,7883032,584,2696,utRho24
rrsD,6858094,6858094,6857524,570,336,utRho24
rrsE,8415726,8416294,8415726,568,364,utRho24
rrsG,5462896,5462896,5462314,582,3004,utRho24
rrsH,446970,447542,446970,572,392,utRho24
rsd,8393908,8393908,8393616,292,1132,utRho24
rseA,5419264,5419264,5418808,456,60,utRho24
rseP,392940,393092,392940,152,16,utRho24
rseX,4067298,4067298,4067298,0,0,utRho24
rsfS,1338144,1338144,1338072,72,174,utRho24
rsgA,8783132,8783132,8783018,114,288,utRho24
rsmA,105176,105176,104860,316,1618,utRho24
rsmB,6869982,6870414,6869982,432,470,utRho24
rsmC,9215736,9215736,9215400,336,274,utRho24
rsmD,7208594,7208786,7208594,192,32,utRho24
rsmE,6182036,6182268,6182036,232,1010,utRho24
rsmG,7847512,7847512,7847360,152,752,utRho24
rsmH,180020,180188,180020,168,116,utRho24
rsmI,6587106,6587106,6586670,436,1736,utRho24
rssA,2578212,2578412,2578212,200,778,utRho24
rssB,2580440,2580484,2580440,44,236,utRho24
rstA,3364276,3364300,3364276,24,0,utRho24
rsuA,4561096,4561096,4560966,130,216,utRho24
rsxA,3411510,3411534,3411510,24,0,utRho24
rtcA,7114004,7114004,7113698,306,2700,utRho24
rtcB,7116214,7116214,7116158,56,70,utRho24
rtn,4541356,4541452,4541356,96,22,utRho24
rutA,2148052,2148052,2148022,30,138,utRho24
rutG,2140090,2140090,2139678,412,644,utRho24
rutR,2148226,2148484,2148226,258,898,utRho24
ruvA,7784096,7784096,7783904,192,168,utRho24
ruvB,7782176,7782176,7781424,752,768,utRho24
ruvC,3894878,3894878,3894752,126,32,utRho24
rybB,1776114,1776114,1776114,0,0,utRho24
rydB,3529860,3529860,3529322,538,350,utRho24
rydC,2983012,2983012,2983012,0,0,utRho24
ryfA,5307398,5307710,5307398,312,106,utRho24
ryfD,5468590,5468590,5468590,0,0,utRho24
ryhB,7162032,7162032,7162032,0,0,utRho24
ryjA,8556132,8556132,8556132,0,0,utRho24
ryjB,9055954,9055954,9055954,0,0,utRho24
sad,3229598,3229598,3229406,192,218,utRho24
safA,3168056,3168056,3167918,138,1324,utRho24
sanA,4465368,4465756,4465368,388,242,utRho24
sapF,2705314,2705314,2705268,46,80,utRho24
sbcB,4165456,4165512,4165456,56,0,utRho24
sbcC,831694,831694,831506,188,310,utRho24
sbcD,833954,833954,833904,50,48,utRho24
sbmA,793106,793278,793106,172,3338,utRho24
sbmC,4162650,4162650,4162524,126,36,utRho24
sdaA,3793618,3793864,3793618,246,194,utRho24
sdaC,5856070,5856458,5856070,388,256,utRho24
sdhC,1509916,1510354,1509916,438,16850,utRho24
sdhD,1510808,1511120,1510808,312,6456,utRho24
sdiA,3993834,3993834,3993664,170,76,utRho24
secE,8354354,8354716,8354354,362,220,utRho24
secG,6645180,6645180,6645010,170,98,utRho24
selA,7522594,7522594,7522498,96,1298,utRho24
selB,7519850,7519850,7519722,128,280,utRho24
selC,7672396,7672444,7672396,48,62,utRho24
selD,3696058,3696058,3696016,42,3378,utRho24
seqA,1425884,1425974,1425884,90,146,utRho24
serA,6117098,6117098,6116820,278,236,utRho24
serB,9249712,9249790,9249712,78,240,utRho24
serC,3830380,3830612,3830380,232,28,utRho24
serS,1878730,1878856,1878730,126,668,utRho24
serT,2063438,2063438,2063424,14,0,utRho24
serU,4087124,4087124,4087114,10,66,utRho24
serV,5637394,5637394,5637290,104,154,utRho24
serW,1852014,1852014,1851942,72,122,utRho24
serX,2195352,2195352,2195304,48,26,utRho24
setB,4527426,4527726,4527426,300,20,utRho24
setC,7673488,7673906,7673488,418,3330,utRho24
sfmA,1116124,1116424,1116124,300,216,utRho24
sfmC,1117606,1117948,1117606,342,44,utRho24
sfsA,323030,323030,322972,58,430,utRho24
sfsB,6669592,6669818,6669592,226,616,utRho24
sgrR,154676,154676,154598,78,238,utRho24
sgrS,154734,154734,154734,0,0,utRho24
shiA,4107068,4107286,4107068,218,368,utRho24
sibA,4306622,4306622,4306622,0,0,utRho24
sibB,4307292,4307292,4307292,0,0,utRho24
sibC,6113702,6113702,6113702,0,0,utRho24
sibD,6389730,6389730,6389730,0,0,utRho24
sibE,6390480,6390480,6390480,0,0,utRho24
sixA,4913998,4913998,4913624,374,10,utRho24
slp,7307872,7307922,7307872,50,0,utRho24
slt,9261400,9261466,9261400,66,358,utRho24
slyA,3442028,3442028,3441648,380,142,utRho24
slyB,3439496,3439752,3439496,256,134,utRho24
slyD,6957398,6957398,6956994,404,368,utRho24
slyX,6954862,6955280,6954862,418,1772,utRho24
smf,6867372,6867372,6867120,252,734,utRho24
smpB,5509534,5509792,5509534,258,836,utRho24
smrA,2811872,2811958,2811872,86,600,utRho24
smrB,4896872,4897212,4896872,340,2398,utRho24
smtA,1946808,1947074,1946808,266,142,utRho24
sodA,8201518,8201620,8201518,102,1968,utRho24
sodB,3470646,3470756,3470646,110,530,utRho24
sodC,3449358,3449358,3449310,48,172,utRho24
sohB,2658568,2658664,2658568,96,1008,utRho24
sokB,2984232,2984238,2984232,6,130,utRho24
solA,2241218,2241218,2241172,46,0,utRho24
soxR,8554894,8554938,8554894,44,134,utRho24
soxS,8554846,8554846,8554766,80,64,utRho24
speA,6172096,6172096,6171822,274,116,utRho24
speB,6167892,6167892,6167594,298,54,utRho24
speC,6218350,6218350,6218310,40,32,utRho24
spf,8099798,8099798,8099798,0,0,utRho24
sppA,3697422,3697674,3697422,252,3078,utRho24
spy,3651376,3651376,3651250,126,34,utRho24
sra,3112092,3112092,3111926,166,0,utRho24
sraB,2293178,2293178,2293178,0,0,utRho24
sraC,3846132,3846132,3846132,0,0,utRho24
srlA,5651582,5651664,5651582,82,106,utRho24
srlR,5657720,5658094,5657720,374,11908,utRho24
srmB,5425752,5425792,5425752,40,206,utRho24
sroA,151216,151216,151216,0,0,utRho24
sroG,6369436,6369436,6369436,0,0,utRho24
sroH,8380974,8380974,8380974,0,0,utRho24
ssb,8548022,8548250,8548022,228,302,utRho24
sseA,5304782,5304988,5304782,206,3018,utRho24
sspA,6755138,6755138,6754840,298,246,utRho24
ssrA,5511014,5511186,5511014,172,256,utRho24
ssrS,12223036,12223932,12223036,896,880,utRho24
sstT,6479726,6479888,6479726,162,24,utRho24
ssuB,1988282,1988282,1988088,194,626,utRho24
ssuE,1995126,1995126,1995024,102,0,utRho24
sthA,8321604,8321604,8321580,24,1774,utRho24
stpA,5597156,5597156,5596990,166,40,utRho24
sucA,3034344,3034824,3034344,480,2348,utRho24
sufA,3528836,3528836,3528772,64,84,utRho24
sufE,3518962,3518962,3518580,382,224,utRho24
sugE,8753588,8753750,8753588,162,814,utRho24
sulA,2041894,2041894,2041838,56,3564,utRho24
syd,5850738,5850738,5850560,178,4,utRho24
symE,9159834,9159834,9159680,154,556,utRho24
symR,9159670,9159670,9159670,0,0,utRho24
tabA,8949566,8949724,8949566,158,0,utRho24
talA,5157140,5157332,5157140,192,190,utRho24
talB,16382,16476,16382,94,6060,utRho24
tam,3214442,3214692,3214442,250,606,utRho24
tamA,8884540,8884764,8884540,224,1700,utRho24
tar,3945432,3945432,3945382,50,0,utRho24
tas,5943138,5943194,5943138,56,2724,utRho24
tatA,16087636,16087780,16087636,144,132,utRho24
tatE,1317742,1317894,1317742,152,116,utRho24
tauA,770410,770464,770410,54,68,utRho24
tdcA,6534186,6534186,6534130,56,54,utRho24
tdcG,6519652,6519652,6519298,354,1726,utRho24
tdcR,6534380,6534760,6534380,380,140,utRho24
tdk,2586986,2587054,2586986,68,48,utRho24
tehA,3001072,3001146,3001072,74,64,utRho24
tesA,1039898,1039898,1039530,368,842,utRho24
tesB,950402,950402,950322,80,48,utRho24
tfaE,2418532,2418532,2418238,294,1614,utRho24
tfaQ,3269912,3269912,3269770,142,472,utRho24
tff,379424,379256,379424,168,178,utRho24
tgt,852110,852274,852110,164,44,utRho24
thiD,4369346,4369346,4369032,314,308,utRho24
thiI,882936,883098,882936,162,138,utRho24
thiM,4370902,4370902,4370602,300,840,utRho24
thiQ,146170,146170,145854,316,8098,utRho24
thrL,592,760,592,168,332,utRho24
thrS,7210932,7210932,7210280,652,412,utRho24
thrU,8350762,8350776,8350762,14,0,utRho24
thrV,6847414,6847414,6847310,104,152428,utRho24
thrW,525682,525742,525682,60,5350,utRho24
thyA,5930696,5930696,5930310,386,1384,utRho24
tig,909986,910266,909986,280,48,utRho24
tisB,7706674,7707106,7706674,432,792,utRho24
tktA,6163414,6163414,6163270,144,208,utRho24
tktB,5158616,5159272,5158616,656,4694,utRho24
tldD,6784368,6784368,6784056,312,32,utRho24
tmcA,5191876,5191876,5191718,158,1520,utRho24
tnaC,15553644,15553740,15553644,96,6224,utRho24
tolB,1555074,1555480,1555074,406,334,utRho24
tolC,6356008,6356230,6356008,222,208,utRho24
tomB,961588,961588,961416,172,1318,utRho24
tonB,2622108,2622178,2622108,70,4,utRho24
topA,2661578,2662096,2661578,518,4,utRho24
torC,2116112,2116168,2116112,56,486,utRho24
torR,2115968,2115968,2115908,60,544,utRho24
torS,2112364,2112364,2112356,8,58,utRho24
torT,2112414,2112522,2112414,108,4,utRho24
tpiA,8223138,8223138,8223014,124,108,utRho24
tppB,3425342,3425538,3425342,196,1912,utRho24
tpr,2574376,2574376,2574376,0,0,utRho24
tpx,2777688,2777688,2777622,66,1138,utRho24
tqsA,3347780,3347826,3347780,46,74,utRho24
treA,2494850,2494850,2494752,98,552,utRho24
treB,8932420,8932420,8932360,60,92,utRho24
treF,7339102,7339184,7339102,82,580,utRho24
treR,8934694,8934694,8934492,202,66,utRho24
trg,2984878,2984940,2984878,62,120,utRho24
trkG,2847342,2847564,2847342,222,1304,utRho24
trmA,8326590,8326590,8326540,50,262,utRho24
trpA,2634678,2634678,2634444,234,500,utRho24
trpC,2639888,2639888,2639570,318,0,utRho24
trpL,5292432,5292432,5292328,104,0,utRho24
trpR,9265408,9265520,9265408,112,382,utRho24
trpS,7027394,7027394,7027276,118,1616,utRho24
trpT,7893560,7893914,7893560,354,67754,utRho24
trxA,7931294,7931522,7931294,228,876,utRho24
trxB,1864156,1864156,1864100,56,58,utRho24
trxC,5437350,5437470,5437350,120,448,utRho24
tsaD,6421256,6421256,6421086,170,538,utRho24
tsgA,6985038,6985136,6985038,98,196,utRho24
tsr,9182824,9183314,9182824,490,5366,utRho24
tsx,864490,864490,864026,464,610,utRho24
ttcA,2823970,2823970,2823896,74,2668,utRho24
ttdA,6412848,6412926,6412848,78,124,utRho24
ttdR,6412760,6412760,6412512,248,528,utRho24
tufA,6943448,6943448,6942658,790,26410,utRho24
tus,3368346,3368518,3368346,172,134,utRho24
tusA,7218040,7218040,7217992,48,312,utRho24
tusB,6950218,6950218,6949930,288,1082,utRho24
tynA,2902996,2902996,2902698,298,90,utRho24
typA,8116460,8116814,8116460,354,1760,utRho24
tyrB,8534164,8534228,8534164,64,1028,utRho24
tyrP,3979004,3979362,3979004,358,492,utRho24
tyrR,2773384,2773440,2773384,56,46,utRho24
tyrS,3434566,3434566,3434444,122,40,utRho24
tyrT,2575330,2575330,2575244,86,62,utRho24
uacT,6062378,6062734,6062378,356,3190,utRho24
ubiC,8504886,8505012,8504886,126,386,utRho24
ubiD,8049618,8049976,8049618,358,1882,utRho24
ubiE,8037494,8037710,8037494,216,362,utRho24
ubiG,4679078,4679134,4679078,56,160,utRho24
ucpA,5089342,5089342,5089246,96,0,utRho24
udp,8032782,8032862,8032782,80,324,utRho24
ugd,4199470,4199470,4199226,244,58,utRho24
ugpB,7184852,7184852,7184650,202,4602,utRho24
ugpQ,7176600,7176600,7176226,374,438,utRho24
uhpT,7694396,7694396,7694334,62,22,utRho24
uidA,3392304,3392304,3392142,162,164,utRho24
uidC,3386012,3386012,3385702,310,38,utRho24
uidR,3394150,3394150,3394104,46,10,utRho24
ulaA,8839854,8839960,8839854,106,178,utRho24
ulaG,8839350,8839350,8839250,100,346,utRho24
ulaR,8837124,8837124,8836906,218,120,utRho24
umpG,5741372,5741372,5740548,824,120,utRho24
umpH,1400704,1400704,1400652,52,22,utRho24
umuD,2461476,2461534,2461476,58,42,utRho24
ung,5433476,5433508,5433476,32,150,utRho24
uof,2843316,2843316,2842900,416,2048,utRho24
upp,5241818,5241818,5241744,74,156,utRho24
usg,4873780,4873780,4873298,482,222,utRho24
ushA,1009772,1009828,1009772,56,126,utRho24
uspA,7279966,7280222,7279966,256,588,utRho24
uspB,7279696,7279696,7279440,256,572,utRho24
uspC,3959172,3959506,3959172,334,154,utRho24
uspE,2797318,2797318,2797244,74,62,utRho24
uspF,2871282,2871282,2871238,44,270,utRho24
uspG,1283806,1283806,1283734,72,2240,utRho24
uvrA,8547872,8547872,8547742,130,352,utRho24
uvrB,1626304,1627052,1626304,748,1286,utRho24
uvrC,3989758,3989758,3989412,346,112,utRho24
uvrD,7995814,7995966,7995814,152,780,utRho24
uvrY,3990812,3990812,3990718,94,218,utRho24
uxaB,3221474,3221474,3221360,114,94,utRho24
uxaC,6489714,6489714,6489482,232,160,utRho24
uxuA,9103036,9103272,9103036,236,2962,utRho24
uxuR,9108916,9109152,9108916,236,370,utRho24
valS,8967854,8967854,8967674,180,312,utRho24
valU,5041848,5041862,5041848,14,38,utRho24
valV,3492830,3492870,3492830,40,224,utRho24
ves,3649968,3649968,3649874,94,158,utRho24
waaA,7616512,7617080,7616512,568,674,utRho24
waaH,7580298,7580298,7580162,136,4,utRho24
waaQ,7616476,7616476,7616196,280,516,utRho24
waaU,7598996,7598996,7598624,372,200,utRho24
waaY,7602272,7602272,7601930,342,8012,utRho24
wbbH,4214888,4214888,4214452,436,1606,utRho24
wbbK,4209212,4209212,4209018,194,136,utRho24
wcaM,4231868,4231868,4231792,76,28,utRho24
wrbA,2135516,2135516,2135416,100,52,utRho24
wza,4275166,4275166,4274486,680,286,utRho24
wzxC,4240674,4240674,4240316,358,106,utRho24
wzzB,4196950,4196950,4196602,348,4,utRho24
xanP,7657642,7657890,7657642,248,554,utRho24
xanQ,6048520,6048702,6048520,182,80,utRho24
xapA,5049820,5049820,5049756,64,14,utRho24
xapR,10090252,10090252,10089908,344,56,utRho24
xdhA,6000514,6000690,6000514,176,2858,utRho24
xerD,6079702,6079702,6079486,216,350,utRho24
xseA,5268394,5268464,5268394,70,394,utRho24
xseB,882746,882746,882686,60,164,utRho24
xthA,3664798,3664856,3664798,58,0,utRho24
xylA,7461614,7461614,7461530,84,18484,utRho24
xylE,8484540,8484540,8484508,32,6,utRho24
xylF,7462138,7462262,7462138,124,1058,utRho24
xylR,7469812,7469958,7469812,146,48,utRho24
yaaA,13230,13230,12918,312,12,utRho24
yaaI,23876,23876,23572,304,1902,utRho24
yaaJ,16034,16034,15918,116,96,utRho24
yaaU,91184,91614,91184,430,1520,utRho24
yaaW,23084,23084,22712,372,500,utRho24
yaaX,10060,10468,10060,408,314,utRho24
yabI,142542,142702,142542,160,506,utRho24
yacC,273880,273880,273834,46,836,utRho24
yacH,262932,262932,262520,412,112,utRho24
yacL,268678,268776,268678,98,694,utRho24
yadD,293796,293936,293796,140,198,utRho24
yadE,289930,290162,289930,232,456,utRho24
yadN,314110,314110,313766,344,134,utRho24
yadS,355572,355572,355248,324,7104,utRho24
yadV,312470,312470,312402,68,264,utRho24
yaeF,434270,434270,434006,264,128,utRho24
yaeP,428374,428374,428250,124,738,utRho24
yaeQ,428176,428582,428176,406,1454,utRho24
yaeR,423716,423754,423716,38,194,utRho24
yafC,462166,462166,461762,404,154,utRho24
yafD,462128,462244,462128,116,114,utRho24
yafK,491986,491986,491610,376,2136,utRho24
yafL,493282,493424,493282,142,110,utRho24
yafN,503938,504010,503938,72,166,utRho24
yafS,469568,469632,469568,64,616,utRho24
yafT,474470,474670,474470,200,154,utRho24
yafV,480432,480432,480378,54,90,utRho24
yafZ,536052,536052,536010,42,356,utRho24
yagE,564446,564556,564446,110,2978,utRho24
yagG,570414,570790,570414,376,3432,utRho24
yagI,578384,578384,578324,60,380,utRho24
yagK,586236,586236,585896,340,17492,utRho24
yagL,588062,588062,587836,226,4242,utRho24
yagN,591342,591342,591158,184,1142,utRho24
yahA,663746,664742,663746,996,6650,utRho24
yahC,670136,670136,670044,92,4488,utRho24
yahE,671478,671850,671478,372,966,utRho24
yahM,690504,690808,690504,304,272,utRho24
yahN,692872,692872,692674,198,2162,utRho24
yahO,692864,692968,692864,104,194,utRho24
yaiE,816296,816354,816296,58,96,utRho24
yaiI,811396,811528,811396,132,54,utRho24
yaiO,761946,761946,761684,262,546,utRho24
yaiP,767970,767970,767870,100,118,utRho24
yaiS,769660,769660,769232,428,1036,utRho24
yaiV,788922,788922,788922,0,0,utRho24
yaiY,799094,799094,798666,428,546,utRho24
yaiZ,798888,799186,798888,298,786,utRho24
yajC,854410,854574,854410,164,368,utRho24
yajD,860938,861210,860938,272,300,utRho24
yajI,866068,866068,865702,366,450,utRho24
yajL,887496,887496,887282,214,432,utRho24
yajQ,889316,889366,889316,50,140,utRho24
yajR,893374,893374,893332,42,46,utRho24
ybaB,987418,988152,987418,734,966,utRho24
ybaL,1006590,1006590,1006476,114,334,utRho24
ybaM,980648,980648,980542,106,2294,utRho24
ybaN,981436,981764,981436,328,996,utRho24
ybaO,936704,936766,936704,62,66,utRho24
ybaP,1016568,1016568,1016160,408,1748,utRho24
ybaQ,1016348,1016436,1016348,88,418,utRho24
ybaS,1023146,1023282,1023146,136,1888,utRho24
ybaV,927504,927874,927504,370,4,utRho24
ybaY,950490,950758,950490,268,1094,utRho24
ybbB,1062724,1062724,1062452,272,86,utRho24
ybbJ,1030154,1030154,1029718,436,2266,utRho24
ybbL,1031784,1031838,1031784,54,120,utRho24
ybbN,1037136,1037136,1036558,578,1898,utRho24
ybbO,1038658,1038658,1038298,360,792,utRho24
ybbY,1080718,1081130,1080718,412,2252,utRho24
ybcH,1176140,1176140,1175962,178,610,utRho24
ybcI,1113264,1113264,1113106,158,2734,utRho24
ybcJ,1114050,1114050,1113746,304,114,utRho24
ybcK,1137502,1137804,1137502,302,602,utRho24
ybcL,1141690,1141786,1141690,96,0,utRho24
ybcN,1144628,1144932,1144628,304,334,utRho24
ybcQ,1147548,1147912,1147548,364,3910,utRho24
ybcW,1159610,1159760,1159610,150,264,utRho24
ybdD,1263982,1264364,1263982,382,2404,utRho24
ybdF,1212106,1212106,1211772,334,170,utRho24
ybdH,1267048,1267048,1266954,94,292,utRho24
ybdJ,1212822,1212822,1212398,424,426,utRho24
ybdK,1215122,1215122,1214766,356,2120,utRho24
ybdL,1267114,1267172,1267114,58,470,utRho24
ybdM,1271110,1271110,1270752,358,4258,utRho24
ybdN,1273372,1273372,1273138,234,276,utRho24
ybdR,1283844,1284176,1283844,332,2964,utRho24
ybeD,1325412,1325412,1325284,128,30,utRho24
ybeF,1323090,1323090,1322756,334,1722,utRho24
ybeL,1349986,1350036,1349986,50,820,utRho24
ybeQ,1353412,1353412,1353094,318,152,utRho24
ybeR,1353120,1353422,1353120,302,152,utRho24
ybeT,1358832,1358832,1358812,20,66,utRho24
ybeU,1358924,1359016,1358924,92,148,utRho24
ybeZ,1386938,1386938,1386834,104,2346,utRho24
ybfA,1458074,1458268,1458074,194,698,utRho24
ybfE,1423878,1423878,1423796,82,132,utRho24
ybfF,1425692,1425692,1425604,88,120,utRho24
ybfH,1433282,1433282,1433194,88,90,utRho24
ybgA,1477840,1478002,1477840,162,170,utRho24
ybgC,1549288,1549504,1549288,216,84,utRho24
ybgD,1505916,1505916,1505590,326,11394,utRho24
ybgI,1485238,1485654,1485238,416,40,utRho24
ybgO,1498370,1498370,1497964,406,514,utRho24
ybgS,1570992,1570992,1570634,358,228,utRho24
ybhA,1597184,1597184,1596862,322,142,utRho24
ybhB,1616070,1616070,1615818,252,320,utRho24
ybhC,1614642,1614642,1614562,80,1104,utRho24
ybhD,1601418,1601418,1601276,142,126,utRho24
ybhH,1601104,1601518,1601104,414,240,utRho24
ybhK,1633384,1633384,1633294,90,242,utRho24
ybhM,1641556,1641586,1641556,30,94,utRho24
ybhN,1645296,1645296,1644996,300,898,utRho24
ybhQ,1649202,1649260,1649202,58,2262,utRho24
ybiA,1665920,1665920,1665900,20,28,utRho24
ybiI,1676968,1676968,1676912,56,1034,utRho24
ybiO,1691328,1691328,1690960,368,870,utRho24
ybiP,1705252,1705252,1705194,58,414,utRho24
ybiS,1711572,1711572,1711488,84,402,utRho24
ybiT,1711894,1711926,1711894,32,0,utRho24
ybiU,1718212,1718212,1718122,90,136,utRho24
ybiV,1720176,1720176,1720056,120,80,utRho24
ybiW,1725566,1725566,1725212,354,9808,utRho24
ybiX,1678548,1678548,1678414,134,258,utRho24
ybjC,1781784,1781826,1781784,42,0,utRho24
ybjE,1830154,1830154,1829714,440,728,utRho24
ybjG,1767016,1767016,1766776,240,1152,utRho24
ybjL,1779882,1779882,1779638,244,96,utRho24
ybjM,1779770,1780178,1779770,408,634,utRho24
ybjO,1795704,1795978,1795704,274,38,utRho24
ybjP,1809046,1809046,1808934,112,96,utRho24
ybjQ,1809034,1809186,1809034,152,108,utRho24
ybjS,1813796,1813796,1813506,290,148,utRho24
ybjX,1838206,1838206,1838168,38,0,utRho24
ycaD,1891438,1891742,1891438,304,60,utRho24
ycaI,1928210,1928640,1928210,430,320,utRho24
ycaK,1899094,1899336,1899094,242,540,utRho24
ycaL,1920264,1920528,1920264,264,144,utRho24
ycaM,1894240,1894458,1894240,218,322,utRho24
ycaR,1941284,1941346,1941284,62,1986,utRho24
ycbB,1961862,1962094,1961862,232,1024,utRho24
ycbJ,1943344,1943504,1943344,160,0,utRho24
ycbK,1966046,1966150,1966046,104,76,utRho24
ycbZ,2036920,2036920,2036598,322,36,utRho24
yccA,2062886,2062886,2062836,50,48,utRho24
yccF,2048730,2048730,2048696,34,28,utRho24
yccS,2047988,2047988,2047766,222,582,utRho24
yccT,2055674,2055674,2055546,128,182,utRho24
yccX,2059960,2060128,2059960,168,462,utRho24
ycdT,2185682,2185752,2185682,70,122,utRho24
ycdU,2191266,2191686,2191266,420,692,utRho24
ycdZ,2200504,2200592,2200504,88,144,utRho24
yceA,2233544,2233614,2233544,70,26,utRho24
yceD,2293298,2293588,2293298,290,380,utRho24
yceF,2293522,2293522,2293190,332,232,utRho24
yceH,2252154,2252314,2252154,160,1504,utRho24
yceI,2237282,2237282,2236952,330,232,utRho24
yceJ,2238142,2238142,2238092,50,262,utRho24
yceM,2253208,2253612,2253208,404,124,utRho24
yceO,2239264,2239264,2238894,370,606,utRho24
yceQ,2288760,2289004,2288760,244,2910,utRho24
ycfD,2376540,2376540,2376480,60,142,utRho24
ycfJ,2334814,2335198,2334814,384,350,utRho24
ycfS,2340834,2340834,2340748,86,118,utRho24
ycfT,2350658,2350658,2350330,328,176,utRho24
ycfZ,2362760,2362760,2362534,226,1204,utRho24
ycgB,2474570,2474570,2474482,88,0,utRho24
ycgG,2434614,2434656,2434614,42,1450,utRho24
ycgJ,2452956,2453200,2452956,244,476,utRho24
ycgL,2455218,2455362,2455218,144,56,utRho24
ycgN,2457366,2457660,2457366,294,234,utRho24
ycgR,2489112,2489112,2489054,58,76,utRho24
ycgV,2512222,2512222,2511904,318,1052,utRho24
ycgX,2426568,2426568,2426214,354,14466,utRho24
ycgY,2490166,2490320,2490166,154,894,utRho24
ycgZ,2431504,2431578,2431504,74,82,utRho24
ychE,2596904,2597196,2596904,292,0,utRho24
ychF,2515764,2515764,2515624,140,0,utRho24
ychH,2517476,2517582,2517476,106,580,utRho24
ychJ,2578354,2578354,2578264,90,224,utRho24
ychN,2547310,2547310,2547198,112,40,utRho24
ychO,2547520,2547850,2547520,330,304,utRho24
ychQ,2533798,2533848,2533798,50,56,utRho24
yciA,2624828,2624828,2624492,336,128,utRho24
yciB,2626110,2626110,2625780,330,838,utRho24
yciC,2627396,2627396,2627326,70,36,utRho24
yciE,2630794,2630794,2630448,346,922,utRho24
yciG,5264368,5264368,5264140,228,28,utRho24
yciI,2621784,2621784,2621730,54,6,utRho24
yciN,2661606,2661606,2661336,270,52,utRho24
yciS,2680270,2680486,2680270,216,284,utRho24
yciT,2689088,2689088,2688692,396,1862,utRho24
yciU,2614718,2614718,2614300,418,946,utRho24
yciV,2646376,2646440,2646376,64,0,utRho24
yciW,2700472,2700472,2700214,258,3584,utRho24
yciZ,2689276,2689276,2689218,58,1570,utRho24
ycjD,2703792,2703792,2703520,272,146,utRho24
ycjG,2777748,2777860,2777748,112,232,utRho24
ycjM,2740006,2740432,2740006,426,168,utRho24
ycjW,2767982,2767982,2767922,60,26,utRho24
ycjX,2768138,2768234,2768138,96,136,utRho24
ycjY,5568288,5568288,5567460,828,1668,utRho24
ydaE,2836438,2836438,2836016,422,378,utRho24
ydaN,2816048,2816100,2816048,52,208,utRho24
ydaS,2840340,2840730,2840340,390,728,utRho24
ydbC,2948376,2948442,2948376,66,0,utRho24
ydbD,2950132,2950288,2950132,156,0,utRho24
ydbH,2885800,2886102,2885800,302,276,utRho24
ydbJ,2881712,2882116,2881712,404,1788,utRho24
ydbK,2881692,2881692,2881568,124,378,utRho24
ydcA,2983294,2983354,2983294,60,158,utRho24
ydcF,2974404,2974470,2974404,66,36,utRho24
ydcI,2990268,2990268,2990142,126,0,utRho24
ydcJ,2990266,2990576,2990266,310,36,utRho24
ydcK,3001280,3001280,3000898,382,340,utRho24
ydcL,3004646,3004914,3004646,268,38,utRho24
ydcN,3012308,3012344,3012308,36,1410,utRho24
ydcP,3013508,3013562,3013508,54,226,utRho24
ydcR,3019956,3020006,3019956,50,2,utRho24
ydcS,3022906,3023308,3022906,402,486,utRho24
ydcX,3034442,3034778,3034442,336,1460,utRho24
ydcY,3035220,3035296,3035220,76,94,utRho24
ydcZ,3036750,3036750,3036662,88,4634,utRho24
yddB,3155332,3155332,3155238,94,518,utRho24
yddE,3071738,3071738,3071716,22,0,utRho24
yddG,3094410,3094410,3094338,72,118,utRho24
yddJ,3089732,3089732,3089438,294,1752,utRho24
yddW,3137704,3137704,3137646,58,0,utRho24
ydeA,3233910,3234056,3233910,146,2332,utRho24
ydeE,3242528,3242664,3242528,136,340,utRho24
ydeI,3249118,3249118,3248994,124,172,utRho24
ydeJ,3249376,3249546,3249376,170,24,utRho24
ydeN,3165458,3165458,3165048,410,472,utRho24
ydeP,3173328,3173328,3172972,356,498,utRho24
ydeR,3176596,3176596,3176592,4,534,utRho24
ydfA,3296872,3297016,3296872,144,42,utRho24
ydfG,3254982,3255034,3254982,52,178,utRho24
ydfH,3256652,3256704,3256652,52,16,utRho24
ydfK,3265446,3266144,3265446,698,9780,utRho24
ydgA,3379588,3379704,3379588,116,0,utRho24
ydgC,3364124,3364124,3364060,64,26,utRho24
ydgD,3343906,3343920,3343906,14,284,utRho24
ydgH,3356754,3356854,3356754,100,38,utRho24
ydgJ,3408798,3408798,3408616,182,694,utRho24
ydgK,3410414,3410500,3410414,86,758,utRho24
ydhB,3479618,3479618,3479596,22,0,utRho24
ydhC,3479698,3479822,3479698,124,26,utRho24
ydhF,3451310,3451310,3451264,46,30,utRho24
ydhI,3441996,3442050,3441996,54,38,utRho24
ydhL,3451864,3451864,3451840,24,916,utRho24
ydhQ,3492404,3492404,3492254,150,234,utRho24
ydhS,3494136,3494262,3494136,126,1052,utRho24
ydhT,3499138,3499138,3499118,20,214,utRho24
ydhY,3509284,3509284,3508954,330,1484,utRho24
ydhZ,3510418,3510418,3510282,136,2564,utRho24
ydiE,3579206,3579226,3579206,20,0,utRho24
ydiH,3530582,3530582,3530406,176,4,utRho24
ydiM,3541852,3542142,3541852,290,86,utRho24
ydiN,3544818,3545024,3544818,206,288,utRho24
ydiP,3558656,3558656,3558602,54,512,utRho24
ydiU,3582508,3582508,3582488,20,566,utRho24
ydiV,3584174,3584174,3584040,134,266,utRho24
ydiY,3612500,3612500,3612166,334,262,utRho24
ydjA,3697400,3697400,3697352,48,980,utRho24
ydjE,3708082,3708082,3707958,124,30,utRho24
ydjF,3709848,3709848,3709708,140,28,utRho24
ydjM,3620340,3620422,3620340,82,0,utRho24
ydjO,3626696,3626696,3626288,408,204,utRho24
ydjX,3666434,3666802,3666434,368,2744,utRho24
yeaE,3731448,3731448,3731272,176,280,utRho24
yeaG,3733530,3733816,3733530,286,46,utRho24
yeaI,3740486,3740770,3740486,284,64,utRho24
yeaJ,3743874,3744082,3743874,208,586,utRho24
yeaL,3748646,3748704,3748646,58,694,utRho24
yeaM,3751296,3751296,3751152,144,2,utRho24
yeaN,3750926,3751346,3750926,420,216,utRho24
yeaO,3753554,3753818,3753554,264,278,utRho24
yeaP,3755314,3755430,3755314,116,734,utRho24
yeaQ,3758780,3758780,3758510,270,782,utRho24
yeaR,3759988,3759988,3759896,92,234,utRho24
yeaY,3781122,3781122,3781064,58,0,utRho24
yebB,3892220,3892502,3892220,282,158,utRho24
yebC,3896370,3896370,3896302,68,126,utRho24
yebE,3859464,3859464,3859414,50,1398,utRho24
yebG,3861530,3861530,3861494,36,146,utRho24
yebK,3873180,3873304,3873180,124,60,utRho24
yebQ,3820314,3820552,3820314,238,78,utRho24
yebS,3832238,3832516,3832238,278,0,utRho24
yebV,3843430,3843560,3843430,130,0,utRho24
yebW,3843914,3844242,3843914,328,1846,utRho24
yecC,3995646,3995646,3995628,18,0,utRho24
yecD,3901272,3901664,3901272,392,238,utRho24
yecF,3991434,3991636,3991434,202,460,utRho24
yecH,3979304,3979304,3978980,324,958,utRho24
yecJ,3975604,3975604,3975516,88,0,utRho24
yecM,3919968,3919968,3919692,276,2668,utRho24
yecR,3976400,3976444,3976400,44,120,utRho24
yecT,3923862,3923944,3923862,82,0,utRho24
yedD,4016522,4016522,4016180,342,836,utRho24
yedE,4016310,4016554,4016310,244,568,utRho24
yedI,4058922,4058922,4058732,190,542,utRho24
yedJ,4066446,4066446,4066158,288,718,utRho24
yedV,4076404,4076404,4076304,100,482,utRho24
yedX,4077680,4077912,4077680,232,134,utRho24
yedY,4078572,4078956,4078572,384,946,utRho24
yeeA,4161322,4161322,4161182,140,24,utRho24
yeeE,4171104,4171104,4171050,54,732,utRho24
yeeJ,4089526,4089822,4089526,296,538,utRho24
yeeN,4113508,4113716,4113508,208,306,utRho24
yeeO,4119444,4119444,4119692,248,0,utRho24
yeeX,4158834,4158834,4158722,112,306,utRho24
yeeZ,4178422,4178422,4178256,166,128,utRho24
yefM,4179466,4179466,4179426,40,46,utRho24
yegD,4295288,4295348,4295288,60,168,utRho24
yegH,4275726,4275804,4275726,78,664,utRho24
yegI,4302154,4302154,4301970,184,42,utRho24
yegJ,4302032,4302370,4302032,338,186,utRho24
yegQ,4331182,4331336,4331182,154,1444,utRho24
yegR,4336698,4336698,4336612,86,1074,utRho24
yegS,4337086,4337424,4337086,338,372,utRho24
yegT,4357562,4357642,4357562,80,2042,utRho24
yegX,4367640,4367640,4367302,338,498,utRho24
yehA,4376944,4376944,4376828,116,692,utRho24
yehE,4385818,4385818,4385592,226,52,utRho24
yehK,4407568,4407944,4407568,376,238,utRho24
yehL,4408804,4409192,4408804,388,170,utRho24
yeiB,4486146,4486146,4485934,212,114,utRho24
yeiE,4499422,4499422,4499236,186,20,utRho24
yeiG,4487776,4487820,4487776,44,416,utRho24
yeiH,4499332,4499434,4499332,102,352,utRho24
yeiI,4503306,4503400,4503306,94,124,utRho24
yeiL,4510580,4510710,4510580,130,62,utRho24
yeiP,4530834,4530900,4530834,66,332,utRho24
yeiQ,4532328,4532490,4532328,162,250,utRho24
yeiR,4535484,4535658,4535484,174,742,utRho24
yeiW,4530840,4530840,4530590,250,378,utRho24
yejA,4544624,4544728,4544624,104,18,utRho24
yejG,4556892,4556892,4556474,418,4068,utRho24
yejH,4561244,4561264,4561244,20,60,utRho24
yejK,4568218,4568218,4567894,324,24,utRho24
yejO,4578352,4578352,4577800,552,3984,utRho24
yfaD,4713380,4713808,4713380,428,2030,utRho24
yfaE,4696676,4697028,4696676,352,848,utRho24
yfaL,4688568,4688568,4688338,230,162,utRho24
yfaP,4656398,4656398,4656286,112,136,utRho24
yfaU,4717892,4717892,4717690,202,62,utRho24
yfaY,4727310,4727310,4727266,44,1982,utRho24
yfaZ,4728744,4728744,4728550,194,1198,utRho24
yfbK,4771810,4771810,4771444,366,1312,utRho24
yfbL,4771500,4771720,4771500,220,950,utRho24
yfbN,4777174,4777174,4776852,322,856,utRho24
yfbO,4776916,4777162,4776916,246,820,utRho24
yfbP,4777990,4778232,4777990,242,14864,utRho24
yfbR,4817662,4817724,4817662,62,150,utRho24
yfcI,4847424,4847424,4847078,346,976,utRho24
yfcJ,4880482,4880482,4880240,242,558,utRho24
yfcL,4888502,4888502,4888338,164,116,utRho24
yfcV,4911642,4911642,4911292,350,560,utRho24
yfcZ,4921958,4921958,4921868,90,36,utRho24
yfdF,4925604,4926024,4925604,420,7890,utRho24
yfdG,4935474,4935710,4935474,236,26,utRho24
yfdP,4946844,4947040,4946844,196,132,utRho24
yfdX,4988866,4988866,4988804,62,110,utRho24
yfdY,4990672,4990672,4990584,88,618,utRho24
yfeA,5035784,5035784,5035664,120,9604,utRho24
yfeC,5036668,5036934,5036668,266,0,utRho24
yfeH,5053818,5053892,5053818,74,262,utRho24
yfeK,5074630,5074684,5074630,54,0,utRho24
yfeO,5018906,5019260,5018906,354,630,utRho24
yfeR,5054078,5054078,5053712,366,290,utRho24
yfeX,5101356,5101356,5101090,266,0,utRho24
yfeY,5102486,5102486,5102432,54,6,utRho24
yfeZ,5103842,5103842,5103452,390,168,utRho24
yffO,5123804,5124222,5123804,418,1010,utRho24
yffQ,5126778,5127154,5126778,376,2916,utRho24
yffS,5128800,5128986,5128800,186,64,utRho24
yfgC,5232052,5232188,5232052,136,258,utRho24
yfgF,5258062,5258062,5257876,186,3336,utRho24
yfgG,5258170,5258580,5258170,410,4522,utRho24
yfgH,5259344,5259584,5259344,240,466,utRho24
yfgM,5278866,5278866,5278566,300,806,utRho24
yfhH,5397414,5397518,5397414,104,118,utRho24
yfhM,5304648,5304648,5304574,74,292,utRho24
yfhR,5328408,5328726,5328408,318,6430,utRho24
yfiC,5425610,5425610,5425528,82,202,utRho24
yfiE,5430688,5430688,5430640,48,1286,utRho24
yfiL,5482630,5482720,5482630,90,66,utRho24
yfiM,5448066,5448358,5448066,292,8884,utRho24
yfiR,5483354,5483750,5483354,396,490,utRho24
yfjH,5517326,5517326,5517200,126,336,utRho24
yfjI,5517710,5517970,5517710,260,442,utRho24
yfjJ,5521014,5521094,5521014,80,276,utRho24
yfjM,5531970,5531970,5531552,418,11804,utRho24
yfjP,5535080,5535420,5535080,340,1524,utRho24
yfjW,5546570,5546636,5546570,66,140,utRho24
yfjX,5551776,5551838,5551776,62,0,utRho24
ygaC,5601180,5601180,5599988,1192,3122,utRho24
ygaM,5600242,5600292,5600242,50,832,utRho24
ygaU,5593628,5593628,5593572,56,546,utRho24
ygaZ,5619190,5619234,5619190,44,250,utRho24
ygbA,5713656,5713656,5713612,44,306,utRho24
ygbE,5746784,5746784,5746674,110,270,utRho24
ygbI,5722882,5722882,5722528,354,1150,utRho24
ygbK,5724394,5724670,5724394,276,1306,utRho24
ygbL,5727074,5727186,5727074,112,172,utRho24
ygbN,5729814,5730202,5729814,388,1296,utRho24
ygcG,5811210,5811422,5811210,212,400,utRho24
ygcN,5785144,5785314,5785144,170,658,utRho24
ygcU,5799214,5799214,5798836,378,304,utRho24
ygcW,5800942,5800942,5800546,396,86,utRho24
ygdD,5883442,5883442,5883262,180,308,utRho24
ygdG,5861746,5861930,5861746,184,130,utRho24
ygdI,5886526,5886526,5886290,236,160,utRho24
ygdQ,5940784,5940840,5940784,56,98,utRho24
ygdR,5942494,5942542,5942494,48,2,utRho24
ygeA,5961606,5961606,5961270,336,386,utRho24
ygeH,5983758,5984188,5983758,430,2164,utRho24
ygeI,5987162,5987276,5987162,114,10800,utRho24
ygeR,6000078,6000078,5999782,296,706,utRho24
ygeV,6011694,6011694,6011572,122,56,utRho24
ygeW,6012234,6012524,6012234,290,598,utRho24
ygfB,6110946,6110946,6110888,58,14,utRho24
ygfK,6031984,6032120,6031984,136,176,utRho24
ygfS,6058328,6058328,6058024,304,208,utRho24
ygfZ,6082564,6082626,6082564,62,686,utRho24
yggC,6149512,6149512,6149378,134,130,utRho24
yggE,6136370,6136370,6136160,210,1254,utRho24
yggI,6179176,6179510,6179176,334,524,utRho24
yggL,6204508,6204508,6204266,242,464,utRho24
yggM,6199514,6199514,6199130,384,178,utRho24
yggN,6203596,6203596,6203246,350,1136,utRho24
yggX,18623958,18624558,18623958,600,462,utRho24
yghA,6298966,6299324,6298966,358,426,utRho24
yghB,6307058,6307126,6307058,68,748,utRho24
yghD,6222614,6222614,6222252,362,730,utRho24
yghF,6225798,6225798,6225840,42,40,utRho24
yghJ,6238640,6238640,6238224,416,232,utRho24
yghQ,6265186,6265186,6264816,370,468,utRho24
yghT,6267830,6268262,6267830,432,1216,utRho24
yghU,6277400,6277454,6277400,54,220,utRho24
yghW,6293506,6293506,6293474,32,64,utRho24
yghZ,6295562,6295794,6295562,232,192,utRho24
ygiD,6365122,6365122,6364868,254,3608,utRho24
ygiH,6409066,6409388,6409066,322,514,utRho24
ygiL,6370622,6370828,6370622,206,276,utRho24
ygiM,6402084,6402414,6402084,330,186,utRho24
ygiN,6346156,6346284,6346156,128,524,utRho24
ygiQ,6322620,6322620,6322292,328,1272,utRho24
ygiS,6335462,6335462,6335436,26,204,utRho24
ygiV,6338582,6338582,6338462,120,462,utRho24
ygiW,6339774,6339774,6339352,422,3606,utRho24
ygiZ,6344506,6344506,6344422,84,92,utRho24
ygjH,6442528,6442528,6442494,34,302,utRho24
ygjI,6452140,6452468,6452140,328,40,utRho24
ygjQ,6472730,6473080,6472730,350,2298,utRho24
ygjR,6474564,6474586,6474564,22,0,utRho24
ygjV,6483638,6483638,6483488,150,44,utRho24
yhaB,6535632,6535708,6535632,76,44,utRho24
yhaH,6504498,6504608,6504498,110,666,utRho24
yhaI,6505400,6505822,6505400,422,540,utRho24
yhaJ,6508560,6508560,6508428,132,576,utRho24
yhaK,6508538,6508638,6508538,100,696,utRho24
yhbQ,6599878,6599932,6599878,54,554,utRho24
yhbT,6602736,6602736,6602552,184,2274,utRho24
yhbU,6602558,6602970,6602558,412,3018,utRho24
yhbX,6643302,6643302,6643226,76,84,utRho24
yhbY,6655518,6655580,6655518,62,360,utRho24
yhcA,6723956,6724224,6723956,268,1178,utRho24
yhcB,6760364,6760382,6760364,18,26,utRho24
yhcC,6708470,6708470,6708100,370,754,utRho24
yhcF,6733440,6733852,6733440,412,2716,utRho24
yhcH,6739124,6739124,6738956,168,5192,utRho24
yhcM,6760312,6760312,6759994,318,152,utRho24
yhcN,6770812,6771076,6770812,264,332,utRho24
yhcO,6772606,6772606,6772258,348,16,utRho24
yhdH,6806560,6806968,6806560,408,360,utRho24
yhdJ,6823234,6823306,6823234,72,18,utRho24
yhdN,6879092,6879092,6879018,74,164,utRho24
yhdT,6814702,6814750,6814702,48,28,utRho24
yhdU,6824994,6825242,6824994,248,420,utRho24
yhdV,6836392,6836780,6836392,388,1956,utRho24
yhdW,6837944,6838298,6837944,354,240,utRho24
yheO,6953082,6953082,6952880,202,292,utRho24
yheV,6957970,6957970,6957584,386,142,utRho24
yhfA,6971902,6971902,6971636,266,1238,utRho24
yhfG,6983294,6983294,6983240,54,1690,utRho24
yhfL,6998622,6998896,6998622,274,414,utRho24
yhfY,7023244,7023244,7022844,400,0,utRho24
yhgA,7086294,7086334,7086294,40,0,utRho24
yhgE,7065176,7065176,7064878,298,1482,utRho24
yhgF,7074352,7074770,7074352,418,6820,utRho24
yhhA,7173458,7173886,7173458,428,1316,utRho24
yhhI,7248346,7248756,7248346,410,16,utRho24
yhhJ,7253696,7253696,7253606,90,326,utRho24
yhhM,7211588,7211588,7211220,368,2452,utRho24
yhhN,7211150,7211502,7211150,352,1756,utRho24
yhhQ,7218238,7218434,7218238,196,1536,utRho24
yhhT,7223682,7223730,7223682,48,82,utRho24
yhhX,7162032,7162032,7161610,422,212,utRho24
yhhY,7162222,7162276,7162222,54,98,utRho24
yhhZ,7163516,7163726,7163516,210,1258,utRho24
yhiD,7312220,7312220,7311804,416,21288,utRho24
yhiJ,7265190,7265190,7265180,10,112,utRho24
yhiM,7269270,7269682,7269270,412,4372,utRho24
yhiN,7275000,7275000,7274820,180,808,utRho24
yhjA,7338522,7338522,7338376,146,482,utRho24
yhjB,7344090,7344090,7343788,302,1746,utRho24
yhjC,7344272,7344684,7344272,412,670,utRho24
yhjD,7346660,7346724,7346660,64,80,utRho24
yhjE,7349274,7349572,7349274,298,3196,utRho24
yhjG,7356824,7356824,7356730,94,210,utRho24
yhjH,7358458,7358458,7358374,84,258,utRho24
yhjJ,7364032,7364032,7363880,152,564,utRho24
yhjK,7371296,7371296,7371158,138,358,utRho24
yhjR,7392750,7392750,7392370,380,40,utRho24
yhjV,7400796,7401126,7400796,330,1592,utRho24
yhjX,7424194,7424194,7424014,180,172,utRho24
yhjY,7425966,7425966,7425868,98,180,utRho24
yiaB,7455654,7455654,7455496,158,148,utRho24
yiaD,7432712,7433094,7432712,382,908,utRho24
yiaF,7438194,7438194,7438088,106,570,utRho24
yiaG,7438862,7438956,7438862,94,510,utRho24
yiaJ,7485236,7485236,7485064,172,1896,utRho24
yiaK,7485348,7485466,7485348,118,148,utRho24
yiaT,7503924,7503924,7503736,188,0,utRho24
yiaU,7503792,7503984,7503792,192,0,utRho24
yiaY,7515856,7515856,7515654,202,470,utRho24
yibF,7523950,7523950,7523910,40,144,utRho24
yibG,7536128,7536354,7536128,226,620,utRho24
yibL,7553194,7553330,7553194,136,168,utRho24
yibN,7570112,7570112,7570030,82,146,utRho24
yibT,7552848,7552848,7552760,88,856,utRho24
yicC,7633290,7633352,7633290,62,100,utRho24
yicH,7660862,7660914,7660862,52,172,utRho24
yicJ,7673328,7673328,7671858,1470,6166,utRho24
yicN,7685018,7685018,7684804,214,1822,utRho24
yicO,7687914,7687914,7687578,336,294,utRho24
yicR,15250308,15250308,15250236,72,0,utRho24
yidB,7755230,7755230,7754930,300,440,utRho24
yidE,7732780,7732780,7732546,234,110,utRho24
yidF,7711580,7711580,7711222,358,384,utRho24
yidQ,7735088,7735456,7735088,368,846,utRho24
yidR,7738824,7738824,7738618,206,198,utRho24
yieE,7787658,7787738,7787658,80,1322,utRho24
yieH,7793314,7793548,7793314,234,346,utRho24
yieK,7798928,7798928,7798786,142,222,utRho24
yifB,7900350,7900350,7899998,352,206,utRho24
yifL,7988984,7989044,7988984,60,10118,utRho24
yigF,8005750,8005750,8005598,152,44320,utRho24
yigI,8009448,8009448,8009394,54,1152,utRho24
yigM,8022100,8022152,8022100,52,88,utRho24
yihA,8101970,8101970,8101458,512,238,utRho24
yihD,8084098,8084138,8084098,40,190,utRho24
yihF,8088110,8088398,8088110,288,324,utRho24
yihG,8093304,8093304,8093204,100,202,utRho24
yihI,8102616,8102694,8102616,78,26,utRho24
yihL,8120506,8120894,8120506,388,956,utRho24
yihN,8124332,8124494,8124332,162,1190,utRho24
yihO,8131942,8131942,8131532,410,474,utRho24
yihQ,8138892,8138892,8138552,340,72,utRho24
yihV,8147064,8147478,8147064,414,782,utRho24
yihX,8151096,8151106,8151096,10,132,utRho24
yiiE,8158192,8158582,8158192,390,3372,utRho24
yiiF,8159124,8159502,8159124,378,838,utRho24
yiiG,8173762,8174004,8173762,242,30,utRho24
yiiM,8205506,8205644,8205506,138,3726,utRho24
yiiQ,8224624,8224624,8224428,196,160,utRho24
yiiS,8225738,8225934,8225738,196,8,utRho24
yijE,8272178,8272216,8272178,38,70,utRho24
yijF,8275728,8275728,8275314,414,4806,utRho24
yijO,8296858,8296858,8296634,224,164,utRho24
yjaA,8426240,8426468,8426240,228,64870,utRho24
yjaB,8428312,8428312,8428246,66,50,utRho24
yjaG,8398746,8399008,8398746,262,792,utRho24
yjaH,8401022,8401132,8401022,110,58,utRho24
yjaZ,8379506,8379572,8379506,66,54,utRho24
yjbB,8455204,8455462,8455204,258,270,utRho24
yjbE,16943432,16943624,16943432,192,688,utRho24
yjbL,8520318,8520642,8520318,324,120,utRho24
yjbQ,8540428,8540476,8540428,48,0,utRho24
yjcB,8550328,8550328,8550082,246,424,utRho24
yjcC,8550836,8550942,8550836,106,242,utRho24
yjcD,8556628,8556958,8556628,330,926,utRho24
yjcE,8559658,8559960,8559658,302,1360,utRho24
yjcF,8566212,8566212,8566150,62,40,utRho24
yjcO,8594660,8594660,8594250,410,228,utRho24
yjdA,8654128,8654270,8654128,142,0,utRho24
yjdC,8726660,8726660,8726616,44,80,utRho24
yjdK,8704780,8705168,8704780,388,3800,utRho24
yjdL,8713034,8713034,8712822,212,0,utRho24
yjdM,8653672,8653672,8653468,204,1894,utRho24
yjeF,8787354,8788132,8787354,778,79274,utRho24
yjeI,8745522,8745618,8745522,96,128,utRho24
yjeJ,8748806,8748806,8748468,338,652,utRho24
yjeV,8785472,8785784,8785472,312,2054,utRho24
yjfP,8833512,8833904,8833512,392,624,utRho24
yjfY,8849656,8849656,8849582,74,258,utRho24
yjfZ,8855052,8855052,8854844,208,1128,utRho24
yjgA,8916162,8916162,8915730,432,498,utRho24
yjgL,8950802,8950874,8950802,72,156,utRho24
yjgM,8959342,8959342,8959074,268,144,utRho24
yjgN,8959132,8959460,8959132,328,102,utRho24
yjgR,8980170,8980170,8980126,44,594,utRho24
yjgZ,9002116,9002520,9002116,404,5182,utRho24
yjhB,9007764,9008116,9007764,352,338,utRho24
yjhG,9048452,9048452,9048188,264,39368,utRho24
yjhU,9041080,9041080,9040648,432,1274,utRho24
yjiA,9178096,9178096,9177730,366,1230,utRho24
yjiJ,9125364,9125364,9125350,14,50,utRho24
yjiK,9127270,9127270,9127422,152,554,utRho24
yjiL,9129604,9129604,9129378,226,42,utRho24
yjiS,9143410,9143502,9143410,92,370,utRho24
yjiY,9182734,9182734,9182558,176,1396,utRho24
yjjA,9200674,9200674,9200378,296,872,utRho24
yjjB,18408708,18408708,18407800,908,1384,utRho24
yjjJ,9243314,9243538,9243314,224,50,utRho24
yjjK,9261132,9261132,9261044,88,1292,utRho24
yjjL,9189764,9189764,9189444,320,4198,utRho24
yjjM,9191894,9191894,9191702,192,242,utRho24
yjjP,9206068,9206068,9205716,352,13706,utRho24
yjjQ,9206638,9206954,9206638,316,12580,utRho24
yjjX,9267798,9267798,9267490,308,2144,utRho24
yjjY,9280716,9280804,9280716,88,194,utRho24
yjjZ,9211554,9211608,9211554,54,37020,utRho24
yjtD,9281676,9281884,9281676,208,284,utRho24
ykfB,532454,532454,532174,280,15770,utRho24
ykfI,527636,527636,527338,298,1398,utRho24
ykgB,637050,637050,636638,412,534,utRho24
ykgC,640430,640430,640002,428,624,utRho24
ykgD,640232,640454,640232,222,680,utRho24
ykgE,642962,643216,642962,254,2978,utRho24
ykgJ,608524,608524,608364,160,664,utRho24
ykgL,623878,624224,623878,346,4266,utRho24
ykgM,625610,625610,625554,56,1226,utRho24
ykgR,626570,626570,626484,86,122,utRho24
ylaC,958576,958576,958502,74,3410,utRho24
yliE,1745938,1745958,1745938,20,16,utRho24
ymcE,2103660,2103694,2103660,34,18,utRho24
ymdA,2210450,2210828,2210450,378,350,utRho24
ymdB,2211428,2211640,2211428,212,212,utRho24
ymfD,2395322,2395322,2395064,258,678,utRho24
ymfI,2402880,2402994,2402880,114,0,utRho24
ymfJ,2404518,2404518,2404168,350,786,utRho24
ymfK,2406176,2406176,2405866,310,194,utRho24
ymfT,2405766,2406048,2405766,282,178,utRho24
ymgE,2489110,2489456,2489110,346,1718,utRho24
ymgF,2437628,2437966,2437628,338,156,utRho24
ymiA,2670112,2670320,2670112,208,546,utRho24
ymjA,2715620,2715620,2715336,284,306,utRho24
ynaI,2791946,2791946,2791844,102,166,utRho24
ynaK,2850438,2850754,2850438,316,438,utRho24
ynbA,2954924,2955242,2954924,318,178,utRho24
yncD,3046552,3046552,3046130,422,282,utRho24
yncE,3046454,3046614,3046454,160,60,utRho24
yncG,3052456,3052494,3052456,38,1768,utRho24
yncL,3034492,3034492,3034388,104,1432,utRho24
yneE,3218364,3218364,3218044,320,10,utRho24
yneF,3223748,3223748,3223708,40,0,utRho24
yneJ,3229560,3229608,3229560,48,220,utRho24
yneK,3231100,3231526,3231100,426,838,utRho24
yneM,3245176,3245292,3245176,116,358,utRho24
ynfA,3311398,3311398,3311346,52,70,utRho24
ynfB,3311418,3311616,3311418,198,102,utRho24
ynfC,3315094,3315094,3314914,180,64,utRho24
ynfD,3314828,3315130,3314828,302,104,utRho24
ynfE,3316006,3316138,3316006,132,194,utRho24
ynfK,3334670,3334670,3334438,232,212,utRho24
ynfL,3339304,3339304,3339184,120,100,utRho24
ynfM,3339260,3339398,3339260,138,98,utRho24
ynfN,3276598,3276598,3276218,380,40,utRho24
ynfO,3273454,3273512,3273454,58,636,utRho24
ynhG,3517890,3517890,3517450,440,226,utRho24
yniA,3615158,3615592,3615158,434,1128,utRho24
yniB,3618526,3618526,3618466,60,50,utRho24
yniC,3618652,3618760,3618652,108,56,utRho24
yniD,3610202,3610330,3610202,128,160,utRho24
ynjE,3678880,3678934,3678880,54,110,utRho24
ynjF,3683222,3683222,3682806,416,626,utRho24
ynjH,3684376,3684376,3684270,106,176,utRho24
ynjI,3690022,3690022,3689742,280,1048,utRho24
yoaB,3786642,3786734,3786642,92,280,utRho24
yoaC,3787932,3788146,3787932,214,322,utRho24
yoaE,3803544,3803544,3803170,374,866,utRho24
yoaF,3755444,3755444,3755064,380,1390,utRho24
yoaH,3789866,3789866,3789462,404,1422,utRho24
yobB,3850418,3850880,3850418,462,1242,utRho24
yobF,3815586,3815586,3815182,404,318,utRho24
yobH,3817800,3817850,3817800,50,832,utRho24
yodB,4084352,4084736,4084352,384,1366,utRho24
yodC,4057008,4057008,4056740,268,68,utRho24
yohC,4451358,4451358,4451262,96,252,utRho24
yohD,4451526,4451602,4451526,76,178,utRho24
yohJ,4460986,4461248,4460986,262,768,utRho24
yohO,4431172,4431314,4431172,142,450,utRho24
yojI,4617282,4617282,4617230,52,24,utRho24
ypdI,4988988,4989396,4988988,408,452,utRho24
ypfG,5165786,5165786,5165554,232,254,utRho24
ypfM,5182140,5182140,5181732,408,634,utRho24
yphB,5349590,5349590,5349376,214,368,utRho24
ypjA,5565644,5565644,5565452,192,2104,utRho24
ypjB,5569636,5569636,5568858,778,248,utRho24
ypjD,5495860,5495774,5495860,86,2,utRho24
yqaE,5594170,5594170,5594056,114,274,utRho24
yqcA,5846100,5846100,5845968,132,538,utRho24
yqcE,5800944,5801184,5800944,240,32,utRho24
yqeC,6030468,6030468,6030114,354,338,utRho24
yqeF,5971618,5971618,5971184,434,5654,utRho24
yqeG,5971438,5971694,5971438,256,11522,utRho24
yqeH,5975016,5975072,5975016,56,17868,utRho24
yqeI,5976688,5977004,5976688,316,340,utRho24
yqeK,5981140,5981140,5980720,420,5966,utRho24
yqfA,6086728,6086728,6086296,432,842,utRho24
yqgA,6219042,6219106,6219042,64,84,utRho24
yqgB,6172500,6172500,6172102,398,510,utRho24
yqgE,6185768,6185874,6185768,106,354,utRho24
yqhA,6299150,6299150,6298942,208,324,utRho24
yqhC,6310768,6310768,6310436,332,922,utRho24
yqhD,6310604,6310710,6310604,106,334,utRho24
yqhH,6316842,6317254,6316842,412,1478,utRho24
yqiC,6369662,6369680,6369662,18,728,utRho24
yqiJ,6384108,6384416,6384108,308,416,utRho24
yqjA,6495096,6495546,6495096,450,12068,utRho24
yqjF,6500932,6501124,6500932,192,1170,utRho24
yqjG,6501948,6502048,6501948,100,10,utRho24
yqjH,6433078,6433078,6432982,96,0,utRho24
yqjI,6433506,6433558,6433506,52,124,utRho24
yraH,6574552,6574852,6574552,300,232,utRho24
yraP,6592144,6592818,6592144,674,676,utRho24
yraQ,6596414,6596414,6596276,138,54,utRho24
yraR,6598024,6598024,6597692,332,982,utRho24
yrbG,13360844,13361100,13360844,256,88,utRho24
yrbL,6696842,6696904,6696842,62,1336,utRho24
yrbN,6616172,6616172,6615866,306,1504,utRho24
yrdB,6860176,6860176,6860046,130,0,utRho24
yrfF,7052548,7052938,7052548,390,1232,utRho24
yrhB,7169440,7169518,7169440,78,100,utRho24
ysaB,7451804,7451804,7451424,380,78,utRho24
ysgA,8032686,8032686,8032338,348,944,utRho24
ytfB,8857638,8857638,8857434,204,824,utRho24
ytfE,8864018,8864018,8863966,52,234,utRho24
ytfF,8866296,8866296,8866130,166,636,utRho24
ytfH,8868164,8868226,8868164,62,406,utRho24
ytfI,8875234,8875414,8875234,180,426,utRho24
ytfJ,8878572,8878572,8878524,48,198,utRho24
ytfK,8879022,8879174,8879022,152,330,utRho24
ytfL,8882642,8882642,8882430,212,156,utRho24
ytfQ,8899634,8899924,8899634,290,346,utRho24
ytjB,9249598,9249598,9249578,20,84,utRho24
yzfA,8896588,8896588,8896490,98,2,utRho24
zapA,6111102,6111224,6111102,122,704,utRho24
zapB,8236772,8237030,8236772,258,298,utRho24
zapC,2011700,2011904,2011700,204,162,utRho24
zinT,4082692,4082750,4082692,58,382,utRho24
zipA,5062814,5062814,5062466,348,302,utRho24
zitB,1569716,1569716,1569646,70,124,utRho24
zntA,7212844,7212902,7212844,58,170,utRho24
zntR,6878336,6878336,6878260,76,242,utRho24
znuA,3885322,3885322,3885166,156,212,utRho24
znuC,3885268,3885324,3885268,56,190,utRho24
zraP,8403424,8403424,8403376,48,42,utRho24
zraS,8403810,8403852,8403810,42,4,utRho24
zupT,6364866,6365100,6364866,234,3578,utRho24
zur,8520282,8520282,8520006,276,366,utRho24
zwf,3872752,3872752,3872628,124,124,utRho24
C0343,2818676,2818728,2818676,52,0,utRho25
aaeB,6776526,6776526,6776376,150,52,utRho25
aaeR,6778762,6779040,6778762,278,116,utRho25
aaeX,6778860,6778860,6778674,186,102,utRho25
aat,1854920,1854920,1854864,56,0,utRho25
accA,416822,417242,416822,420,272,utRho25
accB,6810280,6810872,6810280,592,832,utRho25
accD,4868030,4868030,4867852,178,68,utRho25
aceB,8430804,8430956,8430804,152,26,utRho25
aceE,245938,246034,245938,96,134,utRho25
ackA,4826918,4826940,4826918,22,274,utRho25
acnA,2670848,2671662,2670848,814,202,utRho25
acnB,263038,263230,263038,192,566,utRho25
acpP,2303148,2303230,2303148,82,90,utRho25
acpS,5402324,5402324,5401996,328,562,utRho25
acrA,971396,971396,971238,158,0,utRho25
acrB,969370,969370,968806,564,504,utRho25
acrD,5174950,5175190,5174950,240,52,utRho25
acrE,6827404,6827728,6827404,324,22,utRho25
acrR,971398,971522,971398,124,0,utRho25
acrZ,1589502,1589546,1589502,44,0,utRho25
acs,8575190,8575190,8574742,448,674,utRho25
actP,8569870,8569870,8569804,66,52,utRho25
ada,4620854,4620854,4620810,44,0,utRho25
add,3404404,3404466,3404404,62,170,utRho25
ade,7687802,7687928,7687802,126,20,utRho25
adhE,2596826,2596826,2596242,584,0,utRho25
adhP,3107988,3107988,3107676,312,308,utRho25
adiA,8681112,8681112,8681042,70,0,utRho25
adiC,8674404,8674404,8674062,342,20,utRho25
adiY,8676084,8676084,8675858,226,12,utRho25
adk,994278,994350,994278,72,400,utRho25
adrA,807374,807406,807374,32,0,utRho25
aer,6438240,6438240,6438152,88,0,utRho25
aes,1000102,1000102,999946,156,80,utRho25
agaR,6557406,6557406,6557330,76,68,utRho25
agaS,6563778,6563952,6563778,174,0,utRho25
agp,2131118,2131170,2131118,52,0,utRho25
agrA,7296126,7296126,7296126,0,0,utRho25
agrB,7296588,7296588,7296588,0,0,utRho25
ahpC,1277386,1277890,1277386,504,862,utRho25
ahpF,1278004,1279506,1278004,1502,38012,utRho25
ahr,8992698,8992698,8992418,280,60,utRho25
aidB,8828494,8828550,8828494,56,0,utRho25
ais,4731512,4731512,4731240,272,124,utRho25
alaA,4814816,4815122,4814816,306,2,utRho25
alaC,4996798,4996798,4996590,208,74,utRho25
alaE,5598140,5598328,5598140,188,330,utRho25
alaS,5644180,5644180,5644022,158,396,utRho25
alaW,5036612,5036612,5036462,150,128,utRho25
aldA,2976380,2976464,2976380,84,8,utRho25
aldB,7513070,7513070,7513022,48,44,utRho25
alkA,4295118,4295118,4295080,38,0,utRho25
alkB,4618890,4618890,4618682,208,112,utRho25
allA,1064780,1064902,1064780,122,34,utRho25
allD,1092822,1092822,1092726,96,0,utRho25
allE,1088112,1088112,1088092,20,0,utRho25
allS,1064600,1064600,1064442,158,98,utRho25
alr,8531178,8531564,8531178,386,242,utRho25
alsE,8617334,8617334,8616956,378,628,utRho25
alsK,8615990,8615990,8615598,392,60,utRho25
alx,6476740,6477160,6476740,420,96,utRho25
amiA,5104482,5104704,5104482,222,4,utRho25
amiC,5898378,5898378,5898020,358,0,utRho25
amn,4110062,4110122,4110062,60,0,utRho25
ampC,8758006,8758006,8757888,118,0,utRho25
ampD,237362,237466,237362,104,80,utRho25
ampG,907372,907372,907090,282,24,utRho25
ampH,792726,792726,792574,152,0,utRho25
amyA,4012230,4012312,4012230,82,0,utRho25
anmK,3439346,3439346,3439204,142,0,utRho25
ansB,6201580,6201580,6201456,124,56,utRho25
ansP,3052040,3052040,3051960,80,0,utRho25
apaG,104068,104068,103212,856,294,utRho25
apaH,102586,102586,102444,142,88,utRho25
apbE,4623188,4623188,4623068,120,0,utRho25
appA,2081198,2081234,2081198,36,0,utRho25
appC,2075420,2075480,2075420,60,68,utRho25
appY,1167134,1167362,1167134,228,0,utRho25
apt,982620,982824,982620,204,46,utRho25
aqpZ,1832424,1832424,1832094,330,58,utRho25
araB,140150,140150,140096,54,22,utRho25
araC,140482,140774,140482,292,96,utRho25
araE,5964416,5964416,5964364,52,0,utRho25
araF,3972476,3972476,3972256,220,0,utRho25
araH,3967120,3967120,3967086,34,26,utRho25
araJ,825058,825058,824962,96,428,utRho25
arcA,9281602,9281602,9280612,990,1882,utRho25
arcB,6706098,6706098,6706050,48,180,utRho25
arcZ,6701154,6701154,6701154,0,0,utRho25
arfA,6877346,6877346,6877298,48,16,utRho25
argA,5898312,5898484,5898312,172,0,utRho25
argC,8309770,8310002,8309770,232,80,utRho25
argD,6980442,6980442,6980360,82,14,utRho25
argE,8310156,8310156,8309694,462,110,utRho25
argF,580680,580680,580610,70,0,utRho25
argG,6637124,6637274,6637124,150,254,utRho25
argI,8956688,8956688,8956622,66,0,utRho25
argO,6137672,6137672,6137616,56,256,utRho25
argP,6119460,6119506,6119460,46,8,utRho25
argR,6769204,6769406,6769204,202,0,utRho25
argS,3920002,3920124,3920002,122,0,utRho25
argT,4855698,4855698,4855582,116,0,utRho25
argU,1129406,1129446,1129406,40,0,utRho25
argW,4932616,4932618,4932616,2,0,utRho25
argX,7964728,7964750,7964728,22,58,utRho25
aroF,5482402,5482402,5482300,102,0,utRho25
aroG,1571182,1571266,1571182,84,48,utRho25
aroH,3576636,3576870,3576636,234,316,utRho25
aroK,7038760,7038760,7038128,632,588,utRho25
aroL,812560,812810,812560,250,104,utRho25
aroP,243342,243342,243102,240,0,utRho25
arpA,8445382,8445382,8444974,408,6,utRho25
arrS,7316108,7316108,7316108,0,0,utRho25
arsR,7297024,7297056,7297024,32,0,utRho25
artJ,1801252,1801252,1801150,102,0,utRho25
artP,1807686,1807686,1807468,218,324,utRho25
ascF,5678858,5679048,5678858,190,0,utRho25
ascG,5678574,5678574,5678528,46,0,utRho25
aslB,7965562,7965916,7965562,354,250,utRho25
asnA,7854258,7854310,7854258,52,134,utRho25
asnB,1398444,1398444,1398354,90,178,utRho25
asnC,23562186,23562186,23562018,168,402,utRho25
asnS,1978088,1978088,1977970,118,1818,utRho25
asnT,4089082,4089098,4089082,16,0,utRho25
asnU,4119690,4119702,4119690,12,0,utRho25
asnV,4124504,4124520,4124504,16,2,utRho25
aspA,17473728,17473728,17473308,420,4,utRho25
aspC,1971486,1971486,1971418,68,40,utRho25
aspS,3901402,3901402,3901044,358,20,utRho25
aspT,7893560,7893744,7893560,184,104176,utRho25
aspV,473826,473862,473826,36,266,utRho25
asr,3342654,3342752,3342654,98,84,utRho25
astC,3664088,3664088,3663964,124,38,utRho25
astE,3654138,3654138,3653846,292,0,utRho25
atoD,4646824,4646894,4646824,70,120,utRho25
atpB,7844540,7844540,7844102,438,264,utRho25
atpC,7832118,7832118,7831944,174,524,utRho25
atpI,7845050,7845050,7844880,170,494,utRho25
avtA,7479348,7479410,7479348,62,246,utRho25
azoR,2965982,2965982,2965720,262,78,utRho25
azuC,3976002,3976002,3975918,84,24,utRho25
bacA,6408350,6408350,6408262,88,566,utRho25
bamA,394052,395856,394052,1804,1356,utRho25
bamB,5277950,5277950,5277304,646,600,utRho25
bamC,5198028,5198028,5197730,298,418,utRho25
bamD,5471922,5472292,5471922,370,770,utRho25
bamE,5506972,5507210,5506972,238,804,utRho25
basS,8666954,8666954,8666544,410,386,utRho25
bax,7474468,7474468,7474354,114,82,utRho25
bcp,5200874,5200956,5200874,82,300,utRho25
bcsB,7385346,7385346,7385214,132,108,utRho25
bcsE,7392644,7392916,7392644,272,150,utRho25
bdcA,8948128,8948128,8948106,22,34,utRho25
bdcR,8948192,8948248,8948192,56,32,utRho25
bdm,3112680,3112680,3112560,120,138,utRho25
betA,654522,654522,654494,28,0,utRho25
betI,658722,658722,658668,54,20,utRho25
betT,658842,658926,658842,84,56,utRho25
bfr,6933498,6933498,6933450,48,66,utRho25
bglG,23440182,23440182,23439402,780,144,utRho25
bglX,4444240,4444240,4443978,262,0,utRho25
bhsA,2337962,2338146,2337962,184,6,utRho25
bioA,1618584,1618584,1618514,70,0,utRho25
bioB,1618604,1618688,1618604,84,0,utRho25
bioH,7089716,7089716,7089688,28,0,utRho25
bisC,7433026,7433026,7432788,238,58,utRho25
blc,8755490,8755490,8755444,46,0,utRho25
blr,3409024,3409102,3409024,78,26,utRho25
bluF,2431226,2431226,2430950,276,72,utRho25
bluR,2428226,2428226,2428118,108,0,utRho25
bolA,908698,908944,908698,246,4,utRho25
borD,1157842,1157842,1157786,56,6,utRho25
brnQ,838976,839182,838976,206,1038,utRho25
bssR,1756492,1756496,1756492,4,0,utRho25
bssS,2242116,2242116,2241910,206,500,utRho25
btuB,8326798,8327278,8326798,480,742,utRho25
cadB,8720212,8720212,8720062,150,78,utRho25
cadC,8723926,8723926,8723868,58,0,utRho25
caiE,70998,70998,70742,256,30,utRho25
caiF,68436,68600,68436,164,22,utRho25
caiT,84074,84074,83862,212,186,utRho25
can,285406,285406,285340,66,108,utRho25
carA,59102,59302,59102,200,160,utRho25
carB,61550,61634,61550,84,0,utRho25
cas2,5757830,5757830,5757706,124,2,utRho25
casA,5768638,5768638,5768276,362,128,utRho25
cbl,4121882,4121882,4121828,54,0,utRho25
cbpA,2128074,2128074,2127550,524,0,utRho25
cbrA,7738628,7738754,7738628,126,72,utRho25
cbrB,7794958,7795012,7794958,54,32,utRho25
ccmH,4585242,4585242,4584820,422,120,utRho25
cdaR,364894,364926,364894,32,16,utRho25
cdd,4463638,4463688,4463638,50,0,utRho25
cdh,8219814,8219860,8219814,46,56,utRho25
cdsA,391110,391354,391110,244,242,utRho25
cedA,3627484,3627484,3627326,158,160,utRho25
cfa,3482402,3482826,3482402,424,52,utRho25
chaC,2544844,2544972,2544844,128,0,utRho25
chbB,3643452,3643452,3643238,214,0,utRho25
chbG,3634624,3634624,3634270,354,22,utRho25
cheW,3946924,3946924,3946678,246,314,utRho25
chiA,6939792,6939792,6939706,86,206,utRho25
chiP,1416472,1416668,1416472,196,20,utRho25
cho,3646984,3647030,3646984,46,0,utRho25
chpS,8896804,8896894,8896804,90,28,utRho25
cirA,4493884,4493884,4493538,346,44,utRho25
citC,1304078,1304078,1303712,366,420,utRho25
citT,1293264,1293264,1293160,104,0,utRho25
clcA,350104,350214,350104,110,0,utRho25
clpA,1846160,1846528,1846160,368,0,utRho25
clpB,5468410,5468410,5468346,64,390,utRho25
clpP,913154,913354,913154,200,712,utRho25
clpS,1845500,1845826,1845500,326,652,utRho25
clpX,914404,914852,914404,448,2382,utRho25
clsA,2617346,2617346,2617290,56,0,utRho25
clsC,2212584,2212710,2212584,126,8,utRho25
cmk,1922330,1922402,1922330,72,0,utRho25
cnu,3409522,3409898,3409522,376,878,utRho25
coaA,8350214,8350214,8350052,162,62,utRho25
cobC,1340092,1340092,1339814,278,40,utRho25
cobT,4129202,4129202,4128934,268,168,utRho25
cobU,4131944,4131944,4131528,416,152,utRho25
codB,709768,709844,709768,76,0,utRho25
comR,2337726,2337726,2337664,62,26,utRho25
copA,1022822,1022822,1022758,64,0,utRho25
corA,8002388,8002852,8002388,464,31440,utRho25
cpdB,8873258,8873258,8873130,128,86,utRho25
cptB,6082198,6082198,6082140,58,2,utRho25
cpxA,8210202,8210202,8209950,252,58,utRho25
cpxP,8211570,8211640,8211570,70,122,utRho25
cpxR,8211372,8211372,8211340,32,0,utRho25
cra,175894,176056,175894,162,158,utRho25
crcB,1316016,1316016,1315876,140,0,utRho25
creA,9270486,9271042,9270486,556,78,utRho25
creD,9276320,9276356,9276320,36,238,utRho25
crl,515620,515658,515620,38,480,utRho25
crp,6971906,6972240,6971906,334,214,utRho25
crr,5070960,5071668,5070960,708,1178,utRho25
csdA,5886414,5886674,5886414,260,0,utRho25
csgB,2207718,2207902,2207718,184,0,utRho25
csgD,2206688,2206688,2206392,296,172,utRho25
csgG,2203510,2203510,2203368,142,262,utRho25
csiD,5577854,5577970,5577854,116,2,utRho25
csiE,5330802,5330870,5330802,68,28,utRho25
csiR,5590942,5591348,5590942,406,124,utRho25
cspA,7439778,7440098,7439778,320,460,utRho25
cspB,3283430,3283430,3283108,322,0,utRho25
cspC,3815018,3815018,3814870,148,70,utRho25
cspD,1845352,1845352,1845180,172,4674,utRho25
cspE,1314294,1314584,1314294,290,78,utRho25
cspF,3283380,3283710,3283380,330,190,utRho25
cspG,2102610,2102922,2102610,312,212,utRho25
cspH,2102746,2102746,2102350,396,60,utRho25
cspI,3277624,3277624,3277334,290,0,utRho25
csrA,5638746,5638746,5638292,454,482,utRho25
csrB,5849048,5849048,5849048,0,0,utRho25
csrC,8102072,8102072,8102072,0,0,utRho25
csrD,6806850,6806850,6806664,186,242,utRho25
cstA,1259710,1259788,1259710,78,22,utRho25
cueO,274090,274166,274090,76,0,utRho25
cueR,1027948,1027986,1027948,38,2,utRho25
curA,3037784,3038054,3037784,270,76,utRho25
cusC,1191146,1191200,1191146,54,0,utRho25
cusR,1190924,1190924,1190886,38,0,utRho25
cutA,8730784,8730784,8730712,72,26,utRho25
cutC,3918534,3918534,3917920,614,230,utRho25
cvpA,4861600,4861600,4861526,74,100,utRho25
cvrA,2484328,2484328,2484142,186,0,utRho25
cyaA,7981548,7982306,7981548,758,354,utRho25
cyaR,4334228,4334224,4334228,4,26,utRho25
cyaY,7988166,7988166,7988118,48,270,utRho25
cybB,2981522,2981804,2981522,282,0,utRho25
cycA,8859560,8859728,8859560,168,54,utRho25
cydA,1542340,1542916,1542340,576,2094,utRho25
cydC,1858800,1858800,1858390,410,214,utRho25
cydD,1862062,1862062,1861924,138,0,utRho25
cydX,1548300,1548392,1548300,92,168,utRho25
cynR,717418,717418,717380,38,2,utRho25
cynT,1435092,1435196,1435092,104,0,utRho25
cyoA,903306,903306,903220,86,312,utRho25
cyoE,895540,895540,895410,130,120,utRho25
cysB,2667576,2667710,2667576,134,240,utRho25
cysC,5748056,5748056,5747984,72,176,utRho25
cysD,5752736,5752736,5752658,78,64,utRho25
cysE,7565362,7565362,7565124,238,504,utRho25
cysG,6995508,6995656,6995508,148,684,utRho25
cysJ,5783928,5783928,5783796,132,578,utRho25
cysK,5064688,5064818,5064688,130,0,utRho25
cysP,5087114,5087114,5087056,58,2,utRho25
cysS,1109154,1109222,1109154,68,0,utRho25
cysT,3984100,3984100,3983974,126,112,utRho25
cysZ,5062766,5062926,5062766,160,254,utRho25
cytR,8249018,8249018,8248912,106,112,utRho25
dacA,1328002,1328002,1327926,76,0,utRho25
dacB,6657714,6657926,6657714,212,0,utRho25
dacC,1761306,1761454,1761306,148,62,utRho25
dadA,2475018,2475142,2475018,124,8,utRho25
dam,7032504,7032504,7031826,678,422,utRho25
damX,7035200,7035200,7034612,588,1500,utRho25
dapA,5199568,5199568,5199520,48,0,utRho25
dapB,56576,56748,56576,172,206,utRho25
dapD,371954,371954,371894,60,130,utRho25
dapE,5183120,5183214,5183120,94,128,utRho25
dcp,3254844,3254844,3254760,84,14,utRho25
dcrB,7219534,7219910,7219534,376,132,utRho25
dctA,7366996,7366996,7366894,102,124,utRho25
dcuA,8733686,8733686,8733546,140,658,utRho25
dcuB,8698182,8698182,8697488,694,628,utRho25
dcuC,1312166,1312166,1311936,230,564,utRho25
dcuD,6749166,6749738,6749166,572,356,utRho25
dcuR,8701130,8701130,8700068,1062,492,utRho25
dcuS,8703370,8703370,8703324,46,96,utRho25
dcyD,3999016,3999016,3998960,56,0,utRho25
ddpX,3126498,3126498,3126152,346,0,utRho25
deaD,6615818,6615818,6615720,98,64,utRho25
dedA,4869880,4869880,4869482,398,316,utRho25
dedD,4863750,4863750,4863368,382,156,utRho25
def,6867300,6867380,6867300,80,0,utRho25
degP,361690,361768,361690,78,0,utRho25
degQ,6761308,6761486,6761308,178,10,utRho25
deoB,9239134,9239206,9239134,72,52,utRho25
deoC,9233358,9234646,9233358,1288,474,utRho25
dfp,7625406,7625462,7625406,56,0,utRho25
dgcZ,3247758,3247758,3247700,58,0,utRho25
dgkA,8512914,8513274,8512914,360,256,utRho25
dgt,358392,358474,358392,82,86,utRho25
dhaK,2501888,2501888,2501676,212,26,utRho25
dhaR,2502006,2502132,2502006,126,24,utRho25
dicB,3299194,3299218,3299194,24,0,utRho25
dicC,3295752,3295752,3295700,52,0,utRho25
dinB,501760,501796,501760,36,0,utRho25
dinD,7635398,7635520,7635398,122,128,utRho25
dinG,1666146,1666140,1666146,6,0,utRho25
dinI,2243018,2243018,2242974,44,30,utRho25
dinJ,493230,493230,493004,226,2,utRho25
dinQ,7295964,7295964,7295576,388,120,utRho25
djlA,114536,114728,114536,192,56,utRho25
dkgA,6313142,6313246,6313142,104,92,utRho25
dkgB,458196,458334,458196,138,0,utRho25
dksA,321502,321502,321208,294,650,utRho25
dld,4444164,4444370,4444164,206,36,utRho25
dmlA,3763424,3763824,3763424,400,114,utRho25
dmlR,3763710,3763710,3763618,92,26,utRho25
dmsA,1881646,1881918,1881646,272,0,utRho25
dnaA,7767922,7767922,7767458,464,370,utRho25
dnaB,8528566,8528628,8528566,62,264,utRho25
dnaK,24096,24326,24096,230,5134,utRho25
dnaN,7765466,7765466,7764642,824,226,utRho25
dnaQ,471868,472134,471868,266,2912,utRho25
dnaT,18406460,18406460,18406068,392,16,utRho25
dnaX,984112,984184,984112,72,0,utRho25
dosP,3131486,3131486,3131466,20,2,utRho25
dpiB,1303968,1304470,1303968,502,28,utRho25
dppA,7415740,7415740,7415410,330,496,utRho25
dps,1697900,1697900,1697822,78,30,utRho25
dsbA,8086754,8086836,8086754,82,930,utRho25
dsbB,2466294,2466294,2466060,234,20,utRho25
dsbC,6079266,6079266,6077644,1622,766,utRho25
dsbG,1277600,1277600,1277146,454,464,utRho25
dsdA,4958242,4958404,4958242,162,2,utRho25
dsdC,4955492,4955492,4955258,234,0,utRho25
dsdX,4955642,4955694,4955642,52,36,utRho25
dsrA,4050626,4050626,4050626,0,0,utRho25
dsrB,4049686,4049686,4049646,40,0,utRho25
dtpD,1485340,1485340,1485112,228,2,utRho25
dusA,8523200,8523338,8523200,138,700,utRho25
dusB,6820492,6820560,6820492,68,0,utRho25
dusC,4460790,4460790,4460770,20,0,utRho25
dut,7627704,7627864,7627704,160,874,utRho25
dxr,386670,387042,386670,372,374,utRho25
ebgA,6445102,6445266,6445102,164,0,utRho25
ebgR,6442874,6442932,6442874,58,0,utRho25
ecnB,8753018,8753106,8753018,88,32,utRho25
eco,4607594,4607810,4607594,216,42,utRho25
ecpA,621594,621594,621342,252,0,utRho25
ecpB,620238,620238,620052,186,0,utRho25
ecpR,622964,622964,622672,292,0,utRho25
eda,3866218,3866218,3865512,706,24,utRho25
edd,3869426,3869426,3869208,218,4,utRho25
efeO,2164308,2164486,2164308,178,2,utRho25
efeU_1,2162614,2162712,2162614,98,224,utRho25
efp,8751134,8751398,8751134,264,530,utRho25
elaA,4763372,4763372,4763086,286,6,utRho25
elaD,4765308,4765426,4765308,118,22,utRho25
elfA,1995530,1995736,1995530,206,0,utRho25
elfD,1996642,1996980,1996642,338,14,utRho25
emrD,7707690,7707844,7707690,154,0,utRho25
emrK,4966896,4966896,4966678,218,46,utRho25
emrY,4964668,4964668,4964352,316,316,utRho25
emtA,2486250,2486360,2486250,110,0,utRho25
endA,12361100,12361388,12361100,288,0,utRho25
eno,5817692,5817692,5815882,1810,816,utRho25
entC,1249662,1249770,1249662,108,0,utRho25
entD,1220508,1220508,1220158,350,144,utRho25
entH,1258584,1258600,1258584,16,86,utRho25
entS,1244506,1244600,1244506,94,32,utRho25
envR,6827266,6827266,6826930,336,0,utRho25
epd,12295292,12295292,12294764,528,12,utRho25
epmA,8765236,8765286,8765236,50,0,utRho25
epmB,8751406,8751406,8751314,92,326,utRho25
eptB,7421162,7421162,7420950,212,0,utRho25
eptC,8300622,8300622,8300530,92,112,utRho25
erfK,4126708,4126708,4126646,62,28,utRho25
erpA,353122,353220,353122,98,4,utRho25
esrE,8039956,8039956,8039956,0,0,utRho25
essD,1153746,1154796,1153746,1050,232,utRho25
etk,2088606,2088606,2088420,186,150,utRho25
evgA,4967262,4967510,4967262,248,48,utRho25
exbB,6304028,6304028,6303968,60,20,utRho25
exbD,6302780,6302780,6302486,294,56,utRho25
exuR,6493016,6493304,6493016,288,0,utRho25
exuT,6490004,6490208,6490004,204,0,utRho25
fabA,2032996,2032996,2032940,56,64,utRho25
fabB,4883282,4883282,4883210,72,8,utRho25
fabH,2297032,2297518,2297032,486,386,utRho25
fabI,2702236,2702236,2702078,158,46,utRho25
fadB,8062026,8062026,8061942,84,0,utRho25
fadD,3779614,3779614,3779492,122,282,utRho25
fadE,486812,486812,486606,206,286,utRho25
fadH,6463248,6463330,6463248,82,26,utRho25
fadI,4921022,4921022,4920938,84,4,utRho25
fadL,4922410,4922600,4922410,190,220,utRho25
fadM,928720,928804,928720,84,0,utRho25
fadR,2469810,2469876,2469810,66,0,utRho25
fbaB,4357334,4357334,4357128,206,0,utRho25
fdhE,8162722,8162722,8162456,266,448,utRho25
fdhF,8598814,8598814,8598732,82,0,utRho25
fdnG,3094744,3094802,3094744,58,32,utRho25
fdrA,1093012,1093360,1093012,348,72,utRho25
feaB,2894994,2895038,2894994,44,0,utRho25
feaR,2894734,2894734,2894566,168,0,utRho25
fecA,9033454,9033454,9033354,100,30,utRho25
fecE,9023288,9023288,9022914,374,1750,utRho25
fecI,9036564,9036564,9036470,94,110,utRho25
feoA,7080114,7080326,7080114,212,572,utRho25
fepA,1225334,1225334,1224988,346,42,utRho25
fepB,1249454,1249454,1249020,434,0,utRho25
fepD,1244468,1244468,1244378,90,0,utRho25
fes,1225374,1225630,1225374,256,0,utRho25
ffh,5495706,5495706,5495590,116,444,utRho25
ffs,952576,952848,952576,272,124,utRho25
fhuA,334884,334968,334884,84,94,utRho25
fhuE,2323294,2323294,2323102,192,16,utRho25
fhuF,9211504,9211504,9211326,178,198,utRho25
fic,6983296,6983296,6982926,370,0,utRho25
fieF,8212864,8212938,8212864,74,34,utRho25
fimA,9085388,9086230,9085388,842,774,utRho25
fimB,9081334,9081914,9081334,580,1538,utRho25
fimE,9083742,9084074,9083742,332,478,utRho25
fimZ,1129214,1129214,1128960,254,116,utRho25
fiu,1683296,1683296,1683062,234,38,utRho25
fixA,84650,84806,84650,156,0,utRho25
fkpA,6955050,6955050,6954838,212,6418,utRho25
fldA,2846084,2846084,2845860,224,600,utRho25
fldB,6079644,6079710,6079644,66,0,utRho25
flgA,2261770,2261770,2261726,44,184,utRho25
flgB,2261986,2262036,2261986,50,0,utRho25
flgK,2276702,2276756,2276702,54,0,utRho25
flgM,2260330,2260330,2260256,74,28,utRho25
flgN,2259828,2259828,2259660,168,0,utRho25
flhB,3932432,3932432,3932382,50,38,utRho25
flhC,3955864,3955864,3955688,176,194,utRho25
flhD,3957154,3957154,3956394,760,532,utRho25
fliA,4003638,4003638,4003578,60,20,utRho25
fliC,4007352,4007352,4007212,140,110,utRho25
fliD,4007634,4007744,4007634,110,0,utRho25
fliE,4026186,4026186,4026028,158,152,utRho25
fliF,4026292,4026458,4026292,166,26,utRho25
fliL,4039168,4039236,4039168,68,14,utRho25
flk,4875824,4875900,4875824,76,2,utRho25
flu,4142634,4143078,4142634,444,132,utRho25
flxA,3292776,3292810,3292776,34,36,utRho25
fnr,2799104,2799104,2799052,52,56,utRho25
fnrS,2818258,2818258,2818258,0,0,utRho25
focA,1909628,1909628,1908932,696,32,utRho25
folA,99598,99646,99598,48,0,utRho25
folB,6409296,6409296,6409178,118,2,utRho25
folD,1115562,1115562,1115482,80,62,utRho25
folE,4487696,4487696,4487304,392,110,utRho25
fpr,8228998,8228998,8228944,54,0,utRho25
frc,4986878,4986878,4986508,370,116,utRho25
frdA,8764824,8764824,8764636,188,32,utRho25
frdD,8758948,8758948,8758732,216,134,utRho25
fre,8052886,8053054,8052886,168,90,utRho25
frlA,6999518,6999820,6999518,302,16,utRho25
frr,385624,385744,385624,120,420,utRho25
frsA,513004,513054,513004,50,0,utRho25
fruB,4527194,4527194,4526990,204,0,utRho25
frvR,8179804,8179804,8179710,94,0,utRho25
fryA,5008986,5008986,5008970,16,118,utRho25
fsaA,1727060,1727284,1727060,224,8,utRho25
fsr,1009710,1009710,1009392,318,128,utRho25
ftnA,3977364,3977432,3977364,68,8,utRho25
ftnB,3973550,3973850,3973550,300,314,utRho25
ftsA,207122,207964,207122,842,414,utRho25
ftsB,5745802,5745802,5745640,162,0,utRho25
ftsH,6654204,6654204,6653870,334,984,utRho25
ftsK,1865858,1866448,1865858,590,1066,utRho25
ftsL,181376,182064,181376,688,240,utRho25
ftsP,6325732,6325732,6325338,394,48,utRho25
ftsQ,205484,206310,205484,826,506,utRho25
ftsX,7204512,7204512,7204172,340,238,utRho25
ftsZ,209272,210610,209272,1338,160,utRho25
fucA,5867708,5867708,5867376,332,138,utRho25
fucP,5868238,5868470,5868238,232,40,utRho25
fumA,6753760,6753760,6753508,252,1688,utRho25
fumB,8694696,8694696,8694652,44,0,utRho25
fumC,3373418,3373418,3373176,242,52,utRho25
fur,2842892,2842892,2842584,308,396,utRho25
fusA,6947370,6947370,6947028,342,6378,utRho25
fxsA,8737206,8737328,8737206,122,1146,utRho25
gabD,5581824,5582546,5581824,722,876,utRho25
gadA,7335214,7335214,7335160,54,0,utRho25
gadB,3144144,3144144,3144090,54,0,utRho25
gadC,3141168,3141168,3140978,190,544,utRho25
gadE,7315600,7316732,7315600,1132,312,utRho25
gadW,7329562,7329562,7329236,326,0,utRho25
gadX,14663356,14663356,14663240,116,4,utRho25
gadY,7329728,7329728,7329728,0,0,utRho25
galE,1584354,1584354,1584110,244,0,utRho25
galF,4228702,4228702,4228654,48,42,utRho25
galM,1577796,1577796,1577674,122,136,utRho25
galP,6176510,6176568,6176510,58,0,utRho25
galR,5953138,5953198,5953138,60,38,utRho25
galS,4483420,4483420,4483336,84,0,utRho25
galU,2582810,2582914,2582810,104,266,utRho25
gapA,3724480,3725542,3724480,1062,1056,utRho25
garP,6549868,6549868,6549814,54,132,utRho25
gatY,4354468,4354468,4354408,60,0,utRho25
gatZ,4352864,4352864,4352642,222,372,utRho25
gcd,282558,282558,282450,108,58,utRho25
gcl,1067814,1067832,1067814,18,0,utRho25
gcvA,5885278,5885278,5885134,144,0,utRho25
gcvB,5885392,5885392,5885392,0,0,utRho25
gcvR,5199758,5199812,5199758,54,40,utRho25
gcvT,6101544,6101544,6101334,210,186,utRho25
gdhA,3684616,3684742,3684616,126,98,utRho25
gfcA,2099668,2099668,2099488,180,64,utRho25
gfcD,2096236,2096236,2095890,346,268,utRho25
ghrA,2195648,2195772,2195648,124,204,utRho25
ghrB,7434378,7434620,7434378,242,432,utRho25
glcA,6242728,6242728,6242558,170,310,utRho25
glcC,6256412,6256544,6256412,132,0,utRho25
glcD,6256152,6256152,6256042,110,140,utRho25
gldA,8278092,8278092,8278070,22,18,utRho25
glgA,7136784,7136784,7136066,718,58,utRho25
glgB,7147314,7147314,7147004,310,102,utRho25
glgC,7139142,7139142,7138656,486,8,utRho25
glgP,7133546,7133546,7133162,384,136,utRho25
glgS,6384024,6384024,6383878,146,204,utRho25
glgX,7142838,7142838,7142638,200,0,utRho25
glk,5018922,5018922,5018852,70,2,utRho25
glmS,7827622,7827622,7827336,286,490,utRho25
glmU,7830652,7830652,7830400,252,0,utRho25
glmY,10765360,10765360,10765360,0,0,utRho25
glmZ,7972864,7972864,7972864,0,0,utRho25
glnA,16232888,16232888,16232136,752,328,utRho25
glnB,5375052,5375052,5374816,236,54,utRho25
glnD,377310,377310,377300,10,82,utRho25
glnE,6399602,6399602,6399282,320,0,utRho25
glnH,1696396,1696396,1696008,388,38,utRho25
glnK,945112,945196,945112,84,0,utRho25
glnL,8112742,8112742,8112678,64,0,utRho25
glnQ,1693262,1693262,1692926,336,158,utRho25
glnS,1411998,1412186,1411998,188,1956,utRho25
gloA,3455602,3455674,3455602,72,26,utRho25
gloB,469852,469852,469564,288,334,utRho25
glpA,4705166,4705294,4705166,128,0,utRho25
glpD,7123942,7124026,7123942,84,40,utRho25
glpE,7123698,7123698,7123646,52,0,utRho25
glpF,8236322,8236322,8236180,142,244,utRho25
glpG,7122960,7122960,7122904,56,60,utRho25
glpR,7121782,7121782,7121210,572,992,utRho25
glpT,4704902,4704902,4704748,154,310,utRho25
glpX,8231212,8231212,8231158,54,342,utRho25
glrK,5382246,5382246,5382196,50,0,utRho25
gltA,1509534,1509534,1508936,598,1750,utRho25
gltB,6709018,6709264,6709018,246,16,utRho25
gltI,1375792,1375792,1375494,298,656,utRho25
gltP,8588536,8588962,8588536,426,450,utRho25
gltS,7657382,7657382,7657330,52,242,utRho25
gltX,5041568,5041568,5041344,224,388,utRho25
gluQ,320286,320286,320224,62,28,utRho25
glyA,5371148,5371148,5371014,134,0,utRho25
glyQ,7450708,7450708,7450636,72,78,utRho25
glyS,7448990,7448990,7448794,196,696,utRho25
glyU,5998128,5998128,5998114,14,0,utRho25
glyV,8784626,8784720,8784626,94,114,utRho25
glyW,3984360,3984360,3984234,126,4,utRho25
gmhB,445612,445666,445612,54,0,utRho25
gmk,7642776,7642856,7642776,80,0,utRho25
gmr,2693686,2693686,2693484,202,6,utRho25
gnd,4202648,4202648,4202536,112,642,utRho25
gnsB,3275692,3275692,3275564,128,0,utRho25
gntK,14310580,14310580,14310368,212,8,utRho25
gntP,9102668,9102668,9102592,76,380,utRho25
gntR,7157760,7157760,7157452,308,350,utRho25
gntT,7092810,7093118,7092810,308,228,utRho25
gntU,7154170,7154170,7154122,48,56,utRho25
gntX,7089334,7089764,7089334,430,92,utRho25
gor,7292224,7292598,7292224,374,572,utRho25
gpmA,1575340,1575340,1575190,150,4,utRho25
gpmM,7570374,7570520,7570374,146,46,utRho25
gpsA,7567620,7567620,7567322,298,4668,utRho25
gpt,511828,511954,511828,126,280,utRho25
grcA,5433046,5433046,5432898,148,336,utRho25
greA,6657728,6657728,6657430,298,844,utRho25
greB,7073488,7073624,7073488,136,0,utRho25
groL,8741566,8742050,8741566,484,15068,utRho25
groS,8741232,8741376,8741232,144,14872,utRho25
grpE,5501494,5501494,5501416,78,712,utRho25
grxA,1781552,1781552,1781506,46,0,utRho25
grxB,2248206,2248206,2248108,98,258,utRho25
grxC,7569152,7569152,7568884,268,1298,utRho25
grxD,3468324,3468324,3468202,122,2958,utRho25
gspA,6911268,6911268,6910796,472,168,utRho25
gspC,6910964,6911156,6910964,192,94,utRho25
gss,6277220,6277220,6277044,176,48,utRho25
gstA,3428654,3428754,3428654,100,52,utRho25
gstB,1761038,1761038,1760960,78,218,utRho25
guaB,5268214,5268214,5268140,74,98,utRho25
gudD,5839026,5839026,5838770,256,8,utRho25
gyrA,4678914,4678914,4678840,74,76,utRho25
gyrB,7760300,7760300,7760238,62,64,utRho25
hcaE,5337964,5338064,5337964,100,120,utRho25
hcaR,5337928,5337928,5337792,136,134,utRho25
hcaT,5336106,5336106,5335692,414,114,utRho25
hchA,4071260,4071670,4071260,410,4,utRho25
hcp,1828258,1828258,1827628,630,176,utRho25
hcr,1824400,1824400,1824300,100,0,utRho25
hdeA,7313582,7313582,7313480,102,0,utRho25
hdeD,7313920,7313990,7313920,70,540,utRho25
hdfR,7896320,7896320,7895934,386,234,utRho25
hdhA,3396244,3396244,3396080,164,50,utRho25
helD,2048876,2048942,2048876,66,72,utRho25
hemA,2527166,2527428,2527166,262,232,utRho25
hemB,779722,779722,779454,268,350,utRho25
hemF,5106410,5106450,5106410,40,0,utRho25
hemH,996062,996110,996062,48,0,utRho25
hemL,349882,349882,349764,118,0,utRho25
hemN,8103886,8104090,8103886,204,0,utRho25
hepA,127176,127176,126528,648,13042,utRho25
hflD,2385372,2385372,2385262,110,116,utRho25
hfq,8799602,8800576,8799602,974,5166,utRho25
hha,961006,961006,960616,390,0,utRho25
hicA,3018442,3018572,3018442,130,20,utRho25
higA,6468682,6468682,6468288,394,250,utRho25
higB,6468960,6468960,6468910,50,326,utRho25
hinT,2323642,2323770,2323642,128,60,utRho25
hipB,3184964,3184964,3184884,80,10,utRho25
hisB,4186720,4186936,4186720,216,160,utRho25
hisJ,4853674,4853674,4853576,98,20,utRho25
hisL,8359856,8359984,8359856,128,232,utRho25
hisS,5281284,5281284,5281150,134,0,utRho25
hlpA,400910,400964,400910,54,36,utRho25
hlyE,2460932,2460932,2460788,144,126,utRho25
hmp,5371594,5371670,5371594,76,16,utRho25
hns,2585916,2585916,2585844,72,4132,utRho25
hofM,7045856,7045856,7045502,354,0,utRho25
hokA,7441620,7441620,7441200,420,194,utRho25
hokC,33902,33902,33806,96,268,utRho25
hokE,1215462,1215672,1215462,210,0,utRho25
holC,8968546,8968546,8968560,14,44,utRho25
holD,9215562,9215606,9215562,44,0,utRho25
holE,3850040,3850216,3850040,176,50,utRho25
hpt,282720,282862,282720,142,58,utRho25
hrpB,324150,324210,324150,60,12,utRho25
hscB,5319048,5319048,5318934,114,152,utRho25
hscC,1367188,1367188,1366786,402,130,utRho25
hsdS,9163004,9163004,9162924,80,508,utRho25
hslJ,2883560,2883560,2883486,74,680,utRho25
hslO,7059344,7059548,7059344,204,70208,utRho25
hslR,7058220,7058696,7058220,476,7142,utRho25
hslV,8244708,8244708,8244574,134,4,utRho25
hsrA,7881412,7881412,7881224,188,24,utRho25
htgA,21286,21660,21286,374,542,utRho25
htpG,989634,990240,989634,606,824,utRho25
htpX,3825236,3825236,3825152,84,84,utRho25
htrE,311036,311036,310852,184,2,utRho25
htrL,7587668,7587668,7587366,302,6,utRho25
hupA,8400352,8400562,8400352,210,164,utRho25
hupB,1845220,1845804,1845220,584,852,utRho25
hyaA,2063968,2064278,2063968,310,164,utRho25
hybO,6292726,6292726,6292522,204,158,utRho25
hycA,5700922,5700922,5700870,52,0,utRho25
hycI,5686204,5686204,5686086,118,210,utRho25
hydN,5676264,5676264,5676210,54,0,utRho25
hyfA,5202342,5202402,5202342,60,0,utRho25
hypA,11402508,11402588,11402508,80,252,utRho25
hypB,11403356,11404004,11403356,648,0,utRho25
hypF,5676210,5676210,5674850,1360,540,utRho25
hypT,9116634,9116634,9116578,56,0,utRho25
hyuA,6019660,6020056,6019660,396,4,utRho25
iaaA,1733074,1733136,1733074,62,36,utRho25
iadA,9119074,9119074,9119052,22,102,utRho25
iap,5753072,5753162,5753072,90,0,utRho25
ibaG,6673966,6673966,6673606,360,0,utRho25
ibpA,7735036,7735036,7734844,192,6496,utRho25
ibpB,7733962,7733962,7733794,168,61326,utRho25
icd,2389922,2390246,2389922,324,164,utRho25
iclR,8447304,8447304,8447256,48,14,utRho25
idi,6065876,6066130,6065876,254,30,utRho25
idnD,8988870,8988870,8988812,58,0,utRho25
idnK,8989194,8989246,8989194,52,240,utRho25
ihfA,3591442,3591442,3591104,338,518,utRho25
ihfB,1927498,1927656,1927498,158,406,utRho25
ileS,43666,44782,43666,1116,760,utRho25
ileX,6431194,6431196,6431194,2,4,utRho25
ilvA,15820940,15821324,15820940,384,96,utRho25
ilvC,7915824,7915940,7915824,116,0,utRho25
ilvE,15809552,15809936,15809552,384,264,utRho25
ilvI,170840,171260,170840,420,4,utRho25
ilvL,23701308,23701932,23701308,624,360,utRho25
ilvY,7915734,7915734,7915640,94,2,utRho25
inaA,4698998,4698998,4698944,54,0,utRho25
infA,1853370,1853370,1852886,484,208,utRho25
infC,3602692,3602692,3601276,1416,2252,utRho25
insA-5,3958452,3958452,3958430,22,26,utRho25
insA-7,9036758,9037054,9036758,296,232,utRho25
insC-5,6372080,6372284,6372080,204,274,utRho25
insEF-2,785238,785238,785820,582,334,utRho25
insEF-4,2190310,2190310,2190892,582,392,utRho25
insG,9007098,9007098,9006862,236,0,utRho25
insH-1,550596,550596,550234,362,222,utRho25
insH-11,7306538,7306538,7306396,142,48,utRho25
insH-2,1151548,1151548,1151506,42,58,utRho25
insH-3,1378444,1378444,1378026,418,558,utRho25
insH-4,2791942,2792152,2791942,210,182,utRho25
insH-5,2857852,2857852,2857452,400,28,utRho25
insH-6,4135022,4135022,4134642,380,138,utRho25
insH-7,4206186,4206186,4205822,364,4196,utRho25
insH-9,6260050,6260356,6260050,306,722,utRho25
insI-3,9017372,9017372,9017234,138,74,utRho25
insJ,7441188,7441360,7441188,172,44,utRho25
insK,7442130,7442308,7442130,178,0,utRho25
insL-1,30760,30890,30760,130,8772,utRho25
insL-2,1216112,1216130,1216112,18,152,utRho25
insL-3,5028644,5028662,5028644,18,126,utRho25
insN-1,540452,540484,540452,32,4,utRho25
intD,1132202,1132202,1131956,246,334,utRho25
intR,2826520,2826520,2826470,50,0,utRho25
intS,4933026,4933090,4933026,64,4,utRho25
intZ,5117386,5117542,5117386,156,8,utRho25
iraD,9113152,9113986,9113152,834,0,utRho25
iraM,2424246,2424246,2424006,240,44,utRho25
iraP,802638,802772,802638,134,0,utRho25
iscA,5319924,5319924,5319772,152,698,utRho25
iscR,5324398,5324398,5324262,136,1966,utRho25
iscX,5313834,5313834,5313472,362,428,utRho25
ispF,5743968,5743968,5743560,408,6,utRho25
ispG,5283908,5283908,5283608,300,0,utRho25
ispU,389568,389806,389568,238,4,utRho25
isrA,2811502,2811502,2811618,116,18,utRho25
istr-1,7706384,7706384,7706384,0,0,utRho25
istr-2,7706514,7706514,7706514,0,0,utRho25
ivbL,15412092,15412092,15411952,140,288,utRho25
ivy,480638,480686,480638,48,0,utRho25
katE,3627628,3627734,3627628,106,88,utRho25
katG,8267624,8267670,8267624,46,38,utRho25
kbaZ,6557732,6557828,6557732,96,0,utRho25
kbl,7585154,7585154,7585102,52,358,utRho25
kch,2621046,2621046,2620538,508,0,utRho25
kdgR,3820506,3820506,3820198,308,0,utRho25
kdpE,1443788,1443788,1443466,322,56,utRho25
kdpF,1457698,1457698,1457642,56,78,utRho25
kdsA,2535708,2536330,2535708,622,1126,utRho25
kdsC,6683438,6684546,6683438,1108,3394,utRho25
kduI,5968388,5968388,5968248,140,112,utRho25
kefF,94160,94492,94160,332,1008,utRho25
kgtP,5451624,5451624,5451492,132,524,utRho25
kup,7862206,7862632,7862206,426,1508,utRho25
lacI,735076,735076,735020,56,0,utRho25
lacZ,1465508,1465508,1465220,288,96,utRho25
ldcA,2486394,2486394,2486160,234,0,utRho25
ldhA,2885830,2885830,2885686,144,124,utRho25
ldrA,2538954,2538954,2538550,404,324,utRho25
ldrB,2540024,2540024,2539620,404,112,utRho25
ldrC,2541092,2541092,2540690,402,74,utRho25
ldrD,7400544,7400544,7400174,370,364,utRho25
lepA,5414392,5414392,5414248,144,122,utRho25
lepB,5410928,5410928,5410618,310,860,utRho25
leuD,159188,159188,158906,282,168,utRho25
leuE,3761600,3761600,3761518,82,256,utRho25
leuL,168048,168048,167416,632,36,utRho25
leuO,168308,168736,168308,428,8,utRho25
leuQ,9212864,9212864,9212802,62,12,utRho25
leuU,6644556,6644556,6644316,240,1056,utRho25
leuV,9212546,9212546,9212330,216,242,utRho25
leuX,8992772,8992810,8992772,38,4,utRho25
lexA,8514174,8514230,8514174,56,118,utRho25
lhr,3456706,3458174,3456706,1468,400,utRho25
ligA,5060402,5060402,5060352,50,0,utRho25
ligB,7642576,7642576,7642340,236,132,utRho25
lipA,1320602,1320602,1320432,170,114,utRho25
lipB,1324802,1324802,1324556,246,7046,utRho25
lit,2397032,2397390,2397032,358,174,utRho25
livJ,7199524,7199524,7199316,208,1092,utRho25
livK,7195510,7195510,7195120,390,810,utRho25
lldP,7554578,7554798,7554578,220,372,utRho25
lnt,1381968,1381968,1381762,206,676,utRho25
loiP,6163784,6163826,6163784,42,0,utRho25
lolA,1874656,1874738,1874656,82,116,utRho25
lolB,2527112,2527112,2527000,112,100,utRho25
lolC,2350748,2350854,2350748,106,8,utRho25
lon,917630,917776,917630,146,948,utRho25
lpcA,486936,487086,486936,150,80,utRho25
lpd,255434,255824,255434,390,752,utRho25
lplA,9248476,9248476,9248234,242,564,utRho25
lplT,5947878,5947878,5947724,154,24,utRho25
lpoA,6586422,6586800,6586422,378,52,utRho25
lpp,3514592,3514842,3514592,250,20,utRho25
lptA,6686598,6686760,6686598,162,72,utRho25
lptB,6686792,6687888,6686792,1096,1010,utRho25
lptD,114672,114672,114218,454,434,utRho25
lptF,8972244,8972436,8972244,192,92,utRho25
lpxC,213016,213114,213016,98,1382,utRho25
lpxD,401920,401942,401920,22,0,utRho25
lpxL,2233418,2233418,2233164,254,0,utRho25
lpxM,3880456,3880456,3880386,70,0,utRho25
lpxP,4991156,4991290,4991156,134,10,utRho25
lrhA,4813312,4813312,4813282,30,20,utRho25
lrp,1864656,1865190,1864656,534,266,utRho25
lspA,50028,50414,50028,386,384,utRho25
lsrA,3202920,3202980,3202920,60,42,utRho25
lsrR,3202514,3202514,3202482,32,0,utRho25
ltaE,1818640,1818640,1818588,52,0,utRho25
luxS,5630130,5630130,5629466,664,1662,utRho25
lysA,5957902,5957902,5957798,104,0,utRho25
lysC,8467232,8467232,8466466,766,584,utRho25
lysP,4497120,4497120,4497064,56,94,utRho25
lysR,5957900,5958042,5957900,142,0,utRho25
lysT,1561028,1561108,1561028,80,134,utRho25
lysU,8709610,8709610,8709434,176,0,utRho25
macB,1840188,1840694,1840188,506,118,utRho25
maeA,3111484,3111484,3111338,146,418,utRho25
mak,820236,820288,820236,52,34,utRho25
malE,8492928,8492928,8492838,90,56,utRho25
malI,3398456,3398456,3398360,96,0,utRho25
malK,8493472,8493568,8493472,96,70,utRho25
malP,7105020,7105020,7104946,74,64,utRho25
malQ,7100798,7100798,7100140,658,268,utRho25
malS,14949880,14949988,14949880,108,136,utRho25
malT,7106048,7106170,7106048,122,0,utRho25
malX,3398626,3398710,3398626,84,36,utRho25
malZ,1689980,1690072,1689980,92,8,utRho25
manA,3377102,3377152,3377102,50,0,utRho25
manX,3803866,3804096,3803866,230,0,utRho25
marC,3237882,3237882,3237816,66,50,utRho25
marR,3238186,3238240,3238186,54,58,utRho25
matP,2036918,2036970,2036918,52,0,utRho25
mazE,5822736,5822736,5822678,58,0,utRho25
mazG,5821720,5821720,5821370,350,554,utRho25
mcbA,1684306,1684306,1684112,194,0,utRho25
mcbR,3040192,3040524,3040192,332,0,utRho25
mcrA,2420278,2420692,2420278,414,226,utRho25
mcrC,9156124,9156124,9155916,208,454,utRho25
mdaB,6344814,6345060,6344814,246,0,utRho25
mdfA,1767138,1767346,1767138,208,0,utRho25
mdh,6768940,6768940,6768536,404,80,utRho25
mdoB,9198988,9198988,9198882,106,210,utRho25
mdoD,2993290,2993712,2993290,422,0,utRho25
mdoG,2218514,2218670,2218514,156,40,utRho25
mdtA,4307958,4308032,4307958,74,0,utRho25
mdtE,7318168,7318464,7318168,296,502,utRho25
mdtK,3486538,3486914,3486538,376,482,utRho25
mdtP,8602472,8602472,8602060,412,326,utRho25
melA,8683774,8683822,8683774,48,0,utRho25
melR,8683300,8683300,8683256,44,112,utRho25
menA,8240812,8240812,8240698,114,130,utRho25
menB,4753774,4753774,4753638,136,0,utRho25
mepH,3468714,3468870,3468714,156,0,utRho25
mepM,3883666,3883666,3883270,396,6,utRho25
mepS,4539840,4539958,4539840,118,0,utRho25
metA,8428318,8428560,8428318,242,12,utRho25
metB,8257272,8257344,8257272,72,290,utRho25
metC,6304150,6304472,6304150,322,94,utRho25
metE,8025768,8026106,8025768,338,0,utRho25
metF,8265092,8265232,8265092,140,0,utRho25
metG,4388538,4388600,4388538,62,8,utRho25
metH,8447010,8447656,8447010,646,854,utRho25
metJ,8257116,8257116,8256790,326,2,utRho25
metK,6173154,6173412,6173154,258,76,utRho25
metN,445428,445428,445290,138,0,utRho25
metR,8025710,8025710,8025632,78,0,utRho25
metT,1394326,1394326,1394266,60,24,utRho25
metY,19910250,19910250,19909734,516,1620,utRho25
metZ,11789528,11789548,11789528,20,172,utRho25
mfd,2348056,2348056,2347928,128,0,utRho25
mglA,4478782,4478782,4478578,204,138,utRho25
mglB,4481132,4481132,4480696,436,10340,utRho25
mglC,4475918,4475918,4475506,412,98,utRho25
mgrB,3817584,3817584,3817532,52,0,utRho25
mgrR,3245828,3245828,3245828,0,0,utRho25
mgsA,2054082,2054082,2054030,52,32,utRho25
mgtL,8934560,8934862,8934560,302,90,utRho25
mhpA,737038,737222,737038,184,0,utRho25
mhpR,737072,737072,736840,232,32,utRho25
mhpT,750772,750918,750772,146,0,utRho25
miaA,8797964,8798504,8797964,540,182,utRho25
micA,5629604,5629604,5629604,0,0,utRho25
micC,2874242,2874238,2874242,4,0,utRho25
micF,4626168,4626168,4626168,0,0,utRho25
micM,1014408,1014408,1014408,0,0,utRho25
minE,2449422,2449422,2449090,332,302,utRho25
mioC,7852950,7852950,7852910,40,0,utRho25
mipA,3733012,3733012,3732944,68,868,utRho25
mlaA,4930270,4930270,4930014,256,28,utRho25
mlc,3337206,3337206,3337128,78,52,utRho25
mlrA,4429498,4429732,4429498,234,20,utRho25
mltA,5894546,5894546,5894356,190,26,utRho25
mltD,468050,468050,467910,140,130,utRho25
mltF,5391534,5391602,5391534,68,0,utRho25
mmuP,550238,550650,550238,412,232,utRho25
mngA,1531622,1531968,1531622,346,4,utRho25
mngR,1531852,1531852,1531750,102,4,utRho25
mnmG,7851348,7851348,7851266,82,146,utRho25
mntH,5025470,5025470,5025412,58,0,utRho25
mntP,3810918,3811376,3810918,458,44,utRho25
mntR,1706160,1706366,1706160,206,98,utRho25
mntS,1706128,1706128,1705994,134,94,utRho25
moaA,1633654,1634088,1633654,434,22,utRho25
moaB,1635954,1636110,1635954,156,126,utRho25
mobA,8084242,8084242,8083998,244,0,utRho25
mocA,6030112,6030320,6030112,208,80,utRho25
modA,1589990,1590178,1589990,188,0,utRho25
moeA,1732788,1732788,1732728,60,30,utRho25
mokB,2984610,2984610,2984258,352,130,utRho25
molR_1,4392888,4392948,4392888,60,0,utRho25
motA,3954604,3954604,3954278,326,36,utRho25
mpaA,2781278,2781278,2781196,82,28,utRho25
mpl,8911456,8911570,8911456,114,68,utRho25
mppA,2786108,2786454,2786108,346,0,utRho25
mprA,5621494,5621540,5621494,46,84,utRho25
mqo,4613848,4613848,4613508,340,0,utRho25
mqsA,6336742,6336742,6336492,250,226,utRho25
mqsR,6337306,6337306,6337088,218,428,utRho25
mraZ,179192,179268,179192,76,68,utRho25
mrcA,7045652,7045742,7045652,90,0,utRho25
mrcB,329442,329460,329442,18,0,utRho25
mreB,13605424,13605424,13604348,1076,1436,utRho25
mreD,6798166,6798166,6797750,416,100,utRho25
mrp,4388360,4388360,4388336,24,90,utRho25
mscK,972984,973072,972984,88,0,utRho25
mscL,6876002,6876048,6876002,46,694,utRho25
mscS,6139742,6139742,6139614,128,4,utRho25
msrA,8884522,8884522,8884352,170,260,utRho25
msrB,3725168,3725168,3724858,310,158,utRho25
msyB,2228426,2228426,2228362,64,200,utRho25
mtfA,4087236,4087302,4087236,66,0,utRho25
mtgA,6699662,6699662,6699618,44,90,utRho25
mtlA,30177504,30178248,30177504,744,3208,utRho25
mtn,358366,358366,358306,60,190,utRho25
mtr,6611864,6611864,6611634,230,26,utRho25
mug,6430992,6430992,6430946,46,894,utRho25
murQ,5091466,5091546,5091466,80,0,utRho25
murR,5091586,5091586,5091218,368,46,utRho25
mutH,5939164,5939324,5939164,160,450,utRho25
mutL,8794092,8794824,8794092,732,132,utRho25
mutM,7622554,7622554,7622304,250,246,utRho25
mutS,5714038,5714186,5714038,148,180,utRho25
mutY,18617466,18618078,18617466,612,0,utRho25
nac,4123956,4123956,4123866,90,90,utRho25
nadA,1564122,1564170,1564122,48,0,utRho25
nadB,5420714,5420840,5420714,126,54,utRho25
nadC,237326,237326,237290,36,96,utRho25
nadE,3644604,3644916,3644604,312,282,utRho25
nadK,5501526,5501662,5501526,136,0,utRho25
nagA,1406350,1406350,1405502,848,1064,utRho25
nagB,1407416,1407416,1407222,194,0,utRho25
nagC,1404016,1404016,1403188,828,0,utRho25
nagE,1407680,1407888,1407680,208,72,utRho25
nagK,2357080,2357186,2357080,106,116,utRho25
nanA,6747240,6747240,6747152,88,0,utRho25
nanC,9079856,9079856,9079002,854,252,utRho25
nanR,6749406,6749406,6748978,428,632,utRho25
nanS,9075406,9075406,9075188,218,46,utRho25
napF,4607390,4607390,4606994,396,80,utRho25
narG,2559614,2559728,2559614,114,30,utRho25
narK,2555642,2555914,2555642,272,94,utRho25
narP,4580844,4581000,4580844,156,186,utRho25
narQ,5171154,5171462,5171154,308,80,utRho25
narU,3088326,3088326,3088120,206,132,utRho25
narW,3077374,3077374,3074618,2756,164,utRho25
narX,2555554,2555554,2555236,318,74,utRho25
narZ,3085380,3085380,3085180,200,0,utRho25
ndh,2331984,2332170,2331984,186,234,utRho25
ndk,5289920,5289920,5289728,192,124,utRho25
nemR,6904084,6904092,6904084,8,48,utRho25
nepI,7683542,7683542,7683478,64,86,utRho25
nfo,4501612,4501680,4501612,68,18,utRho25
nfsB,1210906,1210906,1210848,58,0,utRho25
nfuA,7090916,7091248,7090916,332,676,utRho25
nhaA,34634,34978,34634,344,398,utRho25
nhaB,2469534,2469534,2469434,100,0,utRho25
nhoA,3067926,3068048,3067926,122,0,utRho25
nikA,7226878,7227334,7226878,456,974,utRho25
nikR,7237074,7237176,7237074,102,110,utRho25
nirB,6987974,6988022,6987974,48,56,utRho25
nlpA,7680034,7680034,7679986,48,0,utRho25
nlpC,3585654,3585654,3585462,192,64,utRho25
nlpD,5737658,5737658,5737506,152,30,utRho25
nlpI,6618080,6618080,6617848,232,68,utRho25
nmpC,1153740,1153740,1153650,90,0,utRho25
nohA,3273206,3273206,3272734,472,4,utRho25
norR,5664614,5664614,5664578,36,0,utRho25
norV,5664878,5664952,5664878,74,40,utRho25
nrdA,4689510,4689730,4689510,220,7974,utRho25
nrdD,8925676,8925676,8925320,356,426,utRho25
nrdH,5601312,5601446,5601312,134,258,utRho25
nrdR,865954,866004,865954,50,70,utRho25
nrfA,8575342,8575528,8575342,186,0,utRho25
nsrR,8812088,8812380,8812088,292,262,utRho25
nudB,3897348,3897348,3897264,84,44,utRho25
nudC,8393428,8393806,8393428,378,14,utRho25
nudE,7052658,7052658,7052298,360,82,utRho25
nudG,3682876,3682980,3682876,104,4,utRho25
nudI,4729050,4729108,4729050,58,0,utRho25
nudJ,2388874,2388874,2388576,298,8,utRho25
nuoA,4810670,4810670,4810144,526,1240,utRho25
nuoN,4783434,4783434,4783010,424,266,utRho25
nupC,5026018,5026084,5026018,66,0,utRho25
nupG,6211302,6211428,6211302,126,184,utRho25
ogrK,4335096,4335096,4335040,56,0,utRho25
ogt,2800568,2800568,2800472,96,312,utRho25
ohsC,5401036,5401040,5401036,4,88,utRho25
ompA,2040382,2040382,2040106,276,5504,utRho25
ompC,4625774,4625774,4625498,276,152,utRho25
ompF,1974184,1974184,1973964,220,0,utRho25
ompL,8128958,8128958,8128590,368,602,utRho25
ompN,2874158,2874158,2873786,372,4,utRho25
ompR,7073510,7073510,7073168,342,0,utRho25
ompT,1171330,1171330,1171266,64,64,utRho25
ompW,2627982,2628040,2627982,58,40,utRho25
ompX,1700418,1700900,1700418,482,820,utRho25
omrA,5952378,5952378,5952378,0,0,utRho25
omrB,5952770,5952770,5952770,0,0,utRho25
oppA,2602170,2602364,2602170,194,264,utRho25
orn,8783168,8783208,8783168,40,16,utRho25
osmB,2686952,2686952,2686656,296,694,utRho25
osmC,3113192,3113250,3113192,58,160,utRho25
osmE,3644566,3644566,3644512,54,52,utRho25
osmF,4439046,4439046,4438962,84,128,utRho25
osmY,9222306,9222792,9222306,486,4,utRho25
otsA,3963302,3963302,3963224,78,112,utRho25
otsB,3964930,3964930,3964774,156,158,utRho25
oxc,4984288,4984288,4983900,388,104,utRho25
oxyR,8316914,8316980,8316914,66,6,utRho25
oxyS,8316788,8316788,8316788,0,0,utRho25
paaA,2907730,2907854,2907730,124,0,utRho25
paaX,2927018,2927078,2927018,60,0,utRho25
paaZ,2907340,2907340,2907284,56,0,utRho25
pabA,6981702,6981702,6981658,44,0,utRho25
pabB,3789256,3789610,3789256,354,84,utRho25
pabC,2306186,2306600,2306186,414,196,utRho25
pagP,1313052,1313114,1313052,62,34,utRho25
panB,299260,299260,299202,58,646,utRho25
panC,297840,297840,297590,250,0,utRho25
panD,293490,293490,293388,102,34,utRho25
panZ,7195656,7195968,7195656,312,114,utRho25
parC,6332060,6332060,6331946,114,124,utRho25
patA,6438916,6438988,6438916,72,16,utRho25
patD,3030830,3031156,3030830,326,0,utRho25
pbpC,5294986,5294986,5294650,336,0,utRho25
pbpG,4450132,4450132,4449740,392,0,utRho25
pck,7065358,7065636,7065358,278,904,utRho25
pcnB,318782,318782,318252,530,158,utRho25
pdhR,244068,244184,244068,116,0,utRho25
pdxB,4875768,4875768,4875702,66,106,utRho25
pdxH,3436068,3436068,3436014,54,4,utRho25
pdxJ,5403626,5403626,5403458,168,324,utRho25
pdxK,5074638,5074638,5074474,164,46,utRho25
pepA,8972278,8972278,8971902,376,158,utRho25
pepD,511618,511618,511432,186,228,utRho25
pepN,1981182,1981244,1981182,62,358,utRho25
pepQ,8062294,8062322,8062294,28,0,utRho25
pepT,2371646,2371688,2371646,42,28,utRho25
pfkA,8214948,8215104,8214948,156,124,utRho25
pfkB,3612646,3612740,3612646,94,0,utRho25
pflA,1902456,1902456,1902160,296,0,utRho25
pflB,1907850,1907850,1907108,742,350,utRho25
pflD,8287716,8287990,8287716,274,0,utRho25
pgaA,2185046,2185046,2184578,468,476,utRho25
pgi,8467444,8467516,8467444,72,0,utRho25
pgk,12291428,12291428,12290488,940,592,utRho25
pgl,1597078,1597172,1597078,94,110,utRho25
pgpB,2678324,2678660,2678324,336,76,utRho25
pgpC,5397276,5397276,5397100,176,0,utRho25
pgrR,2783744,2783982,2783744,238,56,utRho25
pheL,5475158,5475198,5475158,40,0,utRho25
pheM,7197204,7197204,7197080,124,0,utRho25
pheP,1203858,1203918,1203858,60,34,utRho25
pheU,8725254,8725254,8725252,2,0,utRho25
pheV,6220730,6220732,6220730,2,0,utRho25
phnC,8650412,8650412,8650330,82,20,utRho25
phoA,803414,803494,803414,80,144,utRho25
phoB,834202,834284,834202,82,86,utRho25
phoE,520316,520316,520200,116,4,utRho25
phoH,2169730,2169984,2169730,254,138,utRho25
phoP,2381016,2381016,2380894,122,272,utRho25
phoQ,2379880,2379880,2379552,328,206,utRho25
phoU,7815330,7815330,7815156,174,54,utRho25
phr,1478842,1479014,1478842,172,80,utRho25
pinE,2419054,2419370,2419054,316,78,utRho25
pinQ,3267168,3267244,3267168,76,0,utRho25
pinR,2867424,2867424,2867348,76,2,utRho25
pitA,7275224,7275284,7275224,60,20,utRho25
pitB,6272806,6272806,6272742,64,52,utRho25
pka,5439862,5439906,5439862,44,0,utRho25
plaP,4174476,4174476,4174124,352,296,utRho25
pldA,8009628,8009724,8009628,96,228,utRho25
pldB,8018028,8018340,8018028,312,360,utRho25
plsB,8513196,8513196,8512932,264,224,utRho25
pmbA,8915890,8915918,8915890,28,2,utRho25
pmrD,4747148,4747148,4747076,72,0,utRho25
pncB,1980828,1980828,1980712,116,0,utRho25
pncC,5648788,5648788,5648692,96,30,utRho25
pnp,6622652,6622652,6622336,316,90,utRho25
pntA,3355950,3355950,3355806,144,54,utRho25
pntB,3353096,3353096,3352720,376,148,utRho25
polA,8093880,8093932,8093880,52,0,utRho25
polB,131606,131606,131560,46,0,utRho25
potD,2365700,2365700,2365658,42,62,utRho25
potE,1436688,1436688,1436530,158,0,utRho25
potF,1787268,1787568,1787268,300,4,utRho25
poxB,1822152,1822152,1822098,54,14,utRho25
ppa,8899372,8899372,8899304,68,198,utRho25
ppc,8306380,8306380,8306196,184,940,utRho25
ppdA,5928440,5928440,5928354,86,18,utRho25
ppdD,235410,235410,235098,312,92,utRho25
pphA,3846770,3846770,3845938,832,1410,utRho25
pphB,5719474,5719520,5719474,46,0,utRho25
ppiA,6984898,6984898,6984594,304,72,utRho25
ppiC,7919682,7919682,7919626,56,6,utRho25
ppiD,923638,923830,923638,192,90,utRho25
ppk,5245748,5246088,5245748,340,104,utRho25
pppA,6228958,6228958,6228704,254,300,utRho25
ppsA,3574322,3574322,3574224,98,2,utRho25
ppsR,3574678,3574890,3574678,212,72,utRho25
pptA,3065716,3066104,3065716,388,262,utRho25
pqiA,2023318,2024002,2023318,684,16,utRho25
prc,3830054,3830054,3829632,422,1464,utRho25
preT,4467978,4468066,4467978,88,46,utRho25
prfC,9218688,9218828,9218688,140,110,utRho25
prkB,6968622,6968980,6968622,358,62,utRho25
prlC,7290476,7290476,7290364,112,668,utRho25
prlF,6553944,6554004,6553944,60,452,utRho25
proB,520432,520776,520432,344,66,utRho25
proC,811372,811372,811288,84,8,utRho25
proK,7417388,7417388,7417384,4,4,utRho25
proL,4572414,4572422,4572414,8,12,utRho25
proP,8660640,8661004,8660640,364,190,utRho25
proS,437674,437674,437550,124,138,utRho25
proV,5609126,5609630,5609126,504,92,utRho25
prpB,697292,697364,697292,72,0,utRho25
prpR,696942,696942,696886,56,0,utRho25
prs,2524354,2524354,2523750,604,3370,utRho25
psd,8781276,8781276,8780720,556,260,utRho25
psiE,8480600,8480650,8480600,50,0,utRho25
pspA,2736076,2736158,2736076,82,0,utRho25
pspF,2736080,2736080,2735824,256,0,utRho25
pspG,8525632,8525680,8525632,48,0,utRho25
pssA,5445156,5445454,5445156,298,524,utRho25
pstB,7817112,7817112,7816732,380,4,utRho25
pstC,7821084,7821084,7820796,288,0,utRho25
pstS,23469408,23469408,23469150,258,0,utRho25
psuG,4517114,4517114,4516734,380,2330,utRho25
psuT,4514992,4514992,4514670,322,0,utRho25
pth,2517084,2517084,2517026,58,0,utRho25
ptrA,5918022,5918022,5917768,254,76,utRho25
ptrB,3857730,3857730,3857678,52,148,utRho25
ptsG,2315252,2315738,2315252,486,480,utRho25
ptsH,5066996,5067528,5066996,532,366,utRho25
purA,8809328,8809374,8809328,46,166,utRho25
purC,5195562,5195562,5195236,326,0,utRho25
purD,8411972,8411972,8411862,110,4,utRho25
purE,1106284,1106284,1106200,84,0,utRho25
purH,8415254,8415254,8415064,190,0,utRho25
purL,5391178,5391178,5391086,92,188,utRho25
purM,5242306,5242394,5242306,88,10,utRho25
purR,3475378,3475688,3475378,310,36,utRho25
purT,3861438,3861762,3861438,324,30,utRho25
purU,2577512,2577512,2577248,264,0,utRho25
putA,2157850,2157850,2157764,86,0,utRho25
putP,2158336,2158610,2158336,274,92,utRho25
puuA,2721936,2721936,2721816,120,0,utRho25
puuC,2725456,2725486,2725456,30,0,utRho25
puuD,2722104,2722240,2722104,136,0,utRho25
puuP,2718746,2718746,2718374,372,36,utRho25
pykA,3874988,3875298,3874988,310,60,utRho25
pykF,3510934,3511396,3510934,462,18,utRho25
pyrC,2245286,2245286,2245214,72,18,utRho25
pyrD,2009464,2009536,2009464,72,4,utRho25
pyrE,7631970,7631970,7631536,434,0,utRho25
pyrF,2683740,2683842,2683740,102,758,utRho25
pyrG,5819594,5819594,5819332,262,580,utRho25
pyrH,383624,383710,383624,86,334,utRho25
pyrL,8945490,8945490,8945066,424,256,utRho25
qmcA,1031646,1031646,1031546,100,454,utRho25
qor,8528608,8528608,8528462,146,230,utRho25
qseB,6339502,6339656,6339502,154,122,utRho25
queA,849970,850022,849970,52,164,utRho25
queE,5811212,5811212,5810836,376,72,utRho25
queF,5850642,5850696,5850642,54,0,utRho25
queG,8788184,8788184,8788134,50,326,utRho25
racC,2835630,2835630,2835526,104,0,utRho25
racR,2840898,2840898,2840482,416,304,utRho25
raiA,5474208,5474308,5474208,100,54,utRho25
rarD,8008594,8008594,8008356,238,278,utRho25
ravA,7862256,7862256,7862186,70,218,utRho25
rayT,495088,495274,495088,186,24,utRho25
rbn,4763162,4763216,4763162,54,0,utRho25
rbsD,7866644,7866702,7866644,58,0,utRho25
rcnA,4371654,4371834,4371654,180,174,utRho25
rcnB,4373768,4373920,4373768,152,62,utRho25
rcnR,4371806,4371806,4371592,214,328,utRho25
rcsA,4047672,4047936,4047672,264,520,utRho25
rcsB,4631390,4632354,4631390,964,360,utRho25
rcsC,4640162,4640162,4639656,506,0,utRho25
rcsD,4626904,4626976,4626904,72,4,utRho25
rdgB,6193240,6193362,6193240,122,142,utRho25
rdlA,2538646,2538646,2538646,0,0,utRho25
rdlB,2539712,2539716,2539712,4,0,utRho25
rdlC,2540782,2540786,2540782,4,0,utRho25
rdlD,7400272,7400272,7400272,0,0,utRho25
rdoA,8084782,8084830,8084782,48,20,utRho25
recA,11295276,11295276,11295076,200,316,utRho25
recC,5925014,5925014,5924856,158,0,utRho25
recF,7763722,7763722,7762442,1280,1122,utRho25
recN,5503518,5503590,5503518,72,0,utRho25
recQ,8011666,8011728,8011666,62,38,utRho25
relA,5828554,5828554,5827302,1252,20,utRho25
relB,3291806,3291806,3291744,62,126,utRho25
rem,3289950,3289950,3289804,146,0,utRho25
rep,7921294,7921354,7921294,60,66,utRho25
rfaD,7587730,7587974,7587730,244,452,utRho25
rfaE,6393852,6393852,6393506,346,28,utRho25
rfaH,8049930,8049930,8049642,288,1050,utRho25
rfbX,4219436,4219436,4219168,268,634,utRho25
rfe,7935600,7935832,7935600,232,400,utRho25
rhaB,8194944,8194944,8194896,48,0,utRho25
rhaD,8188770,8188770,8188544,226,0,utRho25
rhaS,8195422,8195472,8195422,50,0,utRho25
rhaT,8201132,8201132,8201050,82,0,utRho25
rhlE,1661566,1661744,1661566,178,0,utRho25
rhoL,47593944,47594772,47593944,828,2856,utRho25
rhsB,7238006,7238384,7238006,378,176,utRho25
rhsC,1458758,1459166,1458758,408,44,utRho25
rhsD,1046132,1046522,1046132,390,0,utRho25
rhtA,1700608,1700608,1700194,414,894,utRho25
rhtC,8015478,8015514,8015478,36,180,utRho25
ribA,2678468,2678468,2678320,148,0,utRho25
ribC,3486916,3486916,3486484,432,778,utRho25
ribE,869008,869294,869008,286,4840,utRho25
ribF,42766,42814,42766,48,46,utRho25
ridA,8941892,8941892,8941826,66,62,utRho25
rihA,1369204,1369204,1368824,380,42,utRho25
rihB,4510504,4510504,4510372,132,36,utRho25
rimJ,2251044,2251124,2251044,80,0,utRho25
rimK,1783752,1783934,1783752,182,128,utRho25
rimL,2997486,2997876,2997486,390,0,utRho25
rimO,1756140,1756140,1756070,70,38,utRho25
rimP,6636350,6636350,6636012,338,502,utRho25
rlmA,3814172,3814172,3814120,52,0,utRho25
rlmD,5830086,5830086,5830000,86,0,utRho25
rlmE,6655520,6655520,6655328,192,734,utRho25
rlmF,1684384,1684664,1684384,280,0,utRho25
rlmG,6471784,6471784,6471750,34,52,utRho25
rlmI,2060002,2060002,2059938,64,0,utRho25
rlmJ,7290700,7290770,7290700,70,78,utRho25
rlmL,2015344,2015688,2015344,344,106,utRho25
rlpA,1330444,1330444,1330380,64,14,utRho25
rluA,120900,120900,120692,208,62,utRho25
rluF,8460324,8460708,8460324,384,96,utRho25
rmf,2031006,2031430,2031006,424,220,utRho25
rna,1290068,1290068,1290006,62,0,utRho25
rnb,2698258,2698258,2697824,434,172,utRho25
rnc,10816892,10816892,10816252,640,27036,utRho25
rnd,3776122,3776122,3775982,140,0,utRho25
rne,2289746,2289746,2288734,1012,2128,utRho25
rnhA,472082,472082,472004,78,970,utRho25
rnk,1288360,1288360,1287934,426,0,utRho25
rnlA,5531788,5531836,5531788,48,112,utRho25
rnlB,5533414,5533968,5533414,554,294,utRho25
rnpB,19623552,19623552,19623552,0,0,utRho25
rob,9270706,9270706,9270620,86,36,utRho25
rodZ,5285868,5285868,5285688,180,118,utRho25
rpe,7030306,7030306,7030118,188,196,utRho25
rph,15266320,15266320,15266196,124,100,utRho25
rpiA,6118706,6118706,6118650,56,70,utRho25
rpiB,8626514,8626700,8626514,186,0,utRho25
rpiR,8626274,8626274,8625982,292,36,utRho25
rplJ,8359246,8359992,8359246,746,6444,utRho25
rplK,8356708,8356894,8356708,186,138,utRho25
rplM,6757344,6757344,6757302,42,1160,utRho25
rplN,6896444,6896444,6896298,146,878,utRho25
rplS,5489284,5489284,5489060,224,10230,utRho25
rplT,7199052,7199052,7198996,56,976,utRho25
rplU,6667036,6667036,6666902,134,100,utRho25
rplY,4564866,4565034,4564866,168,176,utRho25
rpmA,6666450,6666450,6666238,212,1136,utRho25
rpmB,15247980,15247980,15246696,1284,51284,utRho25
rpmE,8253816,8254026,8253816,210,288,utRho25
rpmF,2294676,2294734,2294676,58,11544,utRho25
rpmH,7768130,7768672,7768130,542,2124,utRho25
rpmI,3600854,3600854,3599998,856,3838,utRho25
rpoB,8362126,8362490,8362126,364,264,utRho25
rpoD,6424946,6426094,6424946,1148,33250,utRho25
rpoE,5420372,5420372,5420024,348,30,utRho25
rpoH,7202006,7202006,7201566,440,1596,utRho25
rpoN,6689324,6689434,6689324,110,48,utRho25
rpoS,5736236,5736236,5735102,1134,696,utRho25
rpoZ,7644154,7644212,7644154,58,32,utRho25
rppH,5937986,5937986,5937954,32,182,utRho25
rprA,3540744,3540744,3540744,0,0,utRho25
rpsA,1923434,1923990,1923434,556,24272,utRho25
rpsF,8850050,8850236,8850050,186,8632,utRho25
rpsI,6756580,6756580,6756414,166,6728,utRho25
rpsJ,6906884,6906884,6906540,344,2564,utRho25
rpsL,6949242,6949242,6949104,138,1632,utRho25
rpsM,6885130,6885130,6884942,188,208,utRho25
rpsO,13247144,13247144,13246736,408,96,utRho25
rpsP,5492508,5492508,5492370,138,84,utRho25
rpsT,42420,42420,42156,264,86,utRho25
rpsU,12842584,12843124,12842584,540,1892,utRho25
rraA,8238716,8238716,8238660,56,394,utRho25
rraB,8956768,8956946,8956768,178,54,utRho25
rrsA,8070478,8071062,8070478,584,1850,utRho25
rrsB,16665468,16666636,16665468,1168,3888,utRho25
rrsC,7883032,7883616,7883032,584,1098,utRho25
rrsD,6858094,6858094,6857524,570,440,utRho25
rrsE,8415726,8416294,8415726,568,536,utRho25
rrsG,5462896,5462896,5462314,582,1600,utRho25
rrsH,446970,447542,446970,572,454,utRho25
rsd,8393908,8393908,8393616,292,76,utRho25
rseA,5419264,5419264,5418808,456,590,utRho25
rseP,392940,393092,392940,152,118,utRho25
rseX,4067298,4067298,4067298,0,0,utRho25
rsfS,1338144,1338144,1338072,72,268,utRho25
rsgA,8783132,8783132,8783018,114,18,utRho25
rsmA,105176,105176,104860,316,200,utRho25
rsmB,6869982,6870414,6869982,432,72,utRho25
rsmC,9215736,9215736,9215400,336,0,utRho25
rsmD,7208594,7208786,7208594,192,0,utRho25
rsmE,6182036,6182268,6182036,232,54,utRho25
rsmG,7847512,7847512,7847360,152,124,utRho25
rsmH,180020,180188,180020,168,6,utRho25
rsmI,6587106,6587106,6586670,436,218,utRho25
rssA,2578212,2578412,2578212,200,0,utRho25
rssB,2580440,2580484,2580440,44,84,utRho25
rstA,3364276,3364300,3364276,24,0,utRho25
rsuA,4561096,4561096,4560966,130,58,utRho25
rsxA,3411510,3411534,3411510,24,0,utRho25
rtcA,7114004,7114004,7113698,306,50,utRho25
rtcB,7116214,7116214,7116158,56,58,utRho25
rtn,4541356,4541452,4541356,96,0,utRho25
rutA,2148052,2148052,2148022,30,0,utRho25
rutG,2140090,2140090,2139678,412,0,utRho25
rutR,2148226,2148484,2148226,258,0,utRho25
ruvA,7784096,7784096,7783904,192,0,utRho25
ruvB,7782176,7782176,7781424,752,892,utRho25
ruvC,3894878,3894878,3894752,126,0,utRho25
rybB,1776114,1776114,1776114,0,0,utRho25
rydB,3529860,3529860,3529322,538,0,utRho25
rydC,2983012,2983012,2983012,0,0,utRho25
ryfA,5307398,5307710,5307398,312,0,utRho25
ryfD,5468590,5468590,5468590,0,0,utRho25
ryhB,7162032,7162032,7162032,0,0,utRho25
ryjA,8556132,8556132,8556132,0,0,utRho25
ryjB,9055954,9055954,9055954,0,0,utRho25
sad,3229598,3229598,3229406,192,114,utRho25
safA,3168056,3168056,3167918,138,88,utRho25
sanA,4465368,4465756,4465368,388,34,utRho25
sapF,2705314,2705314,2705268,46,0,utRho25
sbcB,4165456,4165512,4165456,56,0,utRho25
sbcC,831694,831694,831506,188,6,utRho25
sbcD,833954,833954,833904,50,158,utRho25
sbmA,793106,793278,793106,172,384,utRho25
sbmC,4162650,4162650,4162524,126,0,utRho25
sdaA,3793618,3793864,3793618,246,838,utRho25
sdaC,5856070,5856458,5856070,388,15914,utRho25
sdhC,1509916,1510354,1509916,438,7964,utRho25
sdhD,1510808,1511120,1510808,312,174,utRho25
sdiA,3993834,3993834,3993664,170,30,utRho25
secE,8354354,8354716,8354354,362,364,utRho25
secG,6645180,6645180,6645010,170,260,utRho25
selA,7522594,7522594,7522498,96,136,utRho25
selB,7519850,7519850,7519722,128,50,utRho25
selC,7672396,7672444,7672396,48,100,utRho25
selD,3696058,3696058,3696016,42,234,utRho25
seqA,1425884,1425974,1425884,90,0,utRho25
serA,6117098,6117098,6116820,278,0,utRho25
serB,9249712,9249790,9249712,78,66,utRho25
serC,3830380,3830612,3830380,232,40,utRho25
serS,1878730,1878856,1878730,126,290,utRho25
serT,2063438,2063438,2063424,14,0,utRho25
serU,4087124,4087124,4087114,10,2,utRho25
serV,5637394,5637394,5637290,104,84,utRho25
serW,1852014,1852014,1851942,72,370,utRho25
serX,2195352,2195352,2195304,48,12,utRho25
setB,4527426,4527726,4527426,300,2,utRho25
setC,7673488,7673906,7673488,418,390,utRho25
sfmA,1116124,1116424,1116124,300,0,utRho25
sfmC,1117606,1117948,1117606,342,80,utRho25
sfsA,323030,323030,322972,58,58,utRho25
sfsB,6669592,6669818,6669592,226,24,utRho25
sgrR,154676,154676,154598,78,108,utRho25
sgrS,154734,154734,154734,0,0,utRho25
shiA,4107068,4107286,4107068,218,0,utRho25
sibA,4306622,4306622,4306622,0,0,utRho25
sibB,4307292,4307292,4307292,0,0,utRho25
sibC,6113702,6113702,6113702,0,0,utRho25
sibD,6389730,6389730,6389730,0,0,utRho25
sibE,6390480,6390480,6390480,0,0,utRho25
sixA,4913998,4913998,4913624,374,0,utRho25
slp,7307872,7307922,7307872,50,0,utRho25
slt,9261400,9261466,9261400,66,42,utRho25
slyA,3442028,3442028,3441648,380,2,utRho25
slyB,3439496,3439752,3439496,256,56,utRho25
slyD,6957398,6957398,6956994,404,308,utRho25
slyX,6954862,6955280,6954862,418,6282,utRho25
smf,6867372,6867372,6867120,252,0,utRho25
smpB,5509534,5509792,5509534,258,332,utRho25
smrA,2811872,2811958,2811872,86,290,utRho25
smrB,4896872,4897212,4896872,340,92,utRho25
smtA,1946808,1947074,1946808,266,0,utRho25
sodA,8201518,8201620,8201518,102,776,utRho25
sodB,3470646,3470756,3470646,110,0,utRho25
sodC,3449358,3449358,3449310,48,0,utRho25
sohB,2658568,2658664,2658568,96,178,utRho25
sokB,2984232,2984238,2984232,6,20,utRho25
solA,2241218,2241218,2241172,46,92,utRho25
soxR,8554894,8554938,8554894,44,0,utRho25
soxS,8554846,8554846,8554766,80,0,utRho25
speA,6172096,6172096,6171822,274,398,utRho25
speB,6167892,6167892,6167594,298,8,utRho25
speC,6218350,6218350,6218310,40,48,utRho25
spf,8099798,8099798,8099798,0,0,utRho25
sppA,3697422,3697674,3697422,252,152,utRho25
spy,3651376,3651376,3651250,126,0,utRho25
sra,3112092,3112092,3111926,166,0,utRho25
sraB,2293178,2293178,2293178,0,0,utRho25
sraC,3846132,3846132,3846132,0,0,utRho25
srlA,5651582,5651664,5651582,82,132,utRho25
srlR,5657720,5658094,5657720,374,344,utRho25
srmB,5425752,5425792,5425752,40,0,utRho25
sroA,151216,151216,151216,0,0,utRho25
sroG,6369436,6369436,6369436,0,0,utRho25
sroH,8380974,8380974,8380974,0,0,utRho25
ssb,8548022,8548250,8548022,228,6,utRho25
sseA,5304782,5304988,5304782,206,1970,utRho25
sspA,6755138,6755138,6754840,298,74,utRho25
ssrA,5511014,5511186,5511014,172,464,utRho25
ssrS,12223036,12223932,12223036,896,3540,utRho25
sstT,6479726,6479888,6479726,162,0,utRho25
ssuB,1988282,1988282,1988088,194,4,utRho25
ssuE,1995126,1995126,1995024,102,0,utRho25
sthA,8321604,8321604,8321580,24,62,utRho25
stpA,5597156,5597156,5596990,166,2,utRho25
sucA,3034344,3034824,3034344,480,304,utRho25
sufA,3528836,3528836,3528772,64,0,utRho25
sufE,3518962,3518962,3518580,382,4,utRho25
sugE,8753588,8753750,8753588,162,2,utRho25
sulA,2041894,2041894,2041838,56,4346,utRho25
syd,5850738,5850738,5850560,178,0,utRho25
symE,9159834,9159834,9159680,154,0,utRho25
symR,9159670,9159670,9159670,0,0,utRho25
tabA,8949566,8949724,8949566,158,0,utRho25
talA,5157140,5157332,5157140,192,0,utRho25
talB,16382,16476,16382,94,4214,utRho25
tam,3214442,3214692,3214442,250,60,utRho25
tamA,8884540,8884764,8884540,224,308,utRho25
tar,3945432,3945432,3945382,50,0,utRho25
tas,5943138,5943194,5943138,56,0,utRho25
tatA,16087636,16087780,16087636,144,4,utRho25
tatE,1317742,1317894,1317742,152,0,utRho25
tauA,770410,770464,770410,54,0,utRho25
tdcA,6534186,6534186,6534130,56,0,utRho25
tdcG,6519652,6519652,6519298,354,148,utRho25
tdcR,6534380,6534760,6534380,380,0,utRho25
tdk,2586986,2587054,2586986,68,136,utRho25
tehA,3001072,3001146,3001072,74,0,utRho25
tesA,1039898,1039898,1039530,368,306,utRho25
tesB,950402,950402,950322,80,0,utRho25
tfaE,2418532,2418532,2418238,294,278,utRho25
tfaQ,3269912,3269912,3269770,142,2,utRho25
tff,379424,379256,379424,168,94,utRho25
tgt,852110,852274,852110,164,0,utRho25
thiD,4369346,4369346,4369032,314,0,utRho25
thiI,882936,883098,882936,162,0,utRho25
thiM,4370902,4370902,4370602,300,26,utRho25
thiQ,146170,146170,145854,316,2754,utRho25
thrL,592,760,592,168,216,utRho25
thrS,7210932,7210932,7210280,652,400,utRho25
thrU,8350762,8350776,8350762,14,388,utRho25
thrV,6847414,6847414,6847310,104,202992,utRho25
thrW,525682,525742,525682,60,36,utRho25
thyA,5930696,5930696,5930310,386,178,utRho25
tig,909986,910266,909986,280,412,utRho25
tisB,7706674,7707106,7706674,432,948,utRho25
tktA,6163414,6163414,6163270,144,50,utRho25
tktB,5158616,5159272,5158616,656,264,utRho25
tldD,6784368,6784368,6784056,312,0,utRho25
tmcA,5191876,5191876,5191718,158,0,utRho25
tnaC,15553644,15553740,15553644,96,100,utRho25
tolB,1555074,1555480,1555074,406,628,utRho25
tolC,6356008,6356230,6356008,222,76,utRho25
tomB,961588,961588,961416,172,176,utRho25
tonB,2622108,2622178,2622108,70,0,utRho25
topA,2661578,2662096,2661578,518,370,utRho25
torC,2116112,2116168,2116112,56,130,utRho25
torR,2115968,2115968,2115908,60,170,utRho25
torS,2112364,2112364,2112356,8,0,utRho25
torT,2112414,2112522,2112414,108,0,utRho25
tpiA,8223138,8223138,8223014,124,2,utRho25
tppB,3425342,3425538,3425342,196,164,utRho25
tpr,2574376,2574376,2574376,0,0,utRho25
tpx,2777688,2777688,2777622,66,472,utRho25
tqsA,3347780,3347826,3347780,46,2,utRho25
treA,2494850,2494850,2494752,98,2,utRho25
treB,8932420,8932420,8932360,60,24,utRho25
treF,7339102,7339184,7339102,82,8,utRho25
treR,8934694,8934694,8934492,202,28,utRho25
trg,2984878,2984940,2984878,62,24,utRho25
trkG,2847342,2847564,2847342,222,568,utRho25
trmA,8326590,8326590,8326540,50,84,utRho25
trpA,2634678,2634678,2634444,234,68,utRho25
trpC,2639888,2639888,2639570,318,38,utRho25
trpL,5292432,5292432,5292328,104,0,utRho25
trpR,9265408,9265520,9265408,112,64,utRho25
trpS,7027394,7027394,7027276,118,266,utRho25
trpT,7893560,7893914,7893560,354,104602,utRho25
trxA,7931294,7931522,7931294,228,892,utRho25
trxB,1864156,1864156,1864100,56,40,utRho25
trxC,5437350,5437470,5437350,120,108,utRho25
tsaD,6421256,6421256,6421086,170,162,utRho25
tsgA,6985038,6985136,6985038,98,2,utRho25
tsr,9182824,9183314,9182824,490,54,utRho25
tsx,864490,864490,864026,464,100,utRho25
ttcA,2823970,2823970,2823896,74,958,utRho25
ttdA,6412848,6412926,6412848,78,62,utRho25
ttdR,6412760,6412760,6412512,248,58,utRho25
tufA,6943448,6943448,6942658,790,26376,utRho25
tus,3368346,3368518,3368346,172,92,utRho25
tusA,7218040,7218040,7217992,48,268,utRho25
tusB,6950218,6950218,6949930,288,164,utRho25
tynA,2902996,2902996,2902698,298,0,utRho25
typA,8116460,8116814,8116460,354,584,utRho25
tyrB,8534164,8534228,8534164,64,150,utRho25
tyrP,3979004,3979362,3979004,358,28,utRho25
tyrR,2773384,2773440,2773384,56,22,utRho25
tyrS,3434566,3434566,3434444,122,0,utRho25
tyrT,2575330,2575330,2575244,86,30,utRho25
uacT,6062378,6062734,6062378,356,92,utRho25
ubiC,8504886,8505012,8504886,126,96,utRho25
ubiD,8049618,8049976,8049618,358,1306,utRho25
ubiE,8037494,8037710,8037494,216,82,utRho25
ubiG,4679078,4679134,4679078,56,0,utRho25
ucpA,5089342,5089342,5089246,96,42,utRho25
udp,8032782,8032862,8032782,80,0,utRho25
ugd,4199470,4199470,4199226,244,0,utRho25
ugpB,7184852,7184852,7184650,202,590,utRho25
ugpQ,7176600,7176600,7176226,374,0,utRho25
uhpT,7694396,7694396,7694334,62,0,utRho25
uidA,3392304,3392304,3392142,162,0,utRho25
uidC,3386012,3386012,3385702,310,4,utRho25
uidR,3394150,3394150,3394104,46,0,utRho25
ulaA,8839854,8839960,8839854,106,20,utRho25
ulaG,8839350,8839350,8839250,100,4,utRho25
ulaR,8837124,8837124,8836906,218,0,utRho25
umpG,5741372,5741372,5740548,824,80,utRho25
umpH,1400704,1400704,1400652,52,18,utRho25
umuD,2461476,2461534,2461476,58,0,utRho25
ung,5433476,5433508,5433476,32,0,utRho25
uof,2843316,2843316,2842900,416,404,utRho25
upp,5241818,5241818,5241744,74,82,utRho25
usg,4873780,4873780,4873298,482,42,utRho25
ushA,1009772,1009828,1009772,56,8,utRho25
uspA,7279966,7280222,7279966,256,406,utRho25
uspB,7279696,7279696,7279440,256,118,utRho25
uspC,3959172,3959506,3959172,334,30,utRho25
uspE,2797318,2797318,2797244,74,98,utRho25
uspF,2871282,2871282,2871238,44,58,utRho25
uspG,1283806,1283806,1283734,72,130,utRho25
uvrA,8547872,8547872,8547742,130,224,utRho25
uvrB,1626304,1627052,1626304,748,154,utRho25
uvrC,3989758,3989758,3989412,346,0,utRho25
uvrD,7995814,7995966,7995814,152,28,utRho25
uvrY,3990812,3990812,3990718,94,78,utRho25
uxaB,3221474,3221474,3221360,114,56,utRho25
uxaC,6489714,6489714,6489482,232,36,utRho25
uxuA,9103036,9103272,9103036,236,324,utRho25
uxuR,9108916,9109152,9108916,236,12,utRho25
valS,8967854,8967854,8967674,180,168,utRho25
valU,5041848,5041862,5041848,14,46,utRho25
valV,3492830,3492870,3492830,40,2,utRho25
ves,3649968,3649968,3649874,94,0,utRho25
waaA,7616512,7617080,7616512,568,552,utRho25
waaH,7580298,7580298,7580162,136,0,utRho25
waaQ,7616476,7616476,7616196,280,552,utRho25
waaU,7598996,7598996,7598624,372,42,utRho25
waaY,7602272,7602272,7601930,342,7978,utRho25
wbbH,4214888,4214888,4214452,436,1626,utRho25
wbbK,4209212,4209212,4209018,194,334,utRho25
wcaM,4231868,4231868,4231792,76,0,utRho25
wrbA,2135516,2135516,2135416,100,0,utRho25
wza,4275166,4275166,4274486,680,52,utRho25
wzxC,4240674,4240674,4240316,358,0,utRho25
wzzB,4196950,4196950,4196602,348,198,utRho25
xanP,7657642,7657890,7657642,248,60,utRho25
xanQ,6048520,6048702,6048520,182,62,utRho25
xapA,5049820,5049820,5049756,64,0,utRho25
xapR,10090252,10090252,10089908,344,0,utRho25
xdhA,6000514,6000690,6000514,176,162,utRho25
xerD,6079702,6079702,6079486,216,36,utRho25
xseA,5268394,5268464,5268394,70,76,utRho25
xseB,882746,882746,882686,60,30,utRho25
xthA,3664798,3664856,3664798,58,0,utRho25
xylA,7461614,7461614,7461530,84,1768,utRho25
xylE,8484540,8484540,8484508,32,0,utRho25
xylF,7462138,7462262,7462138,124,240,utRho25
xylR,7469812,7469958,7469812,146,88,utRho25
yaaA,13230,13230,12918,312,204,utRho25
yaaI,23876,23876,23572,304,72,utRho25
yaaJ,16034,16034,15918,116,94,utRho25
yaaU,91184,91614,91184,430,52,utRho25
yaaW,23084,23084,22712,372,108,utRho25
yaaX,10060,10468,10060,408,150,utRho25
yabI,142542,142702,142542,160,136,utRho25
yacC,273880,273880,273834,46,2,utRho25
yacH,262932,262932,262520,412,0,utRho25
yacL,268678,268776,268678,98,0,utRho25
yadD,293796,293936,293796,140,2,utRho25
yadE,289930,290162,289930,232,156,utRho25
yadN,314110,314110,313766,344,44,utRho25
yadS,355572,355572,355248,324,172,utRho25
yadV,312470,312470,312402,68,166,utRho25
yaeF,434270,434270,434006,264,14,utRho25
yaeP,428374,428374,428250,124,126,utRho25
yaeQ,428176,428582,428176,406,128,utRho25
yaeR,423716,423754,423716,38,48,utRho25
yafC,462166,462166,461762,404,402,utRho25
yafD,462128,462244,462128,116,460,utRho25
yafK,491986,491986,491610,376,186,utRho25
yafL,493282,493424,493282,142,2,utRho25
yafN,503938,504010,503938,72,32,utRho25
yafS,469568,469632,469568,64,186,utRho25
yafT,474470,474670,474470,200,22,utRho25
yafV,480432,480432,480378,54,0,utRho25
yafZ,536052,536052,536010,42,10,utRho25
yagE,564446,564556,564446,110,58,utRho25
yagG,570414,570790,570414,376,82,utRho25
yagI,578384,578384,578324,60,0,utRho25
yagK,586236,586236,585896,340,494,utRho25
yagL,588062,588062,587836,226,12,utRho25
yagN,591342,591342,591158,184,30,utRho25
yahA,663746,664742,663746,996,998,utRho25
yahC,670136,670136,670044,92,22,utRho25
yahE,671478,671850,671478,372,208,utRho25
yahM,690504,690808,690504,304,442,utRho25
yahN,692872,692872,692674,198,412,utRho25
yahO,692864,692968,692864,104,296,utRho25
yaiE,816296,816354,816296,58,80,utRho25
yaiI,811396,811528,811396,132,82,utRho25
yaiO,761946,761946,761684,262,148,utRho25
yaiP,767970,767970,767870,100,0,utRho25
yaiS,769660,769660,769232,428,650,utRho25
yaiV,788922,788922,788922,0,0,utRho25
yaiY,799094,799094,798666,428,56,utRho25
yaiZ,798888,799186,798888,298,6,utRho25
yajC,854410,854574,854410,164,100,utRho25
yajD,860938,861210,860938,272,224,utRho25
yajI,866068,866068,865702,366,282,utRho25
yajL,887496,887496,887282,214,136,utRho25
yajQ,889316,889366,889316,50,166,utRho25
yajR,893374,893374,893332,42,34,utRho25
ybaB,987418,988152,987418,734,444,utRho25
ybaL,1006590,1006590,1006476,114,32,utRho25
ybaM,980648,980648,980542,106,78,utRho25
ybaN,981436,981764,981436,328,278,utRho25
ybaO,936704,936766,936704,62,0,utRho25
ybaP,1016568,1016568,1016160,408,700,utRho25
ybaQ,1016348,1016436,1016348,88,154,utRho25
ybaS,1023146,1023282,1023146,136,56,utRho25
ybaV,927504,927874,927504,370,0,utRho25
ybaY,950490,950758,950490,268,76,utRho25
ybbB,1062724,1062724,1062452,272,0,utRho25
ybbJ,1030154,1030154,1029718,436,400,utRho25
ybbL,1031784,1031838,1031784,54,4,utRho25
ybbN,1037136,1037136,1036558,578,972,utRho25
ybbO,1038658,1038658,1038298,360,484,utRho25
ybbY,1080718,1081130,1080718,412,102,utRho25
ybcH,1176140,1176140,1175962,178,52,utRho25
ybcI,1113264,1113264,1113106,158,84,utRho25
ybcJ,1114050,1114050,1113746,304,138,utRho25
ybcK,1137502,1137804,1137502,302,166,utRho25
ybcL,1141690,1141786,1141690,96,6,utRho25
ybcN,1144628,1144932,1144628,304,84,utRho25
ybcQ,1147548,1147912,1147548,364,0,utRho25
ybcW,1159610,1159760,1159610,150,44,utRho25
ybdD,1263982,1264364,1263982,382,66,utRho25
ybdF,1212106,1212106,1211772,334,38,utRho25
ybdH,1267048,1267048,1266954,94,2,utRho25
ybdJ,1212822,1212822,1212398,424,56,utRho25
ybdK,1215122,1215122,1214766,356,156,utRho25
ybdL,1267114,1267172,1267114,58,68,utRho25
ybdM,1271110,1271110,1270752,358,56,utRho25
ybdN,1273372,1273372,1273138,234,62,utRho25
ybdR,1283844,1284176,1283844,332,198,utRho25
ybeD,1325412,1325412,1325284,128,1066,utRho25
ybeF,1323090,1323090,1322756,334,268,utRho25
ybeL,1349986,1350036,1349986,50,0,utRho25
ybeQ,1353412,1353412,1353094,318,86,utRho25
ybeR,1353120,1353422,1353120,302,86,utRho25
ybeT,1358832,1358832,1358812,20,0,utRho25
ybeU,1358924,1359016,1358924,92,26,utRho25
ybeZ,1386938,1386938,1386834,104,332,utRho25
ybfA,1458074,1458268,1458074,194,78,utRho25
ybfE,1423878,1423878,1423796,82,194,utRho25
ybfF,1425692,1425692,1425604,88,192,utRho25
ybfH,1433282,1433282,1433194,88,26,utRho25
ybgA,1477840,1478002,1477840,162,88,utRho25
ybgC,1549288,1549504,1549288,216,20,utRho25
ybgD,1505916,1505916,1505590,326,3482,utRho25
ybgI,1485238,1485654,1485238,416,0,utRho25
ybgO,1498370,1498370,1497964,406,212,utRho25
ybgS,1570992,1570992,1570634,358,152,utRho25
ybhA,1597184,1597184,1596862,322,110,utRho25
ybhB,1616070,1616070,1615818,252,0,utRho25
ybhC,1614642,1614642,1614562,80,14,utRho25
ybhD,1601418,1601418,1601276,142,32,utRho25
ybhH,1601104,1601518,1601104,414,32,utRho25
ybhK,1633384,1633384,1633294,90,0,utRho25
ybhM,1641556,1641586,1641556,30,86,utRho25
ybhN,1645296,1645296,1644996,300,100,utRho25
ybhQ,1649202,1649260,1649202,58,82,utRho25
ybiA,1665920,1665920,1665900,20,0,utRho25
ybiI,1676968,1676968,1676912,56,34,utRho25
ybiO,1691328,1691328,1690960,368,188,utRho25
ybiP,1705252,1705252,1705194,58,54,utRho25
ybiS,1711572,1711572,1711488,84,0,utRho25
ybiT,1711894,1711926,1711894,32,14,utRho25
ybiU,1718212,1718212,1718122,90,22,utRho25
ybiV,1720176,1720176,1720056,120,0,utRho25
ybiW,1725566,1725566,1725212,354,390,utRho25
ybiX,1678548,1678548,1678414,134,262,utRho25
ybjC,1781784,1781826,1781784,42,0,utRho25
ybjE,1830154,1830154,1829714,440,250,utRho25
ybjG,1767016,1767016,1766776,240,306,utRho25
ybjL,1779882,1779882,1779638,244,0,utRho25
ybjM,1779770,1780178,1779770,408,0,utRho25
ybjO,1795704,1795978,1795704,274,0,utRho25
ybjP,1809046,1809046,1808934,112,0,utRho25
ybjQ,1809034,1809186,1809034,152,76,utRho25
ybjS,1813796,1813796,1813506,290,60,utRho25
ybjX,1838206,1838206,1838168,38,16,utRho25
ycaD,1891438,1891742,1891438,304,84,utRho25
ycaI,1928210,1928640,1928210,430,78,utRho25
ycaK,1899094,1899336,1899094,242,210,utRho25
ycaL,1920264,1920528,1920264,264,0,utRho25
ycaM,1894240,1894458,1894240,218,184,utRho25
ycaR,1941284,1941346,1941284,62,134,utRho25
ycbB,1961862,1962094,1961862,232,118,utRho25
ycbJ,1943344,1943504,1943344,160,0,utRho25
ycbK,1966046,1966150,1966046,104,40,utRho25
ycbZ,2036920,2036920,2036598,322,44,utRho25
yccA,2062886,2062886,2062836,50,0,utRho25
yccF,2048730,2048730,2048696,34,0,utRho25
yccS,2047988,2047988,2047766,222,186,utRho25
yccT,2055674,2055674,2055546,128,176,utRho25
yccX,2059960,2060128,2059960,168,4,utRho25
ycdT,2185682,2185752,2185682,70,0,utRho25
ycdU,2191266,2191686,2191266,420,12,utRho25
ycdZ,2200504,2200592,2200504,88,0,utRho25
yceA,2233544,2233614,2233544,70,24,utRho25
yceD,2293298,2293588,2293298,290,1436,utRho25
yceF,2293522,2293522,2293190,332,816,utRho25
yceH,2252154,2252314,2252154,160,390,utRho25
yceI,2237282,2237282,2236952,330,138,utRho25
yceJ,2238142,2238142,2238092,50,62,utRho25
yceM,2253208,2253612,2253208,404,0,utRho25
yceO,2239264,2239264,2238894,370,340,utRho25
yceQ,2288760,2289004,2288760,244,1840,utRho25
ycfD,2376540,2376540,2376480,60,0,utRho25
ycfJ,2334814,2335198,2334814,384,0,utRho25
ycfS,2340834,2340834,2340748,86,0,utRho25
ycfT,2350658,2350658,2350330,328,108,utRho25
ycfZ,2362760,2362760,2362534,226,188,utRho25
ycgB,2474570,2474570,2474482,88,0,utRho25
ycgG,2434614,2434656,2434614,42,234,utRho25
ycgJ,2452956,2453200,2452956,244,0,utRho25
ycgL,2455218,2455362,2455218,144,4,utRho25
ycgN,2457366,2457660,2457366,294,166,utRho25
ycgR,2489112,2489112,2489054,58,0,utRho25
ycgV,2512222,2512222,2511904,318,448,utRho25
ycgX,2426568,2426568,2426214,354,454,utRho25
ycgY,2490166,2490320,2490166,154,56,utRho25
ycgZ,2431504,2431578,2431504,74,94,utRho25
ychE,2596904,2597196,2596904,292,20,utRho25
ychF,2515764,2515764,2515624,140,0,utRho25
ychH,2517476,2517582,2517476,106,540,utRho25
ychJ,2578354,2578354,2578264,90,0,utRho25
ychN,2547310,2547310,2547198,112,0,utRho25
ychO,2547520,2547850,2547520,330,40,utRho25
ychQ,2533798,2533848,2533798,50,0,utRho25
yciA,2624828,2624828,2624492,336,10,utRho25
yciB,2626110,2626110,2625780,330,144,utRho25
yciC,2627396,2627396,2627326,70,0,utRho25
yciE,2630794,2630794,2630448,346,22,utRho25
yciG,5264368,5264368,5264140,228,0,utRho25
yciI,2621784,2621784,2621730,54,0,utRho25
yciN,2661606,2661606,2661336,270,192,utRho25
yciS,2680270,2680486,2680270,216,0,utRho25
yciT,2689088,2689088,2688692,396,104,utRho25
yciU,2614718,2614718,2614300,418,116,utRho25
yciV,2646376,2646440,2646376,64,0,utRho25
yciW,2700472,2700472,2700214,258,90,utRho25
yciZ,2689276,2689276,2689218,58,192,utRho25
ycjD,2703792,2703792,2703520,272,0,utRho25
ycjG,2777748,2777860,2777748,112,0,utRho25
ycjM,2740006,2740432,2740006,426,108,utRho25
ycjW,2767982,2767982,2767922,60,0,utRho25
ycjX,2768138,2768234,2768138,96,132,utRho25
ycjY,5568288,5568288,5567460,828,172,utRho25
ydaE,2836438,2836438,2836016,422,80,utRho25
ydaN,2816048,2816100,2816048,52,0,utRho25
ydaS,2840340,2840730,2840340,390,234,utRho25
ydbC,2948376,2948442,2948376,66,0,utRho25
ydbD,2950132,2950288,2950132,156,0,utRho25
ydbH,2885800,2886102,2885800,302,2230,utRho25
ydbJ,2881712,2882116,2881712,404,540,utRho25
ydbK,2881692,2881692,2881568,124,200,utRho25
ydcA,2983294,2983354,2983294,60,46,utRho25
ydcF,2974404,2974470,2974404,66,4,utRho25
ydcI,2990268,2990268,2990142,126,0,utRho25
ydcJ,2990266,2990576,2990266,310,0,utRho25
ydcK,3001280,3001280,3000898,382,60,utRho25
ydcL,3004646,3004914,3004646,268,16,utRho25
ydcN,3012308,3012344,3012308,36,54,utRho25
ydcP,3013508,3013562,3013508,54,26,utRho25
ydcR,3019956,3020006,3019956,50,0,utRho25
ydcS,3022906,3023308,3022906,402,4,utRho25
ydcX,3034442,3034778,3034442,336,230,utRho25
ydcY,3035220,3035296,3035220,76,0,utRho25
ydcZ,3036750,3036750,3036662,88,18,utRho25
yddB,3155332,3155332,3155238,94,0,utRho25
yddE,3071738,3071738,3071716,22,0,utRho25
yddG,3094410,3094410,3094338,72,12,utRho25
yddJ,3089732,3089732,3089438,294,176,utRho25
yddW,3137704,3137704,3137646,58,0,utRho25
ydeA,3233910,3234056,3233910,146,12,utRho25
ydeE,3242528,3242664,3242528,136,0,utRho25
ydeI,3249118,3249118,3248994,124,0,utRho25
ydeJ,3249376,3249546,3249376,170,0,utRho25
ydeN,3165458,3165458,3165048,410,0,utRho25
ydeP,3173328,3173328,3172972,356,102,utRho25
ydeR,3176596,3176596,3176592,4,36,utRho25
ydfA,3296872,3297016,3296872,144,0,utRho25
ydfG,3254982,3255034,3254982,52,0,utRho25
ydfH,3256652,3256704,3256652,52,0,utRho25
ydfK,3265446,3266144,3265446,698,306,utRho25
ydgA,3379588,3379704,3379588,116,0,utRho25
ydgC,3364124,3364124,3364060,64,0,utRho25
ydgD,3343906,3343920,3343906,14,82,utRho25
ydgH,3356754,3356854,3356754,100,12,utRho25
ydgJ,3408798,3408798,3408616,182,24,utRho25
ydgK,3410414,3410500,3410414,86,374,utRho25
ydhB,3479618,3479618,3479596,22,0,utRho25
ydhC,3479698,3479822,3479698,124,0,utRho25
ydhF,3451310,3451310,3451264,46,0,utRho25
ydhI,3441996,3442050,3441996,54,0,utRho25
ydhL,3451864,3451864,3451840,24,0,utRho25
ydhQ,3492404,3492404,3492254,150,0,utRho25
ydhS,3494136,3494262,3494136,126,10,utRho25
ydhT,3499138,3499138,3499118,20,0,utRho25
ydhY,3509284,3509284,3508954,330,28,utRho25
ydhZ,3510418,3510418,3510282,136,56,utRho25
ydiE,3579206,3579226,3579206,20,0,utRho25
ydiH,3530582,3530582,3530406,176,0,utRho25
ydiM,3541852,3542142,3541852,290,0,utRho25
ydiN,3544818,3545024,3544818,206,0,utRho25
ydiP,3558656,3558656,3558602,54,40,utRho25
ydiU,3582508,3582508,3582488,20,0,utRho25
ydiV,3584174,3584174,3584040,134,0,utRho25
ydiY,3612500,3612500,3612166,334,130,utRho25
ydjA,3697400,3697400,3697352,48,42,utRho25
ydjE,3708082,3708082,3707958,124,0,utRho25
ydjF,3709848,3709848,3709708,140,0,utRho25
ydjM,3620340,3620422,3620340,82,68,utRho25
ydjO,3626696,3626696,3626288,408,0,utRho25
ydjX,3666434,3666802,3666434,368,112,utRho25
yeaE,3731448,3731448,3731272,176,180,utRho25
yeaG,3733530,3733816,3733530,286,0,utRho25
yeaI,3740486,3740770,3740486,284,84,utRho25
yeaJ,3743874,3744082,3743874,208,172,utRho25
yeaL,3748646,3748704,3748646,58,44,utRho25
yeaM,3751296,3751296,3751152,144,0,utRho25
yeaN,3750926,3751346,3750926,420,0,utRho25
yeaO,3753554,3753818,3753554,264,54,utRho25
yeaP,3755314,3755430,3755314,116,8,utRho25
yeaQ,3758780,3758780,3758510,270,28,utRho25
yeaR,3759988,3759988,3759896,92,0,utRho25
yeaY,3781122,3781122,3781064,58,14,utRho25
yebB,3892220,3892502,3892220,282,128,utRho25
yebC,3896370,3896370,3896302,68,0,utRho25
yebE,3859464,3859464,3859414,50,54,utRho25
yebG,3861530,3861530,3861494,36,0,utRho25
yebK,3873180,3873304,3873180,124,0,utRho25
yebQ,3820314,3820552,3820314,238,0,utRho25
yebS,3832238,3832516,3832238,278,64,utRho25
yebV,3843430,3843560,3843430,130,0,utRho25
yebW,3843914,3844242,3843914,328,516,utRho25
yecC,3995646,3995646,3995628,18,36,utRho25
yecD,3901272,3901664,3901272,392,0,utRho25
yecF,3991434,3991636,3991434,202,24,utRho25
yecH,3979304,3979304,3978980,324,28,utRho25
yecJ,3975604,3975604,3975516,88,0,utRho25
yecM,3919968,3919968,3919692,276,48,utRho25
yecR,3976400,3976444,3976400,44,156,utRho25
yecT,3923862,3923944,3923862,82,22,utRho25
yedD,4016522,4016522,4016180,342,36,utRho25
yedE,4016310,4016554,4016310,244,32,utRho25
yedI,4058922,4058922,4058732,190,0,utRho25
yedJ,4066446,4066446,4066158,288,0,utRho25
yedV,4076404,4076404,4076304,100,40,utRho25
yedX,4077680,4077912,4077680,232,52,utRho25
yedY,4078572,4078956,4078572,384,58,utRho25
yeeA,4161322,4161322,4161182,140,76,utRho25
yeeE,4171104,4171104,4171050,54,2,utRho25
yeeJ,4089526,4089822,4089526,296,0,utRho25
yeeN,4113508,4113716,4113508,208,12,utRho25
yeeO,4119444,4119444,4119692,248,440,utRho25
yeeX,4158834,4158834,4158722,112,162,utRho25
yeeZ,4178422,4178422,4178256,166,0,utRho25
yefM,4179466,4179466,4179426,40,4,utRho25
yegD,4295288,4295348,4295288,60,0,utRho25
yegH,4275726,4275804,4275726,78,72,utRho25
yegI,4302154,4302154,4301970,184,0,utRho25
yegJ,4302032,4302370,4302032,338,20,utRho25
yegQ,4331182,4331336,4331182,154,248,utRho25
yegR,4336698,4336698,4336612,86,456,utRho25
yegS,4337086,4337424,4337086,338,80,utRho25
yegT,4357562,4357642,4357562,80,2,utRho25
yegX,4367640,4367640,4367302,338,0,utRho25
yehA,4376944,4376944,4376828,116,94,utRho25
yehE,4385818,4385818,4385592,226,0,utRho25
yehK,4407568,4407944,4407568,376,0,utRho25
yehL,4408804,4409192,4408804,388,0,utRho25
yeiB,4486146,4486146,4485934,212,0,utRho25
yeiE,4499422,4499422,4499236,186,0,utRho25
yeiG,4487776,4487820,4487776,44,106,utRho25
yeiH,4499332,4499434,4499332,102,100,utRho25
yeiI,4503306,4503400,4503306,94,42,utRho25
yeiL,4510580,4510710,4510580,130,20,utRho25
yeiP,4530834,4530900,4530834,66,134,utRho25
yeiQ,4532328,4532490,4532328,162,4,utRho25
yeiR,4535484,4535658,4535484,174,0,utRho25
yeiW,4530840,4530840,4530590,250,116,utRho25
yejA,4544624,4544728,4544624,104,0,utRho25
yejG,4556892,4556892,4556474,418,926,utRho25
yejH,4561244,4561264,4561244,20,4,utRho25
yejK,4568218,4568218,4567894,324,100,utRho25
yejO,4578352,4578352,4577800,552,188,utRho25
yfaD,4713380,4713808,4713380,428,252,utRho25
yfaE,4696676,4697028,4696676,352,112,utRho25
yfaL,4688568,4688568,4688338,230,62,utRho25
yfaP,4656398,4656398,4656286,112,108,utRho25
yfaU,4717892,4717892,4717690,202,2,utRho25
yfaY,4727310,4727310,4727266,44,156,utRho25
yfaZ,4728744,4728744,4728550,194,52,utRho25
yfbK,4771810,4771810,4771444,366,104,utRho25
yfbL,4771500,4771720,4771500,220,90,utRho25
yfbN,4777174,4777174,4776852,322,254,utRho25
yfbO,4776916,4777162,4776916,246,254,utRho25
yfbP,4777990,4778232,4777990,242,144,utRho25
yfbR,4817662,4817724,4817662,62,28,utRho25
yfcI,4847424,4847424,4847078,346,266,utRho25
yfcJ,4880482,4880482,4880240,242,0,utRho25
yfcL,4888502,4888502,4888338,164,24,utRho25
yfcV,4911642,4911642,4911292,350,72,utRho25
yfcZ,4921958,4921958,4921868,90,26,utRho25
yfdF,4925604,4926024,4925604,420,120,utRho25
yfdG,4935474,4935710,4935474,236,0,utRho25
yfdP,4946844,4947040,4946844,196,36,utRho25
yfdX,4988866,4988866,4988804,62,108,utRho25
yfdY,4990672,4990672,4990584,88,40,utRho25
yfeA,5035784,5035784,5035664,120,542,utRho25
yfeC,5036668,5036934,5036668,266,2,utRho25
yfeH,5053818,5053892,5053818,74,0,utRho25
yfeK,5074630,5074684,5074630,54,16,utRho25
yfeO,5018906,5019260,5018906,354,10,utRho25
yfeR,5054078,5054078,5053712,366,0,utRho25
yfeX,5101356,5101356,5101090,266,2,utRho25
yfeY,5102486,5102486,5102432,54,0,utRho25
yfeZ,5103842,5103842,5103452,390,94,utRho25
yffO,5123804,5124222,5123804,418,408,utRho25
yffQ,5126778,5127154,5126778,376,152,utRho25
yffS,5128800,5128986,5128800,186,90,utRho25
yfgC,5232052,5232188,5232052,136,0,utRho25
yfgF,5258062,5258062,5257876,186,402,utRho25
yfgG,5258170,5258580,5258170,410,456,utRho25
yfgH,5259344,5259584,5259344,240,0,utRho25
yfgM,5278866,5278866,5278566,300,212,utRho25
yfhH,5397414,5397518,5397414,104,4,utRho25
yfhM,5304648,5304648,5304574,74,0,utRho25
yfhR,5328408,5328726,5328408,318,30,utRho25
yfiC,5425610,5425610,5425528,82,0,utRho25
yfiE,5430688,5430688,5430640,48,112,utRho25
yfiL,5482630,5482720,5482630,90,0,utRho25
yfiM,5448066,5448358,5448066,292,1646,utRho25
yfiR,5483354,5483750,5483354,396,52,utRho25
yfjH,5517326,5517326,5517200,126,0,utRho25
yfjI,5517710,5517970,5517710,260,0,utRho25
yfjJ,5521014,5521094,5521014,80,0,utRho25
yfjM,5531970,5531970,5531552,418,718,utRho25
yfjP,5535080,5535420,5535080,340,588,utRho25
yfjW,5546570,5546636,5546570,66,0,utRho25
yfjX,5551776,5551838,5551776,62,0,utRho25
ygaC,5601180,5601180,5599988,1192,9342,utRho25
ygaM,5600242,5600292,5600242,50,2888,utRho25
ygaU,5593628,5593628,5593572,56,60,utRho25
ygaZ,5619190,5619234,5619190,44,0,utRho25
ygbA,5713656,5713656,5713612,44,36,utRho25
ygbE,5746784,5746784,5746674,110,68,utRho25
ygbI,5722882,5722882,5722528,354,0,utRho25
ygbK,5724394,5724670,5724394,276,424,utRho25
ygbL,5727074,5727186,5727074,112,14,utRho25
ygbN,5729814,5730202,5729814,388,642,utRho25
ygcG,5811210,5811422,5811210,212,80,utRho25
ygcN,5785144,5785314,5785144,170,170,utRho25
ygcU,5799214,5799214,5798836,378,116,utRho25
ygcW,5800942,5800942,5800546,396,8,utRho25
ygdD,5883442,5883442,5883262,180,252,utRho25
ygdG,5861746,5861930,5861746,184,316,utRho25
ygdI,5886526,5886526,5886290,236,2,utRho25
ygdQ,5940784,5940840,5940784,56,4,utRho25
ygdR,5942494,5942542,5942494,48,128,utRho25
ygeA,5961606,5961606,5961270,336,0,utRho25
ygeH,5983758,5984188,5983758,430,6,utRho25
ygeI,5987162,5987276,5987162,114,108,utRho25
ygeR,6000078,6000078,5999782,296,432,utRho25
ygeV,6011694,6011694,6011572,122,0,utRho25
ygeW,6012234,6012524,6012234,290,688,utRho25
ygfB,6110946,6110946,6110888,58,0,utRho25
ygfK,6031984,6032120,6031984,136,50,utRho25
ygfS,6058328,6058328,6058024,304,100,utRho25
ygfZ,6082564,6082626,6082564,62,122,utRho25
yggC,6149512,6149512,6149378,134,2,utRho25
yggE,6136370,6136370,6136160,210,12,utRho25
yggI,6179176,6179510,6179176,334,100,utRho25
yggL,6204508,6204508,6204266,242,20,utRho25
yggM,6199514,6199514,6199130,384,152,utRho25
yggN,6203596,6203596,6203246,350,124,utRho25
yggX,18623958,18624558,18623958,600,264,utRho25
yghA,6298966,6299324,6298966,358,78,utRho25
yghB,6307058,6307126,6307058,68,46,utRho25
yghD,6222614,6222614,6222252,362,240,utRho25
yghF,6225798,6225798,6225840,42,0,utRho25
yghJ,6238640,6238640,6238224,416,14,utRho25
yghQ,6265186,6265186,6264816,370,332,utRho25
yghT,6267830,6268262,6267830,432,128,utRho25
yghU,6277400,6277454,6277400,54,32,utRho25
yghW,6293506,6293506,6293474,32,60,utRho25
yghZ,6295562,6295794,6295562,232,0,utRho25
ygiD,6365122,6365122,6364868,254,48,utRho25
ygiH,6409066,6409388,6409066,322,84,utRho25
ygiL,6370622,6370828,6370622,206,0,utRho25
ygiM,6402084,6402414,6402084,330,786,utRho25
ygiN,6346156,6346284,6346156,128,630,utRho25
ygiQ,6322620,6322620,6322292,328,46,utRho25
ygiS,6335462,6335462,6335436,26,0,utRho25
ygiV,6338582,6338582,6338462,120,26,utRho25
ygiW,6339774,6339774,6339352,422,150,utRho25
ygiZ,6344506,6344506,6344422,84,76,utRho25
ygjH,6442528,6442528,6442494,34,0,utRho25
ygjI,6452140,6452468,6452140,328,0,utRho25
ygjQ,6472730,6473080,6472730,350,184,utRho25
ygjR,6474564,6474586,6474564,22,0,utRho25
ygjV,6483638,6483638,6483488,150,0,utRho25
yhaB,6535632,6535708,6535632,76,0,utRho25
yhaH,6504498,6504608,6504498,110,456,utRho25
yhaI,6505400,6505822,6505400,422,150,utRho25
yhaJ,6508560,6508560,6508428,132,4,utRho25
yhaK,6508538,6508638,6508538,100,10,utRho25
yhbQ,6599878,6599932,6599878,54,0,utRho25
yhbT,6602736,6602736,6602552,184,0,utRho25
yhbU,6602558,6602970,6602558,412,12,utRho25
yhbX,6643302,6643302,6643226,76,62,utRho25
yhbY,6655518,6655580,6655518,62,222,utRho25
yhcA,6723956,6724224,6723956,268,8,utRho25
yhcB,6760364,6760382,6760364,18,0,utRho25
yhcC,6708470,6708470,6708100,370,4,utRho25
yhcF,6733440,6733852,6733440,412,112,utRho25
yhcH,6739124,6739124,6738956,168,240,utRho25
yhcM,6760312,6760312,6759994,318,52,utRho25
yhcN,6770812,6771076,6770812,264,210,utRho25
yhcO,6772606,6772606,6772258,348,34,utRho25
yhdH,6806560,6806968,6806560,408,444,utRho25
yhdJ,6823234,6823306,6823234,72,0,utRho25
yhdN,6879092,6879092,6879018,74,726,utRho25
yhdT,6814702,6814750,6814702,48,6,utRho25
yhdU,6824994,6825242,6824994,248,168,utRho25
yhdV,6836392,6836780,6836392,388,28,utRho25
yhdW,6837944,6838298,6837944,354,64,utRho25
yheO,6953082,6953082,6952880,202,2,utRho25
yheV,6957970,6957970,6957584,386,100,utRho25
yhfA,6971902,6971902,6971636,266,192,utRho25
yhfG,6983294,6983294,6983240,54,0,utRho25
yhfL,6998622,6998896,6998622,274,252,utRho25
yhfY,7023244,7023244,7022844,400,0,utRho25
yhgA,7086294,7086334,7086294,40,0,utRho25
yhgE,7065176,7065176,7064878,298,48,utRho25
yhgF,7074352,7074770,7074352,418,982,utRho25
yhhA,7173458,7173886,7173458,428,26,utRho25
yhhI,7248346,7248756,7248346,410,0,utRho25
yhhJ,7253696,7253696,7253606,90,2,utRho25
yhhM,7211588,7211588,7211220,368,38,utRho25
yhhN,7211150,7211502,7211150,352,18,utRho25
yhhQ,7218238,7218434,7218238,196,218,utRho25
yhhT,7223682,7223730,7223682,48,0,utRho25
yhhX,7162032,7162032,7161610,422,4,utRho25
yhhY,7162222,7162276,7162222,54,0,utRho25
yhhZ,7163516,7163726,7163516,210,170,utRho25
yhiD,7312220,7312220,7311804,416,3922,utRho25
yhiJ,7265190,7265190,7265180,10,64,utRho25
yhiM,7269270,7269682,7269270,412,1588,utRho25
yhiN,7275000,7275000,7274820,180,120,utRho25
yhjA,7338522,7338522,7338376,146,74,utRho25
yhjB,7344090,7344090,7343788,302,246,utRho25
yhjC,7344272,7344684,7344272,412,174,utRho25
yhjD,7346660,7346724,7346660,64,42,utRho25
yhjE,7349274,7349572,7349274,298,404,utRho25
yhjG,7356824,7356824,7356730,94,20,utRho25
yhjH,7358458,7358458,7358374,84,90,utRho25
yhjJ,7364032,7364032,7363880,152,108,utRho25
yhjK,7371296,7371296,7371158,138,170,utRho25
yhjR,7392750,7392750,7392370,380,0,utRho25
yhjV,7400796,7401126,7400796,330,72,utRho25
yhjX,7424194,7424194,7424014,180,32,utRho25
yhjY,7425966,7425966,7425868,98,0,utRho25
yiaB,7455654,7455654,7455496,158,104,utRho25
yiaD,7432712,7433094,7432712,382,116,utRho25
yiaF,7438194,7438194,7438088,106,80,utRho25
yiaG,7438862,7438956,7438862,94,52,utRho25
yiaJ,7485236,7485236,7485064,172,72,utRho25
yiaK,7485348,7485466,7485348,118,88,utRho25
yiaT,7503924,7503924,7503736,188,0,utRho25
yiaU,7503792,7503984,7503792,192,0,utRho25
yiaY,7515856,7515856,7515654,202,122,utRho25
yibF,7523950,7523950,7523910,40,0,utRho25
yibG,7536128,7536354,7536128,226,676,utRho25
yibL,7553194,7553330,7553194,136,92,utRho25
yibN,7570112,7570112,7570030,82,280,utRho25
yibT,7552848,7552848,7552760,88,392,utRho25
yicC,7633290,7633352,7633290,62,0,utRho25
yicH,7660862,7660914,7660862,52,0,utRho25
yicJ,7673328,7673328,7671858,1470,5056,utRho25
yicN,7685018,7685018,7684804,214,28,utRho25
yicO,7687914,7687914,7687578,336,20,utRho25
yicR,15250308,15250308,15250236,72,0,utRho25
yidB,7755230,7755230,7754930,300,262,utRho25
yidE,7732780,7732780,7732546,234,0,utRho25
yidF,7711580,7711580,7711222,358,0,utRho25
yidQ,7735088,7735456,7735088,368,794,utRho25
yidR,7738824,7738824,7738618,206,144,utRho25
yieE,7787658,7787738,7787658,80,330,utRho25
yieH,7793314,7793548,7793314,234,0,utRho25
yieK,7798928,7798928,7798786,142,0,utRho25
yifB,7900350,7900350,7899998,352,198,utRho25
yifL,7988984,7989044,7988984,60,140,utRho25
yigF,8005750,8005750,8005598,152,1068,utRho25
yigI,8009448,8009448,8009394,54,114,utRho25
yigM,8022100,8022152,8022100,52,302,utRho25
yihA,8101970,8101970,8101458,512,0,utRho25
yihD,8084098,8084138,8084098,40,0,utRho25
yihF,8088110,8088398,8088110,288,132,utRho25
yihG,8093304,8093304,8093204,100,0,utRho25
yihI,8102616,8102694,8102616,78,0,utRho25
yihL,8120506,8120894,8120506,388,138,utRho25
yihN,8124332,8124494,8124332,162,330,utRho25
yihO,8131942,8131942,8131532,410,118,utRho25
yihQ,8138892,8138892,8138552,340,2,utRho25
yihV,8147064,8147478,8147064,414,52,utRho25
yihX,8151096,8151106,8151096,10,28,utRho25
yiiE,8158192,8158582,8158192,390,212,utRho25
yiiF,8159124,8159502,8159124,378,4,utRho25
yiiG,8173762,8174004,8173762,242,0,utRho25
yiiM,8205506,8205644,8205506,138,58,utRho25
yiiQ,8224624,8224624,8224428,196,0,utRho25
yiiS,8225738,8225934,8225738,196,0,utRho25
yijE,8272178,8272216,8272178,38,0,utRho25
yijF,8275728,8275728,8275314,414,610,utRho25
yijO,8296858,8296858,8296634,224,2,utRho25
yjaA,8426240,8426468,8426240,228,100260,utRho25
yjaB,8428312,8428312,8428246,66,0,utRho25
yjaG,8398746,8399008,8398746,262,220,utRho25
yjaH,8401022,8401132,8401022,110,338,utRho25
yjaZ,8379506,8379572,8379506,66,0,utRho25
yjbB,8455204,8455462,8455204,258,22,utRho25
yjbE,16943432,16943624,16943432,192,36,utRho25
yjbL,8520318,8520642,8520318,324,70,utRho25
yjbQ,8540428,8540476,8540428,48,78,utRho25
yjcB,8550328,8550328,8550082,246,538,utRho25
yjcC,8550836,8550942,8550836,106,58,utRho25
yjcD,8556628,8556958,8556628,330,48,utRho25
yjcE,8559658,8559960,8559658,302,76,utRho25
yjcF,8566212,8566212,8566150,62,0,utRho25
yjcO,8594660,8594660,8594250,410,44,utRho25
yjdA,8654128,8654270,8654128,142,0,utRho25
yjdC,8726660,8726660,8726616,44,36,utRho25
yjdK,8704780,8705168,8704780,388,1280,utRho25
yjdL,8713034,8713034,8712822,212,24,utRho25
yjdM,8653672,8653672,8653468,204,1340,utRho25
yjeF,8787354,8788132,8787354,778,754,utRho25
yjeI,8745522,8745618,8745522,96,130,utRho25
yjeJ,8748806,8748806,8748468,338,408,utRho25
yjeV,8785472,8785784,8785472,312,10,utRho25
yjfP,8833512,8833904,8833512,392,0,utRho25
yjfY,8849656,8849656,8849582,74,152,utRho25
yjfZ,8855052,8855052,8854844,208,70,utRho25
yjgA,8916162,8916162,8915730,432,2,utRho25
yjgL,8950802,8950874,8950802,72,28,utRho25
yjgM,8959342,8959342,8959074,268,0,utRho25
yjgN,8959132,8959460,8959132,328,66,utRho25
yjgR,8980170,8980170,8980126,44,48,utRho25
yjgZ,9002116,9002520,9002116,404,656,utRho25
yjhB,9007764,9008116,9007764,352,66,utRho25
yjhG,9048452,9048452,9048188,264,528,utRho25
yjhU,9041080,9041080,9040648,432,604,utRho25
yjiA,9178096,9178096,9177730,366,22,utRho25
yjiJ,9125364,9125364,9125350,14,128,utRho25
yjiK,9127270,9127270,9127422,152,84,utRho25
yjiL,9129604,9129604,9129378,226,60,utRho25
yjiS,9143410,9143502,9143410,92,0,utRho25
yjiY,9182734,9182734,9182558,176,70,utRho25
yjjA,9200674,9200674,9200378,296,98,utRho25
yjjB,18408708,18408708,18407800,908,600,utRho25
yjjJ,9243314,9243538,9243314,224,0,utRho25
yjjK,9261132,9261132,9261044,88,0,utRho25
yjjL,9189764,9189764,9189444,320,0,utRho25
yjjM,9191894,9191894,9191702,192,200,utRho25
yjjP,9206068,9206068,9205716,352,110,utRho25
yjjQ,9206638,9206954,9206638,316,266,utRho25
yjjX,9267798,9267798,9267490,308,64,utRho25
yjjY,9280716,9280804,9280716,88,188,utRho25
yjjZ,9211554,9211608,9211554,54,46,utRho25
yjtD,9281676,9281884,9281676,208,612,utRho25
ykfB,532454,532454,532174,280,54,utRho25
ykfI,527636,527636,527338,298,638,utRho25
ykgB,637050,637050,636638,412,60,utRho25
ykgC,640430,640430,640002,428,0,utRho25
ykgD,640232,640454,640232,222,0,utRho25
ykgE,642962,643216,642962,254,382,utRho25
ykgJ,608524,608524,608364,160,124,utRho25
ykgL,623878,624224,623878,346,94,utRho25
ykgM,625610,625610,625554,56,2,utRho25
ykgR,626570,626570,626484,86,0,utRho25
ylaC,958576,958576,958502,74,462,utRho25
yliE,1745938,1745958,1745938,20,0,utRho25
ymcE,2103660,2103694,2103660,34,0,utRho25
ymdA,2210450,2210828,2210450,378,98,utRho25
ymdB,2211428,2211640,2211428,212,0,utRho25
ymfD,2395322,2395322,2395064,258,128,utRho25
ymfI,2402880,2402994,2402880,114,0,utRho25
ymfJ,2404518,2404518,2404168,350,2,utRho25
ymfK,2406176,2406176,2405866,310,0,utRho25
ymfT,2405766,2406048,2405766,282,0,utRho25
ymgE,2489110,2489456,2489110,346,142,utRho25
ymgF,2437628,2437966,2437628,338,292,utRho25
ymiA,2670112,2670320,2670112,208,64,utRho25
ymjA,2715620,2715620,2715336,284,0,utRho25
ynaI,2791946,2791946,2791844,102,86,utRho25
ynaK,2850438,2850754,2850438,316,50,utRho25
ynbA,2954924,2955242,2954924,318,128,utRho25
yncD,3046552,3046552,3046130,422,0,utRho25
yncE,3046454,3046614,3046454,160,0,utRho25
yncG,3052456,3052494,3052456,38,4,utRho25
yncL,3034492,3034492,3034388,104,110,utRho25
yneE,3218364,3218364,3218044,320,0,utRho25
yneF,3223748,3223748,3223708,40,22,utRho25
yneJ,3229560,3229608,3229560,48,56,utRho25
yneK,3231100,3231526,3231100,426,16,utRho25
yneM,3245176,3245292,3245176,116,106,utRho25
ynfA,3311398,3311398,3311346,52,0,utRho25
ynfB,3311418,3311616,3311418,198,60,utRho25
ynfC,3315094,3315094,3314914,180,0,utRho25
ynfD,3314828,3315130,3314828,302,0,utRho25
ynfE,3316006,3316138,3316006,132,0,utRho25
ynfK,3334670,3334670,3334438,232,44,utRho25
ynfL,3339304,3339304,3339184,120,24,utRho25
ynfM,3339260,3339398,3339260,138,24,utRho25
ynfN,3276598,3276598,3276218,380,60,utRho25
ynfO,3273454,3273512,3273454,58,0,utRho25
ynhG,3517890,3517890,3517450,440,112,utRho25
yniA,3615158,3615592,3615158,434,8,utRho25
yniB,3618526,3618526,3618466,60,6,utRho25
yniC,3618652,3618760,3618652,108,0,utRho25
yniD,3610202,3610330,3610202,128,24,utRho25
ynjE,3678880,3678934,3678880,54,0,utRho25
ynjF,3683222,3683222,3682806,416,16,utRho25
ynjH,3684376,3684376,3684270,106,74,utRho25
ynjI,3690022,3690022,3689742,280,168,utRho25
yoaB,3786642,3786734,3786642,92,0,utRho25
yoaC,3787932,3788146,3787932,214,56,utRho25
yoaE,3803544,3803544,3803170,374,16,utRho25
yoaF,3755444,3755444,3755064,380,16,utRho25
yoaH,3789866,3789866,3789462,404,216,utRho25
yobB,3850418,3850880,3850418,462,2,utRho25
yobF,3815586,3815586,3815182,404,372,utRho25
yobH,3817800,3817850,3817800,50,102,utRho25
yodB,4084352,4084736,4084352,384,44,utRho25
yodC,4057008,4057008,4056740,268,22,utRho25
yohC,4451358,4451358,4451262,96,44,utRho25
yohD,4451526,4451602,4451526,76,78,utRho25
yohJ,4460986,4461248,4460986,262,432,utRho25
yohO,4431172,4431314,4431172,142,52,utRho25
yojI,4617282,4617282,4617230,52,56,utRho25
ypdI,4988988,4989396,4988988,408,146,utRho25
ypfG,5165786,5165786,5165554,232,18,utRho25
ypfM,5182140,5182140,5181732,408,414,utRho25
yphB,5349590,5349590,5349376,214,2,utRho25
ypjA,5565644,5565644,5565452,192,670,utRho25
ypjB,5569636,5569636,5568858,778,40,utRho25
ypjD,5495860,5495774,5495860,86,32,utRho25
yqaE,5594170,5594170,5594056,114,240,utRho25
yqcA,5846100,5846100,5845968,132,0,utRho25
yqcE,5800944,5801184,5800944,240,0,utRho25
yqeC,6030468,6030468,6030114,354,82,utRho25
yqeF,5971618,5971618,5971184,434,492,utRho25
yqeG,5971438,5971694,5971438,256,742,utRho25
yqeH,5975016,5975072,5975016,56,258,utRho25
yqeI,5976688,5977004,5976688,316,94,utRho25
yqeK,5981140,5981140,5980720,420,368,utRho25
yqfA,6086728,6086728,6086296,432,112,utRho25
yqgA,6219042,6219106,6219042,64,20,utRho25
yqgB,6172500,6172500,6172102,398,572,utRho25
yqgE,6185768,6185874,6185768,106,0,utRho25
yqhA,6299150,6299150,6298942,208,46,utRho25
yqhC,6310768,6310768,6310436,332,100,utRho25
yqhD,6310604,6310710,6310604,106,44,utRho25
yqhH,6316842,6317254,6316842,412,44,utRho25
yqiC,6369662,6369680,6369662,18,8,utRho25
yqiJ,6384108,6384416,6384108,308,256,utRho25
yqjA,6495096,6495546,6495096,450,50,utRho25
yqjF,6500932,6501124,6500932,192,664,utRho25
yqjG,6501948,6502048,6501948,100,0,utRho25
yqjH,6433078,6433078,6432982,96,0,utRho25
yqjI,6433506,6433558,6433506,52,0,utRho25
yraH,6574552,6574852,6574552,300,18,utRho25
yraP,6592144,6592818,6592144,674,62,utRho25
yraQ,6596414,6596414,6596276,138,0,utRho25
yraR,6598024,6598024,6597692,332,48,utRho25
yrbG,13360844,13361100,13360844,256,128,utRho25
yrbL,6696842,6696904,6696842,62,140,utRho25
yrbN,6616172,6616172,6615866,306,194,utRho25
yrdB,6860176,6860176,6860046,130,292,utRho25
yrfF,7052548,7052938,7052548,390,28,utRho25
yrhB,7169440,7169518,7169440,78,0,utRho25
ysaB,7451804,7451804,7451424,380,18,utRho25
ysgA,8032686,8032686,8032338,348,492,utRho25
ytfB,8857638,8857638,8857434,204,160,utRho25
ytfE,8864018,8864018,8863966,52,68,utRho25
ytfF,8866296,8866296,8866130,166,714,utRho25
ytfH,8868164,8868226,8868164,62,62,utRho25
ytfI,8875234,8875414,8875234,180,80,utRho25
ytfJ,8878572,8878572,8878524,48,8,utRho25
ytfK,8879022,8879174,8879022,152,362,utRho25
ytfL,8882642,8882642,8882430,212,0,utRho25
ytfQ,8899634,8899924,8899634,290,144,utRho25
ytjB,9249598,9249598,9249578,20,0,utRho25
yzfA,8896588,8896588,8896490,98,0,utRho25
zapA,6111102,6111224,6111102,122,544,utRho25
zapB,8236772,8237030,8236772,258,94,utRho25
zapC,2011700,2011904,2011700,204,20,utRho25
zinT,4082692,4082750,4082692,58,2,utRho25
zipA,5062814,5062814,5062466,348,0,utRho25
zitB,1569716,1569716,1569646,70,58,utRho25
zntA,7212844,7212902,7212844,58,0,utRho25
zntR,6878336,6878336,6878260,76,62,utRho25
znuA,3885322,3885322,3885166,156,2,utRho25
znuC,3885268,3885324,3885268,56,2,utRho25
zraP,8403424,8403424,8403376,48,0,utRho25
zraS,8403810,8403852,8403810,42,180,utRho25
zupT,6364866,6365100,6364866,234,46,utRho25
zur,8520282,8520282,8520006,276,28,utRho25
zwf,3872752,3872752,3872628,124,0,utRho25
C0343,2818676,2818728,2818676,52,0,utRho26
aaeB,6776526,6776526,6776376,150,0,utRho26
aaeR,6778762,6779040,6778762,278,60,utRho26
aaeX,6778860,6778860,6778674,186,118,utRho26
aat,1854920,1854920,1854864,56,0,utRho26
accA,416822,417242,416822,420,112,utRho26
accB,6810280,6810872,6810280,592,912,utRho26
accD,4868030,4868030,4867852,178,194,utRho26
aceB,8430804,8430956,8430804,152,2,utRho26
aceE,245938,246034,245938,96,106,utRho26
ackA,4826918,4826940,4826918,22,312,utRho26
acnA,2670848,2671662,2670848,814,202,utRho26
acnB,263038,263230,263038,192,368,utRho26
acpP,2303148,2303230,2303148,82,48,utRho26
acpS,5402324,5402324,5401996,328,526,utRho26
acrA,971396,971396,971238,158,10,utRho26
acrB,969370,969370,968806,564,130,utRho26
acrD,5174950,5175190,5174950,240,0,utRho26
acrE,6827404,6827728,6827404,324,64,utRho26
acrR,971398,971522,971398,124,4,utRho26
acrZ,1589502,1589546,1589502,44,0,utRho26
acs,8575190,8575190,8574742,448,292,utRho26
actP,8569870,8569870,8569804,66,148,utRho26
ada,4620854,4620854,4620810,44,0,utRho26
add,3404404,3404466,3404404,62,0,utRho26
ade,7687802,7687928,7687802,126,0,utRho26
adhE,2596826,2596826,2596242,584,0,utRho26
adhP,3107988,3107988,3107676,312,476,utRho26
adiA,8681112,8681112,8681042,70,42,utRho26
adiC,8674404,8674404,8674062,342,2,utRho26
adiY,8676084,8676084,8675858,226,32,utRho26
adk,994278,994350,994278,72,306,utRho26
adrA,807374,807406,807374,32,0,utRho26
aer,6438240,6438240,6438152,88,0,utRho26
aes,1000102,1000102,999946,156,2,utRho26
agaR,6557406,6557406,6557330,76,0,utRho26
agaS,6563778,6563952,6563778,174,62,utRho26
agp,2131118,2131170,2131118,52,0,utRho26
agrA,7296126,7296126,7296126,0,0,utRho26
agrB,7296588,7296588,7296588,0,0,utRho26
ahpC,1277386,1277890,1277386,504,780,utRho26
ahpF,1278004,1279506,1278004,1502,25458,utRho26
ahr,8992698,8992698,8992418,280,112,utRho26
aidB,8828494,8828550,8828494,56,0,utRho26
ais,4731512,4731512,4731240,272,126,utRho26
alaA,4814816,4815122,4814816,306,38,utRho26
alaC,4996798,4996798,4996590,208,0,utRho26
alaE,5598140,5598328,5598140,188,40,utRho26
alaS,5644180,5644180,5644022,158,540,utRho26
alaW,5036612,5036612,5036462,150,18,utRho26
aldA,2976380,2976464,2976380,84,270,utRho26
aldB,7513070,7513070,7513022,48,24,utRho26
alkA,4295118,4295118,4295080,38,0,utRho26
alkB,4618890,4618890,4618682,208,148,utRho26
allA,1064780,1064902,1064780,122,0,utRho26
allD,1092822,1092822,1092726,96,0,utRho26
allE,1088112,1088112,1088092,20,0,utRho26
allS,1064600,1064600,1064442,158,0,utRho26
alr,8531178,8531564,8531178,386,118,utRho26
alsE,8617334,8617334,8616956,378,298,utRho26
alsK,8615990,8615990,8615598,392,216,utRho26
alx,6476740,6477160,6476740,420,56,utRho26
amiA,5104482,5104704,5104482,222,0,utRho26
amiC,5898378,5898378,5898020,358,0,utRho26
amn,4110062,4110122,4110062,60,0,utRho26
ampC,8758006,8758006,8757888,118,0,utRho26
ampD,237362,237466,237362,104,0,utRho26
ampG,907372,907372,907090,282,180,utRho26
ampH,792726,792726,792574,152,0,utRho26
amyA,4012230,4012312,4012230,82,0,utRho26
anmK,3439346,3439346,3439204,142,36,utRho26
ansB,6201580,6201580,6201456,124,58,utRho26
ansP,3052040,3052040,3051960,80,0,utRho26
apaG,104068,104068,103212,856,350,utRho26
apaH,102586,102586,102444,142,136,utRho26
apbE,4623188,4623188,4623068,120,0,utRho26
appA,2081198,2081234,2081198,36,0,utRho26
appC,2075420,2075480,2075420,60,0,utRho26
appY,1167134,1167362,1167134,228,0,utRho26
apt,982620,982824,982620,204,0,utRho26
aqpZ,1832424,1832424,1832094,330,0,utRho26
araB,140150,140150,140096,54,0,utRho26
araC,140482,140774,140482,292,184,utRho26
araE,5964416,5964416,5964364,52,12,utRho26
araF,3972476,3972476,3972256,220,0,utRho26
araH,3967120,3967120,3967086,34,0,utRho26
araJ,825058,825058,824962,96,50,utRho26
arcA,9281602,9281602,9280612,990,1608,utRho26
arcB,6706098,6706098,6706050,48,86,utRho26
arcZ,6701154,6701154,6701154,0,0,utRho26
arfA,6877346,6877346,6877298,48,12,utRho26
argA,5898312,5898484,5898312,172,0,utRho26
argC,8309770,8310002,8309770,232,102,utRho26
argD,6980442,6980442,6980360,82,0,utRho26
argE,8310156,8310156,8309694,462,388,utRho26
argF,580680,580680,580610,70,0,utRho26
argG,6637124,6637274,6637124,150,222,utRho26
argI,8956688,8956688,8956622,66,34,utRho26
argO,6137672,6137672,6137616,56,286,utRho26
argP,6119460,6119506,6119460,46,0,utRho26
argR,6769204,6769406,6769204,202,0,utRho26
argS,3920002,3920124,3920002,122,0,utRho26
argT,4855698,4855698,4855582,116,0,utRho26
argU,1129406,1129446,1129406,40,36,utRho26
argW,4932616,4932618,4932616,2,0,utRho26
argX,7964728,7964750,7964728,22,28,utRho26
aroF,5482402,5482402,5482300,102,82,utRho26
aroG,1571182,1571266,1571182,84,94,utRho26
aroH,3576636,3576870,3576636,234,0,utRho26
aroK,7038760,7038760,7038128,632,352,utRho26
aroL,812560,812810,812560,250,114,utRho26
aroP,243342,243342,243102,240,0,utRho26
arpA,8445382,8445382,8444974,408,0,utRho26
arrS,7316108,7316108,7316108,0,0,utRho26
arsR,7297024,7297056,7297024,32,0,utRho26
artJ,1801252,1801252,1801150,102,0,utRho26
artP,1807686,1807686,1807468,218,4,utRho26
ascF,5678858,5679048,5678858,190,0,utRho26
ascG,5678574,5678574,5678528,46,0,utRho26
aslB,7965562,7965916,7965562,354,122,utRho26
asnA,7854258,7854310,7854258,52,182,utRho26
asnB,1398444,1398444,1398354,90,86,utRho26
asnC,23562186,23562186,23562018,168,0,utRho26
asnS,1978088,1978088,1977970,118,1678,utRho26
asnT,4089082,4089098,4089082,16,12,utRho26
asnU,4119690,4119702,4119690,12,16,utRho26
asnV,4124504,4124520,4124504,16,4,utRho26
aspA,17473728,17473728,17473308,420,180,utRho26
aspC,1971486,1971486,1971418,68,14,utRho26
aspS,3901402,3901402,3901044,358,312,utRho26
aspT,7893560,7893744,7893560,184,120632,utRho26
aspV,473826,473862,473826,36,188,utRho26
asr,3342654,3342752,3342654,98,0,utRho26
astC,3664088,3664088,3663964,124,16,utRho26
astE,3654138,3654138,3653846,292,80,utRho26
atoD,4646824,4646894,4646824,70,0,utRho26
atpB,7844540,7844540,7844102,438,530,utRho26
atpC,7832118,7832118,7831944,174,736,utRho26
atpI,7845050,7845050,7844880,170,870,utRho26
avtA,7479348,7479410,7479348,62,718,utRho26
azoR,2965982,2965982,2965720,262,0,utRho26
azuC,3976002,3976002,3975918,84,176,utRho26
bacA,6408350,6408350,6408262,88,776,utRho26
bamA,394052,395856,394052,1804,566,utRho26
bamB,5277950,5277950,5277304,646,392,utRho26
bamC,5198028,5198028,5197730,298,848,utRho26
bamD,5471922,5472292,5471922,370,444,utRho26
bamE,5506972,5507210,5506972,238,962,utRho26
basS,8666954,8666954,8666544,410,76,utRho26
bax,7474468,7474468,7474354,114,132,utRho26
bcp,5200874,5200956,5200874,82,234,utRho26
bcsB,7385346,7385346,7385214,132,0,utRho26
bcsE,7392644,7392916,7392644,272,2,utRho26
bdcA,8948128,8948128,8948106,22,150,utRho26
bdcR,8948192,8948248,8948192,56,88,utRho26
bdm,3112680,3112680,3112560,120,0,utRho26
betA,654522,654522,654494,28,2,utRho26
betI,658722,658722,658668,54,0,utRho26
betT,658842,658926,658842,84,48,utRho26
bfr,6933498,6933498,6933450,48,66,utRho26
bglG,23440182,23440182,23439402,780,144,utRho26
bglX,4444240,4444240,4443978,262,0,utRho26
bhsA,2337962,2338146,2337962,184,56,utRho26
bioA,1618584,1618584,1618514,70,0,utRho26
bioB,1618604,1618688,1618604,84,0,utRho26
bioH,7089716,7089716,7089688,28,92,utRho26
bisC,7433026,7433026,7432788,238,216,utRho26
blc,8755490,8755490,8755444,46,0,utRho26
blr,3409024,3409102,3409024,78,54,utRho26
bluF,2431226,2431226,2430950,276,176,utRho26
bluR,2428226,2428226,2428118,108,4,utRho26
bolA,908698,908944,908698,246,2,utRho26
borD,1157842,1157842,1157786,56,92,utRho26
brnQ,838976,839182,838976,206,534,utRho26
bssR,1756492,1756496,1756492,4,0,utRho26
bssS,2242116,2242116,2241910,206,548,utRho26
btuB,8326798,8327278,8326798,480,414,utRho26
cadB,8720212,8720212,8720062,150,136,utRho26
cadC,8723926,8723926,8723868,58,0,utRho26
caiE,70998,70998,70742,256,6,utRho26
caiF,68436,68600,68436,164,270,utRho26
caiT,84074,84074,83862,212,2,utRho26
can,285406,285406,285340,66,108,utRho26
carA,59102,59302,59102,200,0,utRho26
carB,61550,61634,61550,84,110,utRho26
cas2,5757830,5757830,5757706,124,0,utRho26
casA,5768638,5768638,5768276,362,0,utRho26
cbl,4121882,4121882,4121828,54,2,utRho26
cbpA,2128074,2128074,2127550,524,68,utRho26
cbrA,7738628,7738754,7738628,126,0,utRho26
cbrB,7794958,7795012,7794958,54,0,utRho26
ccmH,4585242,4585242,4584820,422,0,utRho26
cdaR,364894,364926,364894,32,124,utRho26
cdd,4463638,4463688,4463638,50,0,utRho26
cdh,8219814,8219860,8219814,46,78,utRho26
cdsA,391110,391354,391110,244,170,utRho26
cedA,3627484,3627484,3627326,158,0,utRho26
cfa,3482402,3482826,3482402,424,0,utRho26
chaC,2544844,2544972,2544844,128,0,utRho26
chbB,3643452,3643452,3643238,214,0,utRho26
chbG,3634624,3634624,3634270,354,0,utRho26
cheW,3946924,3946924,3946678,246,326,utRho26
chiA,6939792,6939792,6939706,86,14,utRho26
chiP,1416472,1416668,1416472,196,0,utRho26
cho,3646984,3647030,3646984,46,0,utRho26
chpS,8896804,8896894,8896804,90,52,utRho26
cirA,4493884,4493884,4493538,346,112,utRho26
citC,1304078,1304078,1303712,366,508,utRho26
citT,1293264,1293264,1293160,104,0,utRho26
clcA,350104,350214,350104,110,0,utRho26
clpA,1846160,1846528,1846160,368,16,utRho26
clpB,5468410,5468410,5468346,64,292,utRho26
clpP,913154,913354,913154,200,910,utRho26
clpS,1845500,1845826,1845500,326,656,utRho26
clpX,914404,914852,914404,448,1236,utRho26
clsA,2617346,2617346,2617290,56,0,utRho26
clsC,2212584,2212710,2212584,126,104,utRho26
cmk,1922330,1922402,1922330,72,112,utRho26
cnu,3409522,3409898,3409522,376,864,utRho26
coaA,8350214,8350214,8350052,162,0,utRho26
cobC,1340092,1340092,1339814,278,172,utRho26
cobT,4129202,4129202,4128934,268,0,utRho26
cobU,4131944,4131944,4131528,416,62,utRho26
codB,709768,709844,709768,76,90,utRho26
comR,2337726,2337726,2337664,62,0,utRho26
copA,1022822,1022822,1022758,64,0,utRho26
corA,8002388,8002852,8002388,464,32066,utRho26
cpdB,8873258,8873258,8873130,128,0,utRho26
cptB,6082198,6082198,6082140,58,0,utRho26
cpxA,8210202,8210202,8209950,252,4,utRho26
cpxP,8211570,8211640,8211570,70,200,utRho26
cpxR,8211372,8211372,8211340,32,0,utRho26
cra,175894,176056,175894,162,0,utRho26
crcB,1316016,1316016,1315876,140,0,utRho26
creA,9270486,9271042,9270486,556,0,utRho26
creD,9276320,9276356,9276320,36,0,utRho26
crl,515620,515658,515620,38,202,utRho26
crp,6971906,6972240,6971906,334,14,utRho26
crr,5070960,5071668,5070960,708,1158,utRho26
csdA,5886414,5886674,5886414,260,0,utRho26
csgB,2207718,2207902,2207718,184,0,utRho26
csgD,2206688,2206688,2206392,296,76,utRho26
csgG,2203510,2203510,2203368,142,122,utRho26
csiD,5577854,5577970,5577854,116,0,utRho26
csiE,5330802,5330870,5330802,68,0,utRho26
csiR,5590942,5591348,5590942,406,54,utRho26
cspA,7439778,7440098,7439778,320,872,utRho26
cspB,3283430,3283430,3283108,322,0,utRho26
cspC,3815018,3815018,3814870,148,30,utRho26
cspD,1845352,1845352,1845180,172,5016,utRho26
cspE,1314294,1314584,1314294,290,382,utRho26
cspF,3283380,3283710,3283380,330,76,utRho26
cspG,2102610,2102922,2102610,312,184,utRho26
cspH,2102746,2102746,2102350,396,2,utRho26
cspI,3277624,3277624,3277334,290,56,utRho26
csrA,5638746,5638746,5638292,454,470,utRho26
csrB,5849048,5849048,5849048,0,0,utRho26
csrC,8102072,8102072,8102072,0,0,utRho26
csrD,6806850,6806850,6806664,186,212,utRho26
cstA,1259710,1259788,1259710,78,0,utRho26
cueO,274090,274166,274090,76,0,utRho26
cueR,1027948,1027986,1027948,38,0,utRho26
curA,3037784,3038054,3037784,270,84,utRho26
cusC,1191146,1191200,1191146,54,0,utRho26
cusR,1190924,1190924,1190886,38,0,utRho26
cutA,8730784,8730784,8730712,72,0,utRho26
cutC,3918534,3918534,3917920,614,0,utRho26
cvpA,4861600,4861600,4861526,74,0,utRho26
cvrA,2484328,2484328,2484142,186,0,utRho26
cyaA,7981548,7982306,7981548,758,156,utRho26
cyaR,4334228,4334224,4334228,4,18,utRho26
cyaY,7988166,7988166,7988118,48,130,utRho26
cybB,2981522,2981804,2981522,282,0,utRho26
cycA,8859560,8859728,8859560,168,2,utRho26
cydA,1542340,1542916,1542340,576,2310,utRho26
cydC,1858800,1858800,1858390,410,0,utRho26
cydD,1862062,1862062,1861924,138,0,utRho26
cydX,1548300,1548392,1548300,92,348,utRho26
cynR,717418,717418,717380,38,0,utRho26
cynT,1435092,1435196,1435092,104,0,utRho26
cyoA,903306,903306,903220,86,70,utRho26
cyoE,895540,895540,895410,130,140,utRho26
cysB,2667576,2667710,2667576,134,334,utRho26
cysC,5748056,5748056,5747984,72,0,utRho26
cysD,5752736,5752736,5752658,78,4,utRho26
cysE,7565362,7565362,7565124,238,622,utRho26
cysG,6995508,6995656,6995508,148,652,utRho26
cysJ,5783928,5783928,5783796,132,676,utRho26
cysK,5064688,5064818,5064688,130,0,utRho26
cysP,5087114,5087114,5087056,58,2,utRho26
cysS,1109154,1109222,1109154,68,0,utRho26
cysT,3984100,3984100,3983974,126,122,utRho26
cysZ,5062766,5062926,5062766,160,322,utRho26
cytR,8249018,8249018,8248912,106,84,utRho26
dacA,1328002,1328002,1327926,76,0,utRho26
dacB,6657714,6657926,6657714,212,0,utRho26
dacC,1761306,1761454,1761306,148,192,utRho26
dadA,2475018,2475142,2475018,124,0,utRho26
dam,7032504,7032504,7031826,678,352,utRho26
damX,7035200,7035200,7034612,588,1218,utRho26
dapA,5199568,5199568,5199520,48,0,utRho26
dapB,56576,56748,56576,172,82,utRho26
dapD,371954,371954,371894,60,0,utRho26
dapE,5183120,5183214,5183120,94,202,utRho26
dcp,3254844,3254844,3254760,84,58,utRho26
dcrB,7219534,7219910,7219534,376,94,utRho26
dctA,7366996,7366996,7366894,102,126,utRho26
dcuA,8733686,8733686,8733546,140,140,utRho26
dcuB,8698182,8698182,8697488,694,592,utRho26
dcuC,1312166,1312166,1311936,230,930,utRho26
dcuD,6749166,6749738,6749166,572,158,utRho26
dcuR,8701130,8701130,8700068,1062,178,utRho26
dcuS,8703370,8703370,8703324,46,56,utRho26
dcyD,3999016,3999016,3998960,56,0,utRho26
ddpX,3126498,3126498,3126152,346,2,utRho26
deaD,6615818,6615818,6615720,98,124,utRho26
dedA,4869880,4869880,4869482,398,620,utRho26
dedD,4863750,4863750,4863368,382,0,utRho26
def,6867300,6867380,6867300,80,0,utRho26
degP,361690,361768,361690,78,0,utRho26
degQ,6761308,6761486,6761308,178,164,utRho26
deoB,9239134,9239206,9239134,72,94,utRho26
deoC,9233358,9234646,9233358,1288,352,utRho26
dfp,7625406,7625462,7625406,56,0,utRho26
dgcZ,3247758,3247758,3247700,58,0,utRho26
dgkA,8512914,8513274,8512914,360,528,utRho26
dgt,358392,358474,358392,82,66,utRho26
dhaK,2501888,2501888,2501676,212,270,utRho26
dhaR,2502006,2502132,2502006,126,258,utRho26
dicB,3299194,3299218,3299194,24,0,utRho26
dicC,3295752,3295752,3295700,52,0,utRho26
dinB,501760,501796,501760,36,0,utRho26
dinD,7635398,7635520,7635398,122,0,utRho26
dinG,1666146,1666140,1666146,6,0,utRho26
dinI,2243018,2243018,2242974,44,114,utRho26
dinJ,493230,493230,493004,226,0,utRho26
dinQ,7295964,7295964,7295576,388,144,utRho26
djlA,114536,114728,114536,192,0,utRho26
dkgA,6313142,6313246,6313142,104,0,utRho26
dkgB,458196,458334,458196,138,0,utRho26
dksA,321502,321502,321208,294,750,utRho26
dld,4444164,4444370,4444164,206,50,utRho26
dmlA,3763424,3763824,3763424,400,364,utRho26
dmlR,3763710,3763710,3763618,92,180,utRho26
dmsA,1881646,1881918,1881646,272,0,utRho26
dnaA,7767922,7767922,7767458,464,264,utRho26
dnaB,8528566,8528628,8528566,62,22,utRho26
dnaK,24096,24326,24096,230,6722,utRho26
dnaN,7765466,7765466,7764642,824,16,utRho26
dnaQ,471868,472134,471868,266,1588,utRho26
dnaT,18406460,18406460,18406068,392,12,utRho26
dnaX,984112,984184,984112,72,54,utRho26
dosP,3131486,3131486,3131466,20,0,utRho26
dpiB,1303968,1304470,1303968,502,110,utRho26
dppA,7415740,7415740,7415410,330,574,utRho26
dps,1697900,1697900,1697822,78,0,utRho26
dsbA,8086754,8086836,8086754,82,212,utRho26
dsbB,2466294,2466294,2466060,234,2,utRho26
dsbC,6079266,6079266,6077644,1622,532,utRho26
dsbG,1277600,1277600,1277146,454,256,utRho26
dsdA,4958242,4958404,4958242,162,132,utRho26
dsdC,4955492,4955492,4955258,234,38,utRho26
dsdX,4955642,4955694,4955642,52,196,utRho26
dsrA,4050626,4050626,4050626,0,0,utRho26
dsrB,4049686,4049686,4049646,40,2,utRho26
dtpD,1485340,1485340,1485112,228,0,utRho26
dusA,8523200,8523338,8523200,138,1542,utRho26
dusB,6820492,6820560,6820492,68,0,utRho26
dusC,4460790,4460790,4460770,20,0,utRho26
dut,7627704,7627864,7627704,160,766,utRho26
dxr,386670,387042,386670,372,284,utRho26
ebgA,6445102,6445266,6445102,164,0,utRho26
ebgR,6442874,6442932,6442874,58,0,utRho26
ecnB,8753018,8753106,8753018,88,0,utRho26
eco,4607594,4607810,4607594,216,144,utRho26
ecpA,621594,621594,621342,252,0,utRho26
ecpB,620238,620238,620052,186,0,utRho26
ecpR,622964,622964,622672,292,2,utRho26
eda,3866218,3866218,3865512,706,60,utRho26
edd,3869426,3869426,3869208,218,0,utRho26
efeO,2164308,2164486,2164308,178,0,utRho26
efeU_1,2162614,2162712,2162614,98,220,utRho26
efp,8751134,8751398,8751134,264,438,utRho26
elaA,4763372,4763372,4763086,286,0,utRho26
elaD,4765308,4765426,4765308,118,40,utRho26
elfA,1995530,1995736,1995530,206,0,utRho26
elfD,1996642,1996980,1996642,338,0,utRho26
emrD,7707690,7707844,7707690,154,20,utRho26
emrK,4966896,4966896,4966678,218,120,utRho26
emrY,4964668,4964668,4964352,316,188,utRho26
emtA,2486250,2486360,2486250,110,0,utRho26
endA,12361100,12361388,12361100,288,0,utRho26
eno,5817692,5817692,5815882,1810,826,utRho26
entC,1249662,1249770,1249662,108,0,utRho26
entD,1220508,1220508,1220158,350,12,utRho26
entH,1258584,1258600,1258584,16,0,utRho26
entS,1244506,1244600,1244506,94,0,utRho26
envR,6827266,6827266,6826930,336,0,utRho26
epd,12295292,12295292,12294764,528,64,utRho26
epmA,8765236,8765286,8765236,50,0,utRho26
epmB,8751406,8751406,8751314,92,350,utRho26
eptB,7421162,7421162,7420950,212,36,utRho26
eptC,8300622,8300622,8300530,92,126,utRho26
erfK,4126708,4126708,4126646,62,16,utRho26
erpA,353122,353220,353122,98,74,utRho26
esrE,8039956,8039956,8039956,0,0,utRho26
essD,1153746,1154796,1153746,1050,0,utRho26
etk,2088606,2088606,2088420,186,106,utRho26
evgA,4967262,4967510,4967262,248,0,utRho26
exbB,6304028,6304028,6303968,60,0,utRho26
exbD,6302780,6302780,6302486,294,0,utRho26
exuR,6493016,6493304,6493016,288,0,utRho26
exuT,6490004,6490208,6490004,204,4,utRho26
fabA,2032996,2032996,2032940,56,2,utRho26
fabB,4883282,4883282,4883210,72,0,utRho26
fabH,2297032,2297518,2297032,486,238,utRho26
fabI,2702236,2702236,2702078,158,0,utRho26
fadB,8062026,8062026,8061942,84,0,utRho26
fadD,3779614,3779614,3779492,122,170,utRho26
fadE,486812,486812,486606,206,0,utRho26
fadH,6463248,6463330,6463248,82,0,utRho26
fadI,4921022,4921022,4920938,84,0,utRho26
fadL,4922410,4922600,4922410,190,142,utRho26
fadM,928720,928804,928720,84,0,utRho26
fadR,2469810,2469876,2469810,66,0,utRho26
fbaB,4357334,4357334,4357128,206,0,utRho26
fdhE,8162722,8162722,8162456,266,302,utRho26
fdhF,8598814,8598814,8598732,82,0,utRho26
fdnG,3094744,3094802,3094744,58,0,utRho26
fdrA,1093012,1093360,1093012,348,0,utRho26
feaB,2894994,2895038,2894994,44,0,utRho26
feaR,2894734,2894734,2894566,168,0,utRho26
fecA,9033454,9033454,9033354,100,36,utRho26
fecE,9023288,9023288,9022914,374,1064,utRho26
fecI,9036564,9036564,9036470,94,0,utRho26
feoA,7080114,7080326,7080114,212,158,utRho26
fepA,1225334,1225334,1224988,346,0,utRho26
fepB,1249454,1249454,1249020,434,0,utRho26
fepD,1244468,1244468,1244378,90,0,utRho26
fes,1225374,1225630,1225374,256,0,utRho26
ffh,5495706,5495706,5495590,116,418,utRho26
ffs,952576,952848,952576,272,176,utRho26
fhuA,334884,334968,334884,84,0,utRho26
fhuE,2323294,2323294,2323102,192,116,utRho26
fhuF,9211504,9211504,9211326,178,116,utRho26
fic,6983296,6983296,6982926,370,4,utRho26
fieF,8212864,8212938,8212864,74,108,utRho26
fimA,9085388,9086230,9085388,842,374,utRho26
fimB,9081334,9081914,9081334,580,730,utRho26
fimE,9083742,9084074,9083742,332,152,utRho26
fimZ,1129214,1129214,1128960,254,0,utRho26
fiu,1683296,1683296,1683062,234,0,utRho26
fixA,84650,84806,84650,156,16,utRho26
fkpA,6955050,6955050,6954838,212,8144,utRho26
fldA,2846084,2846084,2845860,224,1180,utRho26
fldB,6079644,6079710,6079644,66,0,utRho26
flgA,2261770,2261770,2261726,44,104,utRho26
flgB,2261986,2262036,2261986,50,102,utRho26
flgK,2276702,2276756,2276702,54,4,utRho26
flgM,2260330,2260330,2260256,74,2,utRho26
flgN,2259828,2259828,2259660,168,0,utRho26
flhB,3932432,3932432,3932382,50,154,utRho26
flhC,3955864,3955864,3955688,176,0,utRho26
flhD,3957154,3957154,3956394,760,610,utRho26
fliA,4003638,4003638,4003578,60,0,utRho26
fliC,4007352,4007352,4007212,140,80,utRho26
fliD,4007634,4007744,4007634,110,0,utRho26
fliE,4026186,4026186,4026028,158,4,utRho26
fliF,4026292,4026458,4026292,166,112,utRho26
fliL,4039168,4039236,4039168,68,16,utRho26
flk,4875824,4875900,4875824,76,0,utRho26
flu,4142634,4143078,4142634,444,10,utRho26
flxA,3292776,3292810,3292776,34,194,utRho26
fnr,2799104,2799104,2799052,52,0,utRho26
fnrS,2818258,2818258,2818258,0,0,utRho26
focA,1909628,1909628,1908932,696,12,utRho26
folA,99598,99646,99598,48,0,utRho26
folB,6409296,6409296,6409178,118,0,utRho26
folD,1115562,1115562,1115482,80,148,utRho26
folE,4487696,4487696,4487304,392,260,utRho26
fpr,8228998,8228998,8228944,54,0,utRho26
frc,4986878,4986878,4986508,370,0,utRho26
frdA,8764824,8764824,8764636,188,0,utRho26
frdD,8758948,8758948,8758732,216,128,utRho26
fre,8052886,8053054,8052886,168,132,utRho26
frlA,6999518,6999820,6999518,302,300,utRho26
frr,385624,385744,385624,120,260,utRho26
frsA,513004,513054,513004,50,0,utRho26
fruB,4527194,4527194,4526990,204,0,utRho26
frvR,8179804,8179804,8179710,94,114,utRho26
fryA,5008986,5008986,5008970,16,0,utRho26
fsaA,1727060,1727284,1727060,224,114,utRho26
fsr,1009710,1009710,1009392,318,58,utRho26
ftnA,3977364,3977432,3977364,68,0,utRho26
ftnB,3973550,3973850,3973550,300,0,utRho26
ftsA,207122,207964,207122,842,144,utRho26
ftsB,5745802,5745802,5745640,162,0,utRho26
ftsH,6654204,6654204,6653870,334,1238,utRho26
ftsK,1865858,1866448,1865858,590,938,utRho26
ftsL,181376,182064,181376,688,10,utRho26
ftsP,6325732,6325732,6325338,394,0,utRho26
ftsQ,205484,206310,205484,826,606,utRho26
ftsX,7204512,7204512,7204172,340,378,utRho26
ftsZ,209272,210610,209272,1338,184,utRho26
fucA,5867708,5867708,5867376,332,10,utRho26
fucP,5868238,5868470,5868238,232,88,utRho26
fumA,6753760,6753760,6753508,252,1092,utRho26
fumB,8694696,8694696,8694652,44,48,utRho26
fumC,3373418,3373418,3373176,242,0,utRho26
fur,2842892,2842892,2842584,308,420,utRho26
fusA,6947370,6947370,6947028,342,6332,utRho26
fxsA,8737206,8737328,8737206,122,1566,utRho26
gabD,5581824,5582546,5581824,722,688,utRho26
gadA,7335214,7335214,7335160,54,0,utRho26
gadB,3144144,3144144,3144090,54,0,utRho26
gadC,3141168,3141168,3140978,190,188,utRho26
gadE,7315600,7316732,7315600,1132,476,utRho26
gadW,7329562,7329562,7329236,326,0,utRho26
gadX,14663356,14663356,14663240,116,0,utRho26
gadY,7329728,7329728,7329728,0,0,utRho26
galE,1584354,1584354,1584110,244,0,utRho26
galF,4228702,4228702,4228654,48,98,utRho26
galM,1577796,1577796,1577674,122,80,utRho26
galP,6176510,6176568,6176510,58,0,utRho26
galR,5953138,5953198,5953138,60,0,utRho26
galS,4483420,4483420,4483336,84,0,utRho26
galU,2582810,2582914,2582810,104,192,utRho26
gapA,3724480,3725542,3724480,1062,1742,utRho26
garP,6549868,6549868,6549814,54,52,utRho26
gatY,4354468,4354468,4354408,60,0,utRho26
gatZ,4352864,4352864,4352642,222,1404,utRho26
gcd,282558,282558,282450,108,50,utRho26
gcl,1067814,1067832,1067814,18,0,utRho26
gcvA,5885278,5885278,5885134,144,0,utRho26
gcvB,5885392,5885392,5885392,0,0,utRho26
gcvR,5199758,5199812,5199758,54,0,utRho26
gcvT,6101544,6101544,6101334,210,188,utRho26
gdhA,3684616,3684742,3684616,126,30,utRho26
gfcA,2099668,2099668,2099488,180,26,utRho26
gfcD,2096236,2096236,2095890,346,56,utRho26
ghrA,2195648,2195772,2195648,124,0,utRho26
ghrB,7434378,7434620,7434378,242,72,utRho26
glcA,6242728,6242728,6242558,170,48,utRho26
glcC,6256412,6256544,6256412,132,0,utRho26
glcD,6256152,6256152,6256042,110,0,utRho26
gldA,8278092,8278092,8278070,22,40,utRho26
glgA,7136784,7136784,7136066,718,0,utRho26
glgB,7147314,7147314,7147004,310,286,utRho26
glgC,7139142,7139142,7138656,486,116,utRho26
glgP,7133546,7133546,7133162,384,90,utRho26
glgS,6384024,6384024,6383878,146,372,utRho26
glgX,7142838,7142838,7142638,200,0,utRho26
glk,5018922,5018922,5018852,70,0,utRho26
glmS,7827622,7827622,7827336,286,138,utRho26
glmU,7830652,7830652,7830400,252,108,utRho26
glmY,10765360,10765360,10765360,0,0,utRho26
glmZ,7972864,7972864,7972864,0,0,utRho26
glnA,16232888,16232888,16232136,752,0,utRho26
glnB,5375052,5375052,5374816,236,4,utRho26
glnD,377310,377310,377300,10,0,utRho26
glnE,6399602,6399602,6399282,320,20,utRho26
glnH,1696396,1696396,1696008,388,2,utRho26
glnK,945112,945196,945112,84,72,utRho26
glnL,8112742,8112742,8112678,64,0,utRho26
glnQ,1693262,1693262,1692926,336,244,utRho26
glnS,1411998,1412186,1411998,188,1036,utRho26
gloA,3455602,3455674,3455602,72,0,utRho26
gloB,469852,469852,469564,288,502,utRho26
glpA,4705166,4705294,4705166,128,0,utRho26
glpD,7123942,7124026,7123942,84,0,utRho26
glpE,7123698,7123698,7123646,52,0,utRho26
glpF,8236322,8236322,8236180,142,398,utRho26
glpG,7122960,7122960,7122904,56,0,utRho26
glpR,7121782,7121782,7121210,572,766,utRho26
glpT,4704902,4704902,4704748,154,192,utRho26
glpX,8231212,8231212,8231158,54,156,utRho26
glrK,5382246,5382246,5382196,50,4,utRho26
gltA,1509534,1509534,1508936,598,924,utRho26
gltB,6709018,6709264,6709018,246,4,utRho26
gltI,1375792,1375792,1375494,298,806,utRho26
gltP,8588536,8588962,8588536,426,114,utRho26
gltS,7657382,7657382,7657330,52,230,utRho26
gltX,5041568,5041568,5041344,224,164,utRho26
gluQ,320286,320286,320224,62,176,utRho26
glyA,5371148,5371148,5371014,134,0,utRho26
glyQ,7450708,7450708,7450636,72,2,utRho26
glyS,7448990,7448990,7448794,196,520,utRho26
glyU,5998128,5998128,5998114,14,126,utRho26
glyV,8784626,8784720,8784626,94,64,utRho26
glyW,3984360,3984360,3984234,126,26,utRho26
gmhB,445612,445666,445612,54,0,utRho26
gmk,7642776,7642856,7642776,80,0,utRho26
gmr,2693686,2693686,2693484,202,0,utRho26
gnd,4202648,4202648,4202536,112,674,utRho26
gnsB,3275692,3275692,3275564,128,0,utRho26
gntK,14310580,14310580,14310368,212,624,utRho26
gntP,9102668,9102668,9102592,76,388,utRho26
gntR,7157760,7157760,7157452,308,386,utRho26
gntT,7092810,7093118,7092810,308,74,utRho26
gntU,7154170,7154170,7154122,48,74,utRho26
gntX,7089334,7089764,7089334,430,94,utRho26
gor,7292224,7292598,7292224,374,228,utRho26
gpmA,1575340,1575340,1575190,150,0,utRho26
gpmM,7570374,7570520,7570374,146,0,utRho26
gpsA,7567620,7567620,7567322,298,2124,utRho26
gpt,511828,511954,511828,126,586,utRho26
grcA,5433046,5433046,5432898,148,4,utRho26
greA,6657728,6657728,6657430,298,514,utRho26
greB,7073488,7073624,7073488,136,0,utRho26
groL,8741566,8742050,8741566,484,11388,utRho26
groS,8741232,8741376,8741232,144,12206,utRho26
grpE,5501494,5501494,5501416,78,540,utRho26
grxA,1781552,1781552,1781506,46,0,utRho26
grxB,2248206,2248206,2248108,98,214,utRho26
grxC,7569152,7569152,7568884,268,1406,utRho26
grxD,3468324,3468324,3468202,122,3222,utRho26
gspA,6911268,6911268,6910796,472,238,utRho26
gspC,6910964,6911156,6910964,192,68,utRho26
gss,6277220,6277220,6277044,176,0,utRho26
gstA,3428654,3428754,3428654,100,0,utRho26
gstB,1761038,1761038,1760960,78,0,utRho26
guaB,5268214,5268214,5268140,74,0,utRho26
gudD,5839026,5839026,5838770,256,0,utRho26
gyrA,4678914,4678914,4678840,74,2,utRho26
gyrB,7760300,7760300,7760238,62,0,utRho26
hcaE,5337964,5338064,5337964,100,6,utRho26
hcaR,5337928,5337928,5337792,136,60,utRho26
hcaT,5336106,5336106,5335692,414,6,utRho26
hchA,4071260,4071670,4071260,410,0,utRho26
hcp,1828258,1828258,1827628,630,242,utRho26
hcr,1824400,1824400,1824300,100,0,utRho26
hdeA,7313582,7313582,7313480,102,0,utRho26
hdeD,7313920,7313990,7313920,70,238,utRho26
hdfR,7896320,7896320,7895934,386,296,utRho26
hdhA,3396244,3396244,3396080,164,114,utRho26
helD,2048876,2048942,2048876,66,0,utRho26
hemA,2527166,2527428,2527166,262,0,utRho26
hemB,779722,779722,779454,268,144,utRho26
hemF,5106410,5106450,5106410,40,0,utRho26
hemH,996062,996110,996062,48,0,utRho26
hemL,349882,349882,349764,118,0,utRho26
hemN,8103886,8104090,8103886,204,0,utRho26
hepA,127176,127176,126528,648,7780,utRho26
hflD,2385372,2385372,2385262,110,130,utRho26
hfq,8799602,8800576,8799602,974,3856,utRho26
hha,961006,961006,960616,390,0,utRho26
hicA,3018442,3018572,3018442,130,0,utRho26
higA,6468682,6468682,6468288,394,486,utRho26
higB,6468960,6468960,6468910,50,148,utRho26
hinT,2323642,2323770,2323642,128,0,utRho26
hipB,3184964,3184964,3184884,80,0,utRho26
hisB,4186720,4186936,4186720,216,276,utRho26
hisJ,4853674,4853674,4853576,98,0,utRho26
hisL,8359856,8359984,8359856,128,0,utRho26
hisS,5281284,5281284,5281150,134,0,utRho26
hlpA,400910,400964,400910,54,0,utRho26
hlyE,2460932,2460932,2460788,144,28,utRho26
hmp,5371594,5371670,5371594,76,0,utRho26
hns,2585916,2585916,2585844,72,4116,utRho26
hofM,7045856,7045856,7045502,354,54,utRho26
hokA,7441620,7441620,7441200,420,118,utRho26
hokC,33902,33902,33806,96,418,utRho26
hokE,1215462,1215672,1215462,210,0,utRho26
holC,8968546,8968546,8968560,14,42,utRho26
holD,9215562,9215606,9215562,44,0,utRho26
holE,3850040,3850216,3850040,176,4,utRho26
hpt,282720,282862,282720,142,0,utRho26
hrpB,324150,324210,324150,60,6,utRho26
hscB,5319048,5319048,5318934,114,168,utRho26
hscC,1367188,1367188,1366786,402,142,utRho26
hsdS,9163004,9163004,9162924,80,458,utRho26
hslJ,2883560,2883560,2883486,74,586,utRho26
hslO,7059344,7059548,7059344,204,59518,utRho26
hslR,7058220,7058696,7058220,476,4784,utRho26
hslV,8244708,8244708,8244574,134,30,utRho26
hsrA,7881412,7881412,7881224,188,80,utRho26
htgA,21286,21660,21286,374,616,utRho26
htpG,989634,990240,989634,606,982,utRho26
htpX,3825236,3825236,3825152,84,116,utRho26
htrE,311036,311036,310852,184,42,utRho26
htrL,7587668,7587668,7587366,302,0,utRho26
hupA,8400352,8400562,8400352,210,112,utRho26
hupB,1845220,1845804,1845220,584,1044,utRho26
hyaA,2063968,2064278,2063968,310,20,utRho26
hybO,6292726,6292726,6292522,204,250,utRho26
hycA,5700922,5700922,5700870,52,0,utRho26
hycI,5686204,5686204,5686086,118,236,utRho26
hydN,5676264,5676264,5676210,54,0,utRho26
hyfA,5202342,5202402,5202342,60,0,utRho26
hypA,11402508,11402588,11402508,80,0,utRho26
hypB,11403356,11404004,11403356,648,0,utRho26
hypF,5676210,5676210,5674850,1360,208,utRho26
hypT,9116634,9116634,9116578,56,0,utRho26
hyuA,6019660,6020056,6019660,396,0,utRho26
iaaA,1733074,1733136,1733074,62,0,utRho26
iadA,9119074,9119074,9119052,22,158,utRho26
iap,5753072,5753162,5753072,90,44,utRho26
ibaG,6673966,6673966,6673606,360,0,utRho26
ibpA,7735036,7735036,7734844,192,6606,utRho26
ibpB,7733962,7733962,7733794,168,49708,utRho26
icd,2389922,2390246,2389922,324,8,utRho26
iclR,8447304,8447304,8447256,48,20,utRho26
idi,6065876,6066130,6065876,254,0,utRho26
idnD,8988870,8988870,8988812,58,0,utRho26
idnK,8989194,8989246,8989194,52,0,utRho26
ihfA,3591442,3591442,3591104,338,318,utRho26
ihfB,1927498,1927656,1927498,158,182,utRho26
ileS,43666,44782,43666,1116,726,utRho26
ileX,6431194,6431196,6431194,2,104,utRho26
ilvA,15820940,15821324,15820940,384,116,utRho26
ilvC,7915824,7915940,7915824,116,282,utRho26
ilvE,15809552,15809936,15809552,384,800,utRho26
ilvI,170840,171260,170840,420,20,utRho26
ilvL,23701308,23701932,23701308,624,372,utRho26
ilvY,7915734,7915734,7915640,94,194,utRho26
inaA,4698998,4698998,4698944,54,0,utRho26
infA,1853370,1853370,1852886,484,78,utRho26
infC,3602692,3602692,3601276,1416,2230,utRho26
insA-5,3958452,3958452,3958430,22,8,utRho26
insA-7,9036758,9037054,9036758,296,4,utRho26
insC-5,6372080,6372284,6372080,204,318,utRho26
insEF-2,785238,785238,785820,582,208,utRho26
insEF-4,2190310,2190310,2190892,582,156,utRho26
insG,9007098,9007098,9006862,236,0,utRho26
insH-1,550596,550596,550234,362,42,utRho26
insH-11,7306538,7306538,7306396,142,164,utRho26
insH-2,1151548,1151548,1151506,42,18,utRho26
insH-3,1378444,1378444,1378026,418,118,utRho26
insH-4,2791942,2792152,2791942,210,22,utRho26
insH-5,2857852,2857852,2857452,400,0,utRho26
insH-6,4135022,4135022,4134642,380,160,utRho26
insH-7,4206186,4206186,4205822,364,4468,utRho26
insH-9,6260050,6260356,6260050,306,652,utRho26
insI-3,9017372,9017372,9017234,138,2,utRho26
insJ,7441188,7441360,7441188,172,4,utRho26
insK,7442130,7442308,7442130,178,88,utRho26
insL-1,30760,30890,30760,130,5182,utRho26
insL-2,1216112,1216130,1216112,18,278,utRho26
insL-3,5028644,5028662,5028644,18,398,utRho26
insN-1,540452,540484,540452,32,0,utRho26
intD,1132202,1132202,1131956,246,28,utRho26
intR,2826520,2826520,2826470,50,0,utRho26
intS,4933026,4933090,4933026,64,74,utRho26
intZ,5117386,5117542,5117386,156,8,utRho26
iraD,9113152,9113986,9113152,834,124,utRho26
iraM,2424246,2424246,2424006,240,0,utRho26
iraP,802638,802772,802638,134,66,utRho26
iscA,5319924,5319924,5319772,152,668,utRho26
iscR,5324398,5324398,5324262,136,1368,utRho26
iscX,5313834,5313834,5313472,362,164,utRho26
ispF,5743968,5743968,5743560,408,82,utRho26
ispG,5283908,5283908,5283608,300,40,utRho26
ispU,389568,389806,389568,238,24,utRho26
isrA,2811502,2811502,2811618,116,0,utRho26
istr-1,7706384,7706384,7706384,0,0,utRho26
istr-2,7706514,7706514,7706514,0,0,utRho26
ivbL,15412092,15412092,15411952,140,40,utRho26
ivy,480638,480686,480638,48,66,utRho26
katE,3627628,3627734,3627628,106,122,utRho26
katG,8267624,8267670,8267624,46,0,utRho26
kbaZ,6557732,6557828,6557732,96,0,utRho26
kbl,7585154,7585154,7585102,52,332,utRho26
kch,2621046,2621046,2620538,508,0,utRho26
kdgR,3820506,3820506,3820198,308,0,utRho26
kdpE,1443788,1443788,1443466,322,164,utRho26
kdpF,1457698,1457698,1457642,56,76,utRho26
kdsA,2535708,2536330,2535708,622,756,utRho26
kdsC,6683438,6684546,6683438,1108,2226,utRho26
kduI,5968388,5968388,5968248,140,138,utRho26
kefF,94160,94492,94160,332,552,utRho26
kgtP,5451624,5451624,5451492,132,176,utRho26
kup,7862206,7862632,7862206,426,1586,utRho26
lacI,735076,735076,735020,56,2,utRho26
lacZ,1465508,1465508,1465220,288,256,utRho26
ldcA,2486394,2486394,2486160,234,4,utRho26
ldhA,2885830,2885830,2885686,144,110,utRho26
ldrA,2538954,2538954,2538550,404,536,utRho26
ldrB,2540024,2540024,2539620,404,320,utRho26
ldrC,2541092,2541092,2540690,402,28,utRho26
ldrD,7400544,7400544,7400174,370,6,utRho26
lepA,5414392,5414392,5414248,144,658,utRho26
lepB,5410928,5410928,5410618,310,740,utRho26
leuD,159188,159188,158906,282,122,utRho26
leuE,3761600,3761600,3761518,82,92,utRho26
leuL,168048,168048,167416,632,84,utRho26
leuO,168308,168736,168308,428,116,utRho26
leuQ,9212864,9212864,9212802,62,0,utRho26
leuU,6644556,6644556,6644316,240,1452,utRho26
leuV,9212546,9212546,9212330,216,454,utRho26
leuX,8992772,8992810,8992772,38,0,utRho26
lexA,8514174,8514230,8514174,56,18,utRho26
lhr,3456706,3458174,3456706,1468,184,utRho26
ligA,5060402,5060402,5060352,50,6,utRho26
ligB,7642576,7642576,7642340,236,0,utRho26
lipA,1320602,1320602,1320432,170,0,utRho26
lipB,1324802,1324802,1324556,246,4406,utRho26
lit,2397032,2397390,2397032,358,460,utRho26
livJ,7199524,7199524,7199316,208,854,utRho26
livK,7195510,7195510,7195120,390,212,utRho26
lldP,7554578,7554798,7554578,220,254,utRho26
lnt,1381968,1381968,1381762,206,234,utRho26
loiP,6163784,6163826,6163784,42,0,utRho26
lolA,1874656,1874738,1874656,82,100,utRho26
lolB,2527112,2527112,2527000,112,0,utRho26
lolC,2350748,2350854,2350748,106,0,utRho26
lon,917630,917776,917630,146,394,utRho26
lpcA,486936,487086,486936,150,0,utRho26
lpd,255434,255824,255434,390,448,utRho26
lplA,9248476,9248476,9248234,242,418,utRho26
lplT,5947878,5947878,5947724,154,0,utRho26
lpoA,6586422,6586800,6586422,378,100,utRho26
lpp,3514592,3514842,3514592,250,112,utRho26
lptA,6686598,6686760,6686598,162,94,utRho26
lptB,6686792,6687888,6686792,1096,352,utRho26
lptD,114672,114672,114218,454,254,utRho26
lptF,8972244,8972436,8972244,192,0,utRho26
lpxC,213016,213114,213016,98,1778,utRho26
lpxD,401920,401942,401920,22,0,utRho26
lpxL,2233418,2233418,2233164,254,28,utRho26
lpxM,3880456,3880456,3880386,70,0,utRho26
lpxP,4991156,4991290,4991156,134,148,utRho26
lrhA,4813312,4813312,4813282,30,4,utRho26
lrp,1864656,1865190,1864656,534,450,utRho26
lspA,50028,50414,50028,386,256,utRho26
lsrA,3202920,3202980,3202920,60,0,utRho26
lsrR,3202514,3202514,3202482,32,0,utRho26
ltaE,1818640,1818640,1818588,52,0,utRho26
luxS,5630130,5630130,5629466,664,1138,utRho26
lysA,5957902,5957902,5957798,104,0,utRho26
lysC,8467232,8467232,8466466,766,176,utRho26
lysP,4497120,4497120,4497064,56,18,utRho26
lysR,5957900,5958042,5957900,142,0,utRho26
lysT,1561028,1561108,1561028,80,0,utRho26
lysU,8709610,8709610,8709434,176,22,utRho26
macB,1840188,1840694,1840188,506,96,utRho26
maeA,3111484,3111484,3111338,146,546,utRho26
mak,820236,820288,820236,52,0,utRho26
malE,8492928,8492928,8492838,90,92,utRho26
malI,3398456,3398456,3398360,96,0,utRho26
malK,8493472,8493568,8493472,96,2,utRho26
malP,7105020,7105020,7104946,74,310,utRho26
malQ,7100798,7100798,7100140,658,232,utRho26
malS,14949880,14949988,14949880,108,0,utRho26
malT,7106048,7106170,7106048,122,42,utRho26
malX,3398626,3398710,3398626,84,0,utRho26
malZ,1689980,1690072,1689980,92,236,utRho26
manA,3377102,3377152,3377102,50,0,utRho26
manX,3803866,3804096,3803866,230,88,utRho26
marC,3237882,3237882,3237816,66,120,utRho26
marR,3238186,3238240,3238186,54,120,utRho26
matP,2036918,2036970,2036918,52,56,utRho26
mazE,5822736,5822736,5822678,58,2,utRho26
mazG,5821720,5821720,5821370,350,850,utRho26
mcbA,1684306,1684306,1684112,194,0,utRho26
mcbR,3040192,3040524,3040192,332,0,utRho26
mcrA,2420278,2420692,2420278,414,2,utRho26
mcrC,9156124,9156124,9155916,208,450,utRho26
mdaB,6344814,6345060,6344814,246,10,utRho26
mdfA,1767138,1767346,1767138,208,0,utRho26
mdh,6768940,6768940,6768536,404,368,utRho26
mdoB,9198988,9198988,9198882,106,96,utRho26
mdoD,2993290,2993712,2993290,422,0,utRho26
mdoG,2218514,2218670,2218514,156,290,utRho26
mdtA,4307958,4308032,4307958,74,0,utRho26
mdtE,7318168,7318464,7318168,296,262,utRho26
mdtK,3486538,3486914,3486538,376,328,utRho26
mdtP,8602472,8602472,8602060,412,52,utRho26
melA,8683774,8683822,8683774,48,0,utRho26
melR,8683300,8683300,8683256,44,208,utRho26
menA,8240812,8240812,8240698,114,420,utRho26
menB,4753774,4753774,4753638,136,128,utRho26
mepH,3468714,3468870,3468714,156,0,utRho26
mepM,3883666,3883666,3883270,396,0,utRho26
mepS,4539840,4539958,4539840,118,302,utRho26
metA,8428318,8428560,8428318,242,0,utRho26
metB,8257272,8257344,8257272,72,636,utRho26
metC,6304150,6304472,6304150,322,246,utRho26
metE,8025768,8026106,8025768,338,32,utRho26
metF,8265092,8265232,8265092,140,38,utRho26
metG,4388538,4388600,4388538,62,0,utRho26
metH,8447010,8447656,8447010,646,302,utRho26
metJ,8257116,8257116,8256790,326,208,utRho26
metK,6173154,6173412,6173154,258,256,utRho26
metN,445428,445428,445290,138,0,utRho26
metR,8025710,8025710,8025632,78,0,utRho26
metT,1394326,1394326,1394266,60,0,utRho26
metY,19910250,19910250,19909734,516,2298,utRho26
metZ,11789528,11789548,11789528,20,92,utRho26
mfd,2348056,2348056,2347928,128,0,utRho26
mglA,4478782,4478782,4478578,204,114,utRho26
mglB,4481132,4481132,4480696,436,8500,utRho26
mglC,4475918,4475918,4475506,412,0,utRho26
mgrB,3817584,3817584,3817532,52,56,utRho26
mgrR,3245828,3245828,3245828,0,0,utRho26
mgsA,2054082,2054082,2054030,52,190,utRho26
mgtL,8934560,8934862,8934560,302,114,utRho26
mhpA,737038,737222,737038,184,0,utRho26
mhpR,737072,737072,736840,232,0,utRho26
mhpT,750772,750918,750772,146,0,utRho26
miaA,8797964,8798504,8797964,540,130,utRho26
micA,5629604,5629604,5629604,0,0,utRho26
micC,2874242,2874238,2874242,4,0,utRho26
micF,4626168,4626168,4626168,0,0,utRho26
micM,1014408,1014408,1014408,0,0,utRho26
minE,2449422,2449422,2449090,332,512,utRho26
mioC,7852950,7852950,7852910,40,0,utRho26
mipA,3733012,3733012,3732944,68,632,utRho26
mlaA,4930270,4930270,4930014,256,0,utRho26
mlc,3337206,3337206,3337128,78,2,utRho26
mlrA,4429498,4429732,4429498,234,6,utRho26
mltA,5894546,5894546,5894356,190,0,utRho26
mltD,468050,468050,467910,140,0,utRho26
mltF,5391534,5391602,5391534,68,0,utRho26
mmuP,550238,550650,550238,412,48,utRho26
mngA,1531622,1531968,1531622,346,0,utRho26
mngR,1531852,1531852,1531750,102,0,utRho26
mnmG,7851348,7851348,7851266,82,50,utRho26
mntH,5025470,5025470,5025412,58,0,utRho26
mntP,3810918,3811376,3810918,458,2,utRho26
mntR,1706160,1706366,1706160,206,0,utRho26
mntS,1706128,1706128,1705994,134,2,utRho26
moaA,1633654,1634088,1633654,434,154,utRho26
moaB,1635954,1636110,1635954,156,42,utRho26
mobA,8084242,8084242,8083998,244,0,utRho26
mocA,6030112,6030320,6030112,208,146,utRho26
modA,1589990,1590178,1589990,188,0,utRho26
moeA,1732788,1732788,1732728,60,0,utRho26
mokB,2984610,2984610,2984258,352,104,utRho26
molR_1,4392888,4392948,4392888,60,0,utRho26
motA,3954604,3954604,3954278,326,26,utRho26
mpaA,2781278,2781278,2781196,82,12,utRho26
mpl,8911456,8911570,8911456,114,0,utRho26
mppA,2786108,2786454,2786108,346,0,utRho26
mprA,5621494,5621540,5621494,46,48,utRho26
mqo,4613848,4613848,4613508,340,4,utRho26
mqsA,6336742,6336742,6336492,250,430,utRho26
mqsR,6337306,6337306,6337088,218,330,utRho26
mraZ,179192,179268,179192,76,106,utRho26
mrcA,7045652,7045742,7045652,90,0,utRho26
mrcB,329442,329460,329442,18,0,utRho26
mreB,13605424,13605424,13604348,1076,864,utRho26
mreD,6798166,6798166,6797750,416,142,utRho26
mrp,4388360,4388360,4388336,24,0,utRho26
mscK,972984,973072,972984,88,2,utRho26
mscL,6876002,6876048,6876002,46,792,utRho26
mscS,6139742,6139742,6139614,128,0,utRho26
msrA,8884522,8884522,8884352,170,384,utRho26
msrB,3725168,3725168,3724858,310,20,utRho26
msyB,2228426,2228426,2228362,64,106,utRho26
mtfA,4087236,4087302,4087236,66,164,utRho26
mtgA,6699662,6699662,6699618,44,92,utRho26
mtlA,30177504,30178248,30177504,744,2016,utRho26
mtn,358366,358366,358306,60,156,utRho26
mtr,6611864,6611864,6611634,230,16,utRho26
mug,6430992,6430992,6430946,46,1306,utRho26
murQ,5091466,5091546,5091466,80,0,utRho26
murR,5091586,5091586,5091218,368,0,utRho26
mutH,5939164,5939324,5939164,160,0,utRho26
mutL,8794092,8794824,8794092,732,414,utRho26
mutM,7622554,7622554,7622304,250,58,utRho26
mutS,5714038,5714186,5714038,148,488,utRho26
mutY,18617466,18618078,18617466,612,6,utRho26
nac,4123956,4123956,4123866,90,0,utRho26
nadA,1564122,1564170,1564122,48,0,utRho26
nadB,5420714,5420840,5420714,126,48,utRho26
nadC,237326,237326,237290,36,0,utRho26
nadE,3644604,3644916,3644604,312,16,utRho26
nadK,5501526,5501662,5501526,136,58,utRho26
nagA,1406350,1406350,1405502,848,614,utRho26
nagB,1407416,1407416,1407222,194,0,utRho26
nagC,1404016,1404016,1403188,828,0,utRho26
nagE,1407680,1407888,1407680,208,90,utRho26
nagK,2357080,2357186,2357080,106,44,utRho26
nanA,6747240,6747240,6747152,88,0,utRho26
nanC,9079856,9079856,9079002,854,240,utRho26
nanR,6749406,6749406,6748978,428,964,utRho26
nanS,9075406,9075406,9075188,218,2,utRho26
napF,4607390,4607390,4606994,396,0,utRho26
narG,2559614,2559728,2559614,114,0,utRho26
narK,2555642,2555914,2555642,272,0,utRho26
narP,4580844,4581000,4580844,156,12,utRho26
narQ,5171154,5171462,5171154,308,180,utRho26
narU,3088326,3088326,3088120,206,610,utRho26
narW,3077374,3077374,3074618,2756,364,utRho26
narX,2555554,2555554,2555236,318,254,utRho26
narZ,3085380,3085380,3085180,200,0,utRho26
ndh,2331984,2332170,2331984,186,220,utRho26
ndk,5289920,5289920,5289728,192,236,utRho26
nemR,6904084,6904092,6904084,8,0,utRho26
nepI,7683542,7683542,7683478,64,258,utRho26
nfo,4501612,4501680,4501612,68,0,utRho26
nfsB,1210906,1210906,1210848,58,0,utRho26
nfuA,7090916,7091248,7090916,332,220,utRho26
nhaA,34634,34978,34634,344,170,utRho26
nhaB,2469534,2469534,2469434,100,0,utRho26
nhoA,3067926,3068048,3067926,122,0,utRho26
nikA,7226878,7227334,7226878,456,576,utRho26
nikR,7237074,7237176,7237074,102,76,utRho26
nirB,6987974,6988022,6987974,48,42,utRho26
nlpA,7680034,7680034,7679986,48,0,utRho26
nlpC,3585654,3585654,3585462,192,122,utRho26
nlpD,5737658,5737658,5737506,152,0,utRho26
nlpI,6618080,6618080,6617848,232,0,utRho26
nmpC,1153740,1153740,1153650,90,0,utRho26
nohA,3273206,3273206,3272734,472,4,utRho26
norR,5664614,5664614,5664578,36,0,utRho26
norV,5664878,5664952,5664878,74,60,utRho26
nrdA,4689510,4689730,4689510,220,6906,utRho26
nrdD,8925676,8925676,8925320,356,220,utRho26
nrdH,5601312,5601446,5601312,134,76,utRho26
nrdR,865954,866004,865954,50,0,utRho26
nrfA,8575342,8575528,8575342,186,0,utRho26
nsrR,8812088,8812380,8812088,292,270,utRho26
nudB,3897348,3897348,3897264,84,0,utRho26
nudC,8393428,8393806,8393428,378,0,utRho26
nudE,7052658,7052658,7052298,360,0,utRho26
nudG,3682876,3682980,3682876,104,0,utRho26
nudI,4729050,4729108,4729050,58,0,utRho26
nudJ,2388874,2388874,2388576,298,128,utRho26
nuoA,4810670,4810670,4810144,526,1038,utRho26
nuoN,4783434,4783434,4783010,424,122,utRho26
nupC,5026018,5026084,5026018,66,0,utRho26
nupG,6211302,6211428,6211302,126,36,utRho26
ogrK,4335096,4335096,4335040,56,0,utRho26
ogt,2800568,2800568,2800472,96,220,utRho26
ohsC,5401036,5401040,5401036,4,0,utRho26
ompA,2040382,2040382,2040106,276,6526,utRho26
ompC,4625774,4625774,4625498,276,84,utRho26
ompF,1974184,1974184,1973964,220,334,utRho26
ompL,8128958,8128958,8128590,368,528,utRho26
ompN,2874158,2874158,2873786,372,0,utRho26
ompR,7073510,7073510,7073168,342,0,utRho26
ompT,1171330,1171330,1171266,64,36,utRho26
ompW,2627982,2628040,2627982,58,0,utRho26
ompX,1700418,1700900,1700418,482,860,utRho26
omrA,5952378,5952378,5952378,0,0,utRho26
omrB,5952770,5952770,5952770,0,0,utRho26
oppA,2602170,2602364,2602170,194,316,utRho26
orn,8783168,8783208,8783168,40,0,utRho26
osmB,2686952,2686952,2686656,296,464,utRho26
osmC,3113192,3113250,3113192,58,4,utRho26
osmE,3644566,3644566,3644512,54,88,utRho26
osmF,4439046,4439046,4438962,84,134,utRho26
osmY,9222306,9222792,9222306,486,0,utRho26
otsA,3963302,3963302,3963224,78,190,utRho26
otsB,3964930,3964930,3964774,156,254,utRho26
oxc,4984288,4984288,4983900,388,2,utRho26
oxyR,8316914,8316980,8316914,66,204,utRho26
oxyS,8316788,8316788,8316788,0,0,utRho26
paaA,2907730,2907854,2907730,124,0,utRho26
paaX,2927018,2927078,2927018,60,0,utRho26
paaZ,2907340,2907340,2907284,56,0,utRho26
pabA,6981702,6981702,6981658,44,0,utRho26
pabB,3789256,3789610,3789256,354,0,utRho26
pabC,2306186,2306600,2306186,414,86,utRho26
pagP,1313052,1313114,1313052,62,0,utRho26
panB,299260,299260,299202,58,252,utRho26
panC,297840,297840,297590,250,94,utRho26
panD,293490,293490,293388,102,46,utRho26
panZ,7195656,7195968,7195656,312,224,utRho26
parC,6332060,6332060,6331946,114,44,utRho26
patA,6438916,6438988,6438916,72,0,utRho26
patD,3030830,3031156,3030830,326,0,utRho26
pbpC,5294986,5294986,5294650,336,0,utRho26
pbpG,4450132,4450132,4449740,392,54,utRho26
pck,7065358,7065636,7065358,278,1618,utRho26
pcnB,318782,318782,318252,530,0,utRho26
pdhR,244068,244184,244068,116,0,utRho26
pdxB,4875768,4875768,4875702,66,18,utRho26
pdxH,3436068,3436068,3436014,54,0,utRho26
pdxJ,5403626,5403626,5403458,168,6,utRho26
pdxK,5074638,5074638,5074474,164,224,utRho26
pepA,8972278,8972278,8971902,376,0,utRho26
pepD,511618,511618,511432,186,424,utRho26
pepN,1981182,1981244,1981182,62,390,utRho26
pepQ,8062294,8062322,8062294,28,0,utRho26
pepT,2371646,2371688,2371646,42,0,utRho26
pfkA,8214948,8215104,8214948,156,226,utRho26
pfkB,3612646,3612740,3612646,94,0,utRho26
pflA,1902456,1902456,1902160,296,24,utRho26
pflB,1907850,1907850,1907108,742,28,utRho26
pflD,8287716,8287990,8287716,274,16,utRho26
pgaA,2185046,2185046,2184578,468,1160,utRho26
pgi,8467444,8467516,8467444,72,0,utRho26
pgk,12291428,12291428,12290488,940,1004,utRho26
pgl,1597078,1597172,1597078,94,0,utRho26
pgpB,2678324,2678660,2678324,336,0,utRho26
pgpC,5397276,5397276,5397100,176,0,utRho26
pgrR,2783744,2783982,2783744,238,52,utRho26
pheL,5475158,5475198,5475158,40,0,utRho26
pheM,7197204,7197204,7197080,124,244,utRho26
pheP,1203858,1203918,1203858,60,60,utRho26
pheU,8725254,8725254,8725252,2,4,utRho26
pheV,6220730,6220732,6220730,2,0,utRho26
phnC,8650412,8650412,8650330,82,80,utRho26
phoA,803414,803494,803414,80,2,utRho26
phoB,834202,834284,834202,82,52,utRho26
phoE,520316,520316,520200,116,2,utRho26
phoH,2169730,2169984,2169730,254,4,utRho26
phoP,2381016,2381016,2380894,122,290,utRho26
phoQ,2379880,2379880,2379552,328,4,utRho26
phoU,7815330,7815330,7815156,174,74,utRho26
phr,1478842,1479014,1478842,172,0,utRho26
pinE,2419054,2419370,2419054,316,8,utRho26
pinQ,3267168,3267244,3267168,76,0,utRho26
pinR,2867424,2867424,2867348,76,0,utRho26
pitA,7275224,7275284,7275224,60,0,utRho26
pitB,6272806,6272806,6272742,64,40,utRho26
pka,5439862,5439906,5439862,44,0,utRho26
plaP,4174476,4174476,4174124,352,0,utRho26
pldA,8009628,8009724,8009628,96,182,utRho26
pldB,8018028,8018340,8018028,312,252,utRho26
plsB,8513196,8513196,8512932,264,464,utRho26
pmbA,8915890,8915918,8915890,28,0,utRho26
pmrD,4747148,4747148,4747076,72,0,utRho26
pncB,1980828,1980828,1980712,116,0,utRho26
pncC,5648788,5648788,5648692,96,66,utRho26
pnp,6622652,6622652,6622336,316,0,utRho26
pntA,3355950,3355950,3355806,144,0,utRho26
pntB,3353096,3353096,3352720,376,32,utRho26
polA,8093880,8093932,8093880,52,6,utRho26
polB,131606,131606,131560,46,0,utRho26
potD,2365700,2365700,2365658,42,0,utRho26
potE,1436688,1436688,1436530,158,12,utRho26
potF,1787268,1787568,1787268,300,4,utRho26
poxB,1822152,1822152,1822098,54,0,utRho26
ppa,8899372,8899372,8899304,68,2,utRho26
ppc,8306380,8306380,8306196,184,298,utRho26
ppdA,5928440,5928440,5928354,86,52,utRho26
ppdD,235410,235410,235098,312,0,utRho26
pphA,3846770,3846770,3845938,832,1808,utRho26
pphB,5719474,5719520,5719474,46,2,utRho26
ppiA,6984898,6984898,6984594,304,126,utRho26
ppiC,7919682,7919682,7919626,56,0,utRho26
ppiD,923638,923830,923638,192,78,utRho26
ppk,5245748,5246088,5245748,340,0,utRho26
pppA,6228958,6228958,6228704,254,72,utRho26
ppsA,3574322,3574322,3574224,98,0,utRho26
ppsR,3574678,3574890,3574678,212,0,utRho26
pptA,3065716,3066104,3065716,388,0,utRho26
pqiA,2023318,2024002,2023318,684,142,utRho26
prc,3830054,3830054,3829632,422,1426,utRho26
preT,4467978,4468066,4467978,88,184,utRho26
prfC,9218688,9218828,9218688,140,102,utRho26
prkB,6968622,6968980,6968622,358,8,utRho26
prlC,7290476,7290476,7290364,112,454,utRho26
prlF,6553944,6554004,6553944,60,474,utRho26
proB,520432,520776,520432,344,0,utRho26
proC,811372,811372,811288,84,0,utRho26
proK,7417388,7417388,7417384,4,6,utRho26
proL,4572414,4572422,4572414,8,0,utRho26
proP,8660640,8661004,8660640,364,32,utRho26
proS,437674,437674,437550,124,148,utRho26
proV,5609126,5609630,5609126,504,0,utRho26
prpB,697292,697364,697292,72,0,utRho26
prpR,696942,696942,696886,56,0,utRho26
prs,2524354,2524354,2523750,604,3356,utRho26
psd,8781276,8781276,8780720,556,716,utRho26
psiE,8480600,8480650,8480600,50,0,utRho26
pspA,2736076,2736158,2736076,82,0,utRho26
pspF,2736080,2736080,2735824,256,0,utRho26
pspG,8525632,8525680,8525632,48,0,utRho26
pssA,5445156,5445454,5445156,298,934,utRho26
pstB,7817112,7817112,7816732,380,212,utRho26
pstC,7821084,7821084,7820796,288,272,utRho26
pstS,23469408,23469408,23469150,258,192,utRho26
psuG,4517114,4517114,4516734,380,2086,utRho26
psuT,4514992,4514992,4514670,322,0,utRho26
pth,2517084,2517084,2517026,58,0,utRho26
ptrA,5918022,5918022,5917768,254,40,utRho26
ptrB,3857730,3857730,3857678,52,262,utRho26
ptsG,2315252,2315738,2315252,486,228,utRho26
ptsH,5066996,5067528,5066996,532,514,utRho26
purA,8809328,8809374,8809328,46,70,utRho26
purC,5195562,5195562,5195236,326,24,utRho26
purD,8411972,8411972,8411862,110,4,utRho26
purE,1106284,1106284,1106200,84,120,utRho26
purH,8415254,8415254,8415064,190,0,utRho26
purL,5391178,5391178,5391086,92,190,utRho26
purM,5242306,5242394,5242306,88,0,utRho26
purR,3475378,3475688,3475378,310,54,utRho26
purT,3861438,3861762,3861438,324,0,utRho26
purU,2577512,2577512,2577248,264,0,utRho26
putA,2157850,2157850,2157764,86,120,utRho26
putP,2158336,2158610,2158336,274,178,utRho26
puuA,2721936,2721936,2721816,120,0,utRho26
puuC,2725456,2725486,2725456,30,0,utRho26
puuD,2722104,2722240,2722104,136,116,utRho26
puuP,2718746,2718746,2718374,372,100,utRho26
pykA,3874988,3875298,3874988,310,34,utRho26
pykF,3510934,3511396,3510934,462,108,utRho26
pyrC,2245286,2245286,2245214,72,0,utRho26
pyrD,2009464,2009536,2009464,72,0,utRho26
pyrE,7631970,7631970,7631536,434,0,utRho26
pyrF,2683740,2683842,2683740,102,484,utRho26
pyrG,5819594,5819594,5819332,262,1046,utRho26
pyrH,383624,383710,383624,86,162,utRho26
pyrL,8945490,8945490,8945066,424,52,utRho26
qmcA,1031646,1031646,1031546,100,36,utRho26
qor,8528608,8528608,8528462,146,22,utRho26
qseB,6339502,6339656,6339502,154,6,utRho26
queA,849970,850022,849970,52,130,utRho26
queE,5811212,5811212,5810836,376,4,utRho26
queF,5850642,5850696,5850642,54,100,utRho26
queG,8788184,8788184,8788134,50,452,utRho26
racC,2835630,2835630,2835526,104,68,utRho26
racR,2840898,2840898,2840482,416,0,utRho26
raiA,5474208,5474308,5474208,100,48,utRho26
rarD,8008594,8008594,8008356,238,360,utRho26
ravA,7862256,7862256,7862186,70,320,utRho26
rayT,495088,495274,495088,186,128,utRho26
rbn,4763162,4763216,4763162,54,0,utRho26
rbsD,7866644,7866702,7866644,58,0,utRho26
rcnA,4371654,4371834,4371654,180,246,utRho26
rcnB,4373768,4373920,4373768,152,4,utRho26
rcnR,4371806,4371806,4371592,214,438,utRho26
rcsA,4047672,4047936,4047672,264,398,utRho26
rcsB,4631390,4632354,4631390,964,8,utRho26
rcsC,4640162,4640162,4639656,506,0,utRho26
rcsD,4626904,4626976,4626904,72,0,utRho26
rdgB,6193240,6193362,6193240,122,126,utRho26
rdlA,2538646,2538646,2538646,0,0,utRho26
rdlB,2539712,2539716,2539712,4,0,utRho26
rdlC,2540782,2540786,2540782,4,0,utRho26
rdlD,7400272,7400272,7400272,0,0,utRho26
rdoA,8084782,8084830,8084782,48,4,utRho26
recA,11295276,11295276,11295076,200,376,utRho26
recC,5925014,5925014,5924856,158,114,utRho26
recF,7763722,7763722,7762442,1280,674,utRho26
recN,5503518,5503590,5503518,72,0,utRho26
recQ,8011666,8011728,8011666,62,0,utRho26
relA,5828554,5828554,5827302,1252,582,utRho26
relB,3291806,3291806,3291744,62,0,utRho26
rem,3289950,3289950,3289804,146,118,utRho26
rep,7921294,7921354,7921294,60,52,utRho26
rfaD,7587730,7587974,7587730,244,52,utRho26
rfaE,6393852,6393852,6393506,346,90,utRho26
rfaH,8049930,8049930,8049642,288,686,utRho26
rfbX,4219436,4219436,4219168,268,702,utRho26
rfe,7935600,7935832,7935600,232,158,utRho26
rhaB,8194944,8194944,8194896,48,0,utRho26
rhaD,8188770,8188770,8188544,226,0,utRho26
rhaS,8195422,8195472,8195422,50,0,utRho26
rhaT,8201132,8201132,8201050,82,0,utRho26
rhlE,1661566,1661744,1661566,178,2,utRho26
rhoL,47593944,47594772,47593944,828,1404,utRho26
rhsB,7238006,7238384,7238006,378,134,utRho26
rhsC,1458758,1459166,1458758,408,0,utRho26
rhsD,1046132,1046522,1046132,390,12,utRho26
rhtA,1700608,1700608,1700194,414,582,utRho26
rhtC,8015478,8015514,8015478,36,64,utRho26
ribA,2678468,2678468,2678320,148,0,utRho26
ribC,3486916,3486916,3486484,432,650,utRho26
ribE,869008,869294,869008,286,2454,utRho26
ribF,42766,42814,42766,48,4,utRho26
ridA,8941892,8941892,8941826,66,2,utRho26
rihA,1369204,1369204,1368824,380,380,utRho26
rihB,4510504,4510504,4510372,132,0,utRho26
rimJ,2251044,2251124,2251044,80,62,utRho26
rimK,1783752,1783934,1783752,182,140,utRho26
rimL,2997486,2997876,2997486,390,116,utRho26
rimO,1756140,1756140,1756070,70,0,utRho26
rimP,6636350,6636350,6636012,338,880,utRho26
rlmA,3814172,3814172,3814120,52,0,utRho26
rlmD,5830086,5830086,5830000,86,0,utRho26
rlmE,6655520,6655520,6655328,192,286,utRho26
rlmF,1684384,1684664,1684384,280,0,utRho26
rlmG,6471784,6471784,6471750,34,0,utRho26
rlmI,2060002,2060002,2059938,64,0,utRho26
rlmJ,7290700,7290770,7290700,70,4,utRho26
rlmL,2015344,2015688,2015344,344,384,utRho26
rlpA,1330444,1330444,1330380,64,0,utRho26
rluA,120900,120900,120692,208,280,utRho26
rluF,8460324,8460708,8460324,384,0,utRho26
rmf,2031006,2031430,2031006,424,196,utRho26
rna,1290068,1290068,1290006,62,0,utRho26
rnb,2698258,2698258,2697824,434,84,utRho26
rnc,10816892,10816892,10816252,640,27004,utRho26
rnd,3776122,3776122,3775982,140,0,utRho26
rne,2289746,2289746,2288734,1012,1702,utRho26
rnhA,472082,472082,472004,78,550,utRho26
rnk,1288360,1288360,1287934,426,0,utRho26
rnlA,5531788,5531836,5531788,48,256,utRho26
rnlB,5533414,5533968,5533414,554,336,utRho26
rnpB,19623552,19623552,19623552,0,0,utRho26
rob,9270706,9270706,9270620,86,0,utRho26
rodZ,5285868,5285868,5285688,180,38,utRho26
rpe,7030306,7030306,7030118,188,40,utRho26
rph,15266320,15266320,15266196,124,224,utRho26
rpiA,6118706,6118706,6118650,56,30,utRho26
rpiB,8626514,8626700,8626514,186,2,utRho26
rpiR,8626274,8626274,8625982,292,0,utRho26
rplJ,8359246,8359992,8359246,746,6880,utRho26
rplK,8356708,8356894,8356708,186,122,utRho26
rplM,6757344,6757344,6757302,42,474,utRho26
rplN,6896444,6896444,6896298,146,1008,utRho26
rplS,5489284,5489284,5489060,224,11574,utRho26
rplT,7199052,7199052,7198996,56,568,utRho26
rplU,6667036,6667036,6666902,134,2,utRho26
rplY,4564866,4565034,4564866,168,0,utRho26
rpmA,6666450,6666450,6666238,212,508,utRho26
rpmB,15247980,15247980,15246696,1284,48964,utRho26
rpmE,8253816,8254026,8253816,210,416,utRho26
rpmF,2294676,2294734,2294676,58,12120,utRho26
rpmH,7768130,7768672,7768130,542,1778,utRho26
rpmI,3600854,3600854,3599998,856,6478,utRho26
rpoB,8362126,8362490,8362126,364,192,utRho26
rpoD,6424946,6426094,6424946,1148,28778,utRho26
rpoE,5420372,5420372,5420024,348,8,utRho26
rpoH,7202006,7202006,7201566,440,1944,utRho26
rpoN,6689324,6689434,6689324,110,2,utRho26
rpoS,5736236,5736236,5735102,1134,804,utRho26
rpoZ,7644154,7644212,7644154,58,50,utRho26
rppH,5937986,5937986,5937954,32,0,utRho26
rprA,3540744,3540744,3540744,0,0,utRho26
rpsA,1923434,1923990,1923434,556,29414,utRho26
rpsF,8850050,8850236,8850050,186,5932,utRho26
rpsI,6756580,6756580,6756414,166,6698,utRho26
rpsJ,6906884,6906884,6906540,344,1960,utRho26
rpsL,6949242,6949242,6949104,138,642,utRho26
rpsM,6885130,6885130,6884942,188,32,utRho26
rpsO,13247144,13247144,13246736,408,544,utRho26
rpsP,5492508,5492508,5492370,138,0,utRho26
rpsT,42420,42420,42156,264,282,utRho26
rpsU,12842584,12843124,12842584,540,776,utRho26
rraA,8238716,8238716,8238660,56,210,utRho26
rraB,8956768,8956946,8956768,178,112,utRho26
rrsA,8070478,8071062,8070478,584,1266,utRho26
rrsB,16665468,16666636,16665468,1168,2984,utRho26
rrsC,7883032,7883616,7883032,584,618,utRho26
rrsD,6858094,6858094,6857524,570,334,utRho26
rrsE,8415726,8416294,8415726,568,700,utRho26
rrsG,5462896,5462896,5462314,582,1190,utRho26
rrsH,446970,447542,446970,572,532,utRho26
rsd,8393908,8393908,8393616,292,0,utRho26
rseA,5419264,5419264,5418808,456,362,utRho26
rseP,392940,393092,392940,152,2,utRho26
rseX,4067298,4067298,4067298,0,0,utRho26
rsfS,1338144,1338144,1338072,72,64,utRho26
rsgA,8783132,8783132,8783018,114,0,utRho26
rsmA,105176,105176,104860,316,168,utRho26
rsmB,6869982,6870414,6869982,432,24,utRho26
rsmC,9215736,9215736,9215400,336,100,utRho26
rsmD,7208594,7208786,7208594,192,0,utRho26
rsmE,6182036,6182268,6182036,232,0,utRho26
rsmG,7847512,7847512,7847360,152,84,utRho26
rsmH,180020,180188,180020,168,0,utRho26
rsmI,6587106,6587106,6586670,436,110,utRho26
rssA,2578212,2578412,2578212,200,0,utRho26
rssB,2580440,2580484,2580440,44,0,utRho26
rstA,3364276,3364300,3364276,24,0,utRho26
rsuA,4561096,4561096,4560966,130,2,utRho26
rsxA,3411510,3411534,3411510,24,76,utRho26
rtcA,7114004,7114004,7113698,306,108,utRho26
rtcB,7116214,7116214,7116158,56,24,utRho26
rtn,4541356,4541452,4541356,96,0,utRho26
rutA,2148052,2148052,2148022,30,0,utRho26
rutG,2140090,2140090,2139678,412,0,utRho26
rutR,2148226,2148484,2148226,258,0,utRho26
ruvA,7784096,7784096,7783904,192,48,utRho26
ruvB,7782176,7782176,7781424,752,304,utRho26
ruvC,3894878,3894878,3894752,126,0,utRho26
rybB,1776114,1776114,1776114,0,0,utRho26
rydB,3529860,3529860,3529322,538,278,utRho26
rydC,2983012,2983012,2983012,0,0,utRho26
ryfA,5307398,5307710,5307398,312,0,utRho26
ryfD,5468590,5468590,5468590,0,0,utRho26
ryhB,7162032,7162032,7162032,0,0,utRho26
ryjA,8556132,8556132,8556132,0,0,utRho26
ryjB,9055954,9055954,9055954,0,0,utRho26
sad,3229598,3229598,3229406,192,0,utRho26
safA,3168056,3168056,3167918,138,0,utRho26
sanA,4465368,4465756,4465368,388,226,utRho26
sapF,2705314,2705314,2705268,46,0,utRho26
sbcB,4165456,4165512,4165456,56,0,utRho26
sbcC,831694,831694,831506,188,0,utRho26
sbcD,833954,833954,833904,50,66,utRho26
sbmA,793106,793278,793106,172,402,utRho26
sbmC,4162650,4162650,4162524,126,0,utRho26
sdaA,3793618,3793864,3793618,246,416,utRho26
sdaC,5856070,5856458,5856070,388,10222,utRho26
sdhC,1509916,1510354,1509916,438,6452,utRho26
sdhD,1510808,1511120,1510808,312,456,utRho26
sdiA,3993834,3993834,3993664,170,4,utRho26
secE,8354354,8354716,8354354,362,158,utRho26
secG,6645180,6645180,6645010,170,210,utRho26
selA,7522594,7522594,7522498,96,2,utRho26
selB,7519850,7519850,7519722,128,0,utRho26
selC,7672396,7672444,7672396,48,200,utRho26
selD,3696058,3696058,3696016,42,96,utRho26
seqA,1425884,1425974,1425884,90,126,utRho26
serA,6117098,6117098,6116820,278,0,utRho26
serB,9249712,9249790,9249712,78,0,utRho26
serC,3830380,3830612,3830380,232,0,utRho26
serS,1878730,1878856,1878730,126,614,utRho26
serT,2063438,2063438,2063424,14,0,utRho26
serU,4087124,4087124,4087114,10,0,utRho26
serV,5637394,5637394,5637290,104,126,utRho26
serW,1852014,1852014,1851942,72,298,utRho26
serX,2195352,2195352,2195304,48,60,utRho26
setB,4527426,4527726,4527426,300,76,utRho26
setC,7673488,7673906,7673488,418,146,utRho26
sfmA,1116124,1116424,1116124,300,176,utRho26
sfmC,1117606,1117948,1117606,342,0,utRho26
sfsA,323030,323030,322972,58,34,utRho26
sfsB,6669592,6669818,6669592,226,2,utRho26
sgrR,154676,154676,154598,78,0,utRho26
sgrS,154734,154734,154734,0,0,utRho26
shiA,4107068,4107286,4107068,218,0,utRho26
sibA,4306622,4306622,4306622,0,0,utRho26
sibB,4307292,4307292,4307292,0,0,utRho26
sibC,6113702,6113702,6113702,0,0,utRho26
sibD,6389730,6389730,6389730,0,0,utRho26
sibE,6390480,6390480,6390480,0,0,utRho26
sixA,4913998,4913998,4913624,374,0,utRho26
slp,7307872,7307922,7307872,50,22,utRho26
slt,9261400,9261466,9261400,66,0,utRho26
slyA,3442028,3442028,3441648,380,48,utRho26
slyB,3439496,3439752,3439496,256,90,utRho26
slyD,6957398,6957398,6956994,404,594,utRho26
slyX,6954862,6955280,6954862,418,7988,utRho26
smf,6867372,6867372,6867120,252,0,utRho26
smpB,5509534,5509792,5509534,258,700,utRho26
smrA,2811872,2811958,2811872,86,150,utRho26
smrB,4896872,4897212,4896872,340,2,utRho26
smtA,1946808,1947074,1946808,266,0,utRho26
sodA,8201518,8201620,8201518,102,946,utRho26
sodB,3470646,3470756,3470646,110,196,utRho26
sodC,3449358,3449358,3449310,48,0,utRho26
sohB,2658568,2658664,2658568,96,80,utRho26
sokB,2984232,2984238,2984232,6,54,utRho26
solA,2241218,2241218,2241172,46,38,utRho26
soxR,8554894,8554938,8554894,44,0,utRho26
soxS,8554846,8554846,8554766,80,0,utRho26
speA,6172096,6172096,6171822,274,468,utRho26
speB,6167892,6167892,6167594,298,170,utRho26
speC,6218350,6218350,6218310,40,0,utRho26
spf,8099798,8099798,8099798,0,0,utRho26
sppA,3697422,3697674,3697422,252,4,utRho26
spy,3651376,3651376,3651250,126,0,utRho26
sra,3112092,3112092,3111926,166,0,utRho26
sraB,2293178,2293178,2293178,0,0,utRho26
sraC,3846132,3846132,3846132,0,0,utRho26
srlA,5651582,5651664,5651582,82,0,utRho26
srlR,5657720,5658094,5657720,374,108,utRho26
srmB,5425752,5425792,5425752,40,258,utRho26
sroA,151216,151216,151216,0,0,utRho26
sroG,6369436,6369436,6369436,0,0,utRho26
sroH,8380974,8380974,8380974,0,0,utRho26
ssb,8548022,8548250,8548022,228,60,utRho26
sseA,5304782,5304988,5304782,206,1740,utRho26
sspA,6755138,6755138,6754840,298,0,utRho26
ssrA,5511014,5511186,5511014,172,306,utRho26
ssrS,12223036,12223932,12223036,896,1928,utRho26
sstT,6479726,6479888,6479726,162,0,utRho26
ssuB,1988282,1988282,1988088,194,0,utRho26
ssuE,1995126,1995126,1995024,102,0,utRho26
sthA,8321604,8321604,8321580,24,78,utRho26
stpA,5597156,5597156,5596990,166,0,utRho26
sucA,3034344,3034824,3034344,480,260,utRho26
sufA,3528836,3528836,3528772,64,56,utRho26
sufE,3518962,3518962,3518580,382,14,utRho26
sugE,8753588,8753750,8753588,162,2,utRho26
sulA,2041894,2041894,2041838,56,4268,utRho26
syd,5850738,5850738,5850560,178,100,utRho26
symE,9159834,9159834,9159680,154,0,utRho26
symR,9159670,9159670,9159670,0,0,utRho26
tabA,8949566,8949724,8949566,158,0,utRho26
talA,5157140,5157332,5157140,192,0,utRho26
talB,16382,16476,16382,94,4036,utRho26
tam,3214442,3214692,3214442,250,0,utRho26
tamA,8884540,8884764,8884540,224,198,utRho26
tar,3945432,3945432,3945382,50,82,utRho26
tas,5943138,5943194,5943138,56,4,utRho26
tatA,16087636,16087780,16087636,144,72,utRho26
tatE,1317742,1317894,1317742,152,80,utRho26
tauA,770410,770464,770410,54,96,utRho26
tdcA,6534186,6534186,6534130,56,4,utRho26
tdcG,6519652,6519652,6519298,354,4,utRho26
tdcR,6534380,6534760,6534380,380,4,utRho26
tdk,2586986,2587054,2586986,68,58,utRho26
tehA,3001072,3001146,3001072,74,0,utRho26
tesA,1039898,1039898,1039530,368,170,utRho26
tesB,950402,950402,950322,80,32,utRho26
tfaE,2418532,2418532,2418238,294,260,utRho26
tfaQ,3269912,3269912,3269770,142,12,utRho26
tff,379424,379256,379424,168,0,utRho26
tgt,852110,852274,852110,164,0,utRho26
thiD,4369346,4369346,4369032,314,118,utRho26
thiI,882936,883098,882936,162,4,utRho26
thiM,4370902,4370902,4370602,300,146,utRho26
thiQ,146170,146170,145854,316,1902,utRho26
thrL,592,760,592,168,324,utRho26
thrS,7210932,7210932,7210280,652,368,utRho26
thrU,8350762,8350776,8350762,14,578,utRho26
thrV,6847414,6847414,6847310,104,202524,utRho26
thrW,525682,525742,525682,60,150,utRho26
thyA,5930696,5930696,5930310,386,8,utRho26
tig,909986,910266,909986,280,292,utRho26
tisB,7706674,7707106,7706674,432,842,utRho26
tktA,6163414,6163414,6163270,144,118,utRho26
tktB,5158616,5159272,5158616,656,240,utRho26
tldD,6784368,6784368,6784056,312,0,utRho26
tmcA,5191876,5191876,5191718,158,62,utRho26
tnaC,15553644,15553740,15553644,96,24,utRho26
tolB,1555074,1555480,1555074,406,228,utRho26
tolC,6356008,6356230,6356008,222,88,utRho26
tomB,961588,961588,961416,172,140,utRho26
tonB,2622108,2622178,2622108,70,2,utRho26
topA,2661578,2662096,2661578,518,30,utRho26
torC,2116112,2116168,2116112,56,124,utRho26
torR,2115968,2115968,2115908,60,66,utRho26
torS,2112364,2112364,2112356,8,0,utRho26
torT,2112414,2112522,2112414,108,0,utRho26
tpiA,8223138,8223138,8223014,124,0,utRho26
tppB,3425342,3425538,3425342,196,476,utRho26
tpr,2574376,2574376,2574376,0,0,utRho26
tpx,2777688,2777688,2777622,66,370,utRho26
tqsA,3347780,3347826,3347780,46,0,utRho26
treA,2494850,2494850,2494752,98,144,utRho26
treB,8932420,8932420,8932360,60,56,utRho26
treF,7339102,7339184,7339102,82,0,utRho26
treR,8934694,8934694,8934492,202,56,utRho26
trg,2984878,2984940,2984878,62,0,utRho26
trkG,2847342,2847564,2847342,222,396,utRho26
trmA,8326590,8326590,8326540,50,0,utRho26
trpA,2634678,2634678,2634444,234,2,utRho26
trpC,2639888,2639888,2639570,318,0,utRho26
trpL,5292432,5292432,5292328,104,0,utRho26
trpR,9265408,9265520,9265408,112,2,utRho26
trpS,7027394,7027394,7027276,118,106,utRho26
trpT,7893560,7893914,7893560,354,121180,utRho26
trxA,7931294,7931522,7931294,228,1346,utRho26
trxB,1864156,1864156,1864100,56,0,utRho26
trxC,5437350,5437470,5437350,120,272,utRho26
tsaD,6421256,6421256,6421086,170,4,utRho26
tsgA,6985038,6985136,6985038,98,14,utRho26
tsr,9182824,9183314,9182824,490,6,utRho26
tsx,864490,864490,864026,464,94,utRho26
ttcA,2823970,2823970,2823896,74,874,utRho26
ttdA,6412848,6412926,6412848,78,130,utRho26
ttdR,6412760,6412760,6412512,248,162,utRho26
tufA,6943448,6943448,6942658,790,24942,utRho26
tus,3368346,3368518,3368346,172,0,utRho26
tusA,7218040,7218040,7217992,48,330,utRho26
tusB,6950218,6950218,6949930,288,200,utRho26
tynA,2902996,2902996,2902698,298,0,utRho26
typA,8116460,8116814,8116460,354,464,utRho26
tyrB,8534164,8534228,8534164,64,208,utRho26
tyrP,3979004,3979362,3979004,358,0,utRho26
tyrR,2773384,2773440,2773384,56,100,utRho26
tyrS,3434566,3434566,3434444,122,0,utRho26
tyrT,2575330,2575330,2575244,86,62,utRho26
uacT,6062378,6062734,6062378,356,38,utRho26
ubiC,8504886,8505012,8504886,126,0,utRho26
ubiD,8049618,8049976,8049618,358,686,utRho26
ubiE,8037494,8037710,8037494,216,4,utRho26
ubiG,4679078,4679134,4679078,56,0,utRho26
ucpA,5089342,5089342,5089246,96,0,utRho26
udp,8032782,8032862,8032782,80,232,utRho26
ugd,4199470,4199470,4199226,244,0,utRho26
ugpB,7184852,7184852,7184650,202,588,utRho26
ugpQ,7176600,7176600,7176226,374,0,utRho26
uhpT,7694396,7694396,7694334,62,0,utRho26
uidA,3392304,3392304,3392142,162,0,utRho26
uidC,3386012,3386012,3385702,310,0,utRho26
uidR,3394150,3394150,3394104,46,0,utRho26
ulaA,8839854,8839960,8839854,106,44,utRho26
ulaG,8839350,8839350,8839250,100,0,utRho26
ulaR,8837124,8837124,8836906,218,0,utRho26
umpG,5741372,5741372,5740548,824,28,utRho26
umpH,1400704,1400704,1400652,52,154,utRho26
umuD,2461476,2461534,2461476,58,0,utRho26
ung,5433476,5433508,5433476,32,0,utRho26
uof,2843316,2843316,2842900,416,412,utRho26
upp,5241818,5241818,5241744,74,92,utRho26
usg,4873780,4873780,4873298,482,0,utRho26
ushA,1009772,1009828,1009772,56,0,utRho26
uspA,7279966,7280222,7279966,256,712,utRho26
uspB,7279696,7279696,7279440,256,136,utRho26
uspC,3959172,3959506,3959172,334,92,utRho26
uspE,2797318,2797318,2797244,74,0,utRho26
uspF,2871282,2871282,2871238,44,138,utRho26
uspG,1283806,1283806,1283734,72,312,utRho26
uvrA,8547872,8547872,8547742,130,242,utRho26
uvrB,1626304,1627052,1626304,748,158,utRho26
uvrC,3989758,3989758,3989412,346,0,utRho26
uvrD,7995814,7995966,7995814,152,4,utRho26
uvrY,3990812,3990812,3990718,94,38,utRho26
uxaB,3221474,3221474,3221360,114,0,utRho26
uxaC,6489714,6489714,6489482,232,108,utRho26
uxuA,9103036,9103272,9103036,236,338,utRho26
uxuR,9108916,9109152,9108916,236,0,utRho26
valS,8967854,8967854,8967674,180,98,utRho26
valU,5041848,5041862,5041848,14,0,utRho26
valV,3492830,3492870,3492830,40,40,utRho26
ves,3649968,3649968,3649874,94,0,utRho26
waaA,7616512,7617080,7616512,568,272,utRho26
waaH,7580298,7580298,7580162,136,0,utRho26
waaQ,7616476,7616476,7616196,280,392,utRho26
waaU,7598996,7598996,7598624,372,6,utRho26
waaY,7602272,7602272,7601930,342,7950,utRho26
wbbH,4214888,4214888,4214452,436,782,utRho26
wbbK,4209212,4209212,4209018,194,122,utRho26
wcaM,4231868,4231868,4231792,76,0,utRho26
wrbA,2135516,2135516,2135416,100,0,utRho26
wza,4275166,4275166,4274486,680,0,utRho26
wzxC,4240674,4240674,4240316,358,254,utRho26
wzzB,4196950,4196950,4196602,348,90,utRho26
xanP,7657642,7657890,7657642,248,0,utRho26
xanQ,6048520,6048702,6048520,182,16,utRho26
xapA,5049820,5049820,5049756,64,0,utRho26
xapR,10090252,10090252,10089908,344,0,utRho26
xdhA,6000514,6000690,6000514,176,362,utRho26
xerD,6079702,6079702,6079486,216,64,utRho26
xseA,5268394,5268464,5268394,70,64,utRho26
xseB,882746,882746,882686,60,0,utRho26
xthA,3664798,3664856,3664798,58,0,utRho26
xylA,7461614,7461614,7461530,84,1832,utRho26
xylE,8484540,8484540,8484508,32,0,utRho26
xylF,7462138,7462262,7462138,124,34,utRho26
xylR,7469812,7469958,7469812,146,0,utRho26
yaaA,13230,13230,12918,312,36,utRho26
yaaI,23876,23876,23572,304,168,utRho26
yaaJ,16034,16034,15918,116,202,utRho26
yaaU,91184,91614,91184,430,0,utRho26
yaaW,23084,23084,22712,372,86,utRho26
yaaX,10060,10468,10060,408,0,utRho26
yabI,142542,142702,142542,160,0,utRho26
yacC,273880,273880,273834,46,2,utRho26
yacH,262932,262932,262520,412,132,utRho26
yacL,268678,268776,268678,98,144,utRho26
yadD,293796,293936,293796,140,0,utRho26
yadE,289930,290162,289930,232,66,utRho26
yadN,314110,314110,313766,344,82,utRho26
yadS,355572,355572,355248,324,622,utRho26
yadV,312470,312470,312402,68,550,utRho26
yaeF,434270,434270,434006,264,0,utRho26
yaeP,428374,428374,428250,124,56,utRho26
yaeQ,428176,428582,428176,406,56,utRho26
yaeR,423716,423754,423716,38,0,utRho26
yafC,462166,462166,461762,404,238,utRho26
yafD,462128,462244,462128,116,364,utRho26
yafK,491986,491986,491610,376,20,utRho26
yafL,493282,493424,493282,142,0,utRho26
yafN,503938,504010,503938,72,0,utRho26
yafS,469568,469632,469568,64,296,utRho26
yafT,474470,474670,474470,200,0,utRho26
yafV,480432,480432,480378,54,66,utRho26
yafZ,536052,536052,536010,42,0,utRho26
yagE,564446,564556,564446,110,0,utRho26
yagG,570414,570790,570414,376,0,utRho26
yagI,578384,578384,578324,60,2,utRho26
yagK,586236,586236,585896,340,358,utRho26
yagL,588062,588062,587836,226,0,utRho26
yagN,591342,591342,591158,184,26,utRho26
yahA,663746,664742,663746,996,1472,utRho26
yahC,670136,670136,670044,92,8,utRho26
yahE,671478,671850,671478,372,0,utRho26
yahM,690504,690808,690504,304,100,utRho26
yahN,692872,692872,692674,198,430,utRho26
yahO,692864,692968,692864,104,198,utRho26
yaiE,816296,816354,816296,58,0,utRho26
yaiI,811396,811528,811396,132,0,utRho26
yaiO,761946,761946,761684,262,0,utRho26
yaiP,767970,767970,767870,100,0,utRho26
yaiS,769660,769660,769232,428,52,utRho26
yaiV,788922,788922,788922,0,0,utRho26
yaiY,799094,799094,798666,428,120,utRho26
yaiZ,798888,799186,798888,298,0,utRho26
yajC,854410,854574,854410,164,50,utRho26
yajD,860938,861210,860938,272,2,utRho26
yajI,866068,866068,865702,366,36,utRho26
yajL,887496,887496,887282,214,16,utRho26
yajQ,889316,889366,889316,50,0,utRho26
yajR,893374,893374,893332,42,0,utRho26
ybaB,987418,988152,987418,734,336,utRho26
ybaL,1006590,1006590,1006476,114,72,utRho26
ybaM,980648,980648,980542,106,6,utRho26
ybaN,981436,981764,981436,328,328,utRho26
ybaO,936704,936766,936704,62,0,utRho26
ybaP,1016568,1016568,1016160,408,334,utRho26
ybaQ,1016348,1016436,1016348,88,108,utRho26
ybaS,1023146,1023282,1023146,136,0,utRho26
ybaV,927504,927874,927504,370,0,utRho26
ybaY,950490,950758,950490,268,0,utRho26
ybbB,1062724,1062724,1062452,272,176,utRho26
ybbJ,1030154,1030154,1029718,436,328,utRho26
ybbL,1031784,1031838,1031784,54,8,utRho26
ybbN,1037136,1037136,1036558,578,844,utRho26
ybbO,1038658,1038658,1038298,360,160,utRho26
ybbY,1080718,1081130,1080718,412,190,utRho26
ybcH,1176140,1176140,1175962,178,88,utRho26
ybcI,1113264,1113264,1113106,158,18,utRho26
ybcJ,1114050,1114050,1113746,304,84,utRho26
ybcK,1137502,1137804,1137502,302,114,utRho26
ybcL,1141690,1141786,1141690,96,0,utRho26
ybcN,1144628,1144932,1144628,304,0,utRho26
ybcQ,1147548,1147912,1147548,364,32,utRho26
ybcW,1159610,1159760,1159610,150,0,utRho26
ybdD,1263982,1264364,1263982,382,6,utRho26
ybdF,1212106,1212106,1211772,334,0,utRho26
ybdH,1267048,1267048,1266954,94,2,utRho26
ybdJ,1212822,1212822,1212398,424,182,utRho26
ybdK,1215122,1215122,1214766,356,4,utRho26
ybdL,1267114,1267172,1267114,58,0,utRho26
ybdM,1271110,1271110,1270752,358,4,utRho26
ybdN,1273372,1273372,1273138,234,22,utRho26
ybdR,1283844,1284176,1283844,332,520,utRho26
ybeD,1325412,1325412,1325284,128,558,utRho26
ybeF,1323090,1323090,1322756,334,118,utRho26
ybeL,1349986,1350036,1349986,50,88,utRho26
ybeQ,1353412,1353412,1353094,318,2,utRho26
ybeR,1353120,1353422,1353120,302,2,utRho26
ybeT,1358832,1358832,1358812,20,0,utRho26
ybeU,1358924,1359016,1358924,92,0,utRho26
ybeZ,1386938,1386938,1386834,104,264,utRho26
ybfA,1458074,1458268,1458074,194,0,utRho26
ybfE,1423878,1423878,1423796,82,198,utRho26
ybfF,1425692,1425692,1425604,88,148,utRho26
ybfH,1433282,1433282,1433194,88,56,utRho26
ybgA,1477840,1478002,1477840,162,2,utRho26
ybgC,1549288,1549504,1549288,216,0,utRho26
ybgD,1505916,1505916,1505590,326,892,utRho26
ybgI,1485238,1485654,1485238,416,0,utRho26
ybgO,1498370,1498370,1497964,406,84,utRho26
ybgS,1570992,1570992,1570634,358,0,utRho26
ybhA,1597184,1597184,1596862,322,0,utRho26
ybhB,1616070,1616070,1615818,252,0,utRho26
ybhC,1614642,1614642,1614562,80,8,utRho26
ybhD,1601418,1601418,1601276,142,0,utRho26
ybhH,1601104,1601518,1601104,414,0,utRho26
ybhK,1633384,1633384,1633294,90,66,utRho26
ybhM,1641556,1641586,1641556,30,42,utRho26
ybhN,1645296,1645296,1644996,300,0,utRho26
ybhQ,1649202,1649260,1649202,58,60,utRho26
ybiA,1665920,1665920,1665900,20,0,utRho26
ybiI,1676968,1676968,1676912,56,108,utRho26
ybiO,1691328,1691328,1690960,368,80,utRho26
ybiP,1705252,1705252,1705194,58,4,utRho26
ybiS,1711572,1711572,1711488,84,198,utRho26
ybiT,1711894,1711926,1711894,32,0,utRho26
ybiU,1718212,1718212,1718122,90,0,utRho26
ybiV,1720176,1720176,1720056,120,0,utRho26
ybiW,1725566,1725566,1725212,354,572,utRho26
ybiX,1678548,1678548,1678414,134,334,utRho26
ybjC,1781784,1781826,1781784,42,0,utRho26
ybjE,1830154,1830154,1829714,440,90,utRho26
ybjG,1767016,1767016,1766776,240,32,utRho26
ybjL,1779882,1779882,1779638,244,0,utRho26
ybjM,1779770,1780178,1779770,408,0,utRho26
ybjO,1795704,1795978,1795704,274,0,utRho26
ybjP,1809046,1809046,1808934,112,0,utRho26
ybjQ,1809034,1809186,1809034,152,0,utRho26
ybjS,1813796,1813796,1813506,290,14,utRho26
ybjX,1838206,1838206,1838168,38,0,utRho26
ycaD,1891438,1891742,1891438,304,0,utRho26
ycaI,1928210,1928640,1928210,430,56,utRho26
ycaK,1899094,1899336,1899094,242,82,utRho26
ycaL,1920264,1920528,1920264,264,0,utRho26
ycaM,1894240,1894458,1894240,218,74,utRho26
ycaR,1941284,1941346,1941284,62,234,utRho26
ycbB,1961862,1962094,1961862,232,376,utRho26
ycbJ,1943344,1943504,1943344,160,0,utRho26
ycbK,1966046,1966150,1966046,104,0,utRho26
ycbZ,2036920,2036920,2036598,322,56,utRho26
yccA,2062886,2062886,2062836,50,50,utRho26
yccF,2048730,2048730,2048696,34,0,utRho26
yccS,2047988,2047988,2047766,222,78,utRho26
yccT,2055674,2055674,2055546,128,0,utRho26
yccX,2059960,2060128,2059960,168,2,utRho26
ycdT,2185682,2185752,2185682,70,86,utRho26
ycdU,2191266,2191686,2191266,420,0,utRho26
ycdZ,2200504,2200592,2200504,88,26,utRho26
yceA,2233544,2233614,2233544,70,0,utRho26
yceD,2293298,2293588,2293298,290,2276,utRho26
yceF,2293522,2293522,2293190,332,1358,utRho26
yceH,2252154,2252314,2252154,160,244,utRho26
yceI,2237282,2237282,2236952,330,100,utRho26
yceJ,2238142,2238142,2238092,50,4,utRho26
yceM,2253208,2253612,2253208,404,24,utRho26
yceO,2239264,2239264,2238894,370,186,utRho26
yceQ,2288760,2289004,2288760,244,1402,utRho26
ycfD,2376540,2376540,2376480,60,42,utRho26
ycfJ,2334814,2335198,2334814,384,0,utRho26
ycfS,2340834,2340834,2340748,86,0,utRho26
ycfT,2350658,2350658,2350330,328,160,utRho26
ycfZ,2362760,2362760,2362534,226,12,utRho26
ycgB,2474570,2474570,2474482,88,0,utRho26
ycgG,2434614,2434656,2434614,42,28,utRho26
ycgJ,2452956,2453200,2452956,244,0,utRho26
ycgL,2455218,2455362,2455218,144,56,utRho26
ycgN,2457366,2457660,2457366,294,116,utRho26
ycgR,2489112,2489112,2489054,58,0,utRho26
ycgV,2512222,2512222,2511904,318,248,utRho26
ycgX,2426568,2426568,2426214,354,378,utRho26
ycgY,2490166,2490320,2490166,154,50,utRho26
ycgZ,2431504,2431578,2431504,74,4,utRho26
ychE,2596904,2597196,2596904,292,94,utRho26
ychF,2515764,2515764,2515624,140,0,utRho26
ychH,2517476,2517582,2517476,106,576,utRho26
ychJ,2578354,2578354,2578264,90,0,utRho26
ychN,2547310,2547310,2547198,112,0,utRho26
ychO,2547520,2547850,2547520,330,132,utRho26
ychQ,2533798,2533848,2533798,50,0,utRho26
yciA,2624828,2624828,2624492,336,2,utRho26
yciB,2626110,2626110,2625780,330,428,utRho26
yciC,2627396,2627396,2627326,70,28,utRho26
yciE,2630794,2630794,2630448,346,0,utRho26
yciG,5264368,5264368,5264140,228,224,utRho26
yciI,2621784,2621784,2621730,54,0,utRho26
yciN,2661606,2661606,2661336,270,0,utRho26
yciS,2680270,2680486,2680270,216,0,utRho26
yciT,2689088,2689088,2688692,396,188,utRho26
yciU,2614718,2614718,2614300,418,222,utRho26
yciV,2646376,2646440,2646376,64,0,utRho26
yciW,2700472,2700472,2700214,258,12,utRho26
yciZ,2689276,2689276,2689218,58,158,utRho26
ycjD,2703792,2703792,2703520,272,0,utRho26
ycjG,2777748,2777860,2777748,112,40,utRho26
ycjM,2740006,2740432,2740006,426,98,utRho26
ycjW,2767982,2767982,2767922,60,0,utRho26
ycjX,2768138,2768234,2768138,96,76,utRho26
ycjY,5568288,5568288,5567460,828,152,utRho26
ydaE,2836438,2836438,2836016,422,90,utRho26
ydaN,2816048,2816100,2816048,52,0,utRho26
ydaS,2840340,2840730,2840340,390,0,utRho26
ydbC,2948376,2948442,2948376,66,2,utRho26
ydbD,2950132,2950288,2950132,156,0,utRho26
ydbH,2885800,2886102,2885800,302,1722,utRho26
ydbJ,2881712,2882116,2881712,404,562,utRho26
ydbK,2881692,2881692,2881568,124,96,utRho26
ydcA,2983294,2983354,2983294,60,0,utRho26
ydcF,2974404,2974470,2974404,66,0,utRho26
ydcI,2990268,2990268,2990142,126,0,utRho26
ydcJ,2990266,2990576,2990266,310,0,utRho26
ydcK,3001280,3001280,3000898,382,0,utRho26
ydcL,3004646,3004914,3004646,268,0,utRho26
ydcN,3012308,3012344,3012308,36,118,utRho26
ydcP,3013508,3013562,3013508,54,0,utRho26
ydcR,3019956,3020006,3019956,50,0,utRho26
ydcS,3022906,3023308,3022906,402,94,utRho26
ydcX,3034442,3034778,3034442,336,4,utRho26
ydcY,3035220,3035296,3035220,76,10,utRho26
ydcZ,3036750,3036750,3036662,88,26,utRho26
yddB,3155332,3155332,3155238,94,0,utRho26
yddE,3071738,3071738,3071716,22,0,utRho26
yddG,3094410,3094410,3094338,72,0,utRho26
yddJ,3089732,3089732,3089438,294,110,utRho26
yddW,3137704,3137704,3137646,58,0,utRho26
ydeA,3233910,3234056,3233910,146,6,utRho26
ydeE,3242528,3242664,3242528,136,0,utRho26
ydeI,3249118,3249118,3248994,124,0,utRho26
ydeJ,3249376,3249546,3249376,170,0,utRho26
ydeN,3165458,3165458,3165048,410,0,utRho26
ydeP,3173328,3173328,3172972,356,188,utRho26
ydeR,3176596,3176596,3176592,4,0,utRho26
ydfA,3296872,3297016,3296872,144,0,utRho26
ydfG,3254982,3255034,3254982,52,58,utRho26
ydfH,3256652,3256704,3256652,52,0,utRho26
ydfK,3265446,3266144,3265446,698,300,utRho26
ydgA,3379588,3379704,3379588,116,0,utRho26
ydgC,3364124,3364124,3364060,64,0,utRho26
ydgD,3343906,3343920,3343906,14,0,utRho26
ydgH,3356754,3356854,3356754,100,24,utRho26
ydgJ,3408798,3408798,3408616,182,24,utRho26
ydgK,3410414,3410500,3410414,86,370,utRho26
ydhB,3479618,3479618,3479596,22,0,utRho26
ydhC,3479698,3479822,3479698,124,0,utRho26
ydhF,3451310,3451310,3451264,46,0,utRho26
ydhI,3441996,3442050,3441996,54,0,utRho26
ydhL,3451864,3451864,3451840,24,0,utRho26
ydhQ,3492404,3492404,3492254,150,0,utRho26
ydhS,3494136,3494262,3494136,126,38,utRho26
ydhT,3499138,3499138,3499118,20,0,utRho26
ydhY,3509284,3509284,3508954,330,0,utRho26
ydhZ,3510418,3510418,3510282,136,0,utRho26
ydiE,3579206,3579226,3579206,20,0,utRho26
ydiH,3530582,3530582,3530406,176,74,utRho26
ydiM,3541852,3542142,3541852,290,4,utRho26
ydiN,3544818,3545024,3544818,206,0,utRho26
ydiP,3558656,3558656,3558602,54,138,utRho26
ydiU,3582508,3582508,3582488,20,0,utRho26
ydiV,3584174,3584174,3584040,134,58,utRho26
ydiY,3612500,3612500,3612166,334,78,utRho26
ydjA,3697400,3697400,3697352,48,0,utRho26
ydjE,3708082,3708082,3707958,124,0,utRho26
ydjF,3709848,3709848,3709708,140,0,utRho26
ydjM,3620340,3620422,3620340,82,0,utRho26
ydjO,3626696,3626696,3626288,408,2,utRho26
ydjX,3666434,3666802,3666434,368,8,utRho26
yeaE,3731448,3731448,3731272,176,166,utRho26
yeaG,3733530,3733816,3733530,286,92,utRho26
yeaI,3740486,3740770,3740486,284,136,utRho26
yeaJ,3743874,3744082,3743874,208,0,utRho26
yeaL,3748646,3748704,3748646,58,42,utRho26
yeaM,3751296,3751296,3751152,144,0,utRho26
yeaN,3750926,3751346,3750926,420,0,utRho26
yeaO,3753554,3753818,3753554,264,0,utRho26
yeaP,3755314,3755430,3755314,116,26,utRho26
yeaQ,3758780,3758780,3758510,270,4,utRho26
yeaR,3759988,3759988,3759896,92,0,utRho26
yeaY,3781122,3781122,3781064,58,6,utRho26
yebB,3892220,3892502,3892220,282,90,utRho26
yebC,3896370,3896370,3896302,68,46,utRho26
yebE,3859464,3859464,3859414,50,0,utRho26
yebG,3861530,3861530,3861494,36,0,utRho26
yebK,3873180,3873304,3873180,124,0,utRho26
yebQ,3820314,3820552,3820314,238,0,utRho26
yebS,3832238,3832516,3832238,278,0,utRho26
yebV,3843430,3843560,3843430,130,0,utRho26
yebW,3843914,3844242,3843914,328,214,utRho26
yecC,3995646,3995646,3995628,18,0,utRho26
yecD,3901272,3901664,3901272,392,92,utRho26
yecF,3991434,3991636,3991434,202,0,utRho26
yecH,3979304,3979304,3978980,324,0,utRho26
yecJ,3975604,3975604,3975516,88,0,utRho26
yecM,3919968,3919968,3919692,276,0,utRho26
yecR,3976400,3976444,3976400,44,354,utRho26
yecT,3923862,3923944,3923862,82,0,utRho26
yedD,4016522,4016522,4016180,342,4,utRho26
yedE,4016310,4016554,4016310,244,6,utRho26
yedI,4058922,4058922,4058732,190,0,utRho26
yedJ,4066446,4066446,4066158,288,0,utRho26
yedV,4076404,4076404,4076304,100,0,utRho26
yedX,4077680,4077912,4077680,232,12,utRho26
yedY,4078572,4078956,4078572,384,0,utRho26
yeeA,4161322,4161322,4161182,140,72,utRho26
yeeE,4171104,4171104,4171050,54,132,utRho26
yeeJ,4089526,4089822,4089526,296,20,utRho26
yeeN,4113508,4113716,4113508,208,2,utRho26
yeeO,4119444,4119444,4119692,248,266,utRho26
yeeX,4158834,4158834,4158722,112,150,utRho26
yeeZ,4178422,4178422,4178256,166,0,utRho26
yefM,4179466,4179466,4179426,40,0,utRho26
yegD,4295288,4295348,4295288,60,0,utRho26
yegH,4275726,4275804,4275726,78,0,utRho26
yegI,4302154,4302154,4301970,184,0,utRho26
yegJ,4302032,4302370,4302032,338,24,utRho26
yegQ,4331182,4331336,4331182,154,72,utRho26
yegR,4336698,4336698,4336612,86,312,utRho26
yegS,4337086,4337424,4337086,338,252,utRho26
yegT,4357562,4357642,4357562,80,168,utRho26
yegX,4367640,4367640,4367302,338,0,utRho26
yehA,4376944,4376944,4376828,116,0,utRho26
yehE,4385818,4385818,4385592,226,0,utRho26
yehK,4407568,4407944,4407568,376,0,utRho26
yehL,4408804,4409192,4408804,388,0,utRho26
yeiB,4486146,4486146,4485934,212,0,utRho26
yeiE,4499422,4499422,4499236,186,0,utRho26
yeiG,4487776,4487820,4487776,44,4,utRho26
yeiH,4499332,4499434,4499332,102,30,utRho26
yeiI,4503306,4503400,4503306,94,0,utRho26
yeiL,4510580,4510710,4510580,130,0,utRho26
yeiP,4530834,4530900,4530834,66,80,utRho26
yeiQ,4532328,4532490,4532328,162,0,utRho26
yeiR,4535484,4535658,4535484,174,2,utRho26
yeiW,4530840,4530840,4530590,250,74,utRho26
yejA,4544624,4544728,4544624,104,0,utRho26
yejG,4556892,4556892,4556474,418,760,utRho26
yejH,4561244,4561264,4561244,20,0,utRho26
yejK,4568218,4568218,4567894,324,0,utRho26
yejO,4578352,4578352,4577800,552,160,utRho26
yfaD,4713380,4713808,4713380,428,244,utRho26
yfaE,4696676,4697028,4696676,352,238,utRho26
yfaL,4688568,4688568,4688338,230,32,utRho26
yfaP,4656398,4656398,4656286,112,0,utRho26
yfaU,4717892,4717892,4717690,202,0,utRho26
yfaY,4727310,4727310,4727266,44,400,utRho26
yfaZ,4728744,4728744,4728550,194,110,utRho26
yfbK,4771810,4771810,4771444,366,60,utRho26
yfbL,4771500,4771720,4771500,220,60,utRho26
yfbN,4777174,4777174,4776852,322,0,utRho26
yfbO,4776916,4777162,4776916,246,0,utRho26
yfbP,4777990,4778232,4777990,242,322,utRho26
yfbR,4817662,4817724,4817662,62,56,utRho26
yfcI,4847424,4847424,4847078,346,8,utRho26
yfcJ,4880482,4880482,4880240,242,122,utRho26
yfcL,4888502,4888502,4888338,164,0,utRho26
yfcV,4911642,4911642,4911292,350,0,utRho26
yfcZ,4921958,4921958,4921868,90,36,utRho26
yfdF,4925604,4926024,4925604,420,136,utRho26
yfdG,4935474,4935710,4935474,236,0,utRho26
yfdP,4946844,4947040,4946844,196,0,utRho26
yfdX,4988866,4988866,4988804,62,76,utRho26
yfdY,4990672,4990672,4990584,88,34,utRho26
yfeA,5035784,5035784,5035664,120,262,utRho26
yfeC,5036668,5036934,5036668,266,24,utRho26
yfeH,5053818,5053892,5053818,74,0,utRho26
yfeK,5074630,5074684,5074630,54,130,utRho26
yfeO,5018906,5019260,5018906,354,114,utRho26
yfeR,5054078,5054078,5053712,366,0,utRho26
yfeX,5101356,5101356,5101090,266,0,utRho26
yfeY,5102486,5102486,5102432,54,0,utRho26
yfeZ,5103842,5103842,5103452,390,118,utRho26
yffO,5123804,5124222,5123804,418,304,utRho26
yffQ,5126778,5127154,5126778,376,0,utRho26
yffS,5128800,5128986,5128800,186,0,utRho26
yfgC,5232052,5232188,5232052,136,0,utRho26
yfgF,5258062,5258062,5257876,186,776,utRho26
yfgG,5258170,5258580,5258170,410,818,utRho26
yfgH,5259344,5259584,5259344,240,2,utRho26
yfgM,5278866,5278866,5278566,300,94,utRho26
yfhH,5397414,5397518,5397414,104,0,utRho26
yfhM,5304648,5304648,5304574,74,0,utRho26
yfhR,5328408,5328726,5328408,318,228,utRho26
yfiC,5425610,5425610,5425528,82,120,utRho26
yfiE,5430688,5430688,5430640,48,0,utRho26
yfiL,5482630,5482720,5482630,90,58,utRho26
yfiM,5448066,5448358,5448066,292,1288,utRho26
yfiR,5483354,5483750,5483354,396,0,utRho26
yfjH,5517326,5517326,5517200,126,106,utRho26
yfjI,5517710,5517970,5517710,260,0,utRho26
yfjJ,5521014,5521094,5521014,80,0,utRho26
yfjM,5531970,5531970,5531552,418,1062,utRho26
yfjP,5535080,5535420,5535080,340,420,utRho26
yfjW,5546570,5546636,5546570,66,0,utRho26
yfjX,5551776,5551838,5551776,62,0,utRho26
ygaC,5601180,5601180,5599988,1192,5146,utRho26
ygaM,5600242,5600292,5600242,50,1434,utRho26
ygaU,5593628,5593628,5593572,56,172,utRho26
ygaZ,5619190,5619234,5619190,44,2,utRho26
ygbA,5713656,5713656,5713612,44,0,utRho26
ygbE,5746784,5746784,5746674,110,0,utRho26
ygbI,5722882,5722882,5722528,354,0,utRho26
ygbK,5724394,5724670,5724394,276,0,utRho26
ygbL,5727074,5727186,5727074,112,0,utRho26
ygbN,5729814,5730202,5729814,388,2,utRho26
ygcG,5811210,5811422,5811210,212,2,utRho26
ygcN,5785144,5785314,5785144,170,2,utRho26
ygcU,5799214,5799214,5798836,378,62,utRho26
ygcW,5800942,5800942,5800546,396,76,utRho26
ygdD,5883442,5883442,5883262,180,4,utRho26
ygdG,5861746,5861930,5861746,184,112,utRho26
ygdI,5886526,5886526,5886290,236,0,utRho26
ygdQ,5940784,5940840,5940784,56,6,utRho26
ygdR,5942494,5942542,5942494,48,0,utRho26
ygeA,5961606,5961606,5961270,336,0,utRho26
ygeH,5983758,5984188,5983758,430,78,utRho26
ygeI,5987162,5987276,5987162,114,148,utRho26
ygeR,6000078,6000078,5999782,296,206,utRho26
ygeV,6011694,6011694,6011572,122,106,utRho26
ygeW,6012234,6012524,6012234,290,232,utRho26
ygfB,6110946,6110946,6110888,58,18,utRho26
ygfK,6031984,6032120,6031984,136,32,utRho26
ygfS,6058328,6058328,6058024,304,0,utRho26
ygfZ,6082564,6082626,6082564,62,92,utRho26
yggC,6149512,6149512,6149378,134,4,utRho26
yggE,6136370,6136370,6136160,210,56,utRho26
yggI,6179176,6179510,6179176,334,192,utRho26
yggL,6204508,6204508,6204266,242,408,utRho26
yggM,6199514,6199514,6199130,384,122,utRho26
yggN,6203596,6203596,6203246,350,182,utRho26
yggX,18623958,18624558,18623958,600,234,utRho26
yghA,6298966,6299324,6298966,358,0,utRho26
yghB,6307058,6307126,6307058,68,74,utRho26
yghD,6222614,6222614,6222252,362,32,utRho26
yghF,6225798,6225798,6225840,42,0,utRho26
yghJ,6238640,6238640,6238224,416,0,utRho26
yghQ,6265186,6265186,6264816,370,92,utRho26
yghT,6267830,6268262,6267830,432,0,utRho26
yghU,6277400,6277454,6277400,54,0,utRho26
yghW,6293506,6293506,6293474,32,0,utRho26
yghZ,6295562,6295794,6295562,232,0,utRho26
ygiD,6365122,6365122,6364868,254,248,utRho26
ygiH,6409066,6409388,6409066,322,4,utRho26
ygiL,6370622,6370828,6370622,206,42,utRho26
ygiM,6402084,6402414,6402084,330,178,utRho26
ygiN,6346156,6346284,6346156,128,2,utRho26
ygiQ,6322620,6322620,6322292,328,70,utRho26
ygiS,6335462,6335462,6335436,26,50,utRho26
ygiV,6338582,6338582,6338462,120,28,utRho26
ygiW,6339774,6339774,6339352,422,12,utRho26
ygiZ,6344506,6344506,6344422,84,44,utRho26
ygjH,6442528,6442528,6442494,34,0,utRho26
ygjI,6452140,6452468,6452140,328,140,utRho26
ygjQ,6472730,6473080,6472730,350,204,utRho26
ygjR,6474564,6474586,6474564,22,46,utRho26
ygjV,6483638,6483638,6483488,150,0,utRho26
yhaB,6535632,6535708,6535632,76,0,utRho26
yhaH,6504498,6504608,6504498,110,96,utRho26
yhaI,6505400,6505822,6505400,422,140,utRho26
yhaJ,6508560,6508560,6508428,132,2,utRho26
yhaK,6508538,6508638,6508538,100,0,utRho26
yhbQ,6599878,6599932,6599878,54,178,utRho26
yhbT,6602736,6602736,6602552,184,68,utRho26
yhbU,6602558,6602970,6602558,412,68,utRho26
yhbX,6643302,6643302,6643226,76,6,utRho26
yhbY,6655518,6655580,6655518,62,400,utRho26
yhcA,6723956,6724224,6723956,268,4,utRho26
yhcB,6760364,6760382,6760364,18,0,utRho26
yhcC,6708470,6708470,6708100,370,50,utRho26
yhcF,6733440,6733852,6733440,412,242,utRho26
yhcH,6739124,6739124,6738956,168,0,utRho26
yhcM,6760312,6760312,6759994,318,0,utRho26
yhcN,6770812,6771076,6770812,264,250,utRho26
yhcO,6772606,6772606,6772258,348,0,utRho26
yhdH,6806560,6806968,6806560,408,390,utRho26
yhdJ,6823234,6823306,6823234,72,0,utRho26
yhdN,6879092,6879092,6879018,74,210,utRho26
yhdT,6814702,6814750,6814702,48,80,utRho26
yhdU,6824994,6825242,6824994,248,0,utRho26
yhdV,6836392,6836780,6836392,388,0,utRho26
yhdW,6837944,6838298,6837944,354,0,utRho26
yheO,6953082,6953082,6952880,202,0,utRho26
yheV,6957970,6957970,6957584,386,98,utRho26
yhfA,6971902,6971902,6971636,266,4,utRho26
yhfG,6983294,6983294,6983240,54,2,utRho26
yhfL,6998622,6998896,6998622,274,50,utRho26
yhfY,7023244,7023244,7022844,400,0,utRho26
yhgA,7086294,7086334,7086294,40,0,utRho26
yhgE,7065176,7065176,7064878,298,62,utRho26
yhgF,7074352,7074770,7074352,418,704,utRho26
yhhA,7173458,7173886,7173458,428,130,utRho26
yhhI,7248346,7248756,7248346,410,0,utRho26
yhhJ,7253696,7253696,7253606,90,2,utRho26
yhhM,7211588,7211588,7211220,368,388,utRho26
yhhN,7211150,7211502,7211150,352,196,utRho26
yhhQ,7218238,7218434,7218238,196,40,utRho26
yhhT,7223682,7223730,7223682,48,2,utRho26
yhhX,7162032,7162032,7161610,422,0,utRho26
yhhY,7162222,7162276,7162222,54,0,utRho26
yhhZ,7163516,7163726,7163516,210,4,utRho26
yhiD,7312220,7312220,7311804,416,4408,utRho26
yhiJ,7265190,7265190,7265180,10,0,utRho26
yhiM,7269270,7269682,7269270,412,618,utRho26
yhiN,7275000,7275000,7274820,180,38,utRho26
yhjA,7338522,7338522,7338376,146,74,utRho26
yhjB,7344090,7344090,7343788,302,356,utRho26
yhjC,7344272,7344684,7344272,412,20,utRho26
yhjD,7346660,7346724,7346660,64,0,utRho26
yhjE,7349274,7349572,7349274,298,22,utRho26
yhjG,7356824,7356824,7356730,94,0,utRho26
yhjH,7358458,7358458,7358374,84,122,utRho26
yhjJ,7364032,7364032,7363880,152,0,utRho26
yhjK,7371296,7371296,7371158,138,352,utRho26
yhjR,7392750,7392750,7392370,380,2,utRho26
yhjV,7400796,7401126,7400796,330,112,utRho26
yhjX,7424194,7424194,7424014,180,108,utRho26
yhjY,7425966,7425966,7425868,98,84,utRho26
yiaB,7455654,7455654,7455496,158,56,utRho26
yiaD,7432712,7433094,7432712,382,268,utRho26
yiaF,7438194,7438194,7438088,106,0,utRho26
yiaG,7438862,7438956,7438862,94,108,utRho26
yiaJ,7485236,7485236,7485064,172,14,utRho26
yiaK,7485348,7485466,7485348,118,86,utRho26
yiaT,7503924,7503924,7503736,188,0,utRho26
yiaU,7503792,7503984,7503792,192,8,utRho26
yiaY,7515856,7515856,7515654,202,22,utRho26
yibF,7523950,7523950,7523910,40,32,utRho26
yibG,7536128,7536354,7536128,226,600,utRho26
yibL,7553194,7553330,7553194,136,236,utRho26
yibN,7570112,7570112,7570030,82,26,utRho26
yibT,7552848,7552848,7552760,88,538,utRho26
yicC,7633290,7633352,7633290,62,108,utRho26
yicH,7660862,7660914,7660862,52,0,utRho26
yicJ,7673328,7673328,7671858,1470,3070,utRho26
yicN,7685018,7685018,7684804,214,90,utRho26
yicO,7687914,7687914,7687578,336,0,utRho26
yicR,15250308,15250308,15250236,72,0,utRho26
yidB,7755230,7755230,7754930,300,66,utRho26
yidE,7732780,7732780,7732546,234,134,utRho26
yidF,7711580,7711580,7711222,358,158,utRho26
yidQ,7735088,7735456,7735088,368,1272,utRho26
yidR,7738824,7738824,7738618,206,0,utRho26
yieE,7787658,7787738,7787658,80,72,utRho26
yieH,7793314,7793548,7793314,234,0,utRho26
yieK,7798928,7798928,7798786,142,0,utRho26
yifB,7900350,7900350,7899998,352,284,utRho26
yifL,7988984,7989044,7988984,60,258,utRho26
yigF,8005750,8005750,8005598,152,832,utRho26
yigI,8009448,8009448,8009394,54,74,utRho26
yigM,8022100,8022152,8022100,52,0,utRho26
yihA,8101970,8101970,8101458,512,282,utRho26
yihD,8084098,8084138,8084098,40,0,utRho26
yihF,8088110,8088398,8088110,288,246,utRho26
yihG,8093304,8093304,8093204,100,246,utRho26
yihI,8102616,8102694,8102616,78,0,utRho26
yihL,8120506,8120894,8120506,388,74,utRho26
yihN,8124332,8124494,8124332,162,236,utRho26
yihO,8131942,8131942,8131532,410,40,utRho26
yihQ,8138892,8138892,8138552,340,0,utRho26
yihV,8147064,8147478,8147064,414,0,utRho26
yihX,8151096,8151106,8151096,10,0,utRho26
yiiE,8158192,8158582,8158192,390,108,utRho26
yiiF,8159124,8159502,8159124,378,64,utRho26
yiiG,8173762,8174004,8173762,242,32,utRho26
yiiM,8205506,8205644,8205506,138,258,utRho26
yiiQ,8224624,8224624,8224428,196,0,utRho26
yiiS,8225738,8225934,8225738,196,2,utRho26
yijE,8272178,8272216,8272178,38,0,utRho26
yijF,8275728,8275728,8275314,414,706,utRho26
yijO,8296858,8296858,8296634,224,52,utRho26
yjaA,8426240,8426468,8426240,228,114196,utRho26
yjaB,8428312,8428312,8428246,66,0,utRho26
yjaG,8398746,8399008,8398746,262,6,utRho26
yjaH,8401022,8401132,8401022,110,118,utRho26
yjaZ,8379506,8379572,8379506,66,0,utRho26
yjbB,8455204,8455462,8455204,258,0,utRho26
yjbE,16943432,16943624,16943432,192,140,utRho26
yjbL,8520318,8520642,8520318,324,0,utRho26
yjbQ,8540428,8540476,8540428,48,0,utRho26
yjcB,8550328,8550328,8550082,246,82,utRho26
yjcC,8550836,8550942,8550836,106,0,utRho26
yjcD,8556628,8556958,8556628,330,0,utRho26
yjcE,8559658,8559960,8559658,302,52,utRho26
yjcF,8566212,8566212,8566150,62,0,utRho26
yjcO,8594660,8594660,8594250,410,0,utRho26
yjdA,8654128,8654270,8654128,142,0,utRho26
yjdC,8726660,8726660,8726616,44,0,utRho26
yjdK,8704780,8705168,8704780,388,630,utRho26
yjdL,8713034,8713034,8712822,212,0,utRho26
yjdM,8653672,8653672,8653468,204,1416,utRho26
yjeF,8787354,8788132,8787354,778,638,utRho26
yjeI,8745522,8745618,8745522,96,68,utRho26
yjeJ,8748806,8748806,8748468,338,252,utRho26
yjeV,8785472,8785784,8785472,312,36,utRho26
yjfP,8833512,8833904,8833512,392,0,utRho26
yjfY,8849656,8849656,8849582,74,0,utRho26
yjfZ,8855052,8855052,8854844,208,2,utRho26
yjgA,8916162,8916162,8915730,432,76,utRho26
yjgL,8950802,8950874,8950802,72,0,utRho26
yjgM,8959342,8959342,8959074,268,0,utRho26
yjgN,8959132,8959460,8959132,328,36,utRho26
yjgR,8980170,8980170,8980126,44,0,utRho26
yjgZ,9002116,9002520,9002116,404,258,utRho26
yjhB,9007764,9008116,9007764,352,160,utRho26
yjhG,9048452,9048452,9048188,264,652,utRho26
yjhU,9041080,9041080,9040648,432,200,utRho26
yjiA,9178096,9178096,9177730,366,0,utRho26
yjiJ,9125364,9125364,9125350,14,0,utRho26
yjiK,9127270,9127270,9127422,152,278,utRho26
yjiL,9129604,9129604,9129378,226,0,utRho26
yjiS,9143410,9143502,9143410,92,0,utRho26
yjiY,9182734,9182734,9182558,176,4,utRho26
yjjA,9200674,9200674,9200378,296,118,utRho26
yjjB,18408708,18408708,18407800,908,192,utRho26
yjjJ,9243314,9243538,9243314,224,0,utRho26
yjjK,9261132,9261132,9261044,88,4,utRho26
yjjL,9189764,9189764,9189444,320,0,utRho26
yjjM,9191894,9191894,9191702,192,374,utRho26
yjjP,9206068,9206068,9205716,352,22,utRho26
yjjQ,9206638,9206954,9206638,316,20,utRho26
yjjX,9267798,9267798,9267490,308,12,utRho26
yjjY,9280716,9280804,9280716,88,364,utRho26
yjjZ,9211554,9211608,9211554,54,56,utRho26
yjtD,9281676,9281884,9281676,208,174,utRho26
ykfB,532454,532454,532174,280,84,utRho26
ykfI,527636,527636,527338,298,188,utRho26
ykgB,637050,637050,636638,412,0,utRho26
ykgC,640430,640430,640002,428,0,utRho26
ykgD,640232,640454,640232,222,2,utRho26
ykgE,642962,643216,642962,254,276,utRho26
ykgJ,608524,608524,608364,160,192,utRho26
ykgL,623878,624224,623878,346,104,utRho26
ykgM,625610,625610,625554,56,138,utRho26
ykgR,626570,626570,626484,86,0,utRho26
ylaC,958576,958576,958502,74,248,utRho26
yliE,1745938,1745958,1745938,20,0,utRho26
ymcE,2103660,2103694,2103660,34,0,utRho26
ymdA,2210450,2210828,2210450,378,2,utRho26
ymdB,2211428,2211640,2211428,212,0,utRho26
ymfD,2395322,2395322,2395064,258,102,utRho26
ymfI,2402880,2402994,2402880,114,0,utRho26
ymfJ,2404518,2404518,2404168,350,38,utRho26
ymfK,2406176,2406176,2405866,310,2,utRho26
ymfT,2405766,2406048,2405766,282,2,utRho26
ymgE,2489110,2489456,2489110,346,72,utRho26
ymgF,2437628,2437966,2437628,338,0,utRho26
ymiA,2670112,2670320,2670112,208,164,utRho26
ymjA,2715620,2715620,2715336,284,2,utRho26
ynaI,2791946,2791946,2791844,102,0,utRho26
ynaK,2850438,2850754,2850438,316,96,utRho26
ynbA,2954924,2955242,2954924,318,160,utRho26
yncD,3046552,3046552,3046130,422,0,utRho26
yncE,3046454,3046614,3046454,160,0,utRho26
yncG,3052456,3052494,3052456,38,82,utRho26
yncL,3034492,3034492,3034388,104,4,utRho26
yneE,3218364,3218364,3218044,320,0,utRho26
yneF,3223748,3223748,3223708,40,0,utRho26
yneJ,3229560,3229608,3229560,48,0,utRho26
yneK,3231100,3231526,3231100,426,94,utRho26
yneM,3245176,3245292,3245176,116,0,utRho26
ynfA,3311398,3311398,3311346,52,0,utRho26
ynfB,3311418,3311616,3311418,198,2,utRho26
ynfC,3315094,3315094,3314914,180,0,utRho26
ynfD,3314828,3315130,3314828,302,0,utRho26
ynfE,3316006,3316138,3316006,132,70,utRho26
ynfK,3334670,3334670,3334438,232,0,utRho26
ynfL,3339304,3339304,3339184,120,0,utRho26
ynfM,3339260,3339398,3339260,138,0,utRho26
ynfN,3276598,3276598,3276218,380,68,utRho26
ynfO,3273454,3273512,3273454,58,2,utRho26
ynhG,3517890,3517890,3517450,440,328,utRho26
yniA,3615158,3615592,3615158,434,0,utRho26
yniB,3618526,3618526,3618466,60,0,utRho26
yniC,3618652,3618760,3618652,108,0,utRho26
yniD,3610202,3610330,3610202,128,0,utRho26
ynjE,3678880,3678934,3678880,54,0,utRho26
ynjF,3683222,3683222,3682806,416,16,utRho26
ynjH,3684376,3684376,3684270,106,94,utRho26
ynjI,3690022,3690022,3689742,280,106,utRho26
yoaB,3786642,3786734,3786642,92,120,utRho26
yoaC,3787932,3788146,3787932,214,202,utRho26
yoaE,3803544,3803544,3803170,374,130,utRho26
yoaF,3755444,3755444,3755064,380,26,utRho26
yoaH,3789866,3789866,3789462,404,0,utRho26
yobB,3850418,3850880,3850418,462,136,utRho26
yobF,3815586,3815586,3815182,404,256,utRho26
yobH,3817800,3817850,3817800,50,0,utRho26
yodB,4084352,4084736,4084352,384,0,utRho26
yodC,4057008,4057008,4056740,268,56,utRho26
yohC,4451358,4451358,4451262,96,0,utRho26
yohD,4451526,4451602,4451526,76,0,utRho26
yohJ,4460986,4461248,4460986,262,388,utRho26
yohO,4431172,4431314,4431172,142,0,utRho26
yojI,4617282,4617282,4617230,52,0,utRho26
ypdI,4988988,4989396,4988988,408,98,utRho26
ypfG,5165786,5165786,5165554,232,0,utRho26
ypfM,5182140,5182140,5181732,408,668,utRho26
yphB,5349590,5349590,5349376,214,0,utRho26
ypjA,5565644,5565644,5565452,192,470,utRho26
ypjB,5569636,5569636,5568858,778,92,utRho26
ypjD,5495860,5495774,5495860,86,66,utRho26
yqaE,5594170,5594170,5594056,114,76,utRho26
yqcA,5846100,5846100,5845968,132,124,utRho26
yqcE,5800944,5801184,5800944,240,26,utRho26
yqeC,6030468,6030468,6030114,354,146,utRho26
yqeF,5971618,5971618,5971184,434,412,utRho26
yqeG,5971438,5971694,5971438,256,314,utRho26
yqeH,5975016,5975072,5975016,56,102,utRho26
yqeI,5976688,5977004,5976688,316,0,utRho26
yqeK,5981140,5981140,5980720,420,402,utRho26
yqfA,6086728,6086728,6086296,432,4,utRho26
yqgA,6219042,6219106,6219042,64,0,utRho26
yqgB,6172500,6172500,6172102,398,294,utRho26
yqgE,6185768,6185874,6185768,106,40,utRho26
yqhA,6299150,6299150,6298942,208,38,utRho26
yqhC,6310768,6310768,6310436,332,48,utRho26
yqhD,6310604,6310710,6310604,106,48,utRho26
yqhH,6316842,6317254,6316842,412,0,utRho26
yqiC,6369662,6369680,6369662,18,0,utRho26
yqiJ,6384108,6384416,6384108,308,20,utRho26
yqjA,6495096,6495546,6495096,450,108,utRho26
yqjF,6500932,6501124,6500932,192,130,utRho26
yqjG,6501948,6502048,6501948,100,0,utRho26
yqjH,6433078,6433078,6432982,96,34,utRho26
yqjI,6433506,6433558,6433506,52,118,utRho26
yraH,6574552,6574852,6574552,300,0,utRho26
yraP,6592144,6592818,6592144,674,114,utRho26
yraQ,6596414,6596414,6596276,138,0,utRho26
yraR,6598024,6598024,6597692,332,0,utRho26
yrbG,13360844,13361100,13360844,256,264,utRho26
yrbL,6696842,6696904,6696842,62,0,utRho26
yrbN,6616172,6616172,6615866,306,412,utRho26
yrdB,6860176,6860176,6860046,130,36,utRho26
yrfF,7052548,7052938,7052548,390,0,utRho26
yrhB,7169440,7169518,7169440,78,0,utRho26
ysaB,7451804,7451804,7451424,380,4,utRho26
ysgA,8032686,8032686,8032338,348,130,utRho26
ytfB,8857638,8857638,8857434,204,154,utRho26
ytfE,8864018,8864018,8863966,52,0,utRho26
ytfF,8866296,8866296,8866130,166,276,utRho26
ytfH,8868164,8868226,8868164,62,0,utRho26
ytfI,8875234,8875414,8875234,180,0,utRho26
ytfJ,8878572,8878572,8878524,48,90,utRho26
ytfK,8879022,8879174,8879022,152,108,utRho26
ytfL,8882642,8882642,8882430,212,0,utRho26
ytfQ,8899634,8899924,8899634,290,158,utRho26
ytjB,9249598,9249598,9249578,20,0,utRho26
yzfA,8896588,8896588,8896490,98,0,utRho26
zapA,6111102,6111224,6111102,122,246,utRho26
zapB,8236772,8237030,8236772,258,340,utRho26
zapC,2011700,2011904,2011700,204,0,utRho26
zinT,4082692,4082750,4082692,58,0,utRho26
zipA,5062814,5062814,5062466,348,62,utRho26
zitB,1569716,1569716,1569646,70,74,utRho26
zntA,7212844,7212902,7212844,58,0,utRho26
zntR,6878336,6878336,6878260,76,2,utRho26
znuA,3885322,3885322,3885166,156,2,utRho26
znuC,3885268,3885324,3885268,56,2,utRho26
zraP,8403424,8403424,8403376,48,4,utRho26
zraS,8403810,8403852,8403810,42,0,utRho26
zupT,6364866,6365100,6364866,234,248,utRho26
zur,8520282,8520282,8520006,276,2,utRho26
zwf,3872752,3872752,3872628,124,52,utRho26
C0343,2818676,2818728,2818676,52,0,utRho27
aaeB,6776526,6776526,6776376,150,0,utRho27
aaeR,6778762,6779040,6778762,278,140,utRho27
aaeX,6778860,6778860,6778674,186,96,utRho27
aat,1854920,1854920,1854864,56,32,utRho27
accA,416822,417242,416822,420,310,utRho27
accB,6810280,6810872,6810280,592,440,utRho27
accD,4868030,4868030,4867852,178,0,utRho27
aceB,8430804,8430956,8430804,152,128,utRho27
aceE,245938,246034,245938,96,98,utRho27
ackA,4826918,4826940,4826918,22,218,utRho27
acnA,2670848,2671662,2670848,814,322,utRho27
acnB,263038,263230,263038,192,442,utRho27
acpP,2303148,2303230,2303148,82,252,utRho27
acpS,5402324,5402324,5401996,328,420,utRho27
acrA,971396,971396,971238,158,0,utRho27
acrB,969370,969370,968806,564,78,utRho27
acrD,5174950,5175190,5174950,240,338,utRho27
acrE,6827404,6827728,6827404,324,0,utRho27
acrR,971398,971522,971398,124,0,utRho27
acrZ,1589502,1589546,1589502,44,0,utRho27
acs,8575190,8575190,8574742,448,656,utRho27
actP,8569870,8569870,8569804,66,0,utRho27
ada,4620854,4620854,4620810,44,0,utRho27
add,3404404,3404466,3404404,62,24,utRho27
ade,7687802,7687928,7687802,126,86,utRho27
adhE,2596826,2596826,2596242,584,0,utRho27
adhP,3107988,3107988,3107676,312,120,utRho27
adiA,8681112,8681112,8681042,70,2,utRho27
adiC,8674404,8674404,8674062,342,22,utRho27
adiY,8676084,8676084,8675858,226,44,utRho27
adk,994278,994350,994278,72,188,utRho27
adrA,807374,807406,807374,32,0,utRho27
aer,6438240,6438240,6438152,88,0,utRho27
aes,1000102,1000102,999946,156,190,utRho27
agaR,6557406,6557406,6557330,76,0,utRho27
agaS,6563778,6563952,6563778,174,0,utRho27
agp,2131118,2131170,2131118,52,0,utRho27
agrA,7296126,7296126,7296126,0,0,utRho27
agrB,7296588,7296588,7296588,0,0,utRho27
ahpC,1277386,1277890,1277386,504,686,utRho27
ahpF,1278004,1279506,1278004,1502,23294,utRho27
ahr,8992698,8992698,8992418,280,202,utRho27
aidB,8828494,8828550,8828494,56,32,utRho27
ais,4731512,4731512,4731240,272,0,utRho27
alaA,4814816,4815122,4814816,306,20,utRho27
alaC,4996798,4996798,4996590,208,16,utRho27
alaE,5598140,5598328,5598140,188,182,utRho27
alaS,5644180,5644180,5644022,158,356,utRho27
alaW,5036612,5036612,5036462,150,6,utRho27
aldA,2976380,2976464,2976380,84,0,utRho27
aldB,7513070,7513070,7513022,48,40,utRho27
alkA,4295118,4295118,4295080,38,36,utRho27
alkB,4618890,4618890,4618682,208,80,utRho27
allA,1064780,1064902,1064780,122,76,utRho27
allD,1092822,1092822,1092726,96,0,utRho27
allE,1088112,1088112,1088092,20,36,utRho27
allS,1064600,1064600,1064442,158,178,utRho27
alr,8531178,8531564,8531178,386,264,utRho27
alsE,8617334,8617334,8616956,378,642,utRho27
alsK,8615990,8615990,8615598,392,208,utRho27
alx,6476740,6477160,6476740,420,20,utRho27
amiA,5104482,5104704,5104482,222,34,utRho27
amiC,5898378,5898378,5898020,358,194,utRho27
amn,4110062,4110122,4110062,60,0,utRho27
ampC,8758006,8758006,8757888,118,0,utRho27
ampD,237362,237466,237362,104,4,utRho27
ampG,907372,907372,907090,282,96,utRho27
ampH,792726,792726,792574,152,44,utRho27
amyA,4012230,4012312,4012230,82,0,utRho27
anmK,3439346,3439346,3439204,142,24,utRho27
ansB,6201580,6201580,6201456,124,162,utRho27
ansP,3052040,3052040,3051960,80,6,utRho27
apaG,104068,104068,103212,856,158,utRho27
apaH,102586,102586,102444,142,48,utRho27
apbE,4623188,4623188,4623068,120,0,utRho27
appA,2081198,2081234,2081198,36,0,utRho27
appC,2075420,2075480,2075420,60,0,utRho27
appY,1167134,1167362,1167134,228,0,utRho27
apt,982620,982824,982620,204,96,utRho27
aqpZ,1832424,1832424,1832094,330,64,utRho27
araB,140150,140150,140096,54,0,utRho27
araC,140482,140774,140482,292,134,utRho27
araE,5964416,5964416,5964364,52,0,utRho27
araF,3972476,3972476,3972256,220,4,utRho27
araH,3967120,3967120,3967086,34,24,utRho27
araJ,825058,825058,824962,96,214,utRho27
arcA,9281602,9281602,9280612,990,1694,utRho27
arcB,6706098,6706098,6706050,48,14,utRho27
arcZ,6701154,6701154,6701154,0,0,utRho27
arfA,6877346,6877346,6877298,48,68,utRho27
argA,5898312,5898484,5898312,172,0,utRho27
argC,8309770,8310002,8309770,232,50,utRho27
argD,6980442,6980442,6980360,82,4,utRho27
argE,8310156,8310156,8309694,462,76,utRho27
argF,580680,580680,580610,70,0,utRho27
argG,6637124,6637274,6637124,150,0,utRho27
argI,8956688,8956688,8956622,66,0,utRho27
argO,6137672,6137672,6137616,56,170,utRho27
argP,6119460,6119506,6119460,46,10,utRho27
argR,6769204,6769406,6769204,202,48,utRho27
argS,3920002,3920124,3920002,122,0,utRho27
argT,4855698,4855698,4855582,116,18,utRho27
argU,1129406,1129446,1129406,40,0,utRho27
argW,4932616,4932618,4932616,2,0,utRho27
argX,7964728,7964750,7964728,22,2,utRho27
aroF,5482402,5482402,5482300,102,26,utRho27
aroG,1571182,1571266,1571182,84,46,utRho27
aroH,3576636,3576870,3576636,234,232,utRho27
aroK,7038760,7038760,7038128,632,228,utRho27
aroL,812560,812810,812560,250,28,utRho27
aroP,243342,243342,243102,240,42,utRho27
arpA,8445382,8445382,8444974,408,8,utRho27
arrS,7316108,7316108,7316108,0,0,utRho27
arsR,7297024,7297056,7297024,32,0,utRho27
artJ,1801252,1801252,1801150,102,0,utRho27
artP,1807686,1807686,1807468,218,118,utRho27
ascF,5678858,5679048,5678858,190,50,utRho27
ascG,5678574,5678574,5678528,46,20,utRho27
aslB,7965562,7965916,7965562,354,204,utRho27
asnA,7854258,7854310,7854258,52,36,utRho27
asnB,1398444,1398444,1398354,90,92,utRho27
asnC,23562186,23562186,23562018,168,0,utRho27
asnS,1978088,1978088,1977970,118,850,utRho27
asnT,4089082,4089098,4089082,16,0,utRho27
asnU,4119690,4119702,4119690,12,0,utRho27
asnV,4124504,4124520,4124504,16,0,utRho27
aspA,17473728,17473728,17473308,420,452,utRho27
aspC,1971486,1971486,1971418,68,2,utRho27
aspS,3901402,3901402,3901044,358,110,utRho27
aspT,7893560,7893744,7893560,184,58620,utRho27
aspV,473826,473862,473826,36,108,utRho27
asr,3342654,3342752,3342654,98,64,utRho27
astC,3664088,3664088,3663964,124,24,utRho27
astE,3654138,3654138,3653846,292,94,utRho27
atoD,4646824,4646894,4646824,70,108,utRho27
atpB,7844540,7844540,7844102,438,136,utRho27
atpC,7832118,7832118,7831944,174,326,utRho27
atpI,7845050,7845050,7844880,170,770,utRho27
avtA,7479348,7479410,7479348,62,444,utRho27
azoR,2965982,2965982,2965720,262,572,utRho27
azuC,3976002,3976002,3975918,84,92,utRho27
bacA,6408350,6408350,6408262,88,926,utRho27
bamA,394052,395856,394052,1804,1126,utRho27
bamB,5277950,5277950,5277304,646,944,utRho27
bamC,5198028,5198028,5197730,298,470,utRho27
bamD,5471922,5472292,5471922,370,496,utRho27
bamE,5506972,5507210,5506972,238,966,utRho27
basS,8666954,8666954,8666544,410,354,utRho27
bax,7474468,7474468,7474354,114,218,utRho27
bcp,5200874,5200956,5200874,82,44,utRho27
bcsB,7385346,7385346,7385214,132,0,utRho27
bcsE,7392644,7392916,7392644,272,62,utRho27
bdcA,8948128,8948128,8948106,22,50,utRho27
bdcR,8948192,8948248,8948192,56,64,utRho27
bdm,3112680,3112680,3112560,120,0,utRho27
betA,654522,654522,654494,28,20,utRho27
betI,658722,658722,658668,54,218,utRho27
betT,658842,658926,658842,84,178,utRho27
bfr,6933498,6933498,6933450,48,0,utRho27
bglG,23440182,23440182,23439402,780,270,utRho27
bglX,4444240,4444240,4443978,262,0,utRho27
bhsA,2337962,2338146,2337962,184,158,utRho27
bioA,1618584,1618584,1618514,70,84,utRho27
bioB,1618604,1618688,1618604,84,84,utRho27
bioH,7089716,7089716,7089688,28,42,utRho27
bisC,7433026,7433026,7432788,238,0,utRho27
blc,8755490,8755490,8755444,46,0,utRho27
blr,3409024,3409102,3409024,78,184,utRho27
bluF,2431226,2431226,2430950,276,364,utRho27
bluR,2428226,2428226,2428118,108,20,utRho27
bolA,908698,908944,908698,246,32,utRho27
borD,1157842,1157842,1157786,56,60,utRho27
brnQ,838976,839182,838976,206,1492,utRho27
bssR,1756492,1756496,1756492,4,0,utRho27
bssS,2242116,2242116,2241910,206,578,utRho27
btuB,8326798,8327278,8326798,480,470,utRho27
cadB,8720212,8720212,8720062,150,184,utRho27
cadC,8723926,8723926,8723868,58,142,utRho27
caiE,70998,70998,70742,256,0,utRho27
caiF,68436,68600,68436,164,236,utRho27
caiT,84074,84074,83862,212,22,utRho27
can,285406,285406,285340,66,230,utRho27
carA,59102,59302,59102,200,2,utRho27
carB,61550,61634,61550,84,38,utRho27
cas2,5757830,5757830,5757706,124,92,utRho27
casA,5768638,5768638,5768276,362,62,utRho27
cbl,4121882,4121882,4121828,54,0,utRho27
cbpA,2128074,2128074,2127550,524,110,utRho27
cbrA,7738628,7738754,7738628,126,48,utRho27
cbrB,7794958,7795012,7794958,54,54,utRho27
ccmH,4585242,4585242,4584820,422,104,utRho27
cdaR,364894,364926,364894,32,48,utRho27
cdd,4463638,4463688,4463638,50,0,utRho27
cdh,8219814,8219860,8219814,46,144,utRho27
cdsA,391110,391354,391110,244,202,utRho27
cedA,3627484,3627484,3627326,158,178,utRho27
cfa,3482402,3482826,3482402,424,0,utRho27
chaC,2544844,2544972,2544844,128,0,utRho27
chbB,3643452,3643452,3643238,214,78,utRho27
chbG,3634624,3634624,3634270,354,0,utRho27
cheW,3946924,3946924,3946678,246,64,utRho27
chiA,6939792,6939792,6939706,86,76,utRho27
chiP,1416472,1416668,1416472,196,0,utRho27
cho,3646984,3647030,3646984,46,0,utRho27
chpS,8896804,8896894,8896804,90,126,utRho27
cirA,4493884,4493884,4493538,346,0,utRho27
citC,1304078,1304078,1303712,366,230,utRho27
citT,1293264,1293264,1293160,104,0,utRho27
clcA,350104,350214,350104,110,0,utRho27
clpA,1846160,1846528,1846160,368,220,utRho27
clpB,5468410,5468410,5468346,64,540,utRho27
clpP,913154,913354,913154,200,1364,utRho27
clpS,1845500,1845826,1845500,326,426,utRho27
clpX,914404,914852,914404,448,2982,utRho27
clsA,2617346,2617346,2617290,56,0,utRho27
clsC,2212584,2212710,2212584,126,86,utRho27
cmk,1922330,1922402,1922330,72,0,utRho27
cnu,3409522,3409898,3409522,376,548,utRho27
coaA,8350214,8350214,8350052,162,318,utRho27
cobC,1340092,1340092,1339814,278,96,utRho27
cobT,4129202,4129202,4128934,268,24,utRho27
cobU,4131944,4131944,4131528,416,0,utRho27
codB,709768,709844,709768,76,16,utRho27
comR,2337726,2337726,2337664,62,0,utRho27
copA,1022822,1022822,1022758,64,0,utRho27
corA,8002388,8002852,8002388,464,12096,utRho27
cpdB,8873258,8873258,8873130,128,34,utRho27
cptB,6082198,6082198,6082140,58,0,utRho27
cpxA,8210202,8210202,8209950,252,76,utRho27
cpxP,8211570,8211640,8211570,70,130,utRho27
cpxR,8211372,8211372,8211340,32,0,utRho27
cra,175894,176056,175894,162,100,utRho27
crcB,1316016,1316016,1315876,140,0,utRho27
creA,9270486,9271042,9270486,556,208,utRho27
creD,9276320,9276356,9276320,36,266,utRho27
crl,515620,515658,515620,38,358,utRho27
crp,6971906,6972240,6971906,334,140,utRho27
crr,5070960,5071668,5070960,708,1634,utRho27
csdA,5886414,5886674,5886414,260,44,utRho27
csgB,2207718,2207902,2207718,184,0,utRho27
csgD,2206688,2206688,2206392,296,356,utRho27
csgG,2203510,2203510,2203368,142,632,utRho27
csiD,5577854,5577970,5577854,116,0,utRho27
csiE,5330802,5330870,5330802,68,172,utRho27
csiR,5590942,5591348,5590942,406,100,utRho27
cspA,7439778,7440098,7439778,320,366,utRho27
cspB,3283430,3283430,3283108,322,0,utRho27
cspC,3815018,3815018,3814870,148,192,utRho27
cspD,1845352,1845352,1845180,172,2802,utRho27
cspE,1314294,1314584,1314294,290,332,utRho27
cspF,3283380,3283710,3283380,330,286,utRho27
cspG,2102610,2102922,2102610,312,486,utRho27
cspH,2102746,2102746,2102350,396,412,utRho27
cspI,3277624,3277624,3277334,290,184,utRho27
csrA,5638746,5638746,5638292,454,608,utRho27
csrB,5849048,5849048,5849048,0,0,utRho27
csrC,8102072,8102072,8102072,0,0,utRho27
csrD,6806850,6806850,6806664,186,48,utRho27
cstA,1259710,1259788,1259710,78,0,utRho27
cueO,274090,274166,274090,76,0,utRho27
cueR,1027948,1027986,1027948,38,0,utRho27
curA,3037784,3038054,3037784,270,44,utRho27
cusC,1191146,1191200,1191146,54,0,utRho27
cusR,1190924,1190924,1190886,38,56,utRho27
cutA,8730784,8730784,8730712,72,0,utRho27
cutC,3918534,3918534,3917920,614,130,utRho27
cvpA,4861600,4861600,4861526,74,0,utRho27
cvrA,2484328,2484328,2484142,186,0,utRho27
cyaA,7981548,7982306,7981548,758,510,utRho27
cyaR,4334228,4334224,4334228,4,0,utRho27
cyaY,7988166,7988166,7988118,48,434,utRho27
cybB,2981522,2981804,2981522,282,8,utRho27
cycA,8859560,8859728,8859560,168,92,utRho27
cydA,1542340,1542916,1542340,576,3878,utRho27
cydC,1858800,1858800,1858390,410,56,utRho27
cydD,1862062,1862062,1861924,138,0,utRho27
cydX,1548300,1548392,1548300,92,238,utRho27
cynR,717418,717418,717380,38,0,utRho27
cynT,1435092,1435196,1435092,104,0,utRho27
cyoA,903306,903306,903220,86,88,utRho27
cyoE,895540,895540,895410,130,20,utRho27
cysB,2667576,2667710,2667576,134,272,utRho27
cysC,5748056,5748056,5747984,72,40,utRho27
cysD,5752736,5752736,5752658,78,84,utRho27
cysE,7565362,7565362,7565124,238,274,utRho27
cysG,6995508,6995656,6995508,148,1046,utRho27
cysJ,5783928,5783928,5783796,132,948,utRho27
cysK,5064688,5064818,5064688,130,0,utRho27
cysP,5087114,5087114,5087056,58,42,utRho27
cysS,1109154,1109222,1109154,68,106,utRho27
cysT,3984100,3984100,3983974,126,14,utRho27
cysZ,5062766,5062926,5062766,160,162,utRho27
cytR,8249018,8249018,8248912,106,140,utRho27
dacA,1328002,1328002,1327926,76,0,utRho27
dacB,6657714,6657926,6657714,212,36,utRho27
dacC,1761306,1761454,1761306,148,36,utRho27
dadA,2475018,2475142,2475018,124,70,utRho27
dam,7032504,7032504,7031826,678,350,utRho27
damX,7035200,7035200,7034612,588,1144,utRho27
dapA,5199568,5199568,5199520,48,0,utRho27
dapB,56576,56748,56576,172,36,utRho27
dapD,371954,371954,371894,60,38,utRho27
dapE,5183120,5183214,5183120,94,184,utRho27
dcp,3254844,3254844,3254760,84,4,utRho27
dcrB,7219534,7219910,7219534,376,58,utRho27
dctA,7366996,7366996,7366894,102,208,utRho27
dcuA,8733686,8733686,8733546,140,642,utRho27
dcuB,8698182,8698182,8697488,694,782,utRho27
dcuC,1312166,1312166,1311936,230,960,utRho27
dcuD,6749166,6749738,6749166,572,724,utRho27
dcuR,8701130,8701130,8700068,1062,426,utRho27
dcuS,8703370,8703370,8703324,46,54,utRho27
dcyD,3999016,3999016,3998960,56,0,utRho27
ddpX,3126498,3126498,3126152,346,0,utRho27
deaD,6615818,6615818,6615720,98,0,utRho27
dedA,4869880,4869880,4869482,398,484,utRho27
dedD,4863750,4863750,4863368,382,26,utRho27
def,6867300,6867380,6867300,80,134,utRho27
degP,361690,361768,361690,78,0,utRho27
degQ,6761308,6761486,6761308,178,160,utRho27
deoB,9239134,9239206,9239134,72,32,utRho27
deoC,9233358,9234646,9233358,1288,104,utRho27
dfp,7625406,7625462,7625406,56,6,utRho27
dgcZ,3247758,3247758,3247700,58,0,utRho27
dgkA,8512914,8513274,8512914,360,134,utRho27
dgt,358392,358474,358392,82,94,utRho27
dhaK,2501888,2501888,2501676,212,12,utRho27
dhaR,2502006,2502132,2502006,126,0,utRho27
dicB,3299194,3299218,3299194,24,0,utRho27
dicC,3295752,3295752,3295700,52,0,utRho27
dinB,501760,501796,501760,36,0,utRho27
dinD,7635398,7635520,7635398,122,152,utRho27
dinG,1666146,1666140,1666146,6,0,utRho27
dinI,2243018,2243018,2242974,44,38,utRho27
dinJ,493230,493230,493004,226,132,utRho27
dinQ,7295964,7295964,7295576,388,292,utRho27
djlA,114536,114728,114536,192,16,utRho27
dkgA,6313142,6313246,6313142,104,48,utRho27
dkgB,458196,458334,458196,138,166,utRho27
dksA,321502,321502,321208,294,314,utRho27
dld,4444164,4444370,4444164,206,0,utRho27
dmlA,3763424,3763824,3763424,400,22,utRho27
dmlR,3763710,3763710,3763618,92,0,utRho27
dmsA,1881646,1881918,1881646,272,54,utRho27
dnaA,7767922,7767922,7767458,464,60,utRho27
dnaB,8528566,8528628,8528566,62,148,utRho27
dnaK,24096,24326,24096,230,8272,utRho27
dnaN,7765466,7765466,7764642,824,190,utRho27
dnaQ,471868,472134,471868,266,2448,utRho27
dnaT,18406460,18406460,18406068,392,0,utRho27
dnaX,984112,984184,984112,72,86,utRho27
dosP,3131486,3131486,3131466,20,0,utRho27
dpiB,1303968,1304470,1303968,502,80,utRho27
dppA,7415740,7415740,7415410,330,396,utRho27
dps,1697900,1697900,1697822,78,16,utRho27
dsbA,8086754,8086836,8086754,82,384,utRho27
dsbB,2466294,2466294,2466060,234,0,utRho27
dsbC,6079266,6079266,6077644,1622,792,utRho27
dsbG,1277600,1277600,1277146,454,222,utRho27
dsdA,4958242,4958404,4958242,162,130,utRho27
dsdC,4955492,4955492,4955258,234,28,utRho27
dsdX,4955642,4955694,4955642,52,290,utRho27
dsrA,4050626,4050626,4050626,0,0,utRho27
dsrB,4049686,4049686,4049646,40,88,utRho27
dtpD,1485340,1485340,1485112,228,6,utRho27
dusA,8523200,8523338,8523200,138,496,utRho27
dusB,6820492,6820560,6820492,68,0,utRho27
dusC,4460790,4460790,4460770,20,0,utRho27
dut,7627704,7627864,7627704,160,126,utRho27
dxr,386670,387042,386670,372,164,utRho27
ebgA,6445102,6445266,6445102,164,40,utRho27
ebgR,6442874,6442932,6442874,58,0,utRho27
ecnB,8753018,8753106,8753018,88,8,utRho27
eco,4607594,4607810,4607594,216,50,utRho27
ecpA,621594,621594,621342,252,52,utRho27
ecpB,620238,620238,620052,186,16,utRho27
ecpR,622964,622964,622672,292,0,utRho27
eda,3866218,3866218,3865512,706,0,utRho27
edd,3869426,3869426,3869208,218,0,utRho27
efeO,2164308,2164486,2164308,178,0,utRho27
efeU_1,2162614,2162712,2162614,98,74,utRho27
efp,8751134,8751398,8751134,264,356,utRho27
elaA,4763372,4763372,4763086,286,62,utRho27
elaD,4765308,4765426,4765308,118,90,utRho27
elfA,1995530,1995736,1995530,206,0,utRho27
elfD,1996642,1996980,1996642,338,38,utRho27
emrD,7707690,7707844,7707690,154,8,utRho27
emrK,4966896,4966896,4966678,218,0,utRho27
emrY,4964668,4964668,4964352,316,696,utRho27
emtA,2486250,2486360,2486250,110,0,utRho27
endA,12361100,12361388,12361100,288,0,utRho27
eno,5817692,5817692,5815882,1810,350,utRho27
entC,1249662,1249770,1249662,108,0,utRho27
entD,1220508,1220508,1220158,350,100,utRho27
entH,1258584,1258600,1258584,16,0,utRho27
entS,1244506,1244600,1244506,94,0,utRho27
envR,6827266,6827266,6826930,336,0,utRho27
epd,12295292,12295292,12294764,528,228,utRho27
epmA,8765236,8765286,8765236,50,24,utRho27
epmB,8751406,8751406,8751314,92,228,utRho27
eptB,7421162,7421162,7420950,212,84,utRho27
eptC,8300622,8300622,8300530,92,170,utRho27
erfK,4126708,4126708,4126646,62,168,utRho27
erpA,353122,353220,353122,98,38,utRho27
esrE,8039956,8039956,8039956,0,0,utRho27
essD,1153746,1154796,1153746,1050,188,utRho27
etk,2088606,2088606,2088420,186,28,utRho27
evgA,4967262,4967510,4967262,248,102,utRho27
exbB,6304028,6304028,6303968,60,68,utRho27
exbD,6302780,6302780,6302486,294,126,utRho27
exuR,6493016,6493304,6493016,288,122,utRho27
exuT,6490004,6490208,6490004,204,4,utRho27
fabA,2032996,2032996,2032940,56,40,utRho27
fabB,4883282,4883282,4883210,72,116,utRho27
fabH,2297032,2297518,2297032,486,228,utRho27
fabI,2702236,2702236,2702078,158,48,utRho27
fadB,8062026,8062026,8061942,84,0,utRho27
fadD,3779614,3779614,3779492,122,196,utRho27
fadE,486812,486812,486606,206,86,utRho27
fadH,6463248,6463330,6463248,82,0,utRho27
fadI,4921022,4921022,4920938,84,0,utRho27
fadL,4922410,4922600,4922410,190,276,utRho27
fadM,928720,928804,928720,84,0,utRho27
fadR,2469810,2469876,2469810,66,0,utRho27
fbaB,4357334,4357334,4357128,206,0,utRho27
fdhE,8162722,8162722,8162456,266,72,utRho27
fdhF,8598814,8598814,8598732,82,0,utRho27
fdnG,3094744,3094802,3094744,58,0,utRho27
fdrA,1093012,1093360,1093012,348,0,utRho27
feaB,2894994,2895038,2894994,44,0,utRho27
feaR,2894734,2894734,2894566,168,0,utRho27
fecA,9033454,9033454,9033354,100,0,utRho27
fecE,9023288,9023288,9022914,374,1266,utRho27
fecI,9036564,9036564,9036470,94,58,utRho27
feoA,7080114,7080326,7080114,212,260,utRho27
fepA,1225334,1225334,1224988,346,306,utRho27
fepB,1249454,1249454,1249020,434,104,utRho27
fepD,1244468,1244468,1244378,90,0,utRho27
fes,1225374,1225630,1225374,256,106,utRho27
ffh,5495706,5495706,5495590,116,226,utRho27
ffs,952576,952848,952576,272,106,utRho27
fhuA,334884,334968,334884,84,30,utRho27
fhuE,2323294,2323294,2323102,192,36,utRho27
fhuF,9211504,9211504,9211326,178,0,utRho27
fic,6983296,6983296,6982926,370,74,utRho27
fieF,8212864,8212938,8212864,74,0,utRho27
fimA,9085388,9086230,9085388,842,1110,utRho27
fimB,9081334,9081914,9081334,580,2746,utRho27
fimE,9083742,9084074,9083742,332,620,utRho27
fimZ,1129214,1129214,1128960,254,14,utRho27
fiu,1683296,1683296,1683062,234,12,utRho27
fixA,84650,84806,84650,156,0,utRho27
fkpA,6955050,6955050,6954838,212,8390,utRho27
fldA,2846084,2846084,2845860,224,752,utRho27
fldB,6079644,6079710,6079644,66,0,utRho27
flgA,2261770,2261770,2261726,44,146,utRho27
flgB,2261986,2262036,2261986,50,0,utRho27
flgK,2276702,2276756,2276702,54,44,utRho27
flgM,2260330,2260330,2260256,74,0,utRho27
flgN,2259828,2259828,2259660,168,0,utRho27
flhB,3932432,3932432,3932382,50,326,utRho27
flhC,3955864,3955864,3955688,176,0,utRho27
flhD,3957154,3957154,3956394,760,562,utRho27
fliA,4003638,4003638,4003578,60,26,utRho27
fliC,4007352,4007352,4007212,140,60,utRho27
fliD,4007634,4007744,4007634,110,142,utRho27
fliE,4026186,4026186,4026028,158,86,utRho27
fliF,4026292,4026458,4026292,166,26,utRho27
fliL,4039168,4039236,4039168,68,2,utRho27
flk,4875824,4875900,4875824,76,0,utRho27
flu,4142634,4143078,4142634,444,12,utRho27
flxA,3292776,3292810,3292776,34,68,utRho27
fnr,2799104,2799104,2799052,52,10,utRho27
fnrS,2818258,2818258,2818258,0,0,utRho27
focA,1909628,1909628,1908932,696,0,utRho27
folA,99598,99646,99598,48,0,utRho27
folB,6409296,6409296,6409178,118,86,utRho27
folD,1115562,1115562,1115482,80,0,utRho27
folE,4487696,4487696,4487304,392,176,utRho27
fpr,8228998,8228998,8228944,54,0,utRho27
frc,4986878,4986878,4986508,370,116,utRho27
frdA,8764824,8764824,8764636,188,156,utRho27
frdD,8758948,8758948,8758732,216,494,utRho27
fre,8052886,8053054,8052886,168,120,utRho27
frlA,6999518,6999820,6999518,302,210,utRho27
frr,385624,385744,385624,120,420,utRho27
frsA,513004,513054,513004,50,0,utRho27
fruB,4527194,4527194,4526990,204,0,utRho27
frvR,8179804,8179804,8179710,94,0,utRho27
fryA,5008986,5008986,5008970,16,4,utRho27
fsaA,1727060,1727284,1727060,224,42,utRho27
fsr,1009710,1009710,1009392,318,276,utRho27
ftnA,3977364,3977432,3977364,68,0,utRho27
ftnB,3973550,3973850,3973550,300,154,utRho27
ftsA,207122,207964,207122,842,348,utRho27
ftsB,5745802,5745802,5745640,162,140,utRho27
ftsH,6654204,6654204,6653870,334,1486,utRho27
ftsK,1865858,1866448,1865858,590,270,utRho27
ftsL,181376,182064,181376,688,306,utRho27
ftsP,6325732,6325732,6325338,394,184,utRho27
ftsQ,205484,206310,205484,826,468,utRho27
ftsX,7204512,7204512,7204172,340,400,utRho27
ftsZ,209272,210610,209272,1338,84,utRho27
fucA,5867708,5867708,5867376,332,236,utRho27
fucP,5868238,5868470,5868238,232,154,utRho27
fumA,6753760,6753760,6753508,252,1380,utRho27
fumB,8694696,8694696,8694652,44,0,utRho27
fumC,3373418,3373418,3373176,242,0,utRho27
fur,2842892,2842892,2842584,308,116,utRho27
fusA,6947370,6947370,6947028,342,3288,utRho27
fxsA,8737206,8737328,8737206,122,1636,utRho27
gabD,5581824,5582546,5581824,722,592,utRho27
gadA,7335214,7335214,7335160,54,0,utRho27
gadB,3144144,3144144,3144090,54,12,utRho27
gadC,3141168,3141168,3140978,190,1204,utRho27
gadE,7315600,7316732,7315600,1132,882,utRho27
gadW,7329562,7329562,7329236,326,216,utRho27
gadX,14663356,14663356,14663240,116,0,utRho27
gadY,7329728,7329728,7329728,0,0,utRho27
galE,1584354,1584354,1584110,244,0,utRho27
galF,4228702,4228702,4228654,48,160,utRho27
galM,1577796,1577796,1577674,122,124,utRho27
galP,6176510,6176568,6176510,58,6,utRho27
galR,5953138,5953198,5953138,60,2,utRho27
galS,4483420,4483420,4483336,84,6,utRho27
galU,2582810,2582914,2582810,104,66,utRho27
gapA,3724480,3725542,3724480,1062,370,utRho27
garP,6549868,6549868,6549814,54,150,utRho27
gatY,4354468,4354468,4354408,60,0,utRho27
gatZ,4352864,4352864,4352642,222,76,utRho27
gcd,282558,282558,282450,108,72,utRho27
gcl,1067814,1067832,1067814,18,0,utRho27
gcvA,5885278,5885278,5885134,144,0,utRho27
gcvB,5885392,5885392,5885392,0,0,utRho27
gcvR,5199758,5199812,5199758,54,0,utRho27
gcvT,6101544,6101544,6101334,210,164,utRho27
gdhA,3684616,3684742,3684616,126,46,utRho27
gfcA,2099668,2099668,2099488,180,50,utRho27
gfcD,2096236,2096236,2095890,346,46,utRho27
ghrA,2195648,2195772,2195648,124,2,utRho27
ghrB,7434378,7434620,7434378,242,34,utRho27
glcA,6242728,6242728,6242558,170,388,utRho27
glcC,6256412,6256544,6256412,132,26,utRho27
glcD,6256152,6256152,6256042,110,44,utRho27
gldA,8278092,8278092,8278070,22,92,utRho27
glgA,7136784,7136784,7136066,718,288,utRho27
glgB,7147314,7147314,7147004,310,382,utRho27
glgC,7139142,7139142,7138656,486,0,utRho27
glgP,7133546,7133546,7133162,384,216,utRho27
glgS,6384024,6384024,6383878,146,390,utRho27
glgX,7142838,7142838,7142638,200,0,utRho27
glk,5018922,5018922,5018852,70,120,utRho27
glmS,7827622,7827622,7827336,286,162,utRho27
glmU,7830652,7830652,7830400,252,36,utRho27
glmY,10765360,10765360,10765360,0,0,utRho27
glmZ,7972864,7972864,7972864,0,0,utRho27
glnA,16232888,16232888,16232136,752,0,utRho27
glnB,5375052,5375052,5374816,236,0,utRho27
glnD,377310,377310,377300,10,0,utRho27
glnE,6399602,6399602,6399282,320,0,utRho27
glnH,1696396,1696396,1696008,388,94,utRho27
glnK,945112,945196,945112,84,0,utRho27
glnL,8112742,8112742,8112678,64,0,utRho27
glnQ,1693262,1693262,1692926,336,24,utRho27
glnS,1411998,1412186,1411998,188,3060,utRho27
gloA,3455602,3455674,3455602,72,0,utRho27
gloB,469852,469852,469564,288,294,utRho27
glpA,4705166,4705294,4705166,128,8,utRho27
glpD,7123942,7124026,7123942,84,48,utRho27
glpE,7123698,7123698,7123646,52,0,utRho27
glpF,8236322,8236322,8236180,142,274,utRho27
glpG,7122960,7122960,7122904,56,170,utRho27
glpR,7121782,7121782,7121210,572,680,utRho27
glpT,4704902,4704902,4704748,154,68,utRho27
glpX,8231212,8231212,8231158,54,44,utRho27
glrK,5382246,5382246,5382196,50,0,utRho27
gltA,1509534,1509534,1508936,598,1088,utRho27
gltB,6709018,6709264,6709018,246,68,utRho27
gltI,1375792,1375792,1375494,298,798,utRho27
gltP,8588536,8588962,8588536,426,558,utRho27
gltS,7657382,7657382,7657330,52,158,utRho27
gltX,5041568,5041568,5041344,224,254,utRho27
gluQ,320286,320286,320224,62,32,utRho27
glyA,5371148,5371148,5371014,134,0,utRho27
glyQ,7450708,7450708,7450636,72,96,utRho27
glyS,7448990,7448990,7448794,196,244,utRho27
glyU,5998128,5998128,5998114,14,14,utRho27
glyV,8784626,8784720,8784626,94,12,utRho27
glyW,3984360,3984360,3984234,126,0,utRho27
gmhB,445612,445666,445612,54,0,utRho27
gmk,7642776,7642856,7642776,80,0,utRho27
gmr,2693686,2693686,2693484,202,0,utRho27
gnd,4202648,4202648,4202536,112,274,utRho27
gnsB,3275692,3275692,3275564,128,0,utRho27
gntK,14310580,14310580,14310368,212,40,utRho27
gntP,9102668,9102668,9102592,76,612,utRho27
gntR,7157760,7157760,7157452,308,324,utRho27
gntT,7092810,7093118,7092810,308,378,utRho27
gntU,7154170,7154170,7154122,48,112,utRho27
gntX,7089334,7089764,7089334,430,100,utRho27
gor,7292224,7292598,7292224,374,24,utRho27
gpmA,1575340,1575340,1575190,150,32,utRho27
gpmM,7570374,7570520,7570374,146,140,utRho27
gpsA,7567620,7567620,7567322,298,1768,utRho27
gpt,511828,511954,511828,126,232,utRho27
grcA,5433046,5433046,5432898,148,320,utRho27
greA,6657728,6657728,6657430,298,856,utRho27
greB,7073488,7073624,7073488,136,84,utRho27
groL,8741566,8742050,8741566,484,20626,utRho27
groS,8741232,8741376,8741232,144,18654,utRho27
grpE,5501494,5501494,5501416,78,528,utRho27
grxA,1781552,1781552,1781506,46,0,utRho27
grxB,2248206,2248206,2248108,98,218,utRho27
grxC,7569152,7569152,7568884,268,766,utRho27
grxD,3468324,3468324,3468202,122,1458,utRho27
gspA,6911268,6911268,6910796,472,354,utRho27
gspC,6910964,6911156,6910964,192,156,utRho27
gss,6277220,6277220,6277044,176,36,utRho27
gstA,3428654,3428754,3428654,100,0,utRho27
gstB,1761038,1761038,1760960,78,266,utRho27
guaB,5268214,5268214,5268140,74,226,utRho27
gudD,5839026,5839026,5838770,256,32,utRho27
gyrA,4678914,4678914,4678840,74,24,utRho27
gyrB,7760300,7760300,7760238,62,86,utRho27
hcaE,5337964,5338064,5337964,100,104,utRho27
hcaR,5337928,5337928,5337792,136,42,utRho27
hcaT,5336106,5336106,5335692,414,62,utRho27
hchA,4071260,4071670,4071260,410,190,utRho27
hcp,1828258,1828258,1827628,630,142,utRho27
hcr,1824400,1824400,1824300,100,0,utRho27
hdeA,7313582,7313582,7313480,102,18,utRho27
hdeD,7313920,7313990,7313920,70,892,utRho27
hdfR,7896320,7896320,7895934,386,134,utRho27
hdhA,3396244,3396244,3396080,164,118,utRho27
helD,2048876,2048942,2048876,66,0,utRho27
hemA,2527166,2527428,2527166,262,202,utRho27
hemB,779722,779722,779454,268,48,utRho27
hemF,5106410,5106450,5106410,40,132,utRho27
hemH,996062,996110,996062,48,0,utRho27
hemL,349882,349882,349764,118,0,utRho27
hemN,8103886,8104090,8103886,204,8,utRho27
hepA,127176,127176,126528,648,21712,utRho27
hflD,2385372,2385372,2385262,110,32,utRho27
hfq,8799602,8800576,8799602,974,4848,utRho27
hha,961006,961006,960616,390,0,utRho27
hicA,3018442,3018572,3018442,130,42,utRho27
higA,6468682,6468682,6468288,394,332,utRho27
higB,6468960,6468960,6468910,50,366,utRho27
hinT,2323642,2323770,2323642,128,0,utRho27
hipB,3184964,3184964,3184884,80,94,utRho27
hisB,4186720,4186936,4186720,216,308,utRho27
hisJ,4853674,4853674,4853576,98,46,utRho27
hisL,8359856,8359984,8359856,128,0,utRho27
hisS,5281284,5281284,5281150,134,0,utRho27
hlpA,400910,400964,400910,54,32,utRho27
hlyE,2460932,2460932,2460788,144,178,utRho27
hmp,5371594,5371670,5371594,76,0,utRho27
hns,2585916,2585916,2585844,72,3732,utRho27
hofM,7045856,7045856,7045502,354,22,utRho27
hokA,7441620,7441620,7441200,420,456,utRho27
hokC,33902,33902,33806,96,262,utRho27
hokE,1215462,1215672,1215462,210,0,utRho27
holC,8968546,8968546,8968560,14,22,utRho27
holD,9215562,9215606,9215562,44,0,utRho27
holE,3850040,3850216,3850040,176,6,utRho27
hpt,282720,282862,282720,142,138,utRho27
hrpB,324150,324210,324150,60,0,utRho27
hscB,5319048,5319048,5318934,114,184,utRho27
hscC,1367188,1367188,1366786,402,254,utRho27
hsdS,9163004,9163004,9162924,80,600,utRho27
hslJ,2883560,2883560,2883486,74,770,utRho27
hslO,7059344,7059548,7059344,204,113844,utRho27
hslR,7058220,7058696,7058220,476,9996,utRho27
hslV,8244708,8244708,8244574,134,0,utRho27
hsrA,7881412,7881412,7881224,188,28,utRho27
htgA,21286,21660,21286,374,606,utRho27
htpG,989634,990240,989634,606,424,utRho27
htpX,3825236,3825236,3825152,84,144,utRho27
htrE,311036,311036,310852,184,44,utRho27
htrL,7587668,7587668,7587366,302,138,utRho27
hupA,8400352,8400562,8400352,210,108,utRho27
hupB,1845220,1845804,1845220,584,168,utRho27
hyaA,2063968,2064278,2063968,310,68,utRho27
hybO,6292726,6292726,6292522,204,286,utRho27
hycA,5700922,5700922,5700870,52,0,utRho27
hycI,5686204,5686204,5686086,118,272,utRho27
hydN,5676264,5676264,5676210,54,0,utRho27
hyfA,5202342,5202402,5202342,60,0,utRho27
hypA,11402508,11402588,11402508,80,232,utRho27
hypB,11403356,11404004,11403356,648,72,utRho27
hypF,5676210,5676210,5674850,1360,288,utRho27
hypT,9116634,9116634,9116578,56,0,utRho27
hyuA,6019660,6020056,6019660,396,0,utRho27
iaaA,1733074,1733136,1733074,62,82,utRho27
iadA,9119074,9119074,9119052,22,86,utRho27
iap,5753072,5753162,5753072,90,40,utRho27
ibaG,6673966,6673966,6673606,360,20,utRho27
ibpA,7735036,7735036,7734844,192,10512,utRho27
ibpB,7733962,7733962,7733794,168,106208,utRho27
icd,2389922,2390246,2389922,324,2,utRho27
iclR,8447304,8447304,8447256,48,66,utRho27
idi,6065876,6066130,6065876,254,26,utRho27
idnD,8988870,8988870,8988812,58,0,utRho27
idnK,8989194,8989246,8989194,52,80,utRho27
ihfA,3591442,3591442,3591104,338,250,utRho27
ihfB,1927498,1927656,1927498,158,56,utRho27
ileS,43666,44782,43666,1116,578,utRho27
ileX,6431194,6431196,6431194,2,0,utRho27
ilvA,15820940,15821324,15820940,384,8,utRho27
ilvC,7915824,7915940,7915824,116,176,utRho27
ilvE,15809552,15809936,15809552,384,880,utRho27
ilvI,170840,171260,170840,420,0,utRho27
ilvL,23701308,23701932,23701308,624,234,utRho27
ilvY,7915734,7915734,7915640,94,144,utRho27
inaA,4698998,4698998,4698944,54,40,utRho27
infA,1853370,1853370,1852886,484,94,utRho27
infC,3602692,3602692,3601276,1416,782,utRho27
insA-5,3958452,3958452,3958430,22,28,utRho27
insA-7,9036758,9037054,9036758,296,124,utRho27
insC-5,6372080,6372284,6372080,204,352,utRho27
insEF-2,785238,785238,785820,582,322,utRho27
insEF-4,2190310,2190310,2190892,582,284,utRho27
insG,9007098,9007098,9006862,236,0,utRho27
insH-1,550596,550596,550234,362,188,utRho27
insH-11,7306538,7306538,7306396,142,126,utRho27
insH-2,1151548,1151548,1151506,42,120,utRho27
insH-3,1378444,1378444,1378026,418,398,utRho27
insH-4,2791942,2792152,2791942,210,18,utRho27
insH-5,2857852,2857852,2857452,400,20,utRho27
insH-6,4135022,4135022,4134642,380,248,utRho27
insH-7,4206186,4206186,4205822,364,2192,utRho27
insH-9,6260050,6260356,6260050,306,426,utRho27
insI-3,9017372,9017372,9017234,138,18,utRho27
insJ,7441188,7441360,7441188,172,244,utRho27
insK,7442130,7442308,7442130,178,0,utRho27
insL-1,30760,30890,30760,130,12532,utRho27
insL-2,1216112,1216130,1216112,18,268,utRho27
insL-3,5028644,5028662,5028644,18,224,utRho27
insN-1,540452,540484,540452,32,0,utRho27
intD,1132202,1132202,1131956,246,44,utRho27
intR,2826520,2826520,2826470,50,0,utRho27
intS,4933026,4933090,4933026,64,12,utRho27
intZ,5117386,5117542,5117386,156,138,utRho27
iraD,9113152,9113986,9113152,834,132,utRho27
iraM,2424246,2424246,2424006,240,62,utRho27
iraP,802638,802772,802638,134,0,utRho27
iscA,5319924,5319924,5319772,152,366,utRho27
iscR,5324398,5324398,5324262,136,1144,utRho27
iscX,5313834,5313834,5313472,362,296,utRho27
ispF,5743968,5743968,5743560,408,44,utRho27
ispG,5283908,5283908,5283608,300,0,utRho27
ispU,389568,389806,389568,238,0,utRho27
isrA,2811502,2811502,2811618,116,0,utRho27
istr-1,7706384,7706384,7706384,0,0,utRho27
istr-2,7706514,7706514,7706514,0,0,utRho27
ivbL,15412092,15412092,15411952,140,76,utRho27
ivy,480638,480686,480638,48,80,utRho27
katE,3627628,3627734,3627628,106,154,utRho27
katG,8267624,8267670,8267624,46,52,utRho27
kbaZ,6557732,6557828,6557732,96,0,utRho27
kbl,7585154,7585154,7585102,52,220,utRho27
kch,2621046,2621046,2620538,508,204,utRho27
kdgR,3820506,3820506,3820198,308,94,utRho27
kdpE,1443788,1443788,1443466,322,46,utRho27
kdpF,1457698,1457698,1457642,56,0,utRho27
kdsA,2535708,2536330,2535708,622,602,utRho27
kdsC,6683438,6684546,6683438,1108,3256,utRho27
kduI,5968388,5968388,5968248,140,144,utRho27
kefF,94160,94492,94160,332,808,utRho27
kgtP,5451624,5451624,5451492,132,434,utRho27
kup,7862206,7862632,7862206,426,2142,utRho27
lacI,735076,735076,735020,56,38,utRho27
lacZ,1465508,1465508,1465220,288,320,utRho27
ldcA,2486394,2486394,2486160,234,0,utRho27
ldhA,2885830,2885830,2885686,144,462,utRho27
ldrA,2538954,2538954,2538550,404,314,utRho27
ldrB,2540024,2540024,2539620,404,82,utRho27
ldrC,2541092,2541092,2540690,402,12,utRho27
ldrD,7400544,7400544,7400174,370,134,utRho27
lepA,5414392,5414392,5414248,144,298,utRho27
lepB,5410928,5410928,5410618,310,1612,utRho27
leuD,159188,159188,158906,282,118,utRho27
leuE,3761600,3761600,3761518,82,90,utRho27
leuL,168048,168048,167416,632,234,utRho27
leuO,168308,168736,168308,428,12,utRho27
leuQ,9212864,9212864,9212802,62,0,utRho27
leuU,6644556,6644556,6644316,240,1134,utRho27
leuV,9212546,9212546,9212330,216,148,utRho27
leuX,8992772,8992810,8992772,38,0,utRho27
lexA,8514174,8514230,8514174,56,550,utRho27
lhr,3456706,3458174,3456706,1468,348,utRho27
ligA,5060402,5060402,5060352,50,0,utRho27
ligB,7642576,7642576,7642340,236,0,utRho27
lipA,1320602,1320602,1320432,170,0,utRho27
lipB,1324802,1324802,1324556,246,8326,utRho27
lit,2397032,2397390,2397032,358,340,utRho27
livJ,7199524,7199524,7199316,208,1358,utRho27
livK,7195510,7195510,7195120,390,1026,utRho27
lldP,7554578,7554798,7554578,220,64,utRho27
lnt,1381968,1381968,1381762,206,736,utRho27
loiP,6163784,6163826,6163784,42,0,utRho27
lolA,1874656,1874738,1874656,82,458,utRho27
lolB,2527112,2527112,2527000,112,114,utRho27
lolC,2350748,2350854,2350748,106,24,utRho27
lon,917630,917776,917630,146,1630,utRho27
lpcA,486936,487086,486936,150,0,utRho27
lpd,255434,255824,255434,390,284,utRho27
lplA,9248476,9248476,9248234,242,684,utRho27
lplT,5947878,5947878,5947724,154,0,utRho27
lpoA,6586422,6586800,6586422,378,0,utRho27
lpp,3514592,3514842,3514592,250,206,utRho27
lptA,6686598,6686760,6686598,162,246,utRho27
lptB,6686792,6687888,6686792,1096,920,utRho27
lptD,114672,114672,114218,454,88,utRho27
lptF,8972244,8972436,8972244,192,0,utRho27
lpxC,213016,213114,213016,98,484,utRho27
lpxD,401920,401942,401920,22,0,utRho27
lpxL,2233418,2233418,2233164,254,0,utRho27
lpxM,3880456,3880456,3880386,70,0,utRho27
lpxP,4991156,4991290,4991156,134,62,utRho27
lrhA,4813312,4813312,4813282,30,12,utRho27
lrp,1864656,1865190,1864656,534,156,utRho27
lspA,50028,50414,50028,386,480,utRho27
lsrA,3202920,3202980,3202920,60,0,utRho27
lsrR,3202514,3202514,3202482,32,0,utRho27
ltaE,1818640,1818640,1818588,52,0,utRho27
luxS,5630130,5630130,5629466,664,620,utRho27
lysA,5957902,5957902,5957798,104,0,utRho27
lysC,8467232,8467232,8466466,766,400,utRho27
lysP,4497120,4497120,4497064,56,90,utRho27
lysR,5957900,5958042,5957900,142,0,utRho27
lysT,1561028,1561108,1561028,80,24,utRho27
lysU,8709610,8709610,8709434,176,252,utRho27
macB,1840188,1840694,1840188,506,208,utRho27
maeA,3111484,3111484,3111338,146,130,utRho27
mak,820236,820288,820236,52,34,utRho27
malE,8492928,8492928,8492838,90,0,utRho27
malI,3398456,3398456,3398360,96,18,utRho27
malK,8493472,8493568,8493472,96,20,utRho27
malP,7105020,7105020,7104946,74,192,utRho27
malQ,7100798,7100798,7100140,658,464,utRho27
malS,14949880,14949988,14949880,108,36,utRho27
malT,7106048,7106170,7106048,122,0,utRho27
malX,3398626,3398710,3398626,84,18,utRho27
malZ,1689980,1690072,1689980,92,308,utRho27
manA,3377102,3377152,3377102,50,0,utRho27
manX,3803866,3804096,3803866,230,0,utRho27
marC,3237882,3237882,3237816,66,16,utRho27
marR,3238186,3238240,3238186,54,32,utRho27
matP,2036918,2036970,2036918,52,0,utRho27
mazE,5822736,5822736,5822678,58,0,utRho27
mazG,5821720,5821720,5821370,350,596,utRho27
mcbA,1684306,1684306,1684112,194,20,utRho27
mcbR,3040192,3040524,3040192,332,0,utRho27
mcrA,2420278,2420692,2420278,414,0,utRho27
mcrC,9156124,9156124,9155916,208,306,utRho27
mdaB,6344814,6345060,6344814,246,38,utRho27
mdfA,1767138,1767346,1767138,208,0,utRho27
mdh,6768940,6768940,6768536,404,54,utRho27
mdoB,9198988,9198988,9198882,106,128,utRho27
mdoD,2993290,2993712,2993290,422,0,utRho27
mdoG,2218514,2218670,2218514,156,60,utRho27
mdtA,4307958,4308032,4307958,74,0,utRho27
mdtE,7318168,7318464,7318168,296,352,utRho27
mdtK,3486538,3486914,3486538,376,614,utRho27
mdtP,8602472,8602472,8602060,412,56,utRho27
melA,8683774,8683822,8683774,48,0,utRho27
melR,8683300,8683300,8683256,44,208,utRho27
menA,8240812,8240812,8240698,114,116,utRho27
menB,4753774,4753774,4753638,136,54,utRho27
mepH,3468714,3468870,3468714,156,0,utRho27
mepM,3883666,3883666,3883270,396,160,utRho27
mepS,4539840,4539958,4539840,118,38,utRho27
metA,8428318,8428560,8428318,242,0,utRho27
metB,8257272,8257344,8257272,72,306,utRho27
metC,6304150,6304472,6304150,322,224,utRho27
metE,8025768,8026106,8025768,338,180,utRho27
metF,8265092,8265232,8265092,140,112,utRho27
metG,4388538,4388600,4388538,62,54,utRho27
metH,8447010,8447656,8447010,646,1792,utRho27
metJ,8257116,8257116,8256790,326,102,utRho27
metK,6173154,6173412,6173154,258,72,utRho27
metN,445428,445428,445290,138,0,utRho27
metR,8025710,8025710,8025632,78,0,utRho27
metT,1394326,1394326,1394266,60,40,utRho27
metY,19910250,19910250,19909734,516,90,utRho27
metZ,11789528,11789548,11789528,20,240,utRho27
mfd,2348056,2348056,2347928,128,0,utRho27
mglA,4478782,4478782,4478578,204,58,utRho27
mglB,4481132,4481132,4480696,436,5444,utRho27
mglC,4475918,4475918,4475506,412,254,utRho27
mgrB,3817584,3817584,3817532,52,0,utRho27
mgrR,3245828,3245828,3245828,0,0,utRho27
mgsA,2054082,2054082,2054030,52,38,utRho27
mgtL,8934560,8934862,8934560,302,204,utRho27
mhpA,737038,737222,737038,184,84,utRho27
mhpR,737072,737072,736840,232,60,utRho27
mhpT,750772,750918,750772,146,36,utRho27
miaA,8797964,8798504,8797964,540,404,utRho27
micA,5629604,5629604,5629604,0,0,utRho27
micC,2874242,2874238,2874242,4,0,utRho27
micF,4626168,4626168,4626168,0,0,utRho27
micM,1014408,1014408,1014408,0,0,utRho27
minE,2449422,2449422,2449090,332,198,utRho27
mioC,7852950,7852950,7852910,40,0,utRho27
mipA,3733012,3733012,3732944,68,400,utRho27
mlaA,4930270,4930270,4930014,256,242,utRho27
mlc,3337206,3337206,3337128,78,0,utRho27
mlrA,4429498,4429732,4429498,234,34,utRho27
mltA,5894546,5894546,5894356,190,108,utRho27
mltD,468050,468050,467910,140,78,utRho27
mltF,5391534,5391602,5391534,68,0,utRho27
mmuP,550238,550650,550238,412,188,utRho27
mngA,1531622,1531968,1531622,346,0,utRho27
mngR,1531852,1531852,1531750,102,0,utRho27
mnmG,7851348,7851348,7851266,82,56,utRho27
mntH,5025470,5025470,5025412,58,0,utRho27
mntP,3810918,3811376,3810918,458,0,utRho27
mntR,1706160,1706366,1706160,206,12,utRho27
mntS,1706128,1706128,1705994,134,12,utRho27
moaA,1633654,1634088,1633654,434,0,utRho27
moaB,1635954,1636110,1635954,156,0,utRho27
mobA,8084242,8084242,8083998,244,180,utRho27
mocA,6030112,6030320,6030112,208,14,utRho27
modA,1589990,1590178,1589990,188,0,utRho27
moeA,1732788,1732788,1732728,60,0,utRho27
mokB,2984610,2984610,2984258,352,36,utRho27
molR_1,4392888,4392948,4392888,60,0,utRho27
motA,3954604,3954604,3954278,326,0,utRho27
mpaA,2781278,2781278,2781196,82,42,utRho27
mpl,8911456,8911570,8911456,114,0,utRho27
mppA,2786108,2786454,2786108,346,0,utRho27
mprA,5621494,5621540,5621494,46,0,utRho27
mqo,4613848,4613848,4613508,340,0,utRho27
mqsA,6336742,6336742,6336492,250,198,utRho27
mqsR,6337306,6337306,6337088,218,288,utRho27
mraZ,179192,179268,179192,76,20,utRho27
mrcA,7045652,7045742,7045652,90,0,utRho27
mrcB,329442,329460,329442,18,0,utRho27
mreB,13605424,13605424,13604348,1076,564,utRho27
mreD,6798166,6798166,6797750,416,90,utRho27
mrp,4388360,4388360,4388336,24,68,utRho27
mscK,972984,973072,972984,88,84,utRho27
mscL,6876002,6876048,6876002,46,690,utRho27
mscS,6139742,6139742,6139614,128,0,utRho27
msrA,8884522,8884522,8884352,170,354,utRho27
msrB,3725168,3725168,3724858,310,4,utRho27
msyB,2228426,2228426,2228362,64,114,utRho27
mtfA,4087236,4087302,4087236,66,160,utRho27
mtgA,6699662,6699662,6699618,44,30,utRho27
mtlA,30177504,30178248,30177504,744,3008,utRho27
mtn,358366,358366,358306,60,96,utRho27
mtr,6611864,6611864,6611634,230,20,utRho27
mug,6430992,6430992,6430946,46,1402,utRho27
murQ,5091466,5091546,5091466,80,0,utRho27
murR,5091586,5091586,5091218,368,0,utRho27
mutH,5939164,5939324,5939164,160,174,utRho27
mutL,8794092,8794824,8794092,732,206,utRho27
mutM,7622554,7622554,7622304,250,104,utRho27
mutS,5714038,5714186,5714038,148,286,utRho27
mutY,18617466,18618078,18617466,612,0,utRho27
nac,4123956,4123956,4123866,90,0,utRho27
nadA,1564122,1564170,1564122,48,66,utRho27
nadB,5420714,5420840,5420714,126,0,utRho27
nadC,237326,237326,237290,36,4,utRho27
nadE,3644604,3644916,3644604,312,70,utRho27
nadK,5501526,5501662,5501526,136,112,utRho27
nagA,1406350,1406350,1405502,848,1044,utRho27
nagB,1407416,1407416,1407222,194,96,utRho27
nagC,1404016,1404016,1403188,828,0,utRho27
nagE,1407680,1407888,1407680,208,580,utRho27
nagK,2357080,2357186,2357080,106,0,utRho27
nanA,6747240,6747240,6747152,88,100,utRho27
nanC,9079856,9079856,9079002,854,396,utRho27
nanR,6749406,6749406,6748978,428,1034,utRho27
nanS,9075406,9075406,9075188,218,0,utRho27
napF,4607390,4607390,4606994,396,46,utRho27
narG,2559614,2559728,2559614,114,52,utRho27
narK,2555642,2555914,2555642,272,70,utRho27
narP,4580844,4581000,4580844,156,206,utRho27
narQ,5171154,5171462,5171154,308,274,utRho27
narU,3088326,3088326,3088120,206,202,utRho27
narW,3077374,3077374,3074618,2756,184,utRho27
narX,2555554,2555554,2555236,318,76,utRho27
narZ,3085380,3085380,3085180,200,0,utRho27
ndh,2331984,2332170,2331984,186,202,utRho27
ndk,5289920,5289920,5289728,192,128,utRho27
nemR,6904084,6904092,6904084,8,0,utRho27
nepI,7683542,7683542,7683478,64,20,utRho27
nfo,4501612,4501680,4501612,68,16,utRho27
nfsB,1210906,1210906,1210848,58,28,utRho27
nfuA,7090916,7091248,7090916,332,1018,utRho27
nhaA,34634,34978,34634,344,550,utRho27
nhaB,2469534,2469534,2469434,100,12,utRho27
nhoA,3067926,3068048,3067926,122,0,utRho27
nikA,7226878,7227334,7226878,456,342,utRho27
nikR,7237074,7237176,7237074,102,68,utRho27
nirB,6987974,6988022,6987974,48,18,utRho27
nlpA,7680034,7680034,7679986,48,0,utRho27
nlpC,3585654,3585654,3585462,192,46,utRho27
nlpD,5737658,5737658,5737506,152,52,utRho27
nlpI,6618080,6618080,6617848,232,0,utRho27
nmpC,1153740,1153740,1153650,90,0,utRho27
nohA,3273206,3273206,3272734,472,118,utRho27
norR,5664614,5664614,5664578,36,0,utRho27
norV,5664878,5664952,5664878,74,42,utRho27
nrdA,4689510,4689730,4689510,220,5272,utRho27
nrdD,8925676,8925676,8925320,356,556,utRho27
nrdH,5601312,5601446,5601312,134,266,utRho27
nrdR,865954,866004,865954,50,0,utRho27
nrfA,8575342,8575528,8575342,186,8,utRho27
nsrR,8812088,8812380,8812088,292,68,utRho27
nudB,3897348,3897348,3897264,84,0,utRho27
nudC,8393428,8393806,8393428,378,0,utRho27
nudE,7052658,7052658,7052298,360,812,utRho27
nudG,3682876,3682980,3682876,104,50,utRho27
nudI,4729050,4729108,4729050,58,0,utRho27
nudJ,2388874,2388874,2388576,298,130,utRho27
nuoA,4810670,4810670,4810144,526,1028,utRho27
nuoN,4783434,4783434,4783010,424,126,utRho27
nupC,5026018,5026084,5026018,66,0,utRho27
nupG,6211302,6211428,6211302,126,32,utRho27
ogrK,4335096,4335096,4335040,56,50,utRho27
ogt,2800568,2800568,2800472,96,444,utRho27
ohsC,5401036,5401040,5401036,4,60,utRho27
ompA,2040382,2040382,2040106,276,3528,utRho27
ompC,4625774,4625774,4625498,276,6,utRho27
ompF,1974184,1974184,1973964,220,118,utRho27
ompL,8128958,8128958,8128590,368,720,utRho27
ompN,2874158,2874158,2873786,372,0,utRho27
ompR,7073510,7073510,7073168,342,84,utRho27
ompT,1171330,1171330,1171266,64,104,utRho27
ompW,2627982,2628040,2627982,58,0,utRho27
ompX,1700418,1700900,1700418,482,1188,utRho27
omrA,5952378,5952378,5952378,0,0,utRho27
omrB,5952770,5952770,5952770,0,0,utRho27
oppA,2602170,2602364,2602170,194,186,utRho27
orn,8783168,8783208,8783168,40,12,utRho27
osmB,2686952,2686952,2686656,296,1286,utRho27
osmC,3113192,3113250,3113192,58,178,utRho27
osmE,3644566,3644566,3644512,54,32,utRho27
osmF,4439046,4439046,4438962,84,160,utRho27
osmY,9222306,9222792,9222306,486,70,utRho27
otsA,3963302,3963302,3963224,78,50,utRho27
otsB,3964930,3964930,3964774,156,454,utRho27
oxc,4984288,4984288,4983900,388,308,utRho27
oxyR,8316914,8316980,8316914,66,70,utRho27
oxyS,8316788,8316788,8316788,0,0,utRho27
paaA,2907730,2907854,2907730,124,0,utRho27
paaX,2927018,2927078,2927018,60,0,utRho27
paaZ,2907340,2907340,2907284,56,4,utRho27
pabA,6981702,6981702,6981658,44,32,utRho27
pabB,3789256,3789610,3789256,354,44,utRho27
pabC,2306186,2306600,2306186,414,88,utRho27
pagP,1313052,1313114,1313052,62,0,utRho27
panB,299260,299260,299202,58,504,utRho27
panC,297840,297840,297590,250,8,utRho27
panD,293490,293490,293388,102,56,utRho27
panZ,7195656,7195968,7195656,312,96,utRho27
parC,6332060,6332060,6331946,114,0,utRho27
patA,6438916,6438988,6438916,72,68,utRho27
patD,3030830,3031156,3030830,326,0,utRho27
pbpC,5294986,5294986,5294650,336,0,utRho27
pbpG,4450132,4450132,4449740,392,0,utRho27
pck,7065358,7065636,7065358,278,884,utRho27
pcnB,318782,318782,318252,530,132,utRho27
pdhR,244068,244184,244068,116,0,utRho27
pdxB,4875768,4875768,4875702,66,0,utRho27
pdxH,3436068,3436068,3436014,54,0,utRho27
pdxJ,5403626,5403626,5403458,168,0,utRho27
pdxK,5074638,5074638,5074474,164,50,utRho27
pepA,8972278,8972278,8971902,376,0,utRho27
pepD,511618,511618,511432,186,258,utRho27
pepN,1981182,1981244,1981182,62,138,utRho27
pepQ,8062294,8062322,8062294,28,148,utRho27
pepT,2371646,2371688,2371646,42,40,utRho27
pfkA,8214948,8215104,8214948,156,120,utRho27
pfkB,3612646,3612740,3612646,94,52,utRho27
pflA,1902456,1902456,1902160,296,0,utRho27
pflB,1907850,1907850,1907108,742,48,utRho27
pflD,8287716,8287990,8287716,274,54,utRho27
pgaA,2185046,2185046,2184578,468,1438,utRho27
pgi,8467444,8467516,8467444,72,0,utRho27
pgk,12291428,12291428,12290488,940,284,utRho27
pgl,1597078,1597172,1597078,94,0,utRho27
pgpB,2678324,2678660,2678324,336,34,utRho27
pgpC,5397276,5397276,5397100,176,60,utRho27
pgrR,2783744,2783982,2783744,238,24,utRho27
pheL,5475158,5475198,5475158,40,0,utRho27
pheM,7197204,7197204,7197080,124,0,utRho27
pheP,1203858,1203918,1203858,60,8,utRho27
pheU,8725254,8725254,8725252,2,0,utRho27
pheV,6220730,6220732,6220730,2,0,utRho27
phnC,8650412,8650412,8650330,82,0,utRho27
phoA,803414,803494,803414,80,0,utRho27
phoB,834202,834284,834202,82,394,utRho27
phoE,520316,520316,520200,116,32,utRho27
phoH,2169730,2169984,2169730,254,36,utRho27
phoP,2381016,2381016,2380894,122,194,utRho27
phoQ,2379880,2379880,2379552,328,96,utRho27
phoU,7815330,7815330,7815156,174,72,utRho27
phr,1478842,1479014,1478842,172,0,utRho27
pinE,2419054,2419370,2419054,316,112,utRho27
pinQ,3267168,3267244,3267168,76,0,utRho27
pinR,2867424,2867424,2867348,76,0,utRho27
pitA,7275224,7275284,7275224,60,0,utRho27
pitB,6272806,6272806,6272742,64,158,utRho27
pka,5439862,5439906,5439862,44,46,utRho27
plaP,4174476,4174476,4174124,352,16,utRho27
pldA,8009628,8009724,8009628,96,152,utRho27
pldB,8018028,8018340,8018028,312,262,utRho27
plsB,8513196,8513196,8512932,264,110,utRho27
pmbA,8915890,8915918,8915890,28,0,utRho27
pmrD,4747148,4747148,4747076,72,0,utRho27
pncB,1980828,1980828,1980712,116,8,utRho27
pncC,5648788,5648788,5648692,96,0,utRho27
pnp,6622652,6622652,6622336,316,0,utRho27
pntA,3355950,3355950,3355806,144,0,utRho27
pntB,3353096,3353096,3352720,376,90,utRho27
polA,8093880,8093932,8093880,52,38,utRho27
polB,131606,131606,131560,46,0,utRho27
potD,2365700,2365700,2365658,42,56,utRho27
potE,1436688,1436688,1436530,158,32,utRho27
potF,1787268,1787568,1787268,300,0,utRho27
poxB,1822152,1822152,1822098,54,16,utRho27
ppa,8899372,8899372,8899304,68,152,utRho27
ppc,8306380,8306380,8306196,184,1058,utRho27
ppdA,5928440,5928440,5928354,86,30,utRho27
ppdD,235410,235410,235098,312,40,utRho27
pphA,3846770,3846770,3845938,832,708,utRho27
pphB,5719474,5719520,5719474,46,0,utRho27
ppiA,6984898,6984898,6984594,304,180,utRho27
ppiC,7919682,7919682,7919626,56,0,utRho27
ppiD,923638,923830,923638,192,20,utRho27
ppk,5245748,5246088,5245748,340,176,utRho27
pppA,6228958,6228958,6228704,254,0,utRho27
ppsA,3574322,3574322,3574224,98,0,utRho27
ppsR,3574678,3574890,3574678,212,0,utRho27
pptA,3065716,3066104,3065716,388,158,utRho27
pqiA,2023318,2024002,2023318,684,46,utRho27
prc,3830054,3830054,3829632,422,608,utRho27
preT,4467978,4468066,4467978,88,16,utRho27
prfC,9218688,9218828,9218688,140,2,utRho27
prkB,6968622,6968980,6968622,358,126,utRho27
prlC,7290476,7290476,7290364,112,1090,utRho27
prlF,6553944,6554004,6553944,60,486,utRho27
proB,520432,520776,520432,344,8,utRho27
proC,811372,811372,811288,84,0,utRho27
proK,7417388,7417388,7417384,4,0,utRho27
proL,4572414,4572422,4572414,8,88,utRho27
proP,8660640,8661004,8660640,364,140,utRho27
proS,437674,437674,437550,124,68,utRho27
proV,5609126,5609630,5609126,504,158,utRho27
prpB,697292,697364,697292,72,0,utRho27
prpR,696942,696942,696886,56,0,utRho27
prs,2524354,2524354,2523750,604,1800,utRho27
psd,8781276,8781276,8780720,556,400,utRho27
psiE,8480600,8480650,8480600,50,0,utRho27
pspA,2736076,2736158,2736076,82,0,utRho27
pspF,2736080,2736080,2735824,256,0,utRho27
pspG,8525632,8525680,8525632,48,44,utRho27
pssA,5445156,5445454,5445156,298,306,utRho27
pstB,7817112,7817112,7816732,380,40,utRho27
pstC,7821084,7821084,7820796,288,70,utRho27
pstS,23469408,23469408,23469150,258,0,utRho27
psuG,4517114,4517114,4516734,380,2420,utRho27
psuT,4514992,4514992,4514670,322,196,utRho27
pth,2517084,2517084,2517026,58,82,utRho27
ptrA,5918022,5918022,5917768,254,48,utRho27
ptrB,3857730,3857730,3857678,52,118,utRho27
ptsG,2315252,2315738,2315252,486,98,utRho27
ptsH,5066996,5067528,5066996,532,252,utRho27
purA,8809328,8809374,8809328,46,220,utRho27
purC,5195562,5195562,5195236,326,0,utRho27
purD,8411972,8411972,8411862,110,20,utRho27
purE,1106284,1106284,1106200,84,0,utRho27
purH,8415254,8415254,8415064,190,0,utRho27
purL,5391178,5391178,5391086,92,40,utRho27
purM,5242306,5242394,5242306,88,0,utRho27
purR,3475378,3475688,3475378,310,44,utRho27
purT,3861438,3861762,3861438,324,4,utRho27
purU,2577512,2577512,2577248,264,0,utRho27
putA,2157850,2157850,2157764,86,32,utRho27
putP,2158336,2158610,2158336,274,82,utRho27
puuA,2721936,2721936,2721816,120,0,utRho27
puuC,2725456,2725486,2725456,30,24,utRho27
puuD,2722104,2722240,2722104,136,0,utRho27
puuP,2718746,2718746,2718374,372,110,utRho27
pykA,3874988,3875298,3874988,310,0,utRho27
pykF,3510934,3511396,3510934,462,186,utRho27
pyrC,2245286,2245286,2245214,72,8,utRho27
pyrD,2009464,2009536,2009464,72,36,utRho27
pyrE,7631970,7631970,7631536,434,26,utRho27
pyrF,2683740,2683842,2683740,102,1424,utRho27
pyrG,5819594,5819594,5819332,262,248,utRho27
pyrH,383624,383710,383624,86,206,utRho27
pyrL,8945490,8945490,8945066,424,440,utRho27
qmcA,1031646,1031646,1031546,100,268,utRho27
qor,8528608,8528608,8528462,146,204,utRho27
qseB,6339502,6339656,6339502,154,0,utRho27
queA,849970,850022,849970,52,210,utRho27
queE,5811212,5811212,5810836,376,12,utRho27
queF,5850642,5850696,5850642,54,258,utRho27
queG,8788184,8788184,8788134,50,200,utRho27
racC,2835630,2835630,2835526,104,0,utRho27
racR,2840898,2840898,2840482,416,64,utRho27
raiA,5474208,5474308,5474208,100,52,utRho27
rarD,8008594,8008594,8008356,238,312,utRho27
ravA,7862256,7862256,7862186,70,394,utRho27
rayT,495088,495274,495088,186,80,utRho27
rbn,4763162,4763216,4763162,54,62,utRho27
rbsD,7866644,7866702,7866644,58,0,utRho27
rcnA,4371654,4371834,4371654,180,124,utRho27
rcnB,4373768,4373920,4373768,152,148,utRho27
rcnR,4371806,4371806,4371592,214,276,utRho27
rcsA,4047672,4047936,4047672,264,488,utRho27
rcsB,4631390,4632354,4631390,964,228,utRho27
rcsC,4640162,4640162,4639656,506,32,utRho27
rcsD,4626904,4626976,4626904,72,4,utRho27
rdgB,6193240,6193362,6193240,122,262,utRho27
rdlA,2538646,2538646,2538646,0,0,utRho27
rdlB,2539712,2539716,2539712,4,0,utRho27
rdlC,2540782,2540786,2540782,4,0,utRho27
rdlD,7400272,7400272,7400272,0,0,utRho27
rdoA,8084782,8084830,8084782,48,0,utRho27
recA,11295276,11295276,11295076,200,100,utRho27
recC,5925014,5925014,5924856,158,20,utRho27
recF,7763722,7763722,7762442,1280,844,utRho27
recN,5503518,5503590,5503518,72,0,utRho27
recQ,8011666,8011728,8011666,62,20,utRho27
relA,5828554,5828554,5827302,1252,320,utRho27
relB,3291806,3291806,3291744,62,0,utRho27
rem,3289950,3289950,3289804,146,0,utRho27
rep,7921294,7921354,7921294,60,34,utRho27
rfaD,7587730,7587974,7587730,244,156,utRho27
rfaE,6393852,6393852,6393506,346,28,utRho27
rfaH,8049930,8049930,8049642,288,708,utRho27
rfbX,4219436,4219436,4219168,268,148,utRho27
rfe,7935600,7935832,7935600,232,170,utRho27
rhaB,8194944,8194944,8194896,48,0,utRho27
rhaD,8188770,8188770,8188544,226,0,utRho27
rhaS,8195422,8195472,8195422,50,0,utRho27
rhaT,8201132,8201132,8201050,82,0,utRho27
rhlE,1661566,1661744,1661566,178,20,utRho27
rhoL,47593944,47594772,47593944,828,1860,utRho27
rhsB,7238006,7238384,7238006,378,160,utRho27
rhsC,1458758,1459166,1458758,408,0,utRho27
rhsD,1046132,1046522,1046132,390,4,utRho27
rhtA,1700608,1700608,1700194,414,1080,utRho27
rhtC,8015478,8015514,8015478,36,34,utRho27
ribA,2678468,2678468,2678320,148,28,utRho27
ribC,3486916,3486916,3486484,432,1040,utRho27
ribE,869008,869294,869008,286,6314,utRho27
ribF,42766,42814,42766,48,70,utRho27
ridA,8941892,8941892,8941826,66,0,utRho27
rihA,1369204,1369204,1368824,380,0,utRho27
rihB,4510504,4510504,4510372,132,150,utRho27
rimJ,2251044,2251124,2251044,80,30,utRho27
rimK,1783752,1783934,1783752,182,28,utRho27
rimL,2997486,2997876,2997486,390,60,utRho27
rimO,1756140,1756140,1756070,70,12,utRho27
rimP,6636350,6636350,6636012,338,106,utRho27
rlmA,3814172,3814172,3814120,52,0,utRho27
rlmD,5830086,5830086,5830000,86,0,utRho27
rlmE,6655520,6655520,6655328,192,782,utRho27
rlmF,1684384,1684664,1684384,280,74,utRho27
rlmG,6471784,6471784,6471750,34,28,utRho27
rlmI,2060002,2060002,2059938,64,0,utRho27
rlmJ,7290700,7290770,7290700,70,0,utRho27
rlmL,2015344,2015688,2015344,344,196,utRho27
rlpA,1330444,1330444,1330380,64,130,utRho27
rluA,120900,120900,120692,208,236,utRho27
rluF,8460324,8460708,8460324,384,14,utRho27
rmf,2031006,2031430,2031006,424,608,utRho27
rna,1290068,1290068,1290006,62,0,utRho27
rnb,2698258,2698258,2697824,434,78,utRho27
rnc,10816892,10816892,10816252,640,23580,utRho27
rnd,3776122,3776122,3775982,140,0,utRho27
rne,2289746,2289746,2288734,1012,622,utRho27
rnhA,472082,472082,472004,78,1018,utRho27
rnk,1288360,1288360,1287934,426,164,utRho27
rnlA,5531788,5531836,5531788,48,66,utRho27
rnlB,5533414,5533968,5533414,554,1032,utRho27
rnpB,19623552,19623552,19623552,0,0,utRho27
rob,9270706,9270706,9270620,86,82,utRho27
rodZ,5285868,5285868,5285688,180,136,utRho27
rpe,7030306,7030306,7030118,188,2,utRho27
rph,15266320,15266320,15266196,124,4,utRho27
rpiA,6118706,6118706,6118650,56,0,utRho27
rpiB,8626514,8626700,8626514,186,8,utRho27
rpiR,8626274,8626274,8625982,292,16,utRho27
rplJ,8359246,8359992,8359246,746,3668,utRho27
rplK,8356708,8356894,8356708,186,80,utRho27
rplM,6757344,6757344,6757302,42,684,utRho27
rplN,6896444,6896444,6896298,146,1024,utRho27
rplS,5489284,5489284,5489060,224,4292,utRho27
rplT,7199052,7199052,7198996,56,364,utRho27
rplU,6667036,6667036,6666902,134,160,utRho27
rplY,4564866,4565034,4564866,168,60,utRho27
rpmA,6666450,6666450,6666238,212,276,utRho27
rpmB,15247980,15247980,15246696,1284,25360,utRho27
rpmE,8253816,8254026,8253816,210,364,utRho27
rpmF,2294676,2294734,2294676,58,5446,utRho27
rpmH,7768130,7768672,7768130,542,456,utRho27
rpmI,3600854,3600854,3599998,856,2382,utRho27
rpoB,8362126,8362490,8362126,364,252,utRho27
rpoD,6424946,6426094,6424946,1148,47914,utRho27
rpoE,5420372,5420372,5420024,348,64,utRho27
rpoH,7202006,7202006,7201566,440,2036,utRho27
rpoN,6689324,6689434,6689324,110,52,utRho27
rpoS,5736236,5736236,5735102,1134,1082,utRho27
rpoZ,7644154,7644212,7644154,58,52,utRho27
rppH,5937986,5937986,5937954,32,200,utRho27
rprA,3540744,3540744,3540744,0,0,utRho27
rpsA,1923434,1923990,1923434,556,9642,utRho27
rpsF,8850050,8850236,8850050,186,5904,utRho27
rpsI,6756580,6756580,6756414,166,3624,utRho27
rpsJ,6906884,6906884,6906540,344,1862,utRho27
rpsL,6949242,6949242,6949104,138,1700,utRho27
rpsM,6885130,6885130,6884942,188,318,utRho27
rpsO,13247144,13247144,13246736,408,536,utRho27
rpsP,5492508,5492508,5492370,138,0,utRho27
rpsT,42420,42420,42156,264,168,utRho27
rpsU,12842584,12843124,12842584,540,0,utRho27
rraA,8238716,8238716,8238660,56,244,utRho27
rraB,8956768,8956946,8956768,178,42,utRho27
rrsA,8070478,8071062,8070478,584,1450,utRho27
rrsB,16665468,16666636,16665468,1168,3244,utRho27
rrsC,7883032,7883616,7883032,584,674,utRho27
rrsD,6858094,6858094,6857524,570,560,utRho27
rrsE,8415726,8416294,8415726,568,594,utRho27
rrsG,5462896,5462896,5462314,582,1528,utRho27
rrsH,446970,447542,446970,572,636,utRho27
rsd,8393908,8393908,8393616,292,22,utRho27
rseA,5419264,5419264,5418808,456,738,utRho27
rseP,392940,393092,392940,152,22,utRho27
rseX,4067298,4067298,4067298,0,0,utRho27
rsfS,1338144,1338144,1338072,72,0,utRho27
rsgA,8783132,8783132,8783018,114,220,utRho27
rsmA,105176,105176,104860,316,112,utRho27
rsmB,6869982,6870414,6869982,432,12,utRho27
rsmC,9215736,9215736,9215400,336,32,utRho27
rsmD,7208594,7208786,7208594,192,0,utRho27
rsmE,6182036,6182268,6182036,232,224,utRho27
rsmG,7847512,7847512,7847360,152,0,utRho27
rsmH,180020,180188,180020,168,0,utRho27
rsmI,6587106,6587106,6586670,436,0,utRho27
rssA,2578212,2578412,2578212,200,52,utRho27
rssB,2580440,2580484,2580440,44,120,utRho27
rstA,3364276,3364300,3364276,24,0,utRho27
rsuA,4561096,4561096,4560966,130,24,utRho27
rsxA,3411510,3411534,3411510,24,44,utRho27
rtcA,7114004,7114004,7113698,306,126,utRho27
rtcB,7116214,7116214,7116158,56,0,utRho27
rtn,4541356,4541452,4541356,96,0,utRho27
rutA,2148052,2148052,2148022,30,0,utRho27
rutG,2140090,2140090,2139678,412,0,utRho27
rutR,2148226,2148484,2148226,258,94,utRho27
ruvA,7784096,7784096,7783904,192,20,utRho27
ruvB,7782176,7782176,7781424,752,120,utRho27
ruvC,3894878,3894878,3894752,126,0,utRho27
rybB,1776114,1776114,1776114,0,0,utRho27
rydB,3529860,3529860,3529322,538,166,utRho27
rydC,2983012,2983012,2983012,0,0,utRho27
ryfA,5307398,5307710,5307398,312,0,utRho27
ryfD,5468590,5468590,5468590,0,0,utRho27
ryhB,7162032,7162032,7162032,0,0,utRho27
ryjA,8556132,8556132,8556132,0,0,utRho27
ryjB,9055954,9055954,9055954,0,0,utRho27
sad,3229598,3229598,3229406,192,0,utRho27
safA,3168056,3168056,3167918,138,208,utRho27
sanA,4465368,4465756,4465368,388,0,utRho27
sapF,2705314,2705314,2705268,46,100,utRho27
sbcB,4165456,4165512,4165456,56,0,utRho27
sbcC,831694,831694,831506,188,0,utRho27
sbcD,833954,833954,833904,50,452,utRho27
sbmA,793106,793278,793106,172,546,utRho27
sbmC,4162650,4162650,4162524,126,2,utRho27
sdaA,3793618,3793864,3793618,246,916,utRho27
sdaC,5856070,5856458,5856070,388,28742,utRho27
sdhC,1509916,1510354,1509916,438,3618,utRho27
sdhD,1510808,1511120,1510808,312,150,utRho27
sdiA,3993834,3993834,3993664,170,72,utRho27
secE,8354354,8354716,8354354,362,178,utRho27
secG,6645180,6645180,6645010,170,210,utRho27
selA,7522594,7522594,7522498,96,0,utRho27
selB,7519850,7519850,7519722,128,12,utRho27
selC,7672396,7672444,7672396,48,34,utRho27
selD,3696058,3696058,3696016,42,378,utRho27
seqA,1425884,1425974,1425884,90,2,utRho27
serA,6117098,6117098,6116820,278,0,utRho27
serB,9249712,9249790,9249712,78,26,utRho27
serC,3830380,3830612,3830380,232,0,utRho27
serS,1878730,1878856,1878730,126,450,utRho27
serT,2063438,2063438,2063424,14,0,utRho27
serU,4087124,4087124,4087114,10,46,utRho27
serV,5637394,5637394,5637290,104,56,utRho27
serW,1852014,1852014,1851942,72,58,utRho27
serX,2195352,2195352,2195304,48,48,utRho27
setB,4527426,4527726,4527426,300,74,utRho27
setC,7673488,7673906,7673488,418,194,utRho27
sfmA,1116124,1116424,1116124,300,0,utRho27
sfmC,1117606,1117948,1117606,342,60,utRho27
sfsA,323030,323030,322972,58,40,utRho27
sfsB,6669592,6669818,6669592,226,164,utRho27
sgrR,154676,154676,154598,78,54,utRho27
sgrS,154734,154734,154734,0,0,utRho27
shiA,4107068,4107286,4107068,218,0,utRho27
sibA,4306622,4306622,4306622,0,0,utRho27
sibB,4307292,4307292,4307292,0,0,utRho27
sibC,6113702,6113702,6113702,0,0,utRho27
sibD,6389730,6389730,6389730,0,0,utRho27
sibE,6390480,6390480,6390480,0,0,utRho27
sixA,4913998,4913998,4913624,374,58,utRho27
slp,7307872,7307922,7307872,50,0,utRho27
slt,9261400,9261466,9261400,66,0,utRho27
slyA,3442028,3442028,3441648,380,0,utRho27
slyB,3439496,3439752,3439496,256,88,utRho27
slyD,6957398,6957398,6956994,404,170,utRho27
slyX,6954862,6955280,6954862,418,8476,utRho27
smf,6867372,6867372,6867120,252,362,utRho27
smpB,5509534,5509792,5509534,258,510,utRho27
smrA,2811872,2811958,2811872,86,224,utRho27
smrB,4896872,4897212,4896872,340,108,utRho27
smtA,1946808,1947074,1946808,266,0,utRho27
sodA,8201518,8201620,8201518,102,398,utRho27
sodB,3470646,3470756,3470646,110,0,utRho27
sodC,3449358,3449358,3449310,48,0,utRho27
sohB,2658568,2658664,2658568,96,48,utRho27
sokB,2984232,2984238,2984232,6,0,utRho27
solA,2241218,2241218,2241172,46,76,utRho27
soxR,8554894,8554938,8554894,44,74,utRho27
soxS,8554846,8554846,8554766,80,102,utRho27
speA,6172096,6172096,6171822,274,180,utRho27
speB,6167892,6167892,6167594,298,98,utRho27
speC,6218350,6218350,6218310,40,18,utRho27
spf,8099798,8099798,8099798,0,0,utRho27
sppA,3697422,3697674,3697422,252,150,utRho27
spy,3651376,3651376,3651250,126,0,utRho27
sra,3112092,3112092,3111926,166,62,utRho27
sraB,2293178,2293178,2293178,0,0,utRho27
sraC,3846132,3846132,3846132,0,0,utRho27
srlA,5651582,5651664,5651582,82,82,utRho27
srlR,5657720,5658094,5657720,374,212,utRho27
srmB,5425752,5425792,5425752,40,0,utRho27
sroA,151216,151216,151216,0,0,utRho27
sroG,6369436,6369436,6369436,0,0,utRho27
sroH,8380974,8380974,8380974,0,0,utRho27
ssb,8548022,8548250,8548022,228,384,utRho27
sseA,5304782,5304988,5304782,206,606,utRho27
sspA,6755138,6755138,6754840,298,120,utRho27
ssrA,5511014,5511186,5511014,172,262,utRho27
ssrS,12223036,12223932,12223036,896,3076,utRho27
sstT,6479726,6479888,6479726,162,224,utRho27
ssuB,1988282,1988282,1988088,194,36,utRho27
ssuE,1995126,1995126,1995024,102,0,utRho27
sthA,8321604,8321604,8321580,24,110,utRho27
stpA,5597156,5597156,5596990,166,42,utRho27
sucA,3034344,3034824,3034344,480,160,utRho27
sufA,3528836,3528836,3528772,64,24,utRho27
sufE,3518962,3518962,3518580,382,192,utRho27
sugE,8753588,8753750,8753588,162,0,utRho27
sulA,2041894,2041894,2041838,56,9142,utRho27
syd,5850738,5850738,5850560,178,458,utRho27
symE,9159834,9159834,9159680,154,78,utRho27
symR,9159670,9159670,9159670,0,0,utRho27
tabA,8949566,8949724,8949566,158,0,utRho27
talA,5157140,5157332,5157140,192,0,utRho27
talB,16382,16476,16382,94,1020,utRho27
tam,3214442,3214692,3214442,250,106,utRho27
tamA,8884540,8884764,8884540,224,198,utRho27
tar,3945432,3945432,3945382,50,0,utRho27
tas,5943138,5943194,5943138,56,2,utRho27
tatA,16087636,16087780,16087636,144,132,utRho27
tatE,1317742,1317894,1317742,152,0,utRho27
tauA,770410,770464,770410,54,0,utRho27
tdcA,6534186,6534186,6534130,56,0,utRho27
tdcG,6519652,6519652,6519298,354,50,utRho27
tdcR,6534380,6534760,6534380,380,2,utRho27
tdk,2586986,2587054,2586986,68,4,utRho27
tehA,3001072,3001146,3001072,74,0,utRho27
tesA,1039898,1039898,1039530,368,524,utRho27
tesB,950402,950402,950322,80,0,utRho27
tfaE,2418532,2418532,2418238,294,44,utRho27
tfaQ,3269912,3269912,3269770,142,10,utRho27
tff,379424,379256,379424,168,144,utRho27
tgt,852110,852274,852110,164,0,utRho27
thiD,4369346,4369346,4369032,314,0,utRho27
thiI,882936,883098,882936,162,0,utRho27
thiM,4370902,4370902,4370602,300,210,utRho27
thiQ,146170,146170,145854,316,2664,utRho27
thrL,592,760,592,168,112,utRho27
thrS,7210932,7210932,7210280,652,476,utRho27
thrU,8350762,8350776,8350762,14,600,utRho27
thrV,6847414,6847414,6847310,104,134342,utRho27
thrW,525682,525742,525682,60,212,utRho27
thyA,5930696,5930696,5930310,386,308,utRho27
tig,909986,910266,909986,280,54,utRho27
tisB,7706674,7707106,7706674,432,984,utRho27
tktA,6163414,6163414,6163270,144,24,utRho27
tktB,5158616,5159272,5158616,656,404,utRho27
tldD,6784368,6784368,6784056,312,0,utRho27
tmcA,5191876,5191876,5191718,158,58,utRho27
tnaC,15553644,15553740,15553644,96,236,utRho27
tolB,1555074,1555480,1555074,406,700,utRho27
tolC,6356008,6356230,6356008,222,40,utRho27
tomB,961588,961588,961416,172,152,utRho27
tonB,2622108,2622178,2622108,70,2,utRho27
topA,2661578,2662096,2661578,518,156,utRho27
torC,2116112,2116168,2116112,56,360,utRho27
torR,2115968,2115968,2115908,60,492,utRho27
torS,2112364,2112364,2112356,8,0,utRho27
torT,2112414,2112522,2112414,108,0,utRho27
tpiA,8223138,8223138,8223014,124,46,utRho27
tppB,3425342,3425538,3425342,196,222,utRho27
tpr,2574376,2574376,2574376,0,0,utRho27
tpx,2777688,2777688,2777622,66,786,utRho27
tqsA,3347780,3347826,3347780,46,22,utRho27
treA,2494850,2494850,2494752,98,0,utRho27
treB,8932420,8932420,8932360,60,0,utRho27
treF,7339102,7339184,7339102,82,60,utRho27
treR,8934694,8934694,8934492,202,48,utRho27
trg,2984878,2984940,2984878,62,0,utRho27
trkG,2847342,2847564,2847342,222,288,utRho27
trmA,8326590,8326590,8326540,50,0,utRho27
trpA,2634678,2634678,2634444,234,182,utRho27
trpC,2639888,2639888,2639570,318,0,utRho27
trpL,5292432,5292432,5292328,104,0,utRho27
trpR,9265408,9265520,9265408,112,0,utRho27
trpS,7027394,7027394,7027276,118,162,utRho27
trpT,7893560,7893914,7893560,354,58788,utRho27
trxA,7931294,7931522,7931294,228,1494,utRho27
trxB,1864156,1864156,1864100,56,0,utRho27
trxC,5437350,5437470,5437350,120,310,utRho27
tsaD,6421256,6421256,6421086,170,12,utRho27
tsgA,6985038,6985136,6985038,98,102,utRho27
tsr,9182824,9183314,9182824,490,538,utRho27
tsx,864490,864490,864026,464,216,utRho27
ttcA,2823970,2823970,2823896,74,1028,utRho27
ttdA,6412848,6412926,6412848,78,0,utRho27
ttdR,6412760,6412760,6412512,248,60,utRho27
tufA,6943448,6943448,6942658,790,18170,utRho27
tus,3368346,3368518,3368346,172,132,utRho27
tusA,7218040,7218040,7217992,48,596,utRho27
tusB,6950218,6950218,6949930,288,90,utRho27
tynA,2902996,2902996,2902698,298,20,utRho27
typA,8116460,8116814,8116460,354,496,utRho27
tyrB,8534164,8534228,8534164,64,152,utRho27
tyrP,3979004,3979362,3979004,358,12,utRho27
tyrR,2773384,2773440,2773384,56,64,utRho27
tyrS,3434566,3434566,3434444,122,44,utRho27
tyrT,2575330,2575330,2575244,86,0,utRho27
uacT,6062378,6062734,6062378,356,62,utRho27
ubiC,8504886,8505012,8504886,126,30,utRho27
ubiD,8049618,8049976,8049618,358,748,utRho27
ubiE,8037494,8037710,8037494,216,46,utRho27
ubiG,4679078,4679134,4679078,56,0,utRho27
ucpA,5089342,5089342,5089246,96,144,utRho27
udp,8032782,8032862,8032782,80,88,utRho27
ugd,4199470,4199470,4199226,244,224,utRho27
ugpB,7184852,7184852,7184650,202,638,utRho27
ugpQ,7176600,7176600,7176226,374,0,utRho27
uhpT,7694396,7694396,7694334,62,198,utRho27
uidA,3392304,3392304,3392142,162,0,utRho27
uidC,3386012,3386012,3385702,310,0,utRho27
uidR,3394150,3394150,3394104,46,38,utRho27
ulaA,8839854,8839960,8839854,106,198,utRho27
ulaG,8839350,8839350,8839250,100,48,utRho27
ulaR,8837124,8837124,8836906,218,6,utRho27
umpG,5741372,5741372,5740548,824,0,utRho27
umpH,1400704,1400704,1400652,52,0,utRho27
umuD,2461476,2461534,2461476,58,0,utRho27
ung,5433476,5433508,5433476,32,0,utRho27
uof,2843316,2843316,2842900,416,200,utRho27
upp,5241818,5241818,5241744,74,8,utRho27
usg,4873780,4873780,4873298,482,48,utRho27
ushA,1009772,1009828,1009772,56,0,utRho27
uspA,7279966,7280222,7279966,256,604,utRho27
uspB,7279696,7279696,7279440,256,296,utRho27
uspC,3959172,3959506,3959172,334,130,utRho27
uspE,2797318,2797318,2797244,74,0,utRho27
uspF,2871282,2871282,2871238,44,92,utRho27
uspG,1283806,1283806,1283734,72,522,utRho27
uvrA,8547872,8547872,8547742,130,190,utRho27
uvrB,1626304,1627052,1626304,748,144,utRho27
uvrC,3989758,3989758,3989412,346,112,utRho27
uvrD,7995814,7995966,7995814,152,72,utRho27
uvrY,3990812,3990812,3990718,94,0,utRho27
uxaB,3221474,3221474,3221360,114,0,utRho27
uxaC,6489714,6489714,6489482,232,40,utRho27
uxuA,9103036,9103272,9103036,236,422,utRho27
uxuR,9108916,9109152,9108916,236,34,utRho27
valS,8967854,8967854,8967674,180,292,utRho27
valU,5041848,5041862,5041848,14,42,utRho27
valV,3492830,3492870,3492830,40,64,utRho27
ves,3649968,3649968,3649874,94,8,utRho27
waaA,7616512,7617080,7616512,568,696,utRho27
waaH,7580298,7580298,7580162,136,0,utRho27
waaQ,7616476,7616476,7616196,280,446,utRho27
waaU,7598996,7598996,7598624,372,60,utRho27
waaY,7602272,7602272,7601930,342,4670,utRho27
wbbH,4214888,4214888,4214452,436,1060,utRho27
wbbK,4209212,4209212,4209018,194,168,utRho27
wcaM,4231868,4231868,4231792,76,0,utRho27
wrbA,2135516,2135516,2135416,100,58,utRho27
wza,4275166,4275166,4274486,680,44,utRho27
wzxC,4240674,4240674,4240316,358,46,utRho27
wzzB,4196950,4196950,4196602,348,12,utRho27
xanP,7657642,7657890,7657642,248,42,utRho27
xanQ,6048520,6048702,6048520,182,0,utRho27
xapA,5049820,5049820,5049756,64,0,utRho27
xapR,10090252,10090252,10089908,344,232,utRho27
xdhA,6000514,6000690,6000514,176,122,utRho27
xerD,6079702,6079702,6079486,216,0,utRho27
xseA,5268394,5268464,5268394,70,0,utRho27
xseB,882746,882746,882686,60,90,utRho27
xthA,3664798,3664856,3664798,58,26,utRho27
xylA,7461614,7461614,7461530,84,2168,utRho27
xylE,8484540,8484540,8484508,32,0,utRho27
xylF,7462138,7462262,7462138,124,320,utRho27
xylR,7469812,7469958,7469812,146,0,utRho27
yaaA,13230,13230,12918,312,262,utRho27
yaaI,23876,23876,23572,304,72,utRho27
yaaJ,16034,16034,15918,116,104,utRho27
yaaU,91184,91614,91184,430,116,utRho27
yaaW,23084,23084,22712,372,318,utRho27
yaaX,10060,10468,10060,408,0,utRho27
yabI,142542,142702,142542,160,0,utRho27
yacC,273880,273880,273834,46,36,utRho27
yacH,262932,262932,262520,412,96,utRho27
yacL,268678,268776,268678,98,0,utRho27
yadD,293796,293936,293796,140,2,utRho27
yadE,289930,290162,289930,232,94,utRho27
yadN,314110,314110,313766,344,0,utRho27
yadS,355572,355572,355248,324,192,utRho27
yadV,312470,312470,312402,68,138,utRho27
yaeF,434270,434270,434006,264,92,utRho27
yaeP,428374,428374,428250,124,0,utRho27
yaeQ,428176,428582,428176,406,24,utRho27
yaeR,423716,423754,423716,38,0,utRho27
yafC,462166,462166,461762,404,396,utRho27
yafD,462128,462244,462128,116,486,utRho27
yafK,491986,491986,491610,376,332,utRho27
yafL,493282,493424,493282,142,24,utRho27
yafN,503938,504010,503938,72,0,utRho27
yafS,469568,469632,469568,64,152,utRho27
yafT,474470,474670,474470,200,64,utRho27
yafV,480432,480432,480378,54,0,utRho27
yafZ,536052,536052,536010,42,0,utRho27
yagE,564446,564556,564446,110,0,utRho27
yagG,570414,570790,570414,376,120,utRho27
yagI,578384,578384,578324,60,0,utRho27
yagK,586236,586236,585896,340,670,utRho27
yagL,588062,588062,587836,226,112,utRho27
yagN,591342,591342,591158,184,252,utRho27
yahA,663746,664742,663746,996,1288,utRho27
yahC,670136,670136,670044,92,32,utRho27
yahE,671478,671850,671478,372,370,utRho27
yahM,690504,690808,690504,304,370,utRho27
yahN,692872,692872,692674,198,318,utRho27
yahO,692864,692968,692864,104,108,utRho27
yaiE,816296,816354,816296,58,18,utRho27
yaiI,811396,811528,811396,132,0,utRho27
yaiO,761946,761946,761684,262,174,utRho27
yaiP,767970,767970,767870,100,46,utRho27
yaiS,769660,769660,769232,428,134,utRho27
yaiV,788922,788922,788922,0,0,utRho27
yaiY,799094,799094,798666,428,294,utRho27
yaiZ,798888,799186,798888,298,70,utRho27
yajC,854410,854574,854410,164,82,utRho27
yajD,860938,861210,860938,272,28,utRho27
yajI,866068,866068,865702,366,0,utRho27
yajL,887496,887496,887282,214,46,utRho27
yajQ,889316,889366,889316,50,88,utRho27
yajR,893374,893374,893332,42,0,utRho27
ybaB,987418,988152,987418,734,92,utRho27
ybaL,1006590,1006590,1006476,114,28,utRho27
ybaM,980648,980648,980542,106,76,utRho27
ybaN,981436,981764,981436,328,218,utRho27
ybaO,936704,936766,936704,62,0,utRho27
ybaP,1016568,1016568,1016160,408,400,utRho27
ybaQ,1016348,1016436,1016348,88,76,utRho27
ybaS,1023146,1023282,1023146,136,120,utRho27
ybaV,927504,927874,927504,370,36,utRho27
ybaY,950490,950758,950490,268,0,utRho27
ybbB,1062724,1062724,1062452,272,138,utRho27
ybbJ,1030154,1030154,1029718,436,402,utRho27
ybbL,1031784,1031838,1031784,54,6,utRho27
ybbN,1037136,1037136,1036558,578,234,utRho27
ybbO,1038658,1038658,1038298,360,188,utRho27
ybbY,1080718,1081130,1080718,412,448,utRho27
ybcH,1176140,1176140,1175962,178,12,utRho27
ybcI,1113264,1113264,1113106,158,68,utRho27
ybcJ,1114050,1114050,1113746,304,46,utRho27
ybcK,1137502,1137804,1137502,302,18,utRho27
ybcL,1141690,1141786,1141690,96,0,utRho27
ybcN,1144628,1144932,1144628,304,16,utRho27
ybcQ,1147548,1147912,1147548,364,68,utRho27
ybcW,1159610,1159760,1159610,150,0,utRho27
ybdD,1263982,1264364,1263982,382,454,utRho27
ybdF,1212106,1212106,1211772,334,4,utRho27
ybdH,1267048,1267048,1266954,94,0,utRho27
ybdJ,1212822,1212822,1212398,424,234,utRho27
ybdK,1215122,1215122,1214766,356,0,utRho27
ybdL,1267114,1267172,1267114,58,2,utRho27
ybdM,1271110,1271110,1270752,358,194,utRho27
ybdN,1273372,1273372,1273138,234,0,utRho27
ybdR,1283844,1284176,1283844,332,566,utRho27
ybeD,1325412,1325412,1325284,128,1142,utRho27
ybeF,1323090,1323090,1322756,334,166,utRho27
ybeL,1349986,1350036,1349986,50,0,utRho27
ybeQ,1353412,1353412,1353094,318,74,utRho27
ybeR,1353120,1353422,1353120,302,74,utRho27
ybeT,1358832,1358832,1358812,20,0,utRho27
ybeU,1358924,1359016,1358924,92,2,utRho27
ybeZ,1386938,1386938,1386834,104,424,utRho27
ybfA,1458074,1458268,1458074,194,54,utRho27
ybfE,1423878,1423878,1423796,82,38,utRho27
ybfF,1425692,1425692,1425604,88,32,utRho27
ybfH,1433282,1433282,1433194,88,58,utRho27
ybgA,1477840,1478002,1477840,162,202,utRho27
ybgC,1549288,1549504,1549288,216,12,utRho27
ybgD,1505916,1505916,1505590,326,6284,utRho27
ybgI,1485238,1485654,1485238,416,0,utRho27
ybgO,1498370,1498370,1497964,406,184,utRho27
ybgS,1570992,1570992,1570634,358,100,utRho27
ybhA,1597184,1597184,1596862,322,0,utRho27
ybhB,1616070,1616070,1615818,252,60,utRho27
ybhC,1614642,1614642,1614562,80,0,utRho27
ybhD,1601418,1601418,1601276,142,0,utRho27
ybhH,1601104,1601518,1601104,414,4,utRho27
ybhK,1633384,1633384,1633294,90,82,utRho27
ybhM,1641556,1641586,1641556,30,0,utRho27
ybhN,1645296,1645296,1644996,300,0,utRho27
ybhQ,1649202,1649260,1649202,58,28,utRho27
ybiA,1665920,1665920,1665900,20,0,utRho27
ybiI,1676968,1676968,1676912,56,10,utRho27
ybiO,1691328,1691328,1690960,368,50,utRho27
ybiP,1705252,1705252,1705194,58,24,utRho27
ybiS,1711572,1711572,1711488,84,0,utRho27
ybiT,1711894,1711926,1711894,32,0,utRho27
ybiU,1718212,1718212,1718122,90,44,utRho27
ybiV,1720176,1720176,1720056,120,0,utRho27
ybiW,1725566,1725566,1725212,354,242,utRho27
ybiX,1678548,1678548,1678414,134,242,utRho27
ybjC,1781784,1781826,1781784,42,0,utRho27
ybjE,1830154,1830154,1829714,440,706,utRho27
ybjG,1767016,1767016,1766776,240,212,utRho27
ybjL,1779882,1779882,1779638,244,74,utRho27
ybjM,1779770,1780178,1779770,408,414,utRho27
ybjO,1795704,1795978,1795704,274,0,utRho27
ybjP,1809046,1809046,1808934,112,0,utRho27
ybjQ,1809034,1809186,1809034,152,0,utRho27
ybjS,1813796,1813796,1813506,290,36,utRho27
ybjX,1838206,1838206,1838168,38,0,utRho27
ycaD,1891438,1891742,1891438,304,0,utRho27
ycaI,1928210,1928640,1928210,430,206,utRho27
ycaK,1899094,1899336,1899094,242,126,utRho27
ycaL,1920264,1920528,1920264,264,120,utRho27
ycaM,1894240,1894458,1894240,218,62,utRho27
ycaR,1941284,1941346,1941284,62,118,utRho27
ycbB,1961862,1962094,1961862,232,338,utRho27
ycbJ,1943344,1943504,1943344,160,0,utRho27
ycbK,1966046,1966150,1966046,104,144,utRho27
ycbZ,2036920,2036920,2036598,322,0,utRho27
yccA,2062886,2062886,2062836,50,54,utRho27
yccF,2048730,2048730,2048696,34,0,utRho27
yccS,2047988,2047988,2047766,222,544,utRho27
yccT,2055674,2055674,2055546,128,176,utRho27
yccX,2059960,2060128,2059960,168,32,utRho27
ycdT,2185682,2185752,2185682,70,44,utRho27
ycdU,2191266,2191686,2191266,420,396,utRho27
ycdZ,2200504,2200592,2200504,88,0,utRho27
yceA,2233544,2233614,2233544,70,6,utRho27
yceD,2293298,2293588,2293298,290,806,utRho27
yceF,2293522,2293522,2293190,332,430,utRho27
yceH,2252154,2252314,2252154,160,126,utRho27
yceI,2237282,2237282,2236952,330,14,utRho27
yceJ,2238142,2238142,2238092,50,98,utRho27
yceM,2253208,2253612,2253208,404,264,utRho27
yceO,2239264,2239264,2238894,370,388,utRho27
yceQ,2288760,2289004,2288760,244,512,utRho27
ycfD,2376540,2376540,2376480,60,56,utRho27
ycfJ,2334814,2335198,2334814,384,10,utRho27
ycfS,2340834,2340834,2340748,86,0,utRho27
ycfT,2350658,2350658,2350330,328,32,utRho27
ycfZ,2362760,2362760,2362534,226,258,utRho27
ycgB,2474570,2474570,2474482,88,50,utRho27
ycgG,2434614,2434656,2434614,42,294,utRho27
ycgJ,2452956,2453200,2452956,244,2,utRho27
ycgL,2455218,2455362,2455218,144,18,utRho27
ycgN,2457366,2457660,2457366,294,0,utRho27
ycgR,2489112,2489112,2489054,58,0,utRho27
ycgV,2512222,2512222,2511904,318,248,utRho27
ycgX,2426568,2426568,2426214,354,766,utRho27
ycgY,2490166,2490320,2490166,154,166,utRho27
ycgZ,2431504,2431578,2431504,74,56,utRho27
ychE,2596904,2597196,2596904,292,0,utRho27
ychF,2515764,2515764,2515624,140,0,utRho27
ychH,2517476,2517582,2517476,106,1014,utRho27
ychJ,2578354,2578354,2578264,90,52,utRho27
ychN,2547310,2547310,2547198,112,0,utRho27
ychO,2547520,2547850,2547520,330,120,utRho27
ychQ,2533798,2533848,2533798,50,0,utRho27
yciA,2624828,2624828,2624492,336,22,utRho27
yciB,2626110,2626110,2625780,330,132,utRho27
yciC,2627396,2627396,2627326,70,8,utRho27
yciE,2630794,2630794,2630448,346,40,utRho27
yciG,5264368,5264368,5264140,228,0,utRho27
yciI,2621784,2621784,2621730,54,34,utRho27
yciN,2661606,2661606,2661336,270,98,utRho27
yciS,2680270,2680486,2680270,216,166,utRho27
yciT,2689088,2689088,2688692,396,250,utRho27
yciU,2614718,2614718,2614300,418,188,utRho27
yciV,2646376,2646440,2646376,64,0,utRho27
yciW,2700472,2700472,2700214,258,14,utRho27
yciZ,2689276,2689276,2689218,58,180,utRho27
ycjD,2703792,2703792,2703520,272,0,utRho27
ycjG,2777748,2777860,2777748,112,136,utRho27
ycjM,2740006,2740432,2740006,426,64,utRho27
ycjW,2767982,2767982,2767922,60,54,utRho27
ycjX,2768138,2768234,2768138,96,28,utRho27
ycjY,5568288,5568288,5567460,828,48,utRho27
ydaE,2836438,2836438,2836016,422,124,utRho27
ydaN,2816048,2816100,2816048,52,6,utRho27
ydaS,2840340,2840730,2840340,390,168,utRho27
ydbC,2948376,2948442,2948376,66,0,utRho27
ydbD,2950132,2950288,2950132,156,80,utRho27
ydbH,2885800,2886102,2885800,302,3304,utRho27
ydbJ,2881712,2882116,2881712,404,552,utRho27
ydbK,2881692,2881692,2881568,124,116,utRho27
ydcA,2983294,2983354,2983294,60,0,utRho27
ydcF,2974404,2974470,2974404,66,32,utRho27
ydcI,2990268,2990268,2990142,126,0,utRho27
ydcJ,2990266,2990576,2990266,310,32,utRho27
ydcK,3001280,3001280,3000898,382,30,utRho27
ydcL,3004646,3004914,3004646,268,0,utRho27
ydcN,3012308,3012344,3012308,36,74,utRho27
ydcP,3013508,3013562,3013508,54,0,utRho27
ydcR,3019956,3020006,3019956,50,0,utRho27
ydcS,3022906,3023308,3022906,402,54,utRho27
ydcX,3034442,3034778,3034442,336,92,utRho27
ydcY,3035220,3035296,3035220,76,0,utRho27
ydcZ,3036750,3036750,3036662,88,64,utRho27
yddB,3155332,3155332,3155238,94,0,utRho27
yddE,3071738,3071738,3071716,22,0,utRho27
yddG,3094410,3094410,3094338,72,0,utRho27
yddJ,3089732,3089732,3089438,294,122,utRho27
yddW,3137704,3137704,3137646,58,0,utRho27
ydeA,3233910,3234056,3233910,146,46,utRho27
ydeE,3242528,3242664,3242528,136,0,utRho27
ydeI,3249118,3249118,3248994,124,0,utRho27
ydeJ,3249376,3249546,3249376,170,30,utRho27
ydeN,3165458,3165458,3165048,410,0,utRho27
ydeP,3173328,3173328,3172972,356,96,utRho27
ydeR,3176596,3176596,3176592,4,0,utRho27
ydfA,3296872,3297016,3296872,144,0,utRho27
ydfG,3254982,3255034,3254982,52,6,utRho27
ydfH,3256652,3256704,3256652,52,0,utRho27
ydfK,3265446,3266144,3265446,698,596,utRho27
ydgA,3379588,3379704,3379588,116,0,utRho27
ydgC,3364124,3364124,3364060,64,0,utRho27
ydgD,3343906,3343920,3343906,14,54,utRho27
ydgH,3356754,3356854,3356754,100,0,utRho27
ydgJ,3408798,3408798,3408616,182,68,utRho27
ydgK,3410414,3410500,3410414,86,504,utRho27
ydhB,3479618,3479618,3479596,22,0,utRho27
ydhC,3479698,3479822,3479698,124,22,utRho27
ydhF,3451310,3451310,3451264,46,0,utRho27
ydhI,3441996,3442050,3441996,54,0,utRho27
ydhL,3451864,3451864,3451840,24,30,utRho27
ydhQ,3492404,3492404,3492254,150,0,utRho27
ydhS,3494136,3494262,3494136,126,112,utRho27
ydhT,3499138,3499138,3499118,20,0,utRho27
ydhY,3509284,3509284,3508954,330,0,utRho27
ydhZ,3510418,3510418,3510282,136,0,utRho27
ydiE,3579206,3579226,3579206,20,28,utRho27
ydiH,3530582,3530582,3530406,176,0,utRho27
ydiM,3541852,3542142,3541852,290,82,utRho27
ydiN,3544818,3545024,3544818,206,146,utRho27
ydiP,3558656,3558656,3558602,54,74,utRho27
ydiU,3582508,3582508,3582488,20,96,utRho27
ydiV,3584174,3584174,3584040,134,40,utRho27
ydiY,3612500,3612500,3612166,334,14,utRho27
ydjA,3697400,3697400,3697352,48,60,utRho27
ydjE,3708082,3708082,3707958,124,42,utRho27
ydjF,3709848,3709848,3709708,140,94,utRho27
ydjM,3620340,3620422,3620340,82,0,utRho27
ydjO,3626696,3626696,3626288,408,0,utRho27
ydjX,3666434,3666802,3666434,368,20,utRho27
yeaE,3731448,3731448,3731272,176,78,utRho27
yeaG,3733530,3733816,3733530,286,0,utRho27
yeaI,3740486,3740770,3740486,284,48,utRho27
yeaJ,3743874,3744082,3743874,208,0,utRho27
yeaL,3748646,3748704,3748646,58,80,utRho27
yeaM,3751296,3751296,3751152,144,0,utRho27
yeaN,3750926,3751346,3750926,420,0,utRho27
yeaO,3753554,3753818,3753554,264,32,utRho27
yeaP,3755314,3755430,3755314,116,0,utRho27
yeaQ,3758780,3758780,3758510,270,0,utRho27
yeaR,3759988,3759988,3759896,92,68,utRho27
yeaY,3781122,3781122,3781064,58,0,utRho27
yebB,3892220,3892502,3892220,282,270,utRho27
yebC,3896370,3896370,3896302,68,0,utRho27
yebE,3859464,3859464,3859414,50,46,utRho27
yebG,3861530,3861530,3861494,36,2,utRho27
yebK,3873180,3873304,3873180,124,54,utRho27
yebQ,3820314,3820552,3820314,238,66,utRho27
yebS,3832238,3832516,3832238,278,14,utRho27
yebV,3843430,3843560,3843430,130,0,utRho27
yebW,3843914,3844242,3843914,328,660,utRho27
yecC,3995646,3995646,3995628,18,0,utRho27
yecD,3901272,3901664,3901272,392,186,utRho27
yecF,3991434,3991636,3991434,202,0,utRho27
yecH,3979304,3979304,3978980,324,0,utRho27
yecJ,3975604,3975604,3975516,88,0,utRho27
yecM,3919968,3919968,3919692,276,0,utRho27
yecR,3976400,3976444,3976400,44,190,utRho27
yecT,3923862,3923944,3923862,82,14,utRho27
yedD,4016522,4016522,4016180,342,188,utRho27
yedE,4016310,4016554,4016310,244,232,utRho27
yedI,4058922,4058922,4058732,190,64,utRho27
yedJ,4066446,4066446,4066158,288,0,utRho27
yedV,4076404,4076404,4076304,100,158,utRho27
yedX,4077680,4077912,4077680,232,0,utRho27
yedY,4078572,4078956,4078572,384,70,utRho27
yeeA,4161322,4161322,4161182,140,20,utRho27
yeeE,4171104,4171104,4171050,54,4,utRho27
yeeJ,4089526,4089822,4089526,296,0,utRho27
yeeN,4113508,4113716,4113508,208,150,utRho27
yeeO,4119444,4119444,4119692,248,256,utRho27
yeeX,4158834,4158834,4158722,112,46,utRho27
yeeZ,4178422,4178422,4178256,166,38,utRho27
yefM,4179466,4179466,4179426,40,0,utRho27
yegD,4295288,4295348,4295288,60,0,utRho27
yegH,4275726,4275804,4275726,78,56,utRho27
yegI,4302154,4302154,4301970,184,0,utRho27
yegJ,4302032,4302370,4302032,338,4,utRho27
yegQ,4331182,4331336,4331182,154,108,utRho27
yegR,4336698,4336698,4336612,86,598,utRho27
yegS,4337086,4337424,4337086,338,354,utRho27
yegT,4357562,4357642,4357562,80,48,utRho27
yegX,4367640,4367640,4367302,338,0,utRho27
yehA,4376944,4376944,4376828,116,28,utRho27
yehE,4385818,4385818,4385592,226,12,utRho27
yehK,4407568,4407944,4407568,376,0,utRho27
yehL,4408804,4409192,4408804,388,60,utRho27
yeiB,4486146,4486146,4485934,212,0,utRho27
yeiE,4499422,4499422,4499236,186,0,utRho27
yeiG,4487776,4487820,4487776,44,0,utRho27
yeiH,4499332,4499434,4499332,102,8,utRho27
yeiI,4503306,4503400,4503306,94,0,utRho27
yeiL,4510580,4510710,4510580,130,0,utRho27
yeiP,4530834,4530900,4530834,66,24,utRho27
yeiQ,4532328,4532490,4532328,162,0,utRho27
yeiR,4535484,4535658,4535484,174,0,utRho27
yeiW,4530840,4530840,4530590,250,76,utRho27
yejA,4544624,4544728,4544624,104,18,utRho27
yejG,4556892,4556892,4556474,418,1544,utRho27
yejH,4561244,4561264,4561244,20,30,utRho27
yejK,4568218,4568218,4567894,324,0,utRho27
yejO,4578352,4578352,4577800,552,128,utRho27
yfaD,4713380,4713808,4713380,428,164,utRho27
yfaE,4696676,4697028,4696676,352,364,utRho27
yfaL,4688568,4688568,4688338,230,10,utRho27
yfaP,4656398,4656398,4656286,112,132,utRho27
yfaU,4717892,4717892,4717690,202,0,utRho27
yfaY,4727310,4727310,4727266,44,60,utRho27
yfaZ,4728744,4728744,4728550,194,26,utRho27
yfbK,4771810,4771810,4771444,366,44,utRho27
yfbL,4771500,4771720,4771500,220,44,utRho27
yfbN,4777174,4777174,4776852,322,202,utRho27
yfbO,4776916,4777162,4776916,246,202,utRho27
yfbP,4777990,4778232,4777990,242,292,utRho27
yfbR,4817662,4817724,4817662,62,0,utRho27
yfcI,4847424,4847424,4847078,346,342,utRho27
yfcJ,4880482,4880482,4880240,242,4,utRho27
yfcL,4888502,4888502,4888338,164,12,utRho27
yfcV,4911642,4911642,4911292,350,118,utRho27
yfcZ,4921958,4921958,4921868,90,18,utRho27
yfdF,4925604,4926024,4925604,420,0,utRho27
yfdG,4935474,4935710,4935474,236,104,utRho27
yfdP,4946844,4947040,4946844,196,0,utRho27
yfdX,4988866,4988866,4988804,62,84,utRho27
yfdY,4990672,4990672,4990584,88,96,utRho27
yfeA,5035784,5035784,5035664,120,474,utRho27
yfeC,5036668,5036934,5036668,266,0,utRho27
yfeH,5053818,5053892,5053818,74,0,utRho27
yfeK,5074630,5074684,5074630,54,120,utRho27
yfeO,5018906,5019260,5018906,354,66,utRho27
yfeR,5054078,5054078,5053712,366,0,utRho27
yfeX,5101356,5101356,5101090,266,0,utRho27
yfeY,5102486,5102486,5102432,54,0,utRho27
yfeZ,5103842,5103842,5103452,390,48,utRho27
yffO,5123804,5124222,5123804,418,276,utRho27
yffQ,5126778,5127154,5126778,376,102,utRho27
yffS,5128800,5128986,5128800,186,108,utRho27
yfgC,5232052,5232188,5232052,136,0,utRho27
yfgF,5258062,5258062,5257876,186,804,utRho27
yfgG,5258170,5258580,5258170,410,712,utRho27
yfgH,5259344,5259584,5259344,240,0,utRho27
yfgM,5278866,5278866,5278566,300,54,utRho27
yfhH,5397414,5397518,5397414,104,22,utRho27
yfhM,5304648,5304648,5304574,74,0,utRho27
yfhR,5328408,5328726,5328408,318,64,utRho27
yfiC,5425610,5425610,5425528,82,84,utRho27
yfiE,5430688,5430688,5430640,48,96,utRho27
yfiL,5482630,5482720,5482630,90,128,utRho27
yfiM,5448066,5448358,5448066,292,792,utRho27
yfiR,5483354,5483750,5483354,396,354,utRho27
yfjH,5517326,5517326,5517200,126,0,utRho27
yfjI,5517710,5517970,5517710,260,0,utRho27
yfjJ,5521014,5521094,5521014,80,48,utRho27
yfjM,5531970,5531970,5531552,418,996,utRho27
yfjP,5535080,5535420,5535080,340,440,utRho27
yfjW,5546570,5546636,5546570,66,0,utRho27
yfjX,5551776,5551838,5551776,62,0,utRho27
ygaC,5601180,5601180,5599988,1192,9276,utRho27
ygaM,5600242,5600292,5600242,50,3264,utRho27
ygaU,5593628,5593628,5593572,56,0,utRho27
ygaZ,5619190,5619234,5619190,44,0,utRho27
ygbA,5713656,5713656,5713612,44,20,utRho27
ygbE,5746784,5746784,5746674,110,0,utRho27
ygbI,5722882,5722882,5722528,354,0,utRho27
ygbK,5724394,5724670,5724394,276,90,utRho27
ygbL,5727074,5727186,5727074,112,0,utRho27
ygbN,5729814,5730202,5729814,388,236,utRho27
ygcG,5811210,5811422,5811210,212,40,utRho27
ygcN,5785144,5785314,5785144,170,20,utRho27
ygcU,5799214,5799214,5798836,378,204,utRho27
ygcW,5800942,5800942,5800546,396,52,utRho27
ygdD,5883442,5883442,5883262,180,250,utRho27
ygdG,5861746,5861930,5861746,184,110,utRho27
ygdI,5886526,5886526,5886290,236,0,utRho27
ygdQ,5940784,5940840,5940784,56,94,utRho27
ygdR,5942494,5942542,5942494,48,98,utRho27
ygeA,5961606,5961606,5961270,336,44,utRho27
ygeH,5983758,5984188,5983758,430,0,utRho27
ygeI,5987162,5987276,5987162,114,154,utRho27
ygeR,6000078,6000078,5999782,296,46,utRho27
ygeV,6011694,6011694,6011572,122,0,utRho27
ygeW,6012234,6012524,6012234,290,346,utRho27
ygfB,6110946,6110946,6110888,58,0,utRho27
ygfK,6031984,6032120,6031984,136,0,utRho27
ygfS,6058328,6058328,6058024,304,60,utRho27
ygfZ,6082564,6082626,6082564,62,0,utRho27
yggC,6149512,6149512,6149378,134,0,utRho27
yggE,6136370,6136370,6136160,210,386,utRho27
yggI,6179176,6179510,6179176,334,92,utRho27
yggL,6204508,6204508,6204266,242,0,utRho27
yggM,6199514,6199514,6199130,384,196,utRho27
yggN,6203596,6203596,6203246,350,26,utRho27
yggX,18623958,18624558,18623958,600,0,utRho27
yghA,6298966,6299324,6298966,358,70,utRho27
yghB,6307058,6307126,6307058,68,6,utRho27
yghD,6222614,6222614,6222252,362,118,utRho27
yghF,6225798,6225798,6225840,42,0,utRho27
yghJ,6238640,6238640,6238224,416,0,utRho27
yghQ,6265186,6265186,6264816,370,206,utRho27
yghT,6267830,6268262,6267830,432,140,utRho27
yghU,6277400,6277454,6277400,54,30,utRho27
yghW,6293506,6293506,6293474,32,4,utRho27
yghZ,6295562,6295794,6295562,232,0,utRho27
ygiD,6365122,6365122,6364868,254,0,utRho27
ygiH,6409066,6409388,6409066,322,190,utRho27
ygiL,6370622,6370828,6370622,206,0,utRho27
ygiM,6402084,6402414,6402084,330,464,utRho27
ygiN,6346156,6346284,6346156,128,420,utRho27
ygiQ,6322620,6322620,6322292,328,8,utRho27
ygiS,6335462,6335462,6335436,26,0,utRho27
ygiV,6338582,6338582,6338462,120,0,utRho27
ygiW,6339774,6339774,6339352,422,124,utRho27
ygiZ,6344506,6344506,6344422,84,0,utRho27
ygjH,6442528,6442528,6442494,34,0,utRho27
ygjI,6452140,6452468,6452140,328,38,utRho27
ygjQ,6472730,6473080,6472730,350,276,utRho27
ygjR,6474564,6474586,6474564,22,38,utRho27
ygjV,6483638,6483638,6483488,150,0,utRho27
yhaB,6535632,6535708,6535632,76,72,utRho27
yhaH,6504498,6504608,6504498,110,496,utRho27
yhaI,6505400,6505822,6505400,422,124,utRho27
yhaJ,6508560,6508560,6508428,132,30,utRho27
yhaK,6508538,6508638,6508538,100,0,utRho27
yhbQ,6599878,6599932,6599878,54,174,utRho27
yhbT,6602736,6602736,6602552,184,224,utRho27
yhbU,6602558,6602970,6602558,412,410,utRho27
yhbX,6643302,6643302,6643226,76,106,utRho27
yhbY,6655518,6655580,6655518,62,366,utRho27
yhcA,6723956,6724224,6723956,268,44,utRho27
yhcB,6760364,6760382,6760364,18,0,utRho27
yhcC,6708470,6708470,6708100,370,130,utRho27
yhcF,6733440,6733852,6733440,412,220,utRho27
yhcH,6739124,6739124,6738956,168,136,utRho27
yhcM,6760312,6760312,6759994,318,64,utRho27
yhcN,6770812,6771076,6770812,264,72,utRho27
yhcO,6772606,6772606,6772258,348,0,utRho27
yhdH,6806560,6806968,6806560,408,328,utRho27
yhdJ,6823234,6823306,6823234,72,0,utRho27
yhdN,6879092,6879092,6879018,74,640,utRho27
yhdT,6814702,6814750,6814702,48,40,utRho27
yhdU,6824994,6825242,6824994,248,172,utRho27
yhdV,6836392,6836780,6836392,388,156,utRho27
yhdW,6837944,6838298,6837944,354,0,utRho27
yheO,6953082,6953082,6952880,202,22,utRho27
yheV,6957970,6957970,6957584,386,72,utRho27
yhfA,6971902,6971902,6971636,266,256,utRho27
yhfG,6983294,6983294,6983240,54,0,utRho27
yhfL,6998622,6998896,6998622,274,224,utRho27
yhfY,7023244,7023244,7022844,400,0,utRho27
yhgA,7086294,7086334,7086294,40,0,utRho27
yhgE,7065176,7065176,7064878,298,106,utRho27
yhgF,7074352,7074770,7074352,418,1586,utRho27
yhhA,7173458,7173886,7173458,428,52,utRho27
yhhI,7248346,7248756,7248346,410,26,utRho27
yhhJ,7253696,7253696,7253606,90,2,utRho27
yhhM,7211588,7211588,7211220,368,572,utRho27
yhhN,7211150,7211502,7211150,352,338,utRho27
yhhQ,7218238,7218434,7218238,196,410,utRho27
yhhT,7223682,7223730,7223682,48,12,utRho27
yhhX,7162032,7162032,7161610,422,108,utRho27
yhhY,7162222,7162276,7162222,54,4,utRho27
yhhZ,7163516,7163726,7163516,210,20,utRho27
yhiD,7312220,7312220,7311804,416,4804,utRho27
yhiJ,7265190,7265190,7265180,10,80,utRho27
yhiM,7269270,7269682,7269270,412,1544,utRho27
yhiN,7275000,7275000,7274820,180,274,utRho27
yhjA,7338522,7338522,7338376,146,0,utRho27
yhjB,7344090,7344090,7343788,302,372,utRho27
yhjC,7344272,7344684,7344272,412,108,utRho27
yhjD,7346660,7346724,7346660,64,0,utRho27
yhjE,7349274,7349572,7349274,298,208,utRho27
yhjG,7356824,7356824,7356730,94,30,utRho27
yhjH,7358458,7358458,7358374,84,60,utRho27
yhjJ,7364032,7364032,7363880,152,122,utRho27
yhjK,7371296,7371296,7371158,138,178,utRho27
yhjR,7392750,7392750,7392370,380,0,utRho27
yhjV,7400796,7401126,7400796,330,542,utRho27
yhjX,7424194,7424194,7424014,180,0,utRho27
yhjY,7425966,7425966,7425868,98,62,utRho27
yiaB,7455654,7455654,7455496,158,272,utRho27
yiaD,7432712,7433094,7432712,382,30,utRho27
yiaF,7438194,7438194,7438088,106,186,utRho27
yiaG,7438862,7438956,7438862,94,10,utRho27
yiaJ,7485236,7485236,7485064,172,222,utRho27
yiaK,7485348,7485466,7485348,118,176,utRho27
yiaT,7503924,7503924,7503736,188,0,utRho27
yiaU,7503792,7503984,7503792,192,0,utRho27
yiaY,7515856,7515856,7515654,202,108,utRho27
yibF,7523950,7523950,7523910,40,0,utRho27
yibG,7536128,7536354,7536128,226,1390,utRho27
yibL,7553194,7553330,7553194,136,76,utRho27
yibN,7570112,7570112,7570030,82,70,utRho27
yibT,7552848,7552848,7552760,88,406,utRho27
yicC,7633290,7633352,7633290,62,0,utRho27
yicH,7660862,7660914,7660862,52,0,utRho27
yicJ,7673328,7673328,7671858,1470,6712,utRho27
yicN,7685018,7685018,7684804,214,8,utRho27
yicO,7687914,7687914,7687578,336,86,utRho27
yicR,15250308,15250308,15250236,72,0,utRho27
yidB,7755230,7755230,7754930,300,198,utRho27
yidE,7732780,7732780,7732546,234,78,utRho27
yidF,7711580,7711580,7711222,358,76,utRho27
yidQ,7735088,7735456,7735088,368,1050,utRho27
yidR,7738824,7738824,7738618,206,96,utRho27
yieE,7787658,7787738,7787658,80,528,utRho27
yieH,7793314,7793548,7793314,234,0,utRho27
yieK,7798928,7798928,7798786,142,104,utRho27
yifB,7900350,7900350,7899998,352,102,utRho27
yifL,7988984,7989044,7988984,60,172,utRho27
yigF,8005750,8005750,8005598,152,1030,utRho27
yigI,8009448,8009448,8009394,54,108,utRho27
yigM,8022100,8022152,8022100,52,130,utRho27
yihA,8101970,8101970,8101458,512,52,utRho27
yihD,8084098,8084138,8084098,40,26,utRho27
yihF,8088110,8088398,8088110,288,208,utRho27
yihG,8093304,8093304,8093204,100,94,utRho27
yihI,8102616,8102694,8102616,78,0,utRho27
yihL,8120506,8120894,8120506,388,128,utRho27
yihN,8124332,8124494,8124332,162,498,utRho27
yihO,8131942,8131942,8131532,410,114,utRho27
yihQ,8138892,8138892,8138552,340,0,utRho27
yihV,8147064,8147478,8147064,414,24,utRho27
yihX,8151096,8151106,8151096,10,0,utRho27
yiiE,8158192,8158582,8158192,390,224,utRho27
yiiF,8159124,8159502,8159124,378,4,utRho27
yiiG,8173762,8174004,8173762,242,0,utRho27
yiiM,8205506,8205644,8205506,138,216,utRho27
yiiQ,8224624,8224624,8224428,196,0,utRho27
yiiS,8225738,8225934,8225738,196,50,utRho27
yijE,8272178,8272216,8272178,38,0,utRho27
yijF,8275728,8275728,8275314,414,1072,utRho27
yijO,8296858,8296858,8296634,224,98,utRho27
yjaA,8426240,8426468,8426240,228,55420,utRho27
yjaB,8428312,8428312,8428246,66,70,utRho27
yjaG,8398746,8399008,8398746,262,0,utRho27
yjaH,8401022,8401132,8401022,110,2,utRho27
yjaZ,8379506,8379572,8379506,66,0,utRho27
yjbB,8455204,8455462,8455204,258,48,utRho27
yjbE,16943432,16943624,16943432,192,36,utRho27
yjbL,8520318,8520642,8520318,324,8,utRho27
yjbQ,8540428,8540476,8540428,48,120,utRho27
yjcB,8550328,8550328,8550082,246,152,utRho27
yjcC,8550836,8550942,8550836,106,108,utRho27
yjcD,8556628,8556958,8556628,330,206,utRho27
yjcE,8559658,8559960,8559658,302,248,utRho27
yjcF,8566212,8566212,8566150,62,0,utRho27
yjcO,8594660,8594660,8594250,410,92,utRho27
yjdA,8654128,8654270,8654128,142,0,utRho27
yjdC,8726660,8726660,8726616,44,54,utRho27
yjdK,8704780,8705168,8704780,388,1222,utRho27
yjdL,8713034,8713034,8712822,212,0,utRho27
yjdM,8653672,8653672,8653468,204,1106,utRho27
yjeF,8787354,8788132,8787354,778,652,utRho27
yjeI,8745522,8745618,8745522,96,114,utRho27
yjeJ,8748806,8748806,8748468,338,1136,utRho27
yjeV,8785472,8785784,8785472,312,0,utRho27
yjfP,8833512,8833904,8833512,392,122,utRho27
yjfY,8849656,8849656,8849582,74,52,utRho27
yjfZ,8855052,8855052,8854844,208,34,utRho27
yjgA,8916162,8916162,8915730,432,86,utRho27
yjgL,8950802,8950874,8950802,72,162,utRho27
yjgM,8959342,8959342,8959074,268,0,utRho27
yjgN,8959132,8959460,8959132,328,40,utRho27
yjgR,8980170,8980170,8980126,44,394,utRho27
yjgZ,9002116,9002520,9002116,404,796,utRho27
yjhB,9007764,9008116,9007764,352,374,utRho27
yjhG,9048452,9048452,9048188,264,596,utRho27
yjhU,9041080,9041080,9040648,432,678,utRho27
yjiA,9178096,9178096,9177730,366,0,utRho27
yjiJ,9125364,9125364,9125350,14,0,utRho27
yjiK,9127270,9127270,9127422,152,148,utRho27
yjiL,9129604,9129604,9129378,226,60,utRho27
yjiS,9143410,9143502,9143410,92,0,utRho27
yjiY,9182734,9182734,9182558,176,66,utRho27
yjjA,9200674,9200674,9200378,296,132,utRho27
yjjB,18408708,18408708,18407800,908,800,utRho27
yjjJ,9243314,9243538,9243314,224,0,utRho27
yjjK,9261132,9261132,9261044,88,60,utRho27
yjjL,9189764,9189764,9189444,320,0,utRho27
yjjM,9191894,9191894,9191702,192,626,utRho27
yjjP,9206068,9206068,9205716,352,218,utRho27
yjjQ,9206638,9206954,9206638,316,94,utRho27
yjjX,9267798,9267798,9267490,308,326,utRho27
yjjY,9280716,9280804,9280716,88,146,utRho27
yjjZ,9211554,9211608,9211554,54,0,utRho27
yjtD,9281676,9281884,9281676,208,254,utRho27
ykfB,532454,532454,532174,280,280,utRho27
ykfI,527636,527636,527338,298,500,utRho27
ykgB,637050,637050,636638,412,60,utRho27
ykgC,640430,640430,640002,428,36,utRho27
ykgD,640232,640454,640232,222,0,utRho27
ykgE,642962,643216,642962,254,492,utRho27
ykgJ,608524,608524,608364,160,76,utRho27
ykgL,623878,624224,623878,346,32,utRho27
ykgM,625610,625610,625554,56,0,utRho27
ykgR,626570,626570,626484,86,2,utRho27
ylaC,958576,958576,958502,74,532,utRho27
yliE,1745938,1745958,1745938,20,0,utRho27
ymcE,2103660,2103694,2103660,34,0,utRho27
ymdA,2210450,2210828,2210450,378,76,utRho27
ymdB,2211428,2211640,2211428,212,92,utRho27
ymfD,2395322,2395322,2395064,258,90,utRho27
ymfI,2402880,2402994,2402880,114,0,utRho27
ymfJ,2404518,2404518,2404168,350,186,utRho27
ymfK,2406176,2406176,2405866,310,0,utRho27
ymfT,2405766,2406048,2405766,282,70,utRho27
ymgE,2489110,2489456,2489110,346,114,utRho27
ymgF,2437628,2437966,2437628,338,60,utRho27
ymiA,2670112,2670320,2670112,208,28,utRho27
ymjA,2715620,2715620,2715336,284,72,utRho27
ynaI,2791946,2791946,2791844,102,0,utRho27
ynaK,2850438,2850754,2850438,316,0,utRho27
ynbA,2954924,2955242,2954924,318,92,utRho27
yncD,3046552,3046552,3046130,422,0,utRho27
yncE,3046454,3046614,3046454,160,0,utRho27
yncG,3052456,3052494,3052456,38,30,utRho27
yncL,3034492,3034492,3034388,104,4,utRho27
yneE,3218364,3218364,3218044,320,0,utRho27
yneF,3223748,3223748,3223708,40,146,utRho27
yneJ,3229560,3229608,3229560,48,24,utRho27
yneK,3231100,3231526,3231100,426,148,utRho27
yneM,3245176,3245292,3245176,116,102,utRho27
ynfA,3311398,3311398,3311346,52,0,utRho27
ynfB,3311418,3311616,3311418,198,0,utRho27
ynfC,3315094,3315094,3314914,180,0,utRho27
ynfD,3314828,3315130,3314828,302,0,utRho27
ynfE,3316006,3316138,3316006,132,0,utRho27
ynfK,3334670,3334670,3334438,232,50,utRho27
ynfL,3339304,3339304,3339184,120,0,utRho27
ynfM,3339260,3339398,3339260,138,0,utRho27
ynfN,3276598,3276598,3276218,380,26,utRho27
ynfO,3273454,3273512,3273454,58,62,utRho27
ynhG,3517890,3517890,3517450,440,30,utRho27
yniA,3615158,3615592,3615158,434,0,utRho27
yniB,3618526,3618526,3618466,60,0,utRho27
yniC,3618652,3618760,3618652,108,104,utRho27
yniD,3610202,3610330,3610202,128,0,utRho27
ynjE,3678880,3678934,3678880,54,0,utRho27
ynjF,3683222,3683222,3682806,416,62,utRho27
ynjH,3684376,3684376,3684270,106,24,utRho27
ynjI,3690022,3690022,3689742,280,36,utRho27
yoaB,3786642,3786734,3786642,92,150,utRho27
yoaC,3787932,3788146,3787932,214,284,utRho27
yoaE,3803544,3803544,3803170,374,12,utRho27
yoaF,3755444,3755444,3755064,380,0,utRho27
yoaH,3789866,3789866,3789462,404,88,utRho27
yobB,3850418,3850880,3850418,462,132,utRho27
yobF,3815586,3815586,3815182,404,220,utRho27
yobH,3817800,3817850,3817800,50,116,utRho27
yodB,4084352,4084736,4084352,384,156,utRho27
yodC,4057008,4057008,4056740,268,0,utRho27
yohC,4451358,4451358,4451262,96,0,utRho27
yohD,4451526,4451602,4451526,76,0,utRho27
yohJ,4460986,4461248,4460986,262,242,utRho27
yohO,4431172,4431314,4431172,142,0,utRho27
yojI,4617282,4617282,4617230,52,86,utRho27
ypdI,4988988,4989396,4988988,408,76,utRho27
ypfG,5165786,5165786,5165554,232,106,utRho27
ypfM,5182140,5182140,5181732,408,432,utRho27
yphB,5349590,5349590,5349376,214,132,utRho27
ypjA,5565644,5565644,5565452,192,712,utRho27
ypjB,5569636,5569636,5568858,778,24,utRho27
ypjD,5495860,5495774,5495860,86,0,utRho27
yqaE,5594170,5594170,5594056,114,96,utRho27
yqcA,5846100,5846100,5845968,132,190,utRho27
yqcE,5800944,5801184,5800944,240,6,utRho27
yqeC,6030468,6030468,6030114,354,28,utRho27
yqeF,5971618,5971618,5971184,434,1078,utRho27
yqeG,5971438,5971694,5971438,256,1016,utRho27
yqeH,5975016,5975072,5975016,56,426,utRho27
yqeI,5976688,5977004,5976688,316,20,utRho27
yqeK,5981140,5981140,5980720,420,854,utRho27
yqfA,6086728,6086728,6086296,432,92,utRho27
yqgA,6219042,6219106,6219042,64,0,utRho27
yqgB,6172500,6172500,6172102,398,28,utRho27
yqgE,6185768,6185874,6185768,106,78,utRho27
yqhA,6299150,6299150,6298942,208,8,utRho27
yqhC,6310768,6310768,6310436,332,134,utRho27
yqhD,6310604,6310710,6310604,106,34,utRho27
yqhH,6316842,6317254,6316842,412,168,utRho27
yqiC,6369662,6369680,6369662,18,22,utRho27
yqiJ,6384108,6384416,6384108,308,246,utRho27
yqjA,6495096,6495546,6495096,450,298,utRho27
yqjF,6500932,6501124,6500932,192,440,utRho27
yqjG,6501948,6502048,6501948,100,0,utRho27
yqjH,6433078,6433078,6432982,96,0,utRho27
yqjI,6433506,6433558,6433506,52,0,utRho27
yraH,6574552,6574852,6574552,300,22,utRho27
yraP,6592144,6592818,6592144,674,230,utRho27
yraQ,6596414,6596414,6596276,138,0,utRho27
yraR,6598024,6598024,6597692,332,0,utRho27
yrbG,13360844,13361100,13360844,256,200,utRho27
yrbL,6696842,6696904,6696842,62,98,utRho27
yrbN,6616172,6616172,6615866,306,4,utRho27
yrdB,6860176,6860176,6860046,130,296,utRho27
yrfF,7052548,7052938,7052548,390,712,utRho27
yrhB,7169440,7169518,7169440,78,102,utRho27
ysaB,7451804,7451804,7451424,380,444,utRho27
ysgA,8032686,8032686,8032338,348,80,utRho27
ytfB,8857638,8857638,8857434,204,146,utRho27
ytfE,8864018,8864018,8863966,52,234,utRho27
ytfF,8866296,8866296,8866130,166,642,utRho27
ytfH,8868164,8868226,8868164,62,0,utRho27
ytfI,8875234,8875414,8875234,180,66,utRho27
ytfJ,8878572,8878572,8878524,48,0,utRho27
ytfK,8879022,8879174,8879022,152,24,utRho27
ytfL,8882642,8882642,8882430,212,4,utRho27
ytfQ,8899634,8899924,8899634,290,132,utRho27
ytjB,9249598,9249598,9249578,20,0,utRho27
yzfA,8896588,8896588,8896490,98,0,utRho27
zapA,6111102,6111224,6111102,122,154,utRho27
zapB,8236772,8237030,8236772,258,202,utRho27
zapC,2011700,2011904,2011700,204,0,utRho27
zinT,4082692,4082750,4082692,58,40,utRho27
zipA,5062814,5062814,5062466,348,48,utRho27
zitB,1569716,1569716,1569646,70,46,utRho27
zntA,7212844,7212902,7212844,58,0,utRho27
zntR,6878336,6878336,6878260,76,46,utRho27
znuA,3885322,3885322,3885166,156,12,utRho27
znuC,3885268,3885324,3885268,56,0,utRho27
zraP,8403424,8403424,8403376,48,18,utRho27
zraS,8403810,8403852,8403810,42,72,utRho27
zupT,6364866,6365100,6364866,234,0,utRho27
zur,8520282,8520282,8520006,276,76,utRho27
zwf,3872752,3872752,3872628,124,32,utRho27
C0343,2818676,2818728,2818676,52,0,utRho28
aaeB,6776526,6776526,6776376,150,244,utRho28
aaeR,6778762,6779040,6778762,278,148,utRho28
aaeX,6778860,6778860,6778674,186,122,utRho28
aat,1854920,1854920,1854864,56,0,utRho28
accA,416822,417242,416822,420,142,utRho28
accB,6810280,6810872,6810280,592,1534,utRho28
accD,4868030,4868030,4867852,178,22,utRho28
aceB,8430804,8430956,8430804,152,196,utRho28
aceE,245938,246034,245938,96,346,utRho28
ackA,4826918,4826940,4826918,22,254,utRho28
acnA,2670848,2671662,2670848,814,230,utRho28
acnB,263038,263230,263038,192,262,utRho28
acpP,2303148,2303230,2303148,82,330,utRho28
acpS,5402324,5402324,5401996,328,1020,utRho28
acrA,971396,971396,971238,158,4,utRho28
acrB,969370,969370,968806,564,190,utRho28
acrD,5174950,5175190,5174950,240,0,utRho28
acrE,6827404,6827728,6827404,324,76,utRho28
acrR,971398,971522,971398,124,0,utRho28
acrZ,1589502,1589546,1589502,44,62,utRho28
acs,8575190,8575190,8574742,448,1676,utRho28
actP,8569870,8569870,8569804,66,80,utRho28
ada,4620854,4620854,4620810,44,0,utRho28
add,3404404,3404466,3404404,62,8,utRho28
ade,7687802,7687928,7687802,126,8,utRho28
adhE,2596826,2596826,2596242,584,76,utRho28
adhP,3107988,3107988,3107676,312,286,utRho28
adiA,8681112,8681112,8681042,70,110,utRho28
adiC,8674404,8674404,8674062,342,12,utRho28
adiY,8676084,8676084,8675858,226,20,utRho28
adk,994278,994350,994278,72,1142,utRho28
adrA,807374,807406,807374,32,28,utRho28
aer,6438240,6438240,6438152,88,56,utRho28
aes,1000102,1000102,999946,156,42,utRho28
agaR,6557406,6557406,6557330,76,0,utRho28
agaS,6563778,6563952,6563778,174,12,utRho28
agp,2131118,2131170,2131118,52,20,utRho28
agrA,7296126,7296126,7296126,0,0,utRho28
agrB,7296588,7296588,7296588,0,0,utRho28
ahpC,1277386,1277890,1277386,504,974,utRho28
ahpF,1278004,1279506,1278004,1502,27728,utRho28
ahr,8992698,8992698,8992418,280,268,utRho28
aidB,8828494,8828550,8828494,56,0,utRho28
ais,4731512,4731512,4731240,272,60,utRho28
alaA,4814816,4815122,4814816,306,68,utRho28
alaC,4996798,4996798,4996590,208,10,utRho28
alaE,5598140,5598328,5598140,188,600,utRho28
alaS,5644180,5644180,5644022,158,406,utRho28
alaW,5036612,5036612,5036462,150,26,utRho28
aldA,2976380,2976464,2976380,84,6,utRho28
aldB,7513070,7513070,7513022,48,162,utRho28
alkA,4295118,4295118,4295080,38,0,utRho28
alkB,4618890,4618890,4618682,208,48,utRho28
allA,1064780,1064902,1064780,122,24,utRho28
allD,1092822,1092822,1092726,96,0,utRho28
allE,1088112,1088112,1088092,20,18,utRho28
allS,1064600,1064600,1064442,158,112,utRho28
alr,8531178,8531564,8531178,386,404,utRho28
alsE,8617334,8617334,8616956,378,1016,utRho28
alsK,8615990,8615990,8615598,392,406,utRho28
alx,6476740,6477160,6476740,420,216,utRho28
amiA,5104482,5104704,5104482,222,44,utRho28
amiC,5898378,5898378,5898020,358,28,utRho28
amn,4110062,4110122,4110062,60,0,utRho28
ampC,8758006,8758006,8757888,118,12,utRho28
ampD,237362,237466,237362,104,92,utRho28
ampG,907372,907372,907090,282,230,utRho28
ampH,792726,792726,792574,152,40,utRho28
amyA,4012230,4012312,4012230,82,0,utRho28
anmK,3439346,3439346,3439204,142,58,utRho28
ansB,6201580,6201580,6201456,124,232,utRho28
ansP,3052040,3052040,3051960,80,72,utRho28
apaG,104068,104068,103212,856,424,utRho28
apaH,102586,102586,102444,142,430,utRho28
apbE,4623188,4623188,4623068,120,20,utRho28
appA,2081198,2081234,2081198,36,0,utRho28
appC,2075420,2075480,2075420,60,0,utRho28
appY,1167134,1167362,1167134,228,0,utRho28
apt,982620,982824,982620,204,8,utRho28
aqpZ,1832424,1832424,1832094,330,122,utRho28
araB,140150,140150,140096,54,18,utRho28
araC,140482,140774,140482,292,76,utRho28
araE,5964416,5964416,5964364,52,4,utRho28
araF,3972476,3972476,3972256,220,0,utRho28
araH,3967120,3967120,3967086,34,80,utRho28
araJ,825058,825058,824962,96,892,utRho28
arcA,9281602,9281602,9280612,990,1356,utRho28
arcB,6706098,6706098,6706050,48,106,utRho28
arcZ,6701154,6701154,6701154,0,0,utRho28
arfA,6877346,6877346,6877298,48,54,utRho28
argA,5898312,5898484,5898312,172,0,utRho28
argC,8309770,8310002,8309770,232,160,utRho28
argD,6980442,6980442,6980360,82,86,utRho28
argE,8310156,8310156,8309694,462,470,utRho28
argF,580680,580680,580610,70,0,utRho28
argG,6637124,6637274,6637124,150,78,utRho28
argI,8956688,8956688,8956622,66,244,utRho28
argO,6137672,6137672,6137616,56,96,utRho28
argP,6119460,6119506,6119460,46,36,utRho28
argR,6769204,6769406,6769204,202,20,utRho28
argS,3920002,3920124,3920002,122,8,utRho28
argT,4855698,4855698,4855582,116,60,utRho28
argU,1129406,1129446,1129406,40,8,utRho28
argW,4932616,4932618,4932616,2,0,utRho28
argX,7964728,7964750,7964728,22,8,utRho28
aroF,5482402,5482402,5482300,102,0,utRho28
aroG,1571182,1571266,1571182,84,90,utRho28
aroH,3576636,3576870,3576636,234,148,utRho28
aroK,7038760,7038760,7038128,632,1186,utRho28
aroL,812560,812810,812560,250,2066,utRho28
aroP,243342,243342,243102,240,42,utRho28
arpA,8445382,8445382,8444974,408,30,utRho28
arrS,7316108,7316108,7316108,0,0,utRho28
arsR,7297024,7297056,7297024,32,0,utRho28
artJ,1801252,1801252,1801150,102,0,utRho28
artP,1807686,1807686,1807468,218,942,utRho28
ascF,5678858,5679048,5678858,190,2,utRho28
ascG,5678574,5678574,5678528,46,76,utRho28
aslB,7965562,7965916,7965562,354,140,utRho28
asnA,7854258,7854310,7854258,52,308,utRho28
asnB,1398444,1398444,1398354,90,110,utRho28
asnC,23562186,23562186,23562018,168,426,utRho28
asnS,1978088,1978088,1977970,118,1018,utRho28
asnT,4089082,4089098,4089082,16,118,utRho28
asnU,4119690,4119702,4119690,12,22,utRho28
asnV,4124504,4124520,4124504,16,46,utRho28
aspA,17473728,17473728,17473308,420,68,utRho28
aspC,1971486,1971486,1971418,68,78,utRho28
aspS,3901402,3901402,3901044,358,228,utRho28
aspT,7893560,7893744,7893560,184,96744,utRho28
aspV,473826,473862,473826,36,264,utRho28
asr,3342654,3342752,3342654,98,62,utRho28
astC,3664088,3664088,3663964,124,50,utRho28
astE,3654138,3654138,3653846,292,136,utRho28
atoD,4646824,4646894,4646824,70,118,utRho28
atpB,7844540,7844540,7844102,438,406,utRho28
atpC,7832118,7832118,7831944,174,704,utRho28
atpI,7845050,7845050,7844880,170,790,utRho28
avtA,7479348,7479410,7479348,62,768,utRho28
azoR,2965982,2965982,2965720,262,210,utRho28
azuC,3976002,3976002,3975918,84,30,utRho28
bacA,6408350,6408350,6408262,88,10806,utRho28
bamA,394052,395856,394052,1804,1996,utRho28
bamB,5277950,5277950,5277304,646,582,utRho28
bamC,5198028,5198028,5197730,298,410,utRho28
bamD,5471922,5472292,5471922,370,420,utRho28
bamE,5506972,5507210,5506972,238,714,utRho28
basS,8666954,8666954,8666544,410,678,utRho28
bax,7474468,7474468,7474354,114,196,utRho28
bcp,5200874,5200956,5200874,82,264,utRho28
bcsB,7385346,7385346,7385214,132,62,utRho28
bcsE,7392644,7392916,7392644,272,10,utRho28
bdcA,8948128,8948128,8948106,22,468,utRho28
bdcR,8948192,8948248,8948192,56,62,utRho28
bdm,3112680,3112680,3112560,120,238,utRho28
betA,654522,654522,654494,28,42,utRho28
betI,658722,658722,658668,54,220,utRho28
betT,658842,658926,658842,84,382,utRho28
bfr,6933498,6933498,6933450,48,100,utRho28
bglG,23440182,23440182,23439402,780,1302,utRho28
bglX,4444240,4444240,4443978,262,86,utRho28
bhsA,2337962,2338146,2337962,184,188,utRho28
bioA,1618584,1618584,1618514,70,0,utRho28
bioB,1618604,1618688,1618604,84,0,utRho28
bioH,7089716,7089716,7089688,28,0,utRho28
bisC,7433026,7433026,7432788,238,124,utRho28
blc,8755490,8755490,8755444,46,66,utRho28
blr,3409024,3409102,3409024,78,270,utRho28
bluF,2431226,2431226,2430950,276,114,utRho28
bluR,2428226,2428226,2428118,108,48,utRho28
bolA,908698,908944,908698,246,64,utRho28
borD,1157842,1157842,1157786,56,50,utRho28
brnQ,838976,839182,838976,206,660,utRho28
bssR,1756492,1756496,1756492,4,10,utRho28
bssS,2242116,2242116,2241910,206,522,utRho28
btuB,8326798,8327278,8326798,480,852,utRho28
cadB,8720212,8720212,8720062,150,90,utRho28
cadC,8723926,8723926,8723868,58,48,utRho28
caiE,70998,70998,70742,256,38,utRho28
caiF,68436,68600,68436,164,200,utRho28
caiT,84074,84074,83862,212,240,utRho28
can,285406,285406,285340,66,86,utRho28
carA,59102,59302,59102,200,594,utRho28
carB,61550,61634,61550,84,96,utRho28
cas2,5757830,5757830,5757706,124,66,utRho28
casA,5768638,5768638,5768276,362,118,utRho28
cbl,4121882,4121882,4121828,54,152,utRho28
cbpA,2128074,2128074,2127550,524,20,utRho28
cbrA,7738628,7738754,7738628,126,136,utRho28
cbrB,7794958,7795012,7794958,54,122,utRho28
ccmH,4585242,4585242,4584820,422,28,utRho28
cdaR,364894,364926,364894,32,50,utRho28
cdd,4463638,4463688,4463638,50,96,utRho28
cdh,8219814,8219860,8219814,46,92,utRho28
cdsA,391110,391354,391110,244,722,utRho28
cedA,3627484,3627484,3627326,158,42,utRho28
cfa,3482402,3482826,3482402,424,0,utRho28
chaC,2544844,2544972,2544844,128,280,utRho28
chbB,3643452,3643452,3643238,214,28,utRho28
chbG,3634624,3634624,3634270,354,64,utRho28
cheW,3946924,3946924,3946678,246,150,utRho28
chiA,6939792,6939792,6939706,86,856,utRho28
chiP,1416472,1416668,1416472,196,28,utRho28
cho,3646984,3647030,3646984,46,0,utRho28
chpS,8896804,8896894,8896804,90,138,utRho28
cirA,4493884,4493884,4493538,346,690,utRho28
citC,1304078,1304078,1303712,366,336,utRho28
citT,1293264,1293264,1293160,104,0,utRho28
clcA,350104,350214,350104,110,8,utRho28
clpA,1846160,1846528,1846160,368,194,utRho28
clpB,5468410,5468410,5468346,64,484,utRho28
clpP,913154,913354,913154,200,806,utRho28
clpS,1845500,1845826,1845500,326,200,utRho28
clpX,914404,914852,914404,448,1448,utRho28
clsA,2617346,2617346,2617290,56,46,utRho28
clsC,2212584,2212710,2212584,126,4,utRho28
cmk,1922330,1922402,1922330,72,24,utRho28
cnu,3409522,3409898,3409522,376,1276,utRho28
coaA,8350214,8350214,8350052,162,746,utRho28
cobC,1340092,1340092,1339814,278,94,utRho28
cobT,4129202,4129202,4128934,268,84,utRho28
cobU,4131944,4131944,4131528,416,86,utRho28
codB,709768,709844,709768,76,314,utRho28
comR,2337726,2337726,2337664,62,0,utRho28
copA,1022822,1022822,1022758,64,0,utRho28
corA,8002388,8002852,8002388,464,21538,utRho28
cpdB,8873258,8873258,8873130,128,116,utRho28
cptB,6082198,6082198,6082140,58,0,utRho28
cpxA,8210202,8210202,8209950,252,154,utRho28
cpxP,8211570,8211640,8211570,70,146,utRho28
cpxR,8211372,8211372,8211340,32,0,utRho28
cra,175894,176056,175894,162,328,utRho28
crcB,1316016,1316016,1315876,140,30,utRho28
creA,9270486,9271042,9270486,556,340,utRho28
creD,9276320,9276356,9276320,36,184,utRho28
crl,515620,515658,515620,38,578,utRho28
crp,6971906,6972240,6971906,334,408,utRho28
crr,5070960,5071668,5070960,708,1496,utRho28
csdA,5886414,5886674,5886414,260,0,utRho28
csgB,2207718,2207902,2207718,184,26,utRho28
csgD,2206688,2206688,2206392,296,790,utRho28
csgG,2203510,2203510,2203368,142,280,utRho28
csiD,5577854,5577970,5577854,116,36,utRho28
csiE,5330802,5330870,5330802,68,0,utRho28
csiR,5590942,5591348,5590942,406,246,utRho28
cspA,7439778,7440098,7439778,320,778,utRho28
cspB,3283430,3283430,3283108,322,80,utRho28
cspC,3815018,3815018,3814870,148,76,utRho28
cspD,1845352,1845352,1845180,172,4938,utRho28
cspE,1314294,1314584,1314294,290,338,utRho28
cspF,3283380,3283710,3283380,330,870,utRho28
cspG,2102610,2102922,2102610,312,318,utRho28
cspH,2102746,2102746,2102350,396,106,utRho28
cspI,3277624,3277624,3277334,290,36,utRho28
csrA,5638746,5638746,5638292,454,2166,utRho28
csrB,5849048,5849048,5849048,0,0,utRho28
csrC,8102072,8102072,8102072,0,0,utRho28
csrD,6806850,6806850,6806664,186,208,utRho28
cstA,1259710,1259788,1259710,78,0,utRho28
cueO,274090,274166,274090,76,38,utRho28
cueR,1027948,1027986,1027948,38,0,utRho28
curA,3037784,3038054,3037784,270,148,utRho28
cusC,1191146,1191200,1191146,54,26,utRho28
cusR,1190924,1190924,1190886,38,82,utRho28
cutA,8730784,8730784,8730712,72,44,utRho28
cutC,3918534,3918534,3917920,614,554,utRho28
cvpA,4861600,4861600,4861526,74,2,utRho28
cvrA,2484328,2484328,2484142,186,68,utRho28
cyaA,7981548,7982306,7981548,758,534,utRho28
cyaR,4334228,4334224,4334228,4,14,utRho28
cyaY,7988166,7988166,7988118,48,454,utRho28
cybB,2981522,2981804,2981522,282,286,utRho28
cycA,8859560,8859728,8859560,168,164,utRho28
cydA,1542340,1542916,1542340,576,2974,utRho28
cydC,1858800,1858800,1858390,410,0,utRho28
cydD,1862062,1862062,1861924,138,0,utRho28
cydX,1548300,1548392,1548300,92,278,utRho28
cynR,717418,717418,717380,38,0,utRho28
cynT,1435092,1435196,1435092,104,0,utRho28
cyoA,903306,903306,903220,86,366,utRho28
cyoE,895540,895540,895410,130,194,utRho28
cysB,2667576,2667710,2667576,134,156,utRho28
cysC,5748056,5748056,5747984,72,182,utRho28
cysD,5752736,5752736,5752658,78,56,utRho28
cysE,7565362,7565362,7565124,238,816,utRho28
cysG,6995508,6995656,6995508,148,3256,utRho28
cysJ,5783928,5783928,5783796,132,904,utRho28
cysK,5064688,5064818,5064688,130,0,utRho28
cysP,5087114,5087114,5087056,58,102,utRho28
cysS,1109154,1109222,1109154,68,70,utRho28
cysT,3984100,3984100,3983974,126,110,utRho28
cysZ,5062766,5062926,5062766,160,252,utRho28
cytR,8249018,8249018,8248912,106,166,utRho28
dacA,1328002,1328002,1327926,76,0,utRho28
dacB,6657714,6657926,6657714,212,52,utRho28
dacC,1761306,1761454,1761306,148,826,utRho28
dadA,2475018,2475142,2475018,124,218,utRho28
dam,7032504,7032504,7031826,678,282,utRho28
damX,7035200,7035200,7034612,588,1618,utRho28
dapA,5199568,5199568,5199520,48,26,utRho28
dapB,56576,56748,56576,172,868,utRho28
dapD,371954,371954,371894,60,236,utRho28
dapE,5183120,5183214,5183120,94,372,utRho28
dcp,3254844,3254844,3254760,84,0,utRho28
dcrB,7219534,7219910,7219534,376,294,utRho28
dctA,7366996,7366996,7366894,102,308,utRho28
dcuA,8733686,8733686,8733546,140,1374,utRho28
dcuB,8698182,8698182,8697488,694,1480,utRho28
dcuC,1312166,1312166,1311936,230,602,utRho28
dcuD,6749166,6749738,6749166,572,684,utRho28
dcuR,8701130,8701130,8700068,1062,1072,utRho28
dcuS,8703370,8703370,8703324,46,474,utRho28
dcyD,3999016,3999016,3998960,56,0,utRho28
ddpX,3126498,3126498,3126152,346,70,utRho28
deaD,6615818,6615818,6615720,98,238,utRho28
dedA,4869880,4869880,4869482,398,748,utRho28
dedD,4863750,4863750,4863368,382,16,utRho28
def,6867300,6867380,6867300,80,250,utRho28
degP,361690,361768,361690,78,40,utRho28
degQ,6761308,6761486,6761308,178,432,utRho28
deoB,9239134,9239206,9239134,72,76,utRho28
deoC,9233358,9234646,9233358,1288,732,utRho28
dfp,7625406,7625462,7625406,56,0,utRho28
dgcZ,3247758,3247758,3247700,58,54,utRho28
dgkA,8512914,8513274,8512914,360,226,utRho28
dgt,358392,358474,358392,82,236,utRho28
dhaK,2501888,2501888,2501676,212,150,utRho28
dhaR,2502006,2502132,2502006,126,116,utRho28
dicB,3299194,3299218,3299194,24,40,utRho28
dicC,3295752,3295752,3295700,52,0,utRho28
dinB,501760,501796,501760,36,0,utRho28
dinD,7635398,7635520,7635398,122,68,utRho28
dinG,1666146,1666140,1666146,6,0,utRho28
dinI,2243018,2243018,2242974,44,122,utRho28
dinJ,493230,493230,493004,226,146,utRho28
dinQ,7295964,7295964,7295576,388,64,utRho28
djlA,114536,114728,114536,192,110,utRho28
dkgA,6313142,6313246,6313142,104,62,utRho28
dkgB,458196,458334,458196,138,20,utRho28
dksA,321502,321502,321208,294,830,utRho28
dld,4444164,4444370,4444164,206,40,utRho28
dmlA,3763424,3763824,3763424,400,126,utRho28
dmlR,3763710,3763710,3763618,92,0,utRho28
dmsA,1881646,1881918,1881646,272,32,utRho28
dnaA,7767922,7767922,7767458,464,356,utRho28
dnaB,8528566,8528628,8528566,62,222,utRho28
dnaK,24096,24326,24096,230,4550,utRho28
dnaN,7765466,7765466,7764642,824,256,utRho28
dnaQ,471868,472134,471868,266,2196,utRho28
dnaT,18406460,18406460,18406068,392,104,utRho28
dnaX,984112,984184,984112,72,24,utRho28
dosP,3131486,3131486,3131466,20,30,utRho28
dpiB,1303968,1304470,1303968,502,144,utRho28
dppA,7415740,7415740,7415410,330,1168,utRho28
dps,1697900,1697900,1697822,78,196,utRho28
dsbA,8086754,8086836,8086754,82,384,utRho28
dsbB,2466294,2466294,2466060,234,58,utRho28
dsbC,6079266,6079266,6077644,1622,1330,utRho28
dsbG,1277600,1277600,1277146,454,428,utRho28
dsdA,4958242,4958404,4958242,162,174,utRho28
dsdC,4955492,4955492,4955258,234,182,utRho28
dsdX,4955642,4955694,4955642,52,786,utRho28
dsrA,4050626,4050626,4050626,0,0,utRho28
dsrB,4049686,4049686,4049646,40,352,utRho28
dtpD,1485340,1485340,1485112,228,354,utRho28
dusA,8523200,8523338,8523200,138,1030,utRho28
dusB,6820492,6820560,6820492,68,60,utRho28
dusC,4460790,4460790,4460770,20,0,utRho28
dut,7627704,7627864,7627704,160,874,utRho28
dxr,386670,387042,386670,372,236,utRho28
ebgA,6445102,6445266,6445102,164,0,utRho28
ebgR,6442874,6442932,6442874,58,16,utRho28
ecnB,8753018,8753106,8753018,88,76,utRho28
eco,4607594,4607810,4607594,216,72,utRho28
ecpA,621594,621594,621342,252,70,utRho28
ecpB,620238,620238,620052,186,106,utRho28
ecpR,622964,622964,622672,292,0,utRho28
eda,3866218,3866218,3865512,706,86,utRho28
edd,3869426,3869426,3869208,218,0,utRho28
efeO,2164308,2164486,2164308,178,22,utRho28
efeU_1,2162614,2162712,2162614,98,400,utRho28
efp,8751134,8751398,8751134,264,934,utRho28
elaA,4763372,4763372,4763086,286,126,utRho28
elaD,4765308,4765426,4765308,118,128,utRho28
elfA,1995530,1995736,1995530,206,0,utRho28
elfD,1996642,1996980,1996642,338,108,utRho28
emrD,7707690,7707844,7707690,154,102,utRho28
emrK,4966896,4966896,4966678,218,68,utRho28
emrY,4964668,4964668,4964352,316,426,utRho28
emtA,2486250,2486360,2486250,110,2,utRho28
endA,12361100,12361388,12361100,288,0,utRho28
eno,5817692,5817692,5815882,1810,680,utRho28
entC,1249662,1249770,1249662,108,0,utRho28
entD,1220508,1220508,1220158,350,162,utRho28
entH,1258584,1258600,1258584,16,0,utRho28
entS,1244506,1244600,1244506,94,0,utRho28
envR,6827266,6827266,6826930,336,140,utRho28
epd,12295292,12295292,12294764,528,268,utRho28
epmA,8765236,8765286,8765236,50,148,utRho28
epmB,8751406,8751406,8751314,92,544,utRho28
eptB,7421162,7421162,7420950,212,0,utRho28
eptC,8300622,8300622,8300530,92,174,utRho28
erfK,4126708,4126708,4126646,62,0,utRho28
erpA,353122,353220,353122,98,32,utRho28
esrE,8039956,8039956,8039956,0,0,utRho28
essD,1153746,1154796,1153746,1050,212,utRho28
etk,2088606,2088606,2088420,186,10,utRho28
evgA,4967262,4967510,4967262,248,120,utRho28
exbB,6304028,6304028,6303968,60,156,utRho28
exbD,6302780,6302780,6302486,294,128,utRho28
exuR,6493016,6493304,6493016,288,0,utRho28
exuT,6490004,6490208,6490004,204,76,utRho28
fabA,2032996,2032996,2032940,56,40,utRho28
fabB,4883282,4883282,4883210,72,16,utRho28
fabH,2297032,2297518,2297032,486,84,utRho28
fabI,2702236,2702236,2702078,158,44,utRho28
fadB,8062026,8062026,8061942,84,6,utRho28
fadD,3779614,3779614,3779492,122,240,utRho28
fadE,486812,486812,486606,206,6,utRho28
fadH,6463248,6463330,6463248,82,100,utRho28
fadI,4921022,4921022,4920938,84,344,utRho28
fadL,4922410,4922600,4922410,190,182,utRho28
fadM,928720,928804,928720,84,10,utRho28
fadR,2469810,2469876,2469810,66,0,utRho28
fbaB,4357334,4357334,4357128,206,0,utRho28
fdhE,8162722,8162722,8162456,266,166,utRho28
fdhF,8598814,8598814,8598732,82,84,utRho28
fdnG,3094744,3094802,3094744,58,0,utRho28
fdrA,1093012,1093360,1093012,348,74,utRho28
feaB,2894994,2895038,2894994,44,0,utRho28
feaR,2894734,2894734,2894566,168,0,utRho28
fecA,9033454,9033454,9033354,100,98,utRho28
fecE,9023288,9023288,9022914,374,2840,utRho28
fecI,9036564,9036564,9036470,94,60,utRho28
feoA,7080114,7080326,7080114,212,362,utRho28
fepA,1225334,1225334,1224988,346,286,utRho28
fepB,1249454,1249454,1249020,434,92,utRho28
fepD,1244468,1244468,1244378,90,0,utRho28
fes,1225374,1225630,1225374,256,332,utRho28
ffh,5495706,5495706,5495590,116,616,utRho28
ffs,952576,952848,952576,272,492,utRho28
fhuA,334884,334968,334884,84,126,utRho28
fhuE,2323294,2323294,2323102,192,242,utRho28
fhuF,9211504,9211504,9211326,178,556,utRho28
fic,6983296,6983296,6982926,370,114,utRho28
fieF,8212864,8212938,8212864,74,146,utRho28
fimA,9085388,9086230,9085388,842,740,utRho28
fimB,9081334,9081914,9081334,580,2356,utRho28
fimE,9083742,9084074,9083742,332,980,utRho28
fimZ,1129214,1129214,1128960,254,142,utRho28
fiu,1683296,1683296,1683062,234,152,utRho28
fixA,84650,84806,84650,156,112,utRho28
fkpA,6955050,6955050,6954838,212,6840,utRho28
fldA,2846084,2846084,2845860,224,1072,utRho28
fldB,6079644,6079710,6079644,66,160,utRho28
flgA,2261770,2261770,2261726,44,360,utRho28
flgB,2261986,2262036,2261986,50,72,utRho28
flgK,2276702,2276756,2276702,54,54,utRho28
flgM,2260330,2260330,2260256,74,58,utRho28
flgN,2259828,2259828,2259660,168,34,utRho28
flhB,3932432,3932432,3932382,50,36,utRho28
flhC,3955864,3955864,3955688,176,0,utRho28
flhD,3957154,3957154,3956394,760,714,utRho28
fliA,4003638,4003638,4003578,60,70,utRho28
fliC,4007352,4007352,4007212,140,116,utRho28
fliD,4007634,4007744,4007634,110,120,utRho28
fliE,4026186,4026186,4026028,158,364,utRho28
fliF,4026292,4026458,4026292,166,22,utRho28
fliL,4039168,4039236,4039168,68,86,utRho28
flk,4875824,4875900,4875824,76,0,utRho28
flu,4142634,4143078,4142634,444,206,utRho28
flxA,3292776,3292810,3292776,34,288,utRho28
fnr,2799104,2799104,2799052,52,0,utRho28
fnrS,2818258,2818258,2818258,0,0,utRho28
focA,1909628,1909628,1908932,696,504,utRho28
folA,99598,99646,99598,48,260,utRho28
folB,6409296,6409296,6409178,118,892,utRho28
folD,1115562,1115562,1115482,80,220,utRho28
folE,4487696,4487696,4487304,392,72,utRho28
fpr,8228998,8228998,8228944,54,0,utRho28
frc,4986878,4986878,4986508,370,224,utRho28
frdA,8764824,8764824,8764636,188,84,utRho28
frdD,8758948,8758948,8758732,216,414,utRho28
fre,8052886,8053054,8052886,168,206,utRho28
frlA,6999518,6999820,6999518,302,150,utRho28
frr,385624,385744,385624,120,120,utRho28
frsA,513004,513054,513004,50,124,utRho28
fruB,4527194,4527194,4526990,204,0,utRho28
frvR,8179804,8179804,8179710,94,0,utRho28
fryA,5008986,5008986,5008970,16,48,utRho28
fsaA,1727060,1727284,1727060,224,284,utRho28
fsr,1009710,1009710,1009392,318,424,utRho28
ftnA,3977364,3977432,3977364,68,20,utRho28
ftnB,3973550,3973850,3973550,300,166,utRho28
ftsA,207122,207964,207122,842,1082,utRho28
ftsB,5745802,5745802,5745640,162,116,utRho28
ftsH,6654204,6654204,6653870,334,1656,utRho28
ftsK,1865858,1866448,1865858,590,1114,utRho28
ftsL,181376,182064,181376,688,570,utRho28
ftsP,6325732,6325732,6325338,394,56,utRho28
ftsQ,205484,206310,205484,826,1190,utRho28
ftsX,7204512,7204512,7204172,340,392,utRho28
ftsZ,209272,210610,209272,1338,328,utRho28
fucA,5867708,5867708,5867376,332,1730,utRho28
fucP,5868238,5868470,5868238,232,180,utRho28
fumA,6753760,6753760,6753508,252,1148,utRho28
fumB,8694696,8694696,8694652,44,0,utRho28
fumC,3373418,3373418,3373176,242,0,utRho28
fur,2842892,2842892,2842584,308,668,utRho28
fusA,6947370,6947370,6947028,342,5210,utRho28
fxsA,8737206,8737328,8737206,122,966,utRho28
gabD,5581824,5582546,5581824,722,1830,utRho28
gadA,7335214,7335214,7335160,54,0,utRho28
gadB,3144144,3144144,3144090,54,0,utRho28
gadC,3141168,3141168,3140978,190,902,utRho28
gadE,7315600,7316732,7315600,1132,464,utRho28
gadW,7329562,7329562,7329236,326,126,utRho28
gadX,14663356,14663356,14663240,116,76,utRho28
gadY,7329728,7329728,7329728,0,0,utRho28
galE,1584354,1584354,1584110,244,40,utRho28
galF,4228702,4228702,4228654,48,314,utRho28
galM,1577796,1577796,1577674,122,180,utRho28
galP,6176510,6176568,6176510,58,110,utRho28
galR,5953138,5953198,5953138,60,48,utRho28
galS,4483420,4483420,4483336,84,0,utRho28
galU,2582810,2582914,2582810,104,182,utRho28
gapA,3724480,3725542,3724480,1062,1218,utRho28
garP,6549868,6549868,6549814,54,296,utRho28
gatY,4354468,4354468,4354408,60,0,utRho28
gatZ,4352864,4352864,4352642,222,182,utRho28
gcd,282558,282558,282450,108,6,utRho28
gcl,1067814,1067832,1067814,18,6,utRho28
gcvA,5885278,5885278,5885134,144,64,utRho28
gcvB,5885392,5885392,5885392,0,0,utRho28
gcvR,5199758,5199812,5199758,54,24,utRho28
gcvT,6101544,6101544,6101334,210,498,utRho28
gdhA,3684616,3684742,3684616,126,0,utRho28
gfcA,2099668,2099668,2099488,180,272,utRho28
gfcD,2096236,2096236,2095890,346,288,utRho28
ghrA,2195648,2195772,2195648,124,120,utRho28
ghrB,7434378,7434620,7434378,242,606,utRho28
glcA,6242728,6242728,6242558,170,268,utRho28
glcC,6256412,6256544,6256412,132,0,utRho28
glcD,6256152,6256152,6256042,110,144,utRho28
gldA,8278092,8278092,8278070,22,44,utRho28
glgA,7136784,7136784,7136066,718,386,utRho28
glgB,7147314,7147314,7147004,310,132,utRho28
glgC,7139142,7139142,7138656,486,4,utRho28
glgP,7133546,7133546,7133162,384,244,utRho28
glgS,6384024,6384024,6383878,146,254,utRho28
glgX,7142838,7142838,7142638,200,0,utRho28
glk,5018922,5018922,5018852,70,30,utRho28
glmS,7827622,7827622,7827336,286,368,utRho28
glmU,7830652,7830652,7830400,252,90,utRho28
glmY,10765360,10765360,10765360,0,0,utRho28
glmZ,7972864,7972864,7972864,0,0,utRho28
glnA,16232888,16232888,16232136,752,112,utRho28
glnB,5375052,5375052,5374816,236,128,utRho28
glnD,377310,377310,377300,10,668,utRho28
glnE,6399602,6399602,6399282,320,76,utRho28
glnH,1696396,1696396,1696008,388,820,utRho28
glnK,945112,945196,945112,84,50,utRho28
glnL,8112742,8112742,8112678,64,0,utRho28
glnQ,1693262,1693262,1692926,336,262,utRho28
glnS,1411998,1412186,1411998,188,1618,utRho28
gloA,3455602,3455674,3455602,72,216,utRho28
gloB,469852,469852,469564,288,584,utRho28
glpA,4705166,4705294,4705166,128,128,utRho28
glpD,7123942,7124026,7123942,84,102,utRho28
glpE,7123698,7123698,7123646,52,74,utRho28
glpF,8236322,8236322,8236180,142,1554,utRho28
glpG,7122960,7122960,7122904,56,32,utRho28
glpR,7121782,7121782,7121210,572,2998,utRho28
glpT,4704902,4704902,4704748,154,300,utRho28
glpX,8231212,8231212,8231158,54,246,utRho28
glrK,5382246,5382246,5382196,50,20,utRho28
gltA,1509534,1509534,1508936,598,918,utRho28
gltB,6709018,6709264,6709018,246,116,utRho28
gltI,1375792,1375792,1375494,298,480,utRho28
gltP,8588536,8588962,8588536,426,578,utRho28
gltS,7657382,7657382,7657330,52,742,utRho28
gltX,5041568,5041568,5041344,224,152,utRho28
gluQ,320286,320286,320224,62,174,utRho28
glyA,5371148,5371148,5371014,134,164,utRho28
glyQ,7450708,7450708,7450636,72,0,utRho28
glyS,7448990,7448990,7448794,196,736,utRho28
glyU,5998128,5998128,5998114,14,0,utRho28
glyV,8784626,8784720,8784626,94,156,utRho28
glyW,3984360,3984360,3984234,126,12,utRho28
gmhB,445612,445666,445612,54,0,utRho28
gmk,7642776,7642856,7642776,80,0,utRho28
gmr,2693686,2693686,2693484,202,52,utRho28
gnd,4202648,4202648,4202536,112,422,utRho28
gnsB,3275692,3275692,3275564,128,0,utRho28
gntK,14310580,14310580,14310368,212,916,utRho28
gntP,9102668,9102668,9102592,76,866,utRho28
gntR,7157760,7157760,7157452,308,282,utRho28
gntT,7092810,7093118,7092810,308,338,utRho28
gntU,7154170,7154170,7154122,48,36,utRho28
gntX,7089334,7089764,7089334,430,310,utRho28
gor,7292224,7292598,7292224,374,276,utRho28
gpmA,1575340,1575340,1575190,150,0,utRho28
gpmM,7570374,7570520,7570374,146,172,utRho28
gpsA,7567620,7567620,7567322,298,2964,utRho28
gpt,511828,511954,511828,126,400,utRho28
grcA,5433046,5433046,5432898,148,582,utRho28
greA,6657728,6657728,6657430,298,814,utRho28
greB,7073488,7073624,7073488,136,64,utRho28
groL,8741566,8742050,8741566,484,10754,utRho28
groS,8741232,8741376,8741232,144,11278,utRho28
grpE,5501494,5501494,5501416,78,626,utRho28
grxA,1781552,1781552,1781506,46,0,utRho28
grxB,2248206,2248206,2248108,98,576,utRho28
grxC,7569152,7569152,7568884,268,1234,utRho28
grxD,3468324,3468324,3468202,122,3058,utRho28
gspA,6911268,6911268,6910796,472,584,utRho28
gspC,6910964,6911156,6910964,192,318,utRho28
gss,6277220,6277220,6277044,176,160,utRho28
gstA,3428654,3428754,3428654,100,0,utRho28
gstB,1761038,1761038,1760960,78,206,utRho28
guaB,5268214,5268214,5268140,74,212,utRho28
gudD,5839026,5839026,5838770,256,56,utRho28
gyrA,4678914,4678914,4678840,74,208,utRho28
gyrB,7760300,7760300,7760238,62,128,utRho28
hcaE,5337964,5338064,5337964,100,512,utRho28
hcaR,5337928,5337928,5337792,136,494,utRho28
hcaT,5336106,5336106,5335692,414,132,utRho28
hchA,4071260,4071670,4071260,410,30,utRho28
hcp,1828258,1828258,1827628,630,796,utRho28
hcr,1824400,1824400,1824300,100,0,utRho28
hdeA,7313582,7313582,7313480,102,14,utRho28
hdeD,7313920,7313990,7313920,70,1468,utRho28
hdfR,7896320,7896320,7895934,386,170,utRho28
hdhA,3396244,3396244,3396080,164,66,utRho28
helD,2048876,2048942,2048876,66,24,utRho28
hemA,2527166,2527428,2527166,262,220,utRho28
hemB,779722,779722,779454,268,206,utRho28
hemF,5106410,5106450,5106410,40,12,utRho28
hemH,996062,996110,996062,48,36,utRho28
hemL,349882,349882,349764,118,80,utRho28
hemN,8103886,8104090,8103886,204,12,utRho28
hepA,127176,127176,126528,648,7898,utRho28
hflD,2385372,2385372,2385262,110,88,utRho28
hfq,8799602,8800576,8799602,974,3920,utRho28
hha,961006,961006,960616,390,0,utRho28
hicA,3018442,3018572,3018442,130,114,utRho28
higA,6468682,6468682,6468288,394,1122,utRho28
higB,6468960,6468960,6468910,50,84,utRho28
hinT,2323642,2323770,2323642,128,0,utRho28
hipB,3184964,3184964,3184884,80,52,utRho28
hisB,4186720,4186936,4186720,216,346,utRho28
hisJ,4853674,4853674,4853576,98,0,utRho28
hisL,8359856,8359984,8359856,128,856,utRho28
hisS,5281284,5281284,5281150,134,28,utRho28
hlpA,400910,400964,400910,54,146,utRho28
hlyE,2460932,2460932,2460788,144,266,utRho28
hmp,5371594,5371670,5371594,76,0,utRho28
hns,2585916,2585916,2585844,72,3800,utRho28
hofM,7045856,7045856,7045502,354,210,utRho28
hokA,7441620,7441620,7441200,420,520,utRho28
hokC,33902,33902,33806,96,302,utRho28
hokE,1215462,1215672,1215462,210,138,utRho28
holC,8968546,8968546,8968560,14,68,utRho28
holD,9215562,9215606,9215562,44,84,utRho28
holE,3850040,3850216,3850040,176,72,utRho28
hpt,282720,282862,282720,142,254,utRho28
hrpB,324150,324210,324150,60,56,utRho28
hscB,5319048,5319048,5318934,114,208,utRho28
hscC,1367188,1367188,1366786,402,538,utRho28
hsdS,9163004,9163004,9162924,80,982,utRho28
hslJ,2883560,2883560,2883486,74,384,utRho28
hslO,7059344,7059548,7059344,204,44818,utRho28
hslR,7058220,7058696,7058220,476,4268,utRho28
hslV,8244708,8244708,8244574,134,150,utRho28
hsrA,7881412,7881412,7881224,188,44,utRho28
htgA,21286,21660,21286,374,492,utRho28
htpG,989634,990240,989634,606,708,utRho28
htpX,3825236,3825236,3825152,84,32,utRho28
htrE,311036,311036,310852,184,470,utRho28
htrL,7587668,7587668,7587366,302,292,utRho28
hupA,8400352,8400562,8400352,210,20,utRho28
hupB,1845220,1845804,1845220,584,208,utRho28
hyaA,2063968,2064278,2063968,310,30,utRho28
hybO,6292726,6292726,6292522,204,432,utRho28
hycA,5700922,5700922,5700870,52,30,utRho28
hycI,5686204,5686204,5686086,118,640,utRho28
hydN,5676264,5676264,5676210,54,50,utRho28
hyfA,5202342,5202402,5202342,60,4,utRho28
hypA,11402508,11402588,11402508,80,536,utRho28
hypB,11403356,11404004,11403356,648,352,utRho28
hypF,5676210,5676210,5674850,1360,3750,utRho28
hypT,9116634,9116634,9116578,56,0,utRho28
hyuA,6019660,6020056,6019660,396,226,utRho28
iaaA,1733074,1733136,1733074,62,0,utRho28
iadA,9119074,9119074,9119052,22,126,utRho28
iap,5753072,5753162,5753072,90,90,utRho28
ibaG,6673966,6673966,6673606,360,68,utRho28
ibpA,7735036,7735036,7734844,192,5792,utRho28
ibpB,7733962,7733962,7733794,168,40700,utRho28
icd,2389922,2390246,2389922,324,30,utRho28
iclR,8447304,8447304,8447256,48,34,utRho28
idi,6065876,6066130,6065876,254,0,utRho28
idnD,8988870,8988870,8988812,58,60,utRho28
idnK,8989194,8989246,8989194,52,230,utRho28
ihfA,3591442,3591442,3591104,338,724,utRho28
ihfB,1927498,1927656,1927498,158,92,utRho28
ileS,43666,44782,43666,1116,1058,utRho28
ileX,6431194,6431196,6431194,2,26,utRho28
ilvA,15820940,15821324,15820940,384,740,utRho28
ilvC,7915824,7915940,7915824,116,204,utRho28
ilvE,15809552,15809936,15809552,384,232,utRho28
ilvI,170840,171260,170840,420,194,utRho28
ilvL,23701308,23701932,23701308,624,324,utRho28
ilvY,7915734,7915734,7915640,94,144,utRho28
inaA,4698998,4698998,4698944,54,110,utRho28
infA,1853370,1853370,1852886,484,370,utRho28
infC,3602692,3602692,3601276,1416,1700,utRho28
insA-5,3958452,3958452,3958430,22,18,utRho28
insA-7,9036758,9037054,9036758,296,478,utRho28
insC-5,6372080,6372284,6372080,204,242,utRho28
insEF-2,785238,785238,785820,582,376,utRho28
insEF-4,2190310,2190310,2190892,582,268,utRho28
insG,9007098,9007098,9006862,236,32,utRho28
insH-1,550596,550596,550234,362,602,utRho28
insH-11,7306538,7306538,7306396,142,240,utRho28
insH-2,1151548,1151548,1151506,42,304,utRho28
insH-3,1378444,1378444,1378026,418,196,utRho28
insH-4,2791942,2792152,2791942,210,12,utRho28
insH-5,2857852,2857852,2857452,400,132,utRho28
insH-6,4135022,4135022,4134642,380,478,utRho28
insH-7,4206186,4206186,4205822,364,4096,utRho28
insH-9,6260050,6260356,6260050,306,278,utRho28
insI-3,9017372,9017372,9017234,138,44,utRho28
insJ,7441188,7441360,7441188,172,62,utRho28
insK,7442130,7442308,7442130,178,20,utRho28
insL-1,30760,30890,30760,130,10130,utRho28
insL-2,1216112,1216130,1216112,18,230,utRho28
insL-3,5028644,5028662,5028644,18,198,utRho28
insN-1,540452,540484,540452,32,0,utRho28
intD,1132202,1132202,1131956,246,510,utRho28
intR,2826520,2826520,2826470,50,48,utRho28
intS,4933026,4933090,4933026,64,2,utRho28
intZ,5117386,5117542,5117386,156,262,utRho28
iraD,9113152,9113986,9113152,834,192,utRho28
iraM,2424246,2424246,2424006,240,116,utRho28
iraP,802638,802772,802638,134,0,utRho28
iscA,5319924,5319924,5319772,152,348,utRho28
iscR,5324398,5324398,5324262,136,3066,utRho28
iscX,5313834,5313834,5313472,362,372,utRho28
ispF,5743968,5743968,5743560,408,132,utRho28
ispG,5283908,5283908,5283608,300,0,utRho28
ispU,389568,389806,389568,238,132,utRho28
isrA,2811502,2811502,2811618,116,14,utRho28
istr-1,7706384,7706384,7706384,0,0,utRho28
istr-2,7706514,7706514,7706514,0,0,utRho28
ivbL,15412092,15412092,15411952,140,284,utRho28
ivy,480638,480686,480638,48,0,utRho28
katE,3627628,3627734,3627628,106,90,utRho28
katG,8267624,8267670,8267624,46,126,utRho28
kbaZ,6557732,6557828,6557732,96,24,utRho28
kbl,7585154,7585154,7585102,52,560,utRho28
kch,2621046,2621046,2620538,508,304,utRho28
kdgR,3820506,3820506,3820198,308,4,utRho28
kdpE,1443788,1443788,1443466,322,194,utRho28
kdpF,1457698,1457698,1457642,56,112,utRho28
kdsA,2535708,2536330,2535708,622,498,utRho28
kdsC,6683438,6684546,6683438,1108,3094,utRho28
kduI,5968388,5968388,5968248,140,256,utRho28
kefF,94160,94492,94160,332,2560,utRho28
kgtP,5451624,5451624,5451492,132,340,utRho28
kup,7862206,7862632,7862206,426,3150,utRho28
lacI,735076,735076,735020,56,92,utRho28
lacZ,1465508,1465508,1465220,288,500,utRho28
ldcA,2486394,2486394,2486160,234,352,utRho28
ldhA,2885830,2885830,2885686,144,114,utRho28
ldrA,2538954,2538954,2538550,404,990,utRho28
ldrB,2540024,2540024,2539620,404,220,utRho28
ldrC,2541092,2541092,2540690,402,278,utRho28
ldrD,7400544,7400544,7400174,370,346,utRho28
lepA,5414392,5414392,5414248,144,678,utRho28
lepB,5410928,5410928,5410618,310,2234,utRho28
leuD,159188,159188,158906,282,102,utRho28
leuE,3761600,3761600,3761518,82,142,utRho28
leuL,168048,168048,167416,632,120,utRho28
leuO,168308,168736,168308,428,94,utRho28
leuQ,9212864,9212864,9212802,62,2,utRho28
leuU,6644556,6644556,6644316,240,1904,utRho28
leuV,9212546,9212546,9212330,216,762,utRho28
leuX,8992772,8992810,8992772,38,144,utRho28
lexA,8514174,8514230,8514174,56,422,utRho28
lhr,3456706,3458174,3456706,1468,706,utRho28
ligA,5060402,5060402,5060352,50,0,utRho28
ligB,7642576,7642576,7642340,236,76,utRho28
lipA,1320602,1320602,1320432,170,256,utRho28
lipB,1324802,1324802,1324556,246,5252,utRho28
lit,2397032,2397390,2397032,358,320,utRho28
livJ,7199524,7199524,7199316,208,2186,utRho28
livK,7195510,7195510,7195120,390,1026,utRho28
lldP,7554578,7554798,7554578,220,198,utRho28
lnt,1381968,1381968,1381762,206,534,utRho28
loiP,6163784,6163826,6163784,42,0,utRho28
lolA,1874656,1874738,1874656,82,54,utRho28
lolB,2527112,2527112,2527000,112,132,utRho28
lolC,2350748,2350854,2350748,106,0,utRho28
lon,917630,917776,917630,146,500,utRho28
lpcA,486936,487086,486936,150,0,utRho28
lpd,255434,255824,255434,390,628,utRho28
lplA,9248476,9248476,9248234,242,346,utRho28
lplT,5947878,5947878,5947724,154,20,utRho28
lpoA,6586422,6586800,6586422,378,462,utRho28
lpp,3514592,3514842,3514592,250,172,utRho28
lptA,6686598,6686760,6686598,162,88,utRho28
lptB,6686792,6687888,6686792,1096,1024,utRho28
lptD,114672,114672,114218,454,216,utRho28
lptF,8972244,8972436,8972244,192,118,utRho28
lpxC,213016,213114,213016,98,1442,utRho28
lpxD,401920,401942,401920,22,0,utRho28
lpxL,2233418,2233418,2233164,254,78,utRho28
lpxM,3880456,3880456,3880386,70,74,utRho28
lpxP,4991156,4991290,4991156,134,180,utRho28
lrhA,4813312,4813312,4813282,30,4,utRho28
lrp,1864656,1865190,1864656,534,278,utRho28
lspA,50028,50414,50028,386,352,utRho28
lsrA,3202920,3202980,3202920,60,28,utRho28
lsrR,3202514,3202514,3202482,32,178,utRho28
ltaE,1818640,1818640,1818588,52,0,utRho28
luxS,5630130,5630130,5629466,664,612,utRho28
lysA,5957902,5957902,5957798,104,94,utRho28
lysC,8467232,8467232,8466466,766,276,utRho28
lysP,4497120,4497120,4497064,56,308,utRho28
lysR,5957900,5958042,5957900,142,0,utRho28
lysT,1561028,1561108,1561028,80,150,utRho28
lysU,8709610,8709610,8709434,176,176,utRho28
macB,1840188,1840694,1840188,506,370,utRho28
maeA,3111484,3111484,3111338,146,346,utRho28
mak,820236,820288,820236,52,200,utRho28
malE,8492928,8492928,8492838,90,42,utRho28
malI,3398456,3398456,3398360,96,46,utRho28
malK,8493472,8493568,8493472,96,170,utRho28
malP,7105020,7105020,7104946,74,380,utRho28
malQ,7100798,7100798,7100140,658,90,utRho28
malS,14949880,14949988,14949880,108,212,utRho28
malT,7106048,7106170,7106048,122,16,utRho28
malX,3398626,3398710,3398626,84,8,utRho28
malZ,1689980,1690072,1689980,92,48,utRho28
manA,3377102,3377152,3377102,50,102,utRho28
manX,3803866,3804096,3803866,230,188,utRho28
marC,3237882,3237882,3237816,66,190,utRho28
marR,3238186,3238240,3238186,54,82,utRho28
matP,2036918,2036970,2036918,52,0,utRho28
mazE,5822736,5822736,5822678,58,58,utRho28
mazG,5821720,5821720,5821370,350,1226,utRho28
mcbA,1684306,1684306,1684112,194,212,utRho28
mcbR,3040192,3040524,3040192,332,24,utRho28
mcrA,2420278,2420692,2420278,414,172,utRho28
mcrC,9156124,9156124,9155916,208,696,utRho28
mdaB,6344814,6345060,6344814,246,66,utRho28
mdfA,1767138,1767346,1767138,208,462,utRho28
mdh,6768940,6768940,6768536,404,120,utRho28
mdoB,9198988,9198988,9198882,106,514,utRho28
mdoD,2993290,2993712,2993290,422,26,utRho28
mdoG,2218514,2218670,2218514,156,150,utRho28
mdtA,4307958,4308032,4307958,74,24,utRho28
mdtE,7318168,7318464,7318168,296,1652,utRho28
mdtK,3486538,3486914,3486538,376,360,utRho28
mdtP,8602472,8602472,8602060,412,798,utRho28
melA,8683774,8683822,8683774,48,0,utRho28
melR,8683300,8683300,8683256,44,242,utRho28
menA,8240812,8240812,8240698,114,122,utRho28
menB,4753774,4753774,4753638,136,0,utRho28
mepH,3468714,3468870,3468714,156,0,utRho28
mepM,3883666,3883666,3883270,396,144,utRho28
mepS,4539840,4539958,4539840,118,128,utRho28
metA,8428318,8428560,8428318,242,16,utRho28
metB,8257272,8257344,8257272,72,368,utRho28
metC,6304150,6304472,6304150,322,370,utRho28
metE,8025768,8026106,8025768,338,64,utRho28
metF,8265092,8265232,8265092,140,14,utRho28
metG,4388538,4388600,4388538,62,58,utRho28
metH,8447010,8447656,8447010,646,1240,utRho28
metJ,8257116,8257116,8256790,326,160,utRho28
metK,6173154,6173412,6173154,258,232,utRho28
metN,445428,445428,445290,138,8,utRho28
metR,8025710,8025710,8025632,78,0,utRho28
metT,1394326,1394326,1394266,60,38,utRho28
metY,19910250,19910250,19909734,516,1350,utRho28
metZ,11789528,11789548,11789528,20,76,utRho28
mfd,2348056,2348056,2347928,128,36,utRho28
mglA,4478782,4478782,4478578,204,152,utRho28
mglB,4481132,4481132,4480696,436,7290,utRho28
mglC,4475918,4475918,4475506,412,150,utRho28
mgrB,3817584,3817584,3817532,52,30,utRho28
mgrR,3245828,3245828,3245828,0,0,utRho28
mgsA,2054082,2054082,2054030,52,170,utRho28
mgtL,8934560,8934862,8934560,302,194,utRho28
mhpA,737038,737222,737038,184,250,utRho28
mhpR,737072,737072,736840,232,164,utRho28
mhpT,750772,750918,750772,146,0,utRho28
miaA,8797964,8798504,8797964,540,202,utRho28
micA,5629604,5629604,5629604,0,0,utRho28
micC,2874242,2874238,2874242,4,0,utRho28
micF,4626168,4626168,4626168,0,0,utRho28
micM,1014408,1014408,1014408,0,0,utRho28
minE,2449422,2449422,2449090,332,62,utRho28
mioC,7852950,7852950,7852910,40,0,utRho28
mipA,3733012,3733012,3732944,68,594,utRho28
mlaA,4930270,4930270,4930014,256,54,utRho28
mlc,3337206,3337206,3337128,78,134,utRho28
mlrA,4429498,4429732,4429498,234,64,utRho28
mltA,5894546,5894546,5894356,190,58,utRho28
mltD,468050,468050,467910,140,144,utRho28
mltF,5391534,5391602,5391534,68,88,utRho28
mmuP,550238,550650,550238,412,656,utRho28
mngA,1531622,1531968,1531622,346,0,utRho28
mngR,1531852,1531852,1531750,102,0,utRho28
mnmG,7851348,7851348,7851266,82,342,utRho28
mntH,5025470,5025470,5025412,58,84,utRho28
mntP,3810918,3811376,3810918,458,208,utRho28
mntR,1706160,1706366,1706160,206,0,utRho28
mntS,1706128,1706128,1705994,134,0,utRho28
moaA,1633654,1634088,1633654,434,178,utRho28
moaB,1635954,1636110,1635954,156,192,utRho28
mobA,8084242,8084242,8083998,244,0,utRho28
mocA,6030112,6030320,6030112,208,74,utRho28
modA,1589990,1590178,1589990,188,88,utRho28
moeA,1732788,1732788,1732728,60,16,utRho28
mokB,2984610,2984610,2984258,352,50,utRho28
molR_1,4392888,4392948,4392888,60,10,utRho28
motA,3954604,3954604,3954278,326,48,utRho28
mpaA,2781278,2781278,2781196,82,412,utRho28
mpl,8911456,8911570,8911456,114,102,utRho28
mppA,2786108,2786454,2786108,346,20,utRho28
mprA,5621494,5621540,5621494,46,86,utRho28
mqo,4613848,4613848,4613508,340,0,utRho28
mqsA,6336742,6336742,6336492,250,412,utRho28
mqsR,6337306,6337306,6337088,218,1028,utRho28
mraZ,179192,179268,179192,76,392,utRho28
mrcA,7045652,7045742,7045652,90,74,utRho28
mrcB,329442,329460,329442,18,0,utRho28
mreB,13605424,13605424,13604348,1076,1028,utRho28
mreD,6798166,6798166,6797750,416,86,utRho28
mrp,4388360,4388360,4388336,24,2,utRho28
mscK,972984,973072,972984,88,182,utRho28
mscL,6876002,6876048,6876002,46,552,utRho28
mscS,6139742,6139742,6139614,128,76,utRho28
msrA,8884522,8884522,8884352,170,1494,utRho28
msrB,3725168,3725168,3724858,310,76,utRho28
msyB,2228426,2228426,2228362,64,252,utRho28
mtfA,4087236,4087302,4087236,66,10,utRho28
mtgA,6699662,6699662,6699618,44,608,utRho28
mtlA,30177504,30178248,30177504,744,7496,utRho28
mtn,358366,358366,358306,60,232,utRho28
mtr,6611864,6611864,6611634,230,84,utRho28
mug,6430992,6430992,6430946,46,2024,utRho28
murQ,5091466,5091546,5091466,80,176,utRho28
murR,5091586,5091586,5091218,368,498,utRho28
mutH,5939164,5939324,5939164,160,506,utRho28
mutL,8794092,8794824,8794092,732,442,utRho28
mutM,7622554,7622554,7622304,250,300,utRho28
mutS,5714038,5714186,5714038,148,974,utRho28
mutY,18617466,18618078,18617466,612,192,utRho28
nac,4123956,4123956,4123866,90,0,utRho28
nadA,1564122,1564170,1564122,48,0,utRho28
nadB,5420714,5420840,5420714,126,0,utRho28
nadC,237326,237326,237290,36,92,utRho28
nadE,3644604,3644916,3644604,312,110,utRho28
nadK,5501526,5501662,5501526,136,90,utRho28
nagA,1406350,1406350,1405502,848,854,utRho28
nagB,1407416,1407416,1407222,194,0,utRho28
nagC,1404016,1404016,1403188,828,16,utRho28
nagE,1407680,1407888,1407680,208,376,utRho28
nagK,2357080,2357186,2357080,106,94,utRho28
nanA,6747240,6747240,6747152,88,268,utRho28
nanC,9079856,9079856,9079002,854,612,utRho28
nanR,6749406,6749406,6748978,428,1158,utRho28
nanS,9075406,9075406,9075188,218,94,utRho28
napF,4607390,4607390,4606994,396,84,utRho28
narG,2559614,2559728,2559614,114,248,utRho28
narK,2555642,2555914,2555642,272,526,utRho28
narP,4580844,4581000,4580844,156,88,utRho28
narQ,5171154,5171462,5171154,308,440,utRho28
narU,3088326,3088326,3088120,206,548,utRho28
narW,3077374,3077374,3074618,2756,1188,utRho28
narX,2555554,2555554,2555236,318,470,utRho28
narZ,3085380,3085380,3085180,200,0,utRho28
ndh,2331984,2332170,2331984,186,960,utRho28
ndk,5289920,5289920,5289728,192,80,utRho28
nemR,6904084,6904092,6904084,8,392,utRho28
nepI,7683542,7683542,7683478,64,104,utRho28
nfo,4501612,4501680,4501612,68,74,utRho28
nfsB,1210906,1210906,1210848,58,0,utRho28
nfuA,7090916,7091248,7090916,332,692,utRho28
nhaA,34634,34978,34634,344,316,utRho28
nhaB,2469534,2469534,2469434,100,0,utRho28
nhoA,3067926,3068048,3067926,122,8,utRho28
nikA,7226878,7227334,7226878,456,670,utRho28
nikR,7237074,7237176,7237074,102,46,utRho28
nirB,6987974,6988022,6987974,48,2,utRho28
nlpA,7680034,7680034,7679986,48,68,utRho28
nlpC,3585654,3585654,3585462,192,38,utRho28
nlpD,5737658,5737658,5737506,152,52,utRho28
nlpI,6618080,6618080,6617848,232,182,utRho28
nmpC,1153740,1153740,1153650,90,136,utRho28
nohA,3273206,3273206,3272734,472,330,utRho28
norR,5664614,5664614,5664578,36,116,utRho28
norV,5664878,5664952,5664878,74,16,utRho28
nrdA,4689510,4689730,4689510,220,8548,utRho28
nrdD,8925676,8925676,8925320,356,244,utRho28
nrdH,5601312,5601446,5601312,134,528,utRho28
nrdR,865954,866004,865954,50,20,utRho28
nrfA,8575342,8575528,8575342,186,74,utRho28
nsrR,8812088,8812380,8812088,292,144,utRho28
nudB,3897348,3897348,3897264,84,0,utRho28
nudC,8393428,8393806,8393428,378,2,utRho28
nudE,7052658,7052658,7052298,360,18,utRho28
nudG,3682876,3682980,3682876,104,0,utRho28
nudI,4729050,4729108,4729050,58,46,utRho28
nudJ,2388874,2388874,2388576,298,122,utRho28
nuoA,4810670,4810670,4810144,526,5662,utRho28
nuoN,4783434,4783434,4783010,424,414,utRho28
nupC,5026018,5026084,5026018,66,2,utRho28
nupG,6211302,6211428,6211302,126,64,utRho28
ogrK,4335096,4335096,4335040,56,0,utRho28
ogt,2800568,2800568,2800472,96,262,utRho28
ohsC,5401036,5401040,5401036,4,60,utRho28
ompA,2040382,2040382,2040106,276,5130,utRho28
ompC,4625774,4625774,4625498,276,244,utRho28
ompF,1974184,1974184,1973964,220,140,utRho28
ompL,8128958,8128958,8128590,368,276,utRho28
ompN,2874158,2874158,2873786,372,34,utRho28
ompR,7073510,7073510,7073168,342,0,utRho28
ompT,1171330,1171330,1171266,64,78,utRho28
ompW,2627982,2628040,2627982,58,150,utRho28
ompX,1700418,1700900,1700418,482,1282,utRho28
omrA,5952378,5952378,5952378,0,0,utRho28
omrB,5952770,5952770,5952770,0,0,utRho28
oppA,2602170,2602364,2602170,194,426,utRho28
orn,8783168,8783208,8783168,40,102,utRho28
osmB,2686952,2686952,2686656,296,440,utRho28
osmC,3113192,3113250,3113192,58,292,utRho28
osmE,3644566,3644566,3644512,54,90,utRho28
osmF,4439046,4439046,4438962,84,92,utRho28
osmY,9222306,9222792,9222306,486,34,utRho28
otsA,3963302,3963302,3963224,78,38,utRho28
otsB,3964930,3964930,3964774,156,322,utRho28
oxc,4984288,4984288,4983900,388,518,utRho28
oxyR,8316914,8316980,8316914,66,84,utRho28
oxyS,8316788,8316788,8316788,0,0,utRho28
paaA,2907730,2907854,2907730,124,0,utRho28
paaX,2927018,2927078,2927018,60,32,utRho28
paaZ,2907340,2907340,2907284,56,22,utRho28
pabA,6981702,6981702,6981658,44,166,utRho28
pabB,3789256,3789610,3789256,354,190,utRho28
pabC,2306186,2306600,2306186,414,310,utRho28
pagP,1313052,1313114,1313052,62,38,utRho28
panB,299260,299260,299202,58,1430,utRho28
panC,297840,297840,297590,250,200,utRho28
panD,293490,293490,293388,102,136,utRho28
panZ,7195656,7195968,7195656,312,284,utRho28
parC,6332060,6332060,6331946,114,34,utRho28
patA,6438916,6438988,6438916,72,280,utRho28
patD,3030830,3031156,3030830,326,154,utRho28
pbpC,5294986,5294986,5294650,336,88,utRho28
pbpG,4450132,4450132,4449740,392,0,utRho28
pck,7065358,7065636,7065358,278,2484,utRho28
pcnB,318782,318782,318252,530,286,utRho28
pdhR,244068,244184,244068,116,22,utRho28
pdxB,4875768,4875768,4875702,66,76,utRho28
pdxH,3436068,3436068,3436014,54,2,utRho28
pdxJ,5403626,5403626,5403458,168,444,utRho28
pdxK,5074638,5074638,5074474,164,0,utRho28
pepA,8972278,8972278,8971902,376,222,utRho28
pepD,511618,511618,511432,186,322,utRho28
pepN,1981182,1981244,1981182,62,1052,utRho28
pepQ,8062294,8062322,8062294,28,6,utRho28
pepT,2371646,2371688,2371646,42,2,utRho28
pfkA,8214948,8215104,8214948,156,138,utRho28
pfkB,3612646,3612740,3612646,94,8,utRho28
pflA,1902456,1902456,1902160,296,6,utRho28
pflB,1907850,1907850,1907108,742,322,utRho28
pflD,8287716,8287990,8287716,274,0,utRho28
pgaA,2185046,2185046,2184578,468,454,utRho28
pgi,8467444,8467516,8467444,72,44,utRho28
pgk,12291428,12291428,12290488,940,2548,utRho28
pgl,1597078,1597172,1597078,94,0,utRho28
pgpB,2678324,2678660,2678324,336,258,utRho28
pgpC,5397276,5397276,5397100,176,60,utRho28
pgrR,2783744,2783982,2783744,238,256,utRho28
pheL,5475158,5475198,5475158,40,0,utRho28
pheM,7197204,7197204,7197080,124,12,utRho28
pheP,1203858,1203918,1203858,60,0,utRho28
pheU,8725254,8725254,8725252,2,6,utRho28
pheV,6220730,6220732,6220730,2,12,utRho28
phnC,8650412,8650412,8650330,82,146,utRho28
phoA,803414,803494,803414,80,44,utRho28
phoB,834202,834284,834202,82,176,utRho28
phoE,520316,520316,520200,116,26,utRho28
phoH,2169730,2169984,2169730,254,0,utRho28
phoP,2381016,2381016,2380894,122,364,utRho28
phoQ,2379880,2379880,2379552,328,236,utRho28
phoU,7815330,7815330,7815156,174,188,utRho28
phr,1478842,1479014,1478842,172,108,utRho28
pinE,2419054,2419370,2419054,316,112,utRho28
pinQ,3267168,3267244,3267168,76,16,utRho28
pinR,2867424,2867424,2867348,76,16,utRho28
pitA,7275224,7275284,7275224,60,20,utRho28
pitB,6272806,6272806,6272742,64,156,utRho28
pka,5439862,5439906,5439862,44,16,utRho28
plaP,4174476,4174476,4174124,352,168,utRho28
pldA,8009628,8009724,8009628,96,822,utRho28
pldB,8018028,8018340,8018028,312,620,utRho28
plsB,8513196,8513196,8512932,264,146,utRho28
pmbA,8915890,8915918,8915890,28,0,utRho28
pmrD,4747148,4747148,4747076,72,0,utRho28
pncB,1980828,1980828,1980712,116,360,utRho28
pncC,5648788,5648788,5648692,96,44,utRho28
pnp,6622652,6622652,6622336,316,66,utRho28
pntA,3355950,3355950,3355806,144,50,utRho28
pntB,3353096,3353096,3352720,376,668,utRho28
polA,8093880,8093932,8093880,52,40,utRho28
polB,131606,131606,131560,46,0,utRho28
potD,2365700,2365700,2365658,42,56,utRho28
potE,1436688,1436688,1436530,158,66,utRho28
potF,1787268,1787568,1787268,300,64,utRho28
poxB,1822152,1822152,1822098,54,12,utRho28
ppa,8899372,8899372,8899304,68,86,utRho28
ppc,8306380,8306380,8306196,184,1228,utRho28
ppdA,5928440,5928440,5928354,86,0,utRho28
ppdD,235410,235410,235098,312,100,utRho28
pphA,3846770,3846770,3845938,832,826,utRho28
pphB,5719474,5719520,5719474,46,0,utRho28
ppiA,6984898,6984898,6984594,304,44,utRho28
ppiC,7919682,7919682,7919626,56,60,utRho28
ppiD,923638,923830,923638,192,104,utRho28
ppk,5245748,5246088,5245748,340,342,utRho28
pppA,6228958,6228958,6228704,254,30,utRho28
ppsA,3574322,3574322,3574224,98,0,utRho28
ppsR,3574678,3574890,3574678,212,4,utRho28
pptA,3065716,3066104,3065716,388,106,utRho28
pqiA,2023318,2024002,2023318,684,156,utRho28
prc,3830054,3830054,3829632,422,1598,utRho28
preT,4467978,4468066,4467978,88,134,utRho28
prfC,9218688,9218828,9218688,140,92,utRho28
prkB,6968622,6968980,6968622,358,252,utRho28
prlC,7290476,7290476,7290364,112,548,utRho28
prlF,6553944,6554004,6553944,60,474,utRho28
proB,520432,520776,520432,344,4,utRho28
proC,811372,811372,811288,84,14,utRho28
proK,7417388,7417388,7417384,4,24,utRho28
proL,4572414,4572422,4572414,8,34,utRho28
proP,8660640,8661004,8660640,364,404,utRho28
proS,437674,437674,437550,124,94,utRho28
proV,5609126,5609630,5609126,504,454,utRho28
prpB,697292,697364,697292,72,0,utRho28
prpR,696942,696942,696886,56,0,utRho28
prs,2524354,2524354,2523750,604,4040,utRho28
psd,8781276,8781276,8780720,556,966,utRho28
psiE,8480600,8480650,8480600,50,0,utRho28
pspA,2736076,2736158,2736076,82,26,utRho28
pspF,2736080,2736080,2735824,256,0,utRho28
pspG,8525632,8525680,8525632,48,0,utRho28
pssA,5445156,5445454,5445156,298,816,utRho28
pstB,7817112,7817112,7816732,380,58,utRho28
pstC,7821084,7821084,7820796,288,68,utRho28
pstS,23469408,23469408,23469150,258,180,utRho28
psuG,4517114,4517114,4516734,380,2226,utRho28
psuT,4514992,4514992,4514670,322,124,utRho28
pth,2517084,2517084,2517026,58,0,utRho28
ptrA,5918022,5918022,5917768,254,60,utRho28
ptrB,3857730,3857730,3857678,52,92,utRho28
ptsG,2315252,2315738,2315252,486,300,utRho28
ptsH,5066996,5067528,5066996,532,596,utRho28
purA,8809328,8809374,8809328,46,370,utRho28
purC,5195562,5195562,5195236,326,0,utRho28
purD,8411972,8411972,8411862,110,46,utRho28
purE,1106284,1106284,1106200,84,0,utRho28
purH,8415254,8415254,8415064,190,62,utRho28
purL,5391178,5391178,5391086,92,880,utRho28
purM,5242306,5242394,5242306,88,146,utRho28
purR,3475378,3475688,3475378,310,142,utRho28
purT,3861438,3861762,3861438,324,60,utRho28
purU,2577512,2577512,2577248,264,0,utRho28
putA,2157850,2157850,2157764,86,8,utRho28
putP,2158336,2158610,2158336,274,188,utRho28
puuA,2721936,2721936,2721816,120,0,utRho28
puuC,2725456,2725486,2725456,30,0,utRho28
puuD,2722104,2722240,2722104,136,0,utRho28
puuP,2718746,2718746,2718374,372,390,utRho28
pykA,3874988,3875298,3874988,310,74,utRho28
pykF,3510934,3511396,3510934,462,152,utRho28
pyrC,2245286,2245286,2245214,72,98,utRho28
pyrD,2009464,2009536,2009464,72,388,utRho28
pyrE,7631970,7631970,7631536,434,74,utRho28
pyrF,2683740,2683842,2683740,102,504,utRho28
pyrG,5819594,5819594,5819332,262,394,utRho28
pyrH,383624,383710,383624,86,518,utRho28
pyrL,8945490,8945490,8945066,424,306,utRho28
qmcA,1031646,1031646,1031546,100,228,utRho28
qor,8528608,8528608,8528462,146,130,utRho28
qseB,6339502,6339656,6339502,154,84,utRho28
queA,849970,850022,849970,52,50,utRho28
queE,5811212,5811212,5810836,376,88,utRho28
queF,5850642,5850696,5850642,54,194,utRho28
queG,8788184,8788184,8788134,50,888,utRho28
racC,2835630,2835630,2835526,104,0,utRho28
racR,2840898,2840898,2840482,416,242,utRho28
raiA,5474208,5474308,5474208,100,90,utRho28
rarD,8008594,8008594,8008356,238,654,utRho28
ravA,7862256,7862256,7862186,70,646,utRho28
rayT,495088,495274,495088,186,96,utRho28
rbn,4763162,4763216,4763162,54,0,utRho28
rbsD,7866644,7866702,7866644,58,116,utRho28
rcnA,4371654,4371834,4371654,180,196,utRho28
rcnB,4373768,4373920,4373768,152,54,utRho28
rcnR,4371806,4371806,4371592,214,436,utRho28
rcsA,4047672,4047936,4047672,264,262,utRho28
rcsB,4631390,4632354,4631390,964,264,utRho28
rcsC,4640162,4640162,4639656,506,26,utRho28
rcsD,4626904,4626976,4626904,72,62,utRho28
rdgB,6193240,6193362,6193240,122,116,utRho28
rdlA,2538646,2538646,2538646,0,0,utRho28
rdlB,2539712,2539716,2539712,4,0,utRho28
rdlC,2540782,2540786,2540782,4,0,utRho28
rdlD,7400272,7400272,7400272,0,0,utRho28
rdoA,8084782,8084830,8084782,48,22,utRho28
recA,11295276,11295276,11295076,200,416,utRho28
recC,5925014,5925014,5924856,158,16,utRho28
recF,7763722,7763722,7762442,1280,1210,utRho28
recN,5503518,5503590,5503518,72,0,utRho28
recQ,8011666,8011728,8011666,62,108,utRho28
relA,5828554,5828554,5827302,1252,342,utRho28
relB,3291806,3291806,3291744,62,46,utRho28
rem,3289950,3289950,3289804,146,20,utRho28
rep,7921294,7921354,7921294,60,8,utRho28
rfaD,7587730,7587974,7587730,244,1148,utRho28
rfaE,6393852,6393852,6393506,346,62,utRho28
rfaH,8049930,8049930,8049642,288,798,utRho28
rfbX,4219436,4219436,4219168,268,1076,utRho28
rfe,7935600,7935832,7935600,232,622,utRho28
rhaB,8194944,8194944,8194896,48,46,utRho28
rhaD,8188770,8188770,8188544,226,0,utRho28
rhaS,8195422,8195472,8195422,50,0,utRho28
rhaT,8201132,8201132,8201050,82,500,utRho28
rhlE,1661566,1661744,1661566,178,40,utRho28
rhoL,47593944,47594772,47593944,828,2040,utRho28
rhsB,7238006,7238384,7238006,378,0,utRho28
rhsC,1458758,1459166,1458758,408,4,utRho28
rhsD,1046132,1046522,1046132,390,346,utRho28
rhtA,1700608,1700608,1700194,414,1498,utRho28
rhtC,8015478,8015514,8015478,36,172,utRho28
ribA,2678468,2678468,2678320,148,130,utRho28
ribC,3486916,3486916,3486484,432,564,utRho28
ribE,869008,869294,869008,286,3140,utRho28
ribF,42766,42814,42766,48,120,utRho28
ridA,8941892,8941892,8941826,66,52,utRho28
rihA,1369204,1369204,1368824,380,392,utRho28
rihB,4510504,4510504,4510372,132,110,utRho28
rimJ,2251044,2251124,2251044,80,82,utRho28
rimK,1783752,1783934,1783752,182,60,utRho28
rimL,2997486,2997876,2997486,390,0,utRho28
rimO,1756140,1756140,1756070,70,66,utRho28
rimP,6636350,6636350,6636012,338,526,utRho28
rlmA,3814172,3814172,3814120,52,0,utRho28
rlmD,5830086,5830086,5830000,86,60,utRho28
rlmE,6655520,6655520,6655328,192,626,utRho28
rlmF,1684384,1684664,1684384,280,394,utRho28
rlmG,6471784,6471784,6471750,34,86,utRho28
rlmI,2060002,2060002,2059938,64,336,utRho28
rlmJ,7290700,7290770,7290700,70,128,utRho28
rlmL,2015344,2015688,2015344,344,482,utRho28
rlpA,1330444,1330444,1330380,64,70,utRho28
rluA,120900,120900,120692,208,278,utRho28
rluF,8460324,8460708,8460324,384,0,utRho28
rmf,2031006,2031430,2031006,424,68,utRho28
rna,1290068,1290068,1290006,62,0,utRho28
rnb,2698258,2698258,2697824,434,446,utRho28
rnc,10816892,10816892,10816252,640,49580,utRho28
rnd,3776122,3776122,3775982,140,0,utRho28
rne,2289746,2289746,2288734,1012,1944,utRho28
rnhA,472082,472082,472004,78,740,utRho28
rnk,1288360,1288360,1287934,426,142,utRho28
rnlA,5531788,5531836,5531788,48,300,utRho28
rnlB,5533414,5533968,5533414,554,1068,utRho28
rnpB,19623552,19623552,19623552,0,0,utRho28
rob,9270706,9270706,9270620,86,8,utRho28
rodZ,5285868,5285868,5285688,180,78,utRho28
rpe,7030306,7030306,7030118,188,94,utRho28
rph,15266320,15266320,15266196,124,200,utRho28
rpiA,6118706,6118706,6118650,56,22,utRho28
rpiB,8626514,8626700,8626514,186,454,utRho28
rpiR,8626274,8626274,8625982,292,36,utRho28
rplJ,8359246,8359992,8359246,746,4402,utRho28
rplK,8356708,8356894,8356708,186,216,utRho28
rplM,6757344,6757344,6757302,42,1910,utRho28
rplN,6896444,6896444,6896298,146,878,utRho28
rplS,5489284,5489284,5489060,224,9346,utRho28
rplT,7199052,7199052,7198996,56,740,utRho28
rplU,6667036,6667036,6666902,134,46,utRho28
rplY,4564866,4565034,4564866,168,84,utRho28
rpmA,6666450,6666450,6666238,212,704,utRho28
rpmB,15247980,15247980,15246696,1284,35636,utRho28
rpmE,8253816,8254026,8253816,210,574,utRho28
rpmF,2294676,2294734,2294676,58,8680,utRho28
rpmH,7768130,7768672,7768130,542,1506,utRho28
rpmI,3600854,3600854,3599998,856,4470,utRho28
rpoB,8362126,8362490,8362126,364,68,utRho28
rpoD,6424946,6426094,6424946,1148,28932,utRho28
rpoE,5420372,5420372,5420024,348,10,utRho28
rpoH,7202006,7202006,7201566,440,1882,utRho28
rpoN,6689324,6689434,6689324,110,12,utRho28
rpoS,5736236,5736236,5735102,1134,1354,utRho28
rpoZ,7644154,7644212,7644154,58,62,utRho28
rppH,5937986,5937986,5937954,32,286,utRho28
rprA,3540744,3540744,3540744,0,0,utRho28
rpsA,1923434,1923990,1923434,556,23156,utRho28
rpsF,8850050,8850236,8850050,186,7028,utRho28
rpsI,6756580,6756580,6756414,166,4548,utRho28
rpsJ,6906884,6906884,6906540,344,1486,utRho28
rpsL,6949242,6949242,6949104,138,772,utRho28
rpsM,6885130,6885130,6884942,188,640,utRho28
rpsO,13247144,13247144,13246736,408,160,utRho28
rpsP,5492508,5492508,5492370,138,114,utRho28
rpsT,42420,42420,42156,264,158,utRho28
rpsU,12842584,12843124,12842584,540,5232,utRho28
rraA,8238716,8238716,8238660,56,280,utRho28
rraB,8956768,8956946,8956768,178,120,utRho28
rrsA,8070478,8071062,8070478,584,1408,utRho28
rrsB,16665468,16666636,16665468,1168,2588,utRho28
rrsC,7883032,7883616,7883032,584,802,utRho28
rrsD,6858094,6858094,6857524,570,772,utRho28
rrsE,8415726,8416294,8415726,568,832,utRho28
rrsG,5462896,5462896,5462314,582,834,utRho28
rrsH,446970,447542,446970,572,756,utRho28
rsd,8393908,8393908,8393616,292,102,utRho28
rseA,5419264,5419264,5418808,456,652,utRho28
rseP,392940,393092,392940,152,34,utRho28
rseX,4067298,4067298,4067298,0,0,utRho28
rsfS,1338144,1338144,1338072,72,188,utRho28
rsgA,8783132,8783132,8783018,114,2,utRho28
rsmA,105176,105176,104860,316,470,utRho28
rsmB,6869982,6870414,6869982,432,350,utRho28
rsmC,9215736,9215736,9215400,336,170,utRho28
rsmD,7208594,7208786,7208594,192,0,utRho28
rsmE,6182036,6182268,6182036,232,52,utRho28
rsmG,7847512,7847512,7847360,152,190,utRho28
rsmH,180020,180188,180020,168,54,utRho28
rsmI,6587106,6587106,6586670,436,786,utRho28
rssA,2578212,2578412,2578212,200,92,utRho28
rssB,2580440,2580484,2580440,44,74,utRho28
rstA,3364276,3364300,3364276,24,0,utRho28
rsuA,4561096,4561096,4560966,130,128,utRho28
rsxA,3411510,3411534,3411510,24,118,utRho28
rtcA,7114004,7114004,7113698,306,730,utRho28
rtcB,7116214,7116214,7116158,56,66,utRho28
rtn,4541356,4541452,4541356,96,0,utRho28
rutA,2148052,2148052,2148022,30,0,utRho28
rutG,2140090,2140090,2139678,412,70,utRho28
rutR,2148226,2148484,2148226,258,184,utRho28
ruvA,7784096,7784096,7783904,192,0,utRho28
ruvB,7782176,7782176,7781424,752,40,utRho28
ruvC,3894878,3894878,3894752,126,52,utRho28
rybB,1776114,1776114,1776114,0,0,utRho28
rydB,3529860,3529860,3529322,538,110,utRho28
rydC,2983012,2983012,2983012,0,0,utRho28
ryfA,5307398,5307710,5307398,312,50,utRho28
ryfD,5468590,5468590,5468590,0,0,utRho28
ryhB,7162032,7162032,7162032,0,0,utRho28
ryjA,8556132,8556132,8556132,0,0,utRho28
ryjB,9055954,9055954,9055954,0,0,utRho28
sad,3229598,3229598,3229406,192,194,utRho28
safA,3168056,3168056,3167918,138,52,utRho28
sanA,4465368,4465756,4465368,388,10,utRho28
sapF,2705314,2705314,2705268,46,0,utRho28
sbcB,4165456,4165512,4165456,56,0,utRho28
sbcC,831694,831694,831506,188,0,utRho28
sbcD,833954,833954,833904,50,74,utRho28
sbmA,793106,793278,793106,172,936,utRho28
sbmC,4162650,4162650,4162524,126,0,utRho28
sdaA,3793618,3793864,3793618,246,460,utRho28
sdaC,5856070,5856458,5856070,388,16824,utRho28
sdhC,1509916,1510354,1509916,438,5774,utRho28
sdhD,1510808,1511120,1510808,312,442,utRho28
sdiA,3993834,3993834,3993664,170,168,utRho28
secE,8354354,8354716,8354354,362,458,utRho28
secG,6645180,6645180,6645010,170,214,utRho28
selA,7522594,7522594,7522498,96,166,utRho28
selB,7519850,7519850,7519722,128,190,utRho28
selC,7672396,7672444,7672396,48,114,utRho28
selD,3696058,3696058,3696016,42,278,utRho28
seqA,1425884,1425974,1425884,90,0,utRho28
serA,6117098,6117098,6116820,278,70,utRho28
serB,9249712,9249790,9249712,78,0,utRho28
serC,3830380,3830612,3830380,232,272,utRho28
serS,1878730,1878856,1878730,126,660,utRho28
serT,2063438,2063438,2063424,14,4,utRho28
serU,4087124,4087124,4087114,10,0,utRho28
serV,5637394,5637394,5637290,104,50,utRho28
serW,1852014,1852014,1851942,72,294,utRho28
serX,2195352,2195352,2195304,48,24,utRho28
setB,4527426,4527726,4527426,300,4,utRho28
setC,7673488,7673906,7673488,418,330,utRho28
sfmA,1116124,1116424,1116124,300,254,utRho28
sfmC,1117606,1117948,1117606,342,254,utRho28
sfsA,323030,323030,322972,58,70,utRho28
sfsB,6669592,6669818,6669592,226,26,utRho28
sgrR,154676,154676,154598,78,358,utRho28
sgrS,154734,154734,154734,0,0,utRho28
shiA,4107068,4107286,4107068,218,62,utRho28
sibA,4306622,4306622,4306622,0,0,utRho28
sibB,4307292,4307292,4307292,0,0,utRho28
sibC,6113702,6113702,6113702,0,0,utRho28
sibD,6389730,6389730,6389730,0,0,utRho28
sibE,6390480,6390480,6390480,0,0,utRho28
sixA,4913998,4913998,4913624,374,132,utRho28
slp,7307872,7307922,7307872,50,0,utRho28
slt,9261400,9261466,9261400,66,34,utRho28
slyA,3442028,3442028,3441648,380,10,utRho28
slyB,3439496,3439752,3439496,256,114,utRho28
slyD,6957398,6957398,6956994,404,356,utRho28
slyX,6954862,6955280,6954862,418,6838,utRho28
smf,6867372,6867372,6867120,252,472,utRho28
smpB,5509534,5509792,5509534,258,1002,utRho28
smrA,2811872,2811958,2811872,86,312,utRho28
smrB,4896872,4897212,4896872,340,184,utRho28
smtA,1946808,1947074,1946808,266,72,utRho28
sodA,8201518,8201620,8201518,102,792,utRho28
sodB,3470646,3470756,3470646,110,116,utRho28
sodC,3449358,3449358,3449310,48,0,utRho28
sohB,2658568,2658664,2658568,96,182,utRho28
sokB,2984232,2984238,2984232,6,24,utRho28
solA,2241218,2241218,2241172,46,10,utRho28
soxR,8554894,8554938,8554894,44,40,utRho28
soxS,8554846,8554846,8554766,80,0,utRho28
speA,6172096,6172096,6171822,274,966,utRho28
speB,6167892,6167892,6167594,298,34,utRho28
speC,6218350,6218350,6218310,40,0,utRho28
spf,8099798,8099798,8099798,0,0,utRho28
sppA,3697422,3697674,3697422,252,150,utRho28
spy,3651376,3651376,3651250,126,28,utRho28
sra,3112092,3112092,3111926,166,10,utRho28
sraB,2293178,2293178,2293178,0,0,utRho28
sraC,3846132,3846132,3846132,0,0,utRho28
srlA,5651582,5651664,5651582,82,658,utRho28
srlR,5657720,5658094,5657720,374,1342,utRho28
srmB,5425752,5425792,5425752,40,140,utRho28
sroA,151216,151216,151216,0,0,utRho28
sroG,6369436,6369436,6369436,0,0,utRho28
sroH,8380974,8380974,8380974,0,0,utRho28
ssb,8548022,8548250,8548022,228,26,utRho28
sseA,5304782,5304988,5304782,206,1898,utRho28
sspA,6755138,6755138,6754840,298,154,utRho28
ssrA,5511014,5511186,5511014,172,346,utRho28
ssrS,12223036,12223932,12223036,896,3548,utRho28
sstT,6479726,6479888,6479726,162,56,utRho28
ssuB,1988282,1988282,1988088,194,584,utRho28
ssuE,1995126,1995126,1995024,102,262,utRho28
sthA,8321604,8321604,8321580,24,150,utRho28
stpA,5597156,5597156,5596990,166,48,utRho28
sucA,3034344,3034824,3034344,480,132,utRho28
sufA,3528836,3528836,3528772,64,0,utRho28
sufE,3518962,3518962,3518580,382,218,utRho28
sugE,8753588,8753750,8753588,162,80,utRho28
sulA,2041894,2041894,2041838,56,8506,utRho28
syd,5850738,5850738,5850560,178,398,utRho28
symE,9159834,9159834,9159680,154,2,utRho28
symR,9159670,9159670,9159670,0,0,utRho28
tabA,8949566,8949724,8949566,158,24,utRho28
talA,5157140,5157332,5157140,192,0,utRho28
talB,16382,16476,16382,94,3134,utRho28
tam,3214442,3214692,3214442,250,918,utRho28
tamA,8884540,8884764,8884540,224,1592,utRho28
tar,3945432,3945432,3945382,50,0,utRho28
tas,5943138,5943194,5943138,56,68,utRho28
tatA,16087636,16087780,16087636,144,216,utRho28
tatE,1317742,1317894,1317742,152,24,utRho28
tauA,770410,770464,770410,54,66,utRho28
tdcA,6534186,6534186,6534130,56,132,utRho28
tdcG,6519652,6519652,6519298,354,416,utRho28
tdcR,6534380,6534760,6534380,380,302,utRho28
tdk,2586986,2587054,2586986,68,128,utRho28
tehA,3001072,3001146,3001072,74,38,utRho28
tesA,1039898,1039898,1039530,368,578,utRho28
tesB,950402,950402,950322,80,0,utRho28
tfaE,2418532,2418532,2418238,294,354,utRho28
tfaQ,3269912,3269912,3269770,142,110,utRho28
tff,379424,379256,379424,168,492,utRho28
tgt,852110,852274,852110,164,18,utRho28
thiD,4369346,4369346,4369032,314,148,utRho28
thiI,882936,883098,882936,162,2,utRho28
thiM,4370902,4370902,4370602,300,376,utRho28
thiQ,146170,146170,145854,316,3200,utRho28
thrL,592,760,592,168,256,utRho28
thrS,7210932,7210932,7210280,652,748,utRho28
thrU,8350762,8350776,8350762,14,516,utRho28
thrV,6847414,6847414,6847310,104,180010,utRho28
thrW,525682,525742,525682,60,172,utRho28
thyA,5930696,5930696,5930310,386,674,utRho28
tig,909986,910266,909986,280,448,utRho28
tisB,7706674,7707106,7706674,432,804,utRho28
tktA,6163414,6163414,6163270,144,244,utRho28
tktB,5158616,5159272,5158616,656,532,utRho28
tldD,6784368,6784368,6784056,312,0,utRho28
tmcA,5191876,5191876,5191718,158,244,utRho28
tnaC,15553644,15553740,15553644,96,180,utRho28
tolB,1555074,1555480,1555074,406,274,utRho28
tolC,6356008,6356230,6356008,222,62,utRho28
tomB,961588,961588,961416,172,72,utRho28
tonB,2622108,2622178,2622108,70,4,utRho28
topA,2661578,2662096,2661578,518,352,utRho28
torC,2116112,2116168,2116112,56,160,utRho28
torR,2115968,2115968,2115908,60,234,utRho28
torS,2112364,2112364,2112356,8,0,utRho28
torT,2112414,2112522,2112414,108,0,utRho28
tpiA,8223138,8223138,8223014,124,46,utRho28
tppB,3425342,3425538,3425342,196,396,utRho28
tpr,2574376,2574376,2574376,0,0,utRho28
tpx,2777688,2777688,2777622,66,562,utRho28
tqsA,3347780,3347826,3347780,46,66,utRho28
treA,2494850,2494850,2494752,98,106,utRho28
treB,8932420,8932420,8932360,60,158,utRho28
treF,7339102,7339184,7339102,82,30,utRho28
treR,8934694,8934694,8934492,202,130,utRho28
trg,2984878,2984940,2984878,62,4,utRho28
trkG,2847342,2847564,2847342,222,732,utRho28
trmA,8326590,8326590,8326540,50,16,utRho28
trpA,2634678,2634678,2634444,234,248,utRho28
trpC,2639888,2639888,2639570,318,0,utRho28
trpL,5292432,5292432,5292328,104,0,utRho28
trpR,9265408,9265520,9265408,112,18,utRho28
trpS,7027394,7027394,7027276,118,78,utRho28
trpT,7893560,7893914,7893560,354,97558,utRho28
trxA,7931294,7931522,7931294,228,1168,utRho28
trxB,1864156,1864156,1864100,56,40,utRho28
trxC,5437350,5437470,5437350,120,126,utRho28
tsaD,6421256,6421256,6421086,170,2510,utRho28
tsgA,6985038,6985136,6985038,98,104,utRho28
tsr,9182824,9183314,9182824,490,820,utRho28
tsx,864490,864490,864026,464,236,utRho28
ttcA,2823970,2823970,2823896,74,1560,utRho28
ttdA,6412848,6412926,6412848,78,0,utRho28
ttdR,6412760,6412760,6412512,248,812,utRho28
tufA,6943448,6943448,6942658,790,27704,utRho28
tus,3368346,3368518,3368346,172,70,utRho28
tusA,7218040,7218040,7217992,48,236,utRho28
tusB,6950218,6950218,6949930,288,202,utRho28
tynA,2902996,2902996,2902698,298,0,utRho28
typA,8116460,8116814,8116460,354,558,utRho28
tyrB,8534164,8534228,8534164,64,156,utRho28
tyrP,3979004,3979362,3979004,358,110,utRho28
tyrR,2773384,2773440,2773384,56,70,utRho28
tyrS,3434566,3434566,3434444,122,0,utRho28
tyrT,2575330,2575330,2575244,86,12,utRho28
uacT,6062378,6062734,6062378,356,490,utRho28
ubiC,8504886,8505012,8504886,126,92,utRho28
ubiD,8049618,8049976,8049618,358,902,utRho28
ubiE,8037494,8037710,8037494,216,48,utRho28
ubiG,4679078,4679134,4679078,56,0,utRho28
ucpA,5089342,5089342,5089246,96,270,utRho28
udp,8032782,8032862,8032782,80,142,utRho28
ugd,4199470,4199470,4199226,244,0,utRho28
ugpB,7184852,7184852,7184650,202,1560,utRho28
ugpQ,7176600,7176600,7176226,374,134,utRho28
uhpT,7694396,7694396,7694334,62,26,utRho28
uidA,3392304,3392304,3392142,162,0,utRho28
uidC,3386012,3386012,3385702,310,0,utRho28
uidR,3394150,3394150,3394104,46,0,utRho28
ulaA,8839854,8839960,8839854,106,162,utRho28
ulaG,8839350,8839350,8839250,100,40,utRho28
ulaR,8837124,8837124,8836906,218,46,utRho28
umpG,5741372,5741372,5740548,824,92,utRho28
umpH,1400704,1400704,1400652,52,12,utRho28
umuD,2461476,2461534,2461476,58,0,utRho28
ung,5433476,5433508,5433476,32,22,utRho28
uof,2843316,2843316,2842900,416,740,utRho28
upp,5241818,5241818,5241744,74,98,utRho28
usg,4873780,4873780,4873298,482,404,utRho28
ushA,1009772,1009828,1009772,56,120,utRho28
uspA,7279966,7280222,7279966,256,484,utRho28
uspB,7279696,7279696,7279440,256,84,utRho28
uspC,3959172,3959506,3959172,334,104,utRho28
uspE,2797318,2797318,2797244,74,0,utRho28
uspF,2871282,2871282,2871238,44,290,utRho28
uspG,1283806,1283806,1283734,72,184,utRho28
uvrA,8547872,8547872,8547742,130,224,utRho28
uvrB,1626304,1627052,1626304,748,120,utRho28
uvrC,3989758,3989758,3989412,346,0,utRho28
uvrD,7995814,7995966,7995814,152,52,utRho28
uvrY,3990812,3990812,3990718,94,156,utRho28
uxaB,3221474,3221474,3221360,114,0,utRho28
uxaC,6489714,6489714,6489482,232,0,utRho28
uxuA,9103036,9103272,9103036,236,282,utRho28
uxuR,9108916,9109152,9108916,236,70,utRho28
valS,8967854,8967854,8967674,180,350,utRho28
valU,5041848,5041862,5041848,14,0,utRho28
valV,3492830,3492870,3492830,40,28,utRho28
ves,3649968,3649968,3649874,94,6,utRho28
waaA,7616512,7617080,7616512,568,856,utRho28
waaH,7580298,7580298,7580162,136,58,utRho28
waaQ,7616476,7616476,7616196,280,736,utRho28
waaU,7598996,7598996,7598624,372,138,utRho28
waaY,7602272,7602272,7601930,342,9234,utRho28
wbbH,4214888,4214888,4214452,436,2770,utRho28
wbbK,4209212,4209212,4209018,194,402,utRho28
wcaM,4231868,4231868,4231792,76,0,utRho28
wrbA,2135516,2135516,2135416,100,6,utRho28
wza,4275166,4275166,4274486,680,180,utRho28
wzxC,4240674,4240674,4240316,358,56,utRho28
wzzB,4196950,4196950,4196602,348,146,utRho28
xanP,7657642,7657890,7657642,248,124,utRho28
xanQ,6048520,6048702,6048520,182,98,utRho28
xapA,5049820,5049820,5049756,64,0,utRho28
xapR,10090252,10090252,10089908,344,12,utRho28
xdhA,6000514,6000690,6000514,176,570,utRho28
xerD,6079702,6079702,6079486,216,384,utRho28
xseA,5268394,5268464,5268394,70,146,utRho28
xseB,882746,882746,882686,60,0,utRho28
xthA,3664798,3664856,3664798,58,0,utRho28
xylA,7461614,7461614,7461530,84,2124,utRho28
xylE,8484540,8484540,8484508,32,0,utRho28
xylF,7462138,7462262,7462138,124,592,utRho28
xylR,7469812,7469958,7469812,146,0,utRho28
yaaA,13230,13230,12918,312,36,utRho28
yaaI,23876,23876,23572,304,148,utRho28
yaaJ,16034,16034,15918,116,32,utRho28
yaaU,91184,91614,91184,430,896,utRho28
yaaW,23084,23084,22712,372,226,utRho28
yaaX,10060,10468,10060,408,42,utRho28
yabI,142542,142702,142542,160,0,utRho28
yacC,273880,273880,273834,46,118,utRho28
yacH,262932,262932,262520,412,80,utRho28
yacL,268678,268776,268678,98,164,utRho28
yadD,293796,293936,293796,140,0,utRho28
yadE,289930,290162,289930,232,246,utRho28
yadN,314110,314110,313766,344,28,utRho28
yadS,355572,355572,355248,324,492,utRho28
yadV,312470,312470,312402,68,492,utRho28
yaeF,434270,434270,434006,264,8,utRho28
yaeP,428374,428374,428250,124,110,utRho28
yaeQ,428176,428582,428176,406,188,utRho28
yaeR,423716,423754,423716,38,18,utRho28
yafC,462166,462166,461762,404,218,utRho28
yafD,462128,462244,462128,116,232,utRho28
yafK,491986,491986,491610,376,280,utRho28
yafL,493282,493424,493282,142,166,utRho28
yafN,503938,504010,503938,72,78,utRho28
yafS,469568,469632,469568,64,268,utRho28
yafT,474470,474670,474470,200,222,utRho28
yafV,480432,480432,480378,54,150,utRho28
yafZ,536052,536052,536010,42,0,utRho28
yagE,564446,564556,564446,110,0,utRho28
yagG,570414,570790,570414,376,56,utRho28
yagI,578384,578384,578324,60,16,utRho28
yagK,586236,586236,585896,340,408,utRho28
yagL,588062,588062,587836,226,234,utRho28
yagN,591342,591342,591158,184,18,utRho28
yahA,663746,664742,663746,996,3422,utRho28
yahC,670136,670136,670044,92,348,utRho28
yahE,671478,671850,671478,372,776,utRho28
yahM,690504,690808,690504,304,534,utRho28
yahN,692872,692872,692674,198,1026,utRho28
yahO,692864,692968,692864,104,756,utRho28
yaiE,816296,816354,816296,58,118,utRho28
yaiI,811396,811528,811396,132,14,utRho28
yaiO,761946,761946,761684,262,346,utRho28
yaiP,767970,767970,767870,100,0,utRho28
yaiS,769660,769660,769232,428,68,utRho28
yaiV,788922,788922,788922,0,0,utRho28
yaiY,799094,799094,798666,428,82,utRho28
yaiZ,798888,799186,798888,298,242,utRho28
yajC,854410,854574,854410,164,200,utRho28
yajD,860938,861210,860938,272,56,utRho28
yajI,866068,866068,865702,366,72,utRho28
yajL,887496,887496,887282,214,292,utRho28
yajQ,889316,889366,889316,50,116,utRho28
yajR,893374,893374,893332,42,56,utRho28
ybaB,987418,988152,987418,734,420,utRho28
ybaL,1006590,1006590,1006476,114,46,utRho28
ybaM,980648,980648,980542,106,186,utRho28
ybaN,981436,981764,981436,328,330,utRho28
ybaO,936704,936766,936704,62,0,utRho28
ybaP,1016568,1016568,1016160,408,336,utRho28
ybaQ,1016348,1016436,1016348,88,96,utRho28
ybaS,1023146,1023282,1023146,136,714,utRho28
ybaV,927504,927874,927504,370,40,utRho28
ybaY,950490,950758,950490,268,14,utRho28
ybbB,1062724,1062724,1062452,272,214,utRho28
ybbJ,1030154,1030154,1029718,436,444,utRho28
ybbL,1031784,1031838,1031784,54,12,utRho28
ybbN,1037136,1037136,1036558,578,652,utRho28
ybbO,1038658,1038658,1038298,360,532,utRho28
ybbY,1080718,1081130,1080718,412,116,utRho28
ybcH,1176140,1176140,1175962,178,94,utRho28
ybcI,1113264,1113264,1113106,158,406,utRho28
ybcJ,1114050,1114050,1113746,304,148,utRho28
ybcK,1137502,1137804,1137502,302,0,utRho28
ybcL,1141690,1141786,1141690,96,0,utRho28
ybcN,1144628,1144932,1144628,304,0,utRho28
ybcQ,1147548,1147912,1147548,364,76,utRho28
ybcW,1159610,1159760,1159610,150,0,utRho28
ybdD,1263982,1264364,1263982,382,342,utRho28
ybdF,1212106,1212106,1211772,334,0,utRho28
ybdH,1267048,1267048,1266954,94,42,utRho28
ybdJ,1212822,1212822,1212398,424,58,utRho28
ybdK,1215122,1215122,1214766,356,362,utRho28
ybdL,1267114,1267172,1267114,58,52,utRho28
ybdM,1271110,1271110,1270752,358,150,utRho28
ybdN,1273372,1273372,1273138,234,36,utRho28
ybdR,1283844,1284176,1283844,332,314,utRho28
ybeD,1325412,1325412,1325284,128,526,utRho28
ybeF,1323090,1323090,1322756,334,1066,utRho28
ybeL,1349986,1350036,1349986,50,86,utRho28
ybeQ,1353412,1353412,1353094,318,72,utRho28
ybeR,1353120,1353422,1353120,302,72,utRho28
ybeT,1358832,1358832,1358812,20,0,utRho28
ybeU,1358924,1359016,1358924,92,148,utRho28
ybeZ,1386938,1386938,1386834,104,308,utRho28
ybfA,1458074,1458268,1458074,194,388,utRho28
ybfE,1423878,1423878,1423796,82,148,utRho28
ybfF,1425692,1425692,1425604,88,180,utRho28
ybfH,1433282,1433282,1433194,88,106,utRho28
ybgA,1477840,1478002,1477840,162,70,utRho28
ybgC,1549288,1549504,1549288,216,78,utRho28
ybgD,1505916,1505916,1505590,326,3754,utRho28
ybgI,1485238,1485654,1485238,416,10,utRho28
ybgO,1498370,1498370,1497964,406,118,utRho28
ybgS,1570992,1570992,1570634,358,70,utRho28
ybhA,1597184,1597184,1596862,322,74,utRho28
ybhB,1616070,1616070,1615818,252,108,utRho28
ybhC,1614642,1614642,1614562,80,28,utRho28
ybhD,1601418,1601418,1601276,142,48,utRho28
ybhH,1601104,1601518,1601104,414,126,utRho28
ybhK,1633384,1633384,1633294,90,0,utRho28
ybhM,1641556,1641586,1641556,30,50,utRho28
ybhN,1645296,1645296,1644996,300,24,utRho28
ybhQ,1649202,1649260,1649202,58,136,utRho28
ybiA,1665920,1665920,1665900,20,0,utRho28
ybiI,1676968,1676968,1676912,56,238,utRho28
ybiO,1691328,1691328,1690960,368,100,utRho28
ybiP,1705252,1705252,1705194,58,0,utRho28
ybiS,1711572,1711572,1711488,84,30,utRho28
ybiT,1711894,1711926,1711894,32,0,utRho28
ybiU,1718212,1718212,1718122,90,0,utRho28
ybiV,1720176,1720176,1720056,120,4,utRho28
ybiW,1725566,1725566,1725212,354,3584,utRho28
ybiX,1678548,1678548,1678414,134,784,utRho28
ybjC,1781784,1781826,1781784,42,0,utRho28
ybjE,1830154,1830154,1829714,440,460,utRho28
ybjG,1767016,1767016,1766776,240,676,utRho28
ybjL,1779882,1779882,1779638,244,48,utRho28
ybjM,1779770,1780178,1779770,408,158,utRho28
ybjO,1795704,1795978,1795704,274,0,utRho28
ybjP,1809046,1809046,1808934,112,0,utRho28
ybjQ,1809034,1809186,1809034,152,32,utRho28
ybjS,1813796,1813796,1813506,290,242,utRho28
ybjX,1838206,1838206,1838168,38,0,utRho28
ycaD,1891438,1891742,1891438,304,62,utRho28
ycaI,1928210,1928640,1928210,430,180,utRho28
ycaK,1899094,1899336,1899094,242,50,utRho28
ycaL,1920264,1920528,1920264,264,78,utRho28
ycaM,1894240,1894458,1894240,218,50,utRho28
ycaR,1941284,1941346,1941284,62,182,utRho28
ycbB,1961862,1962094,1961862,232,378,utRho28
ycbJ,1943344,1943504,1943344,160,138,utRho28
ycbK,1966046,1966150,1966046,104,46,utRho28
ycbZ,2036920,2036920,2036598,322,4,utRho28
yccA,2062886,2062886,2062836,50,268,utRho28
yccF,2048730,2048730,2048696,34,128,utRho28
yccS,2047988,2047988,2047766,222,744,utRho28
yccT,2055674,2055674,2055546,128,152,utRho28
yccX,2059960,2060128,2059960,168,362,utRho28
ycdT,2185682,2185752,2185682,70,30,utRho28
ycdU,2191266,2191686,2191266,420,374,utRho28
ycdZ,2200504,2200592,2200504,88,110,utRho28
yceA,2233544,2233614,2233544,70,0,utRho28
yceD,2293298,2293588,2293298,290,1328,utRho28
yceF,2293522,2293522,2293190,332,818,utRho28
yceH,2252154,2252314,2252154,160,386,utRho28
yceI,2237282,2237282,2236952,330,140,utRho28
yceJ,2238142,2238142,2238092,50,246,utRho28
yceM,2253208,2253612,2253208,404,124,utRho28
yceO,2239264,2239264,2238894,370,374,utRho28
yceQ,2288760,2289004,2288760,244,1762,utRho28
ycfD,2376540,2376540,2376480,60,54,utRho28
ycfJ,2334814,2335198,2334814,384,32,utRho28
ycfS,2340834,2340834,2340748,86,0,utRho28
ycfT,2350658,2350658,2350330,328,204,utRho28
ycfZ,2362760,2362760,2362534,226,270,utRho28
ycgB,2474570,2474570,2474482,88,0,utRho28
ycgG,2434614,2434656,2434614,42,226,utRho28
ycgJ,2452956,2453200,2452956,244,140,utRho28
ycgL,2455218,2455362,2455218,144,44,utRho28
ycgN,2457366,2457660,2457366,294,70,utRho28
ycgR,2489112,2489112,2489054,58,0,utRho28
ycgV,2512222,2512222,2511904,318,186,utRho28
ycgX,2426568,2426568,2426214,354,1316,utRho28
ycgY,2490166,2490320,2490166,154,480,utRho28
ycgZ,2431504,2431578,2431504,74,92,utRho28
ychE,2596904,2597196,2596904,292,70,utRho28
ychF,2515764,2515764,2515624,140,0,utRho28
ychH,2517476,2517582,2517476,106,406,utRho28
ychJ,2578354,2578354,2578264,90,30,utRho28
ychN,2547310,2547310,2547198,112,0,utRho28
ychO,2547520,2547850,2547520,330,548,utRho28
ychQ,2533798,2533848,2533798,50,0,utRho28
yciA,2624828,2624828,2624492,336,0,utRho28
yciB,2626110,2626110,2625780,330,332,utRho28
yciC,2627396,2627396,2627326,70,12,utRho28
yciE,2630794,2630794,2630448,346,0,utRho28
yciG,5264368,5264368,5264140,228,0,utRho28
yciI,2621784,2621784,2621730,54,96,utRho28
yciN,2661606,2661606,2661336,270,136,utRho28
yciS,2680270,2680486,2680270,216,0,utRho28
yciT,2689088,2689088,2688692,396,348,utRho28
yciU,2614718,2614718,2614300,418,48,utRho28
yciV,2646376,2646440,2646376,64,0,utRho28
yciW,2700472,2700472,2700214,258,52,utRho28
yciZ,2689276,2689276,2689218,58,172,utRho28
ycjD,2703792,2703792,2703520,272,96,utRho28
ycjG,2777748,2777860,2777748,112,330,utRho28
ycjM,2740006,2740432,2740006,426,166,utRho28
ycjW,2767982,2767982,2767922,60,74,utRho28
ycjX,2768138,2768234,2768138,96,108,utRho28
ycjY,5568288,5568288,5567460,828,516,utRho28
ydaE,2836438,2836438,2836016,422,166,utRho28
ydaN,2816048,2816100,2816048,52,92,utRho28
ydaS,2840340,2840730,2840340,390,386,utRho28
ydbC,2948376,2948442,2948376,66,130,utRho28
ydbD,2950132,2950288,2950132,156,0,utRho28
ydbH,2885800,2886102,2885800,302,1780,utRho28
ydbJ,2881712,2882116,2881712,404,560,utRho28
ydbK,2881692,2881692,2881568,124,120,utRho28
ydcA,2983294,2983354,2983294,60,18,utRho28
ydcF,2974404,2974470,2974404,66,0,utRho28
ydcI,2990268,2990268,2990142,126,12,utRho28
ydcJ,2990266,2990576,2990266,310,18,utRho28
ydcK,3001280,3001280,3000898,382,430,utRho28
ydcL,3004646,3004914,3004646,268,0,utRho28
ydcN,3012308,3012344,3012308,36,58,utRho28
ydcP,3013508,3013562,3013508,54,0,utRho28
ydcR,3019956,3020006,3019956,50,0,utRho28
ydcS,3022906,3023308,3022906,402,0,utRho28
ydcX,3034442,3034778,3034442,336,120,utRho28
ydcY,3035220,3035296,3035220,76,56,utRho28
ydcZ,3036750,3036750,3036662,88,232,utRho28
yddB,3155332,3155332,3155238,94,94,utRho28
yddE,3071738,3071738,3071716,22,0,utRho28
yddG,3094410,3094410,3094338,72,24,utRho28
yddJ,3089732,3089732,3089438,294,356,utRho28
yddW,3137704,3137704,3137646,58,56,utRho28
ydeA,3233910,3234056,3233910,146,2102,utRho28
ydeE,3242528,3242664,3242528,136,202,utRho28
ydeI,3249118,3249118,3248994,124,0,utRho28
ydeJ,3249376,3249546,3249376,170,0,utRho28
ydeN,3165458,3165458,3165048,410,10,utRho28
ydeP,3173328,3173328,3172972,356,8,utRho28
ydeR,3176596,3176596,3176592,4,0,utRho28
ydfA,3296872,3297016,3296872,144,82,utRho28
ydfG,3254982,3255034,3254982,52,0,utRho28
ydfH,3256652,3256704,3256652,52,0,utRho28
ydfK,3265446,3266144,3265446,698,930,utRho28
ydgA,3379588,3379704,3379588,116,0,utRho28
ydgC,3364124,3364124,3364060,64,24,utRho28
ydgD,3343906,3343920,3343906,14,88,utRho28
ydgH,3356754,3356854,3356754,100,60,utRho28
ydgJ,3408798,3408798,3408616,182,264,utRho28
ydgK,3410414,3410500,3410414,86,578,utRho28
ydhB,3479618,3479618,3479596,22,0,utRho28
ydhC,3479698,3479822,3479698,124,0,utRho28
ydhF,3451310,3451310,3451264,46,0,utRho28
ydhI,3441996,3442050,3441996,54,0,utRho28
ydhL,3451864,3451864,3451840,24,198,utRho28
ydhQ,3492404,3492404,3492254,150,0,utRho28
ydhS,3494136,3494262,3494136,126,26,utRho28
ydhT,3499138,3499138,3499118,20,0,utRho28
ydhY,3509284,3509284,3508954,330,184,utRho28
ydhZ,3510418,3510418,3510282,136,0,utRho28
ydiE,3579206,3579226,3579206,20,0,utRho28
ydiH,3530582,3530582,3530406,176,14,utRho28
ydiM,3541852,3542142,3541852,290,0,utRho28
ydiN,3544818,3545024,3544818,206,0,utRho28
ydiP,3558656,3558656,3558602,54,136,utRho28
ydiU,3582508,3582508,3582488,20,0,utRho28
ydiV,3584174,3584174,3584040,134,92,utRho28
ydiY,3612500,3612500,3612166,334,702,utRho28
ydjA,3697400,3697400,3697352,48,0,utRho28
ydjE,3708082,3708082,3707958,124,0,utRho28
ydjF,3709848,3709848,3709708,140,0,utRho28
ydjM,3620340,3620422,3620340,82,0,utRho28
ydjO,3626696,3626696,3626288,408,0,utRho28
ydjX,3666434,3666802,3666434,368,360,utRho28
yeaE,3731448,3731448,3731272,176,232,utRho28
yeaG,3733530,3733816,3733530,286,44,utRho28
yeaI,3740486,3740770,3740486,284,162,utRho28
yeaJ,3743874,3744082,3743874,208,240,utRho28
yeaL,3748646,3748704,3748646,58,302,utRho28
yeaM,3751296,3751296,3751152,144,0,utRho28
yeaN,3750926,3751346,3750926,420,56,utRho28
yeaO,3753554,3753818,3753554,264,20,utRho28
yeaP,3755314,3755430,3755314,116,40,utRho28
yeaQ,3758780,3758780,3758510,270,54,utRho28
yeaR,3759988,3759988,3759896,92,174,utRho28
yeaY,3781122,3781122,3781064,58,0,utRho28
yebB,3892220,3892502,3892220,282,588,utRho28
yebC,3896370,3896370,3896302,68,28,utRho28
yebE,3859464,3859464,3859414,50,128,utRho28
yebG,3861530,3861530,3861494,36,0,utRho28
yebK,3873180,3873304,3873180,124,0,utRho28
yebQ,3820314,3820552,3820314,238,4,utRho28
yebS,3832238,3832516,3832238,278,138,utRho28
yebV,3843430,3843560,3843430,130,0,utRho28
yebW,3843914,3844242,3843914,328,568,utRho28
yecC,3995646,3995646,3995628,18,0,utRho28
yecD,3901272,3901664,3901272,392,64,utRho28
yecF,3991434,3991636,3991434,202,300,utRho28
yecH,3979304,3979304,3978980,324,110,utRho28
yecJ,3975604,3975604,3975516,88,0,utRho28
yecM,3919968,3919968,3919692,276,400,utRho28
yecR,3976400,3976444,3976400,44,34,utRho28
yecT,3923862,3923944,3923862,82,96,utRho28
yedD,4016522,4016522,4016180,342,76,utRho28
yedE,4016310,4016554,4016310,244,76,utRho28
yedI,4058922,4058922,4058732,190,388,utRho28
yedJ,4066446,4066446,4066158,288,146,utRho28
yedV,4076404,4076404,4076304,100,104,utRho28
yedX,4077680,4077912,4077680,232,48,utRho28
yedY,4078572,4078956,4078572,384,40,utRho28
yeeA,4161322,4161322,4161182,140,64,utRho28
yeeE,4171104,4171104,4171050,54,710,utRho28
yeeJ,4089526,4089822,4089526,296,96,utRho28
yeeN,4113508,4113716,4113508,208,250,utRho28
yeeO,4119444,4119444,4119692,248,212,utRho28
yeeX,4158834,4158834,4158722,112,146,utRho28
yeeZ,4178422,4178422,4178256,166,108,utRho28
yefM,4179466,4179466,4179426,40,0,utRho28
yegD,4295288,4295348,4295288,60,34,utRho28
yegH,4275726,4275804,4275726,78,46,utRho28
yegI,4302154,4302154,4301970,184,18,utRho28
yegJ,4302032,4302370,4302032,338,170,utRho28
yegQ,4331182,4331336,4331182,154,236,utRho28
yegR,4336698,4336698,4336612,86,374,utRho28
yegS,4337086,4337424,4337086,338,148,utRho28
yegT,4357562,4357642,4357562,80,214,utRho28
yegX,4367640,4367640,4367302,338,148,utRho28
yehA,4376944,4376944,4376828,116,118,utRho28
yehE,4385818,4385818,4385592,226,0,utRho28
yehK,4407568,4407944,4407568,376,188,utRho28
yehL,4408804,4409192,4408804,388,110,utRho28
yeiB,4486146,4486146,4485934,212,58,utRho28
yeiE,4499422,4499422,4499236,186,40,utRho28
yeiG,4487776,4487820,4487776,44,40,utRho28
yeiH,4499332,4499434,4499332,102,28,utRho28
yeiI,4503306,4503400,4503306,94,44,utRho28
yeiL,4510580,4510710,4510580,130,10,utRho28
yeiP,4530834,4530900,4530834,66,220,utRho28
yeiQ,4532328,4532490,4532328,162,2,utRho28
yeiR,4535484,4535658,4535484,174,56,utRho28
yeiW,4530840,4530840,4530590,250,320,utRho28
yejA,4544624,4544728,4544624,104,0,utRho28
yejG,4556892,4556892,4556474,418,1158,utRho28
yejH,4561244,4561264,4561244,20,60,utRho28
yejK,4568218,4568218,4567894,324,6,utRho28
yejO,4578352,4578352,4577800,552,154,utRho28
yfaD,4713380,4713808,4713380,428,66,utRho28
yfaE,4696676,4697028,4696676,352,142,utRho28
yfaL,4688568,4688568,4688338,230,106,utRho28
yfaP,4656398,4656398,4656286,112,0,utRho28
yfaU,4717892,4717892,4717690,202,16,utRho28
yfaY,4727310,4727310,4727266,44,1158,utRho28
yfaZ,4728744,4728744,4728550,194,410,utRho28
yfbK,4771810,4771810,4771444,366,686,utRho28
yfbL,4771500,4771720,4771500,220,614,utRho28
yfbN,4777174,4777174,4776852,322,600,utRho28
yfbO,4776916,4777162,4776916,246,582,utRho28
yfbP,4777990,4778232,4777990,242,1020,utRho28
yfbR,4817662,4817724,4817662,62,24,utRho28
yfcI,4847424,4847424,4847078,346,406,utRho28
yfcJ,4880482,4880482,4880240,242,80,utRho28
yfcL,4888502,4888502,4888338,164,0,utRho28
yfcV,4911642,4911642,4911292,350,294,utRho28
yfcZ,4921958,4921958,4921868,90,0,utRho28
yfdF,4925604,4926024,4925604,420,2364,utRho28
yfdG,4935474,4935710,4935474,236,10,utRho28
yfdP,4946844,4947040,4946844,196,140,utRho28
yfdX,4988866,4988866,4988804,62,132,utRho28
yfdY,4990672,4990672,4990584,88,358,utRho28
yfeA,5035784,5035784,5035664,120,290,utRho28
yfeC,5036668,5036934,5036668,266,0,utRho28
yfeH,5053818,5053892,5053818,74,0,utRho28
yfeK,5074630,5074684,5074630,54,0,utRho28
yfeO,5018906,5019260,5018906,354,264,utRho28
yfeR,5054078,5054078,5053712,366,62,utRho28
yfeX,5101356,5101356,5101090,266,28,utRho28
yfeY,5102486,5102486,5102432,54,0,utRho28
yfeZ,5103842,5103842,5103452,390,732,utRho28
yffO,5123804,5124222,5123804,418,708,utRho28
yffQ,5126778,5127154,5126778,376,650,utRho28
yffS,5128800,5128986,5128800,186,122,utRho28
yfgC,5232052,5232188,5232052,136,0,utRho28
yfgF,5258062,5258062,5257876,186,754,utRho28
yfgG,5258170,5258580,5258170,410,826,utRho28
yfgH,5259344,5259584,5259344,240,0,utRho28
yfgM,5278866,5278866,5278566,300,126,utRho28
yfhH,5397414,5397518,5397414,104,372,utRho28
yfhM,5304648,5304648,5304574,74,32,utRho28
yfhR,5328408,5328726,5328408,318,94,utRho28
yfiC,5425610,5425610,5425528,82,0,utRho28
yfiE,5430688,5430688,5430640,48,396,utRho28
yfiL,5482630,5482720,5482630,90,46,utRho28
yfiM,5448066,5448358,5448066,292,978,utRho28
yfiR,5483354,5483750,5483354,396,262,utRho28
yfjH,5517326,5517326,5517200,126,30,utRho28
yfjI,5517710,5517970,5517710,260,32,utRho28
yfjJ,5521014,5521094,5521014,80,48,utRho28
yfjM,5531970,5531970,5531552,418,2246,utRho28
yfjP,5535080,5535420,5535080,340,3378,utRho28
yfjW,5546570,5546636,5546570,66,0,utRho28
yfjX,5551776,5551838,5551776,62,0,utRho28
ygaC,5601180,5601180,5599988,1192,4550,utRho28
ygaM,5600242,5600292,5600242,50,1130,utRho28
ygaU,5593628,5593628,5593572,56,112,utRho28
ygaZ,5619190,5619234,5619190,44,64,utRho28
ygbA,5713656,5713656,5713612,44,72,utRho28
ygbE,5746784,5746784,5746674,110,90,utRho28
ygbI,5722882,5722882,5722528,354,170,utRho28
ygbK,5724394,5724670,5724394,276,188,utRho28
ygbL,5727074,5727186,5727074,112,14,utRho28
ygbN,5729814,5730202,5729814,388,326,utRho28
ygcG,5811210,5811422,5811210,212,174,utRho28
ygcN,5785144,5785314,5785144,170,122,utRho28
ygcU,5799214,5799214,5798836,378,418,utRho28
ygcW,5800942,5800942,5800546,396,36,utRho28
ygdD,5883442,5883442,5883262,180,762,utRho28
ygdG,5861746,5861930,5861746,184,256,utRho28
ygdI,5886526,5886526,5886290,236,0,utRho28
ygdQ,5940784,5940840,5940784,56,108,utRho28
ygdR,5942494,5942542,5942494,48,0,utRho28
ygeA,5961606,5961606,5961270,336,6,utRho28
ygeH,5983758,5984188,5983758,430,28,utRho28
ygeI,5987162,5987276,5987162,114,372,utRho28
ygeR,6000078,6000078,5999782,296,496,utRho28
ygeV,6011694,6011694,6011572,122,0,utRho28
ygeW,6012234,6012524,6012234,290,720,utRho28
ygfB,6110946,6110946,6110888,58,0,utRho28
ygfK,6031984,6032120,6031984,136,2,utRho28
ygfS,6058328,6058328,6058024,304,0,utRho28
ygfZ,6082564,6082626,6082564,62,40,utRho28
yggC,6149512,6149512,6149378,134,0,utRho28
yggE,6136370,6136370,6136160,210,214,utRho28
yggI,6179176,6179510,6179176,334,48,utRho28
yggL,6204508,6204508,6204266,242,114,utRho28
yggM,6199514,6199514,6199130,384,292,utRho28
yggN,6203596,6203596,6203246,350,92,utRho28
yggX,18623958,18624558,18623958,600,84,utRho28
yghA,6298966,6299324,6298966,358,74,utRho28
yghB,6307058,6307126,6307058,68,138,utRho28
yghD,6222614,6222614,6222252,362,134,utRho28
yghF,6225798,6225798,6225840,42,0,utRho28
yghJ,6238640,6238640,6238224,416,234,utRho28
yghQ,6265186,6265186,6264816,370,228,utRho28
yghT,6267830,6268262,6267830,432,430,utRho28
yghU,6277400,6277454,6277400,54,56,utRho28
yghW,6293506,6293506,6293474,32,16,utRho28
yghZ,6295562,6295794,6295562,232,96,utRho28
ygiD,6365122,6365122,6364868,254,250,utRho28
ygiH,6409066,6409388,6409066,322,2398,utRho28
ygiL,6370622,6370828,6370622,206,2,utRho28
ygiM,6402084,6402414,6402084,330,318,utRho28
ygiN,6346156,6346284,6346156,128,174,utRho28
ygiQ,6322620,6322620,6322292,328,212,utRho28
ygiS,6335462,6335462,6335436,26,0,utRho28
ygiV,6338582,6338582,6338462,120,20,utRho28
ygiW,6339774,6339774,6339352,422,284,utRho28
ygiZ,6344506,6344506,6344422,84,78,utRho28
ygjH,6442528,6442528,6442494,34,0,utRho28
ygjI,6452140,6452468,6452140,328,12,utRho28
ygjQ,6472730,6473080,6472730,350,736,utRho28
ygjR,6474564,6474586,6474564,22,134,utRho28
ygjV,6483638,6483638,6483488,150,0,utRho28
yhaB,6535632,6535708,6535632,76,160,utRho28
yhaH,6504498,6504608,6504498,110,214,utRho28
yhaI,6505400,6505822,6505400,422,190,utRho28
yhaJ,6508560,6508560,6508428,132,22,utRho28
yhaK,6508538,6508638,6508538,100,22,utRho28
yhbQ,6599878,6599932,6599878,54,164,utRho28
yhbT,6602736,6602736,6602552,184,510,utRho28
yhbU,6602558,6602970,6602558,412,590,utRho28
yhbX,6643302,6643302,6643226,76,48,utRho28
yhbY,6655518,6655580,6655518,62,448,utRho28
yhcA,6723956,6724224,6723956,268,104,utRho28
yhcB,6760364,6760382,6760364,18,60,utRho28
yhcC,6708470,6708470,6708100,370,286,utRho28
yhcF,6733440,6733852,6733440,412,508,utRho28
yhcH,6739124,6739124,6738956,168,396,utRho28
yhcM,6760312,6760312,6759994,318,34,utRho28
yhcN,6770812,6771076,6770812,264,402,utRho28
yhcO,6772606,6772606,6772258,348,0,utRho28
yhdH,6806560,6806968,6806560,408,316,utRho28
yhdJ,6823234,6823306,6823234,72,0,utRho28
yhdN,6879092,6879092,6879018,74,426,utRho28
yhdT,6814702,6814750,6814702,48,40,utRho28
yhdU,6824994,6825242,6824994,248,260,utRho28
yhdV,6836392,6836780,6836392,388,236,utRho28
yhdW,6837944,6838298,6837944,354,32,utRho28
yheO,6953082,6953082,6952880,202,0,utRho28
yheV,6957970,6957970,6957584,386,0,utRho28
yhfA,6971902,6971902,6971636,266,792,utRho28
yhfG,6983294,6983294,6983240,54,64,utRho28
yhfL,6998622,6998896,6998622,274,374,utRho28
yhfY,7023244,7023244,7022844,400,16,utRho28
yhgA,7086294,7086334,7086294,40,0,utRho28
yhgE,7065176,7065176,7064878,298,694,utRho28
yhgF,7074352,7074770,7074352,418,1508,utRho28
yhhA,7173458,7173886,7173458,428,634,utRho28
yhhI,7248346,7248756,7248346,410,112,utRho28
yhhJ,7253696,7253696,7253606,90,226,utRho28
yhhM,7211588,7211588,7211220,368,994,utRho28
yhhN,7211150,7211502,7211150,352,556,utRho28
yhhQ,7218238,7218434,7218238,196,252,utRho28
yhhT,7223682,7223730,7223682,48,0,utRho28
yhhX,7162032,7162032,7161610,422,164,utRho28
yhhY,7162222,7162276,7162222,54,84,utRho28
yhhZ,7163516,7163726,7163516,210,374,utRho28
yhiD,7312220,7312220,7311804,416,4666,utRho28
yhiJ,7265190,7265190,7265180,10,44,utRho28
yhiM,7269270,7269682,7269270,412,2460,utRho28
yhiN,7275000,7275000,7274820,180,496,utRho28
yhjA,7338522,7338522,7338376,146,224,utRho28
yhjB,7344090,7344090,7343788,302,780,utRho28
yhjC,7344272,7344684,7344272,412,214,utRho28
yhjD,7346660,7346724,7346660,64,64,utRho28
yhjE,7349274,7349572,7349274,298,824,utRho28
yhjG,7356824,7356824,7356730,94,2,utRho28
yhjH,7358458,7358458,7358374,84,248,utRho28
yhjJ,7364032,7364032,7363880,152,282,utRho28
yhjK,7371296,7371296,7371158,138,160,utRho28
yhjR,7392750,7392750,7392370,380,10,utRho28
yhjV,7400796,7401126,7400796,330,496,utRho28
yhjX,7424194,7424194,7424014,180,78,utRho28
yhjY,7425966,7425966,7425868,98,24,utRho28
yiaB,7455654,7455654,7455496,158,266,utRho28
yiaD,7432712,7433094,7432712,382,220,utRho28
yiaF,7438194,7438194,7438088,106,350,utRho28
yiaG,7438862,7438956,7438862,94,338,utRho28
yiaJ,7485236,7485236,7485064,172,476,utRho28
yiaK,7485348,7485466,7485348,118,88,utRho28
yiaT,7503924,7503924,7503736,188,28,utRho28
yiaU,7503792,7503984,7503792,192,48,utRho28
yiaY,7515856,7515856,7515654,202,370,utRho28
yibF,7523950,7523950,7523910,40,56,utRho28
yibG,7536128,7536354,7536128,226,1022,utRho28
yibL,7553194,7553330,7553194,136,296,utRho28
yibN,7570112,7570112,7570030,82,174,utRho28
yibT,7552848,7552848,7552760,88,1446,utRho28
yicC,7633290,7633352,7633290,62,80,utRho28
yicH,7660862,7660914,7660862,52,6,utRho28
yicJ,7673328,7673328,7671858,1470,8414,utRho28
yicN,7685018,7685018,7684804,214,1234,utRho28
yicO,7687914,7687914,7687578,336,8,utRho28
yicR,15250308,15250308,15250236,72,0,utRho28
yidB,7755230,7755230,7754930,300,1138,utRho28
yidE,7732780,7732780,7732546,234,0,utRho28
yidF,7711580,7711580,7711222,358,72,utRho28
yidQ,7735088,7735456,7735088,368,1572,utRho28
yidR,7738824,7738824,7738618,206,160,utRho28
yieE,7787658,7787738,7787658,80,374,utRho28
yieH,7793314,7793548,7793314,234,130,utRho28
yieK,7798928,7798928,7798786,142,22,utRho28
yifB,7900350,7900350,7899998,352,138,utRho28
yifL,7988984,7989044,7988984,60,224,utRho28
yigF,8005750,8005750,8005598,152,1738,utRho28
yigI,8009448,8009448,8009394,54,28,utRho28
yigM,8022100,8022152,8022100,52,610,utRho28
yihA,8101970,8101970,8101458,512,0,utRho28
yihD,8084098,8084138,8084098,40,0,utRho28
yihF,8088110,8088398,8088110,288,326,utRho28
yihG,8093304,8093304,8093204,100,92,utRho28
yihI,8102616,8102694,8102616,78,0,utRho28
yihL,8120506,8120894,8120506,388,1092,utRho28
yihN,8124332,8124494,8124332,162,1322,utRho28
yihO,8131942,8131942,8131532,410,148,utRho28
yihQ,8138892,8138892,8138552,340,138,utRho28
yihV,8147064,8147478,8147064,414,150,utRho28
yihX,8151096,8151106,8151096,10,116,utRho28
yiiE,8158192,8158582,8158192,390,522,utRho28
yiiF,8159124,8159502,8159124,378,102,utRho28
yiiG,8173762,8174004,8173762,242,0,utRho28
yiiM,8205506,8205644,8205506,138,610,utRho28
yiiQ,8224624,8224624,8224428,196,132,utRho28
yiiS,8225738,8225934,8225738,196,2,utRho28
yijE,8272178,8272216,8272178,38,0,utRho28
yijF,8275728,8275728,8275314,414,450,utRho28
yijO,8296858,8296858,8296634,224,66,utRho28
yjaA,8426240,8426468,8426240,228,92302,utRho28
yjaB,8428312,8428312,8428246,66,16,utRho28
yjaG,8398746,8399008,8398746,262,600,utRho28
yjaH,8401022,8401132,8401022,110,14,utRho28
yjaZ,8379506,8379572,8379506,66,0,utRho28
yjbB,8455204,8455462,8455204,258,72,utRho28
yjbE,16943432,16943624,16943432,192,472,utRho28
yjbL,8520318,8520642,8520318,324,180,utRho28
yjbQ,8540428,8540476,8540428,48,2,utRho28
yjcB,8550328,8550328,8550082,246,208,utRho28
yjcC,8550836,8550942,8550836,106,242,utRho28
yjcD,8556628,8556958,8556628,330,460,utRho28
yjcE,8559658,8559960,8559658,302,606,utRho28
yjcF,8566212,8566212,8566150,62,0,utRho28
yjcO,8594660,8594660,8594250,410,512,utRho28
yjdA,8654128,8654270,8654128,142,0,utRho28
yjdC,8726660,8726660,8726616,44,80,utRho28
yjdK,8704780,8705168,8704780,388,1392,utRho28
yjdL,8713034,8713034,8712822,212,18,utRho28
yjdM,8653672,8653672,8653468,204,1844,utRho28
yjeF,8787354,8788132,8787354,778,1816,utRho28
yjeI,8745522,8745618,8745522,96,130,utRho28
yjeJ,8748806,8748806,8748468,338,630,utRho28
yjeV,8785472,8785784,8785472,312,2,utRho28
yjfP,8833512,8833904,8833512,392,108,utRho28
yjfY,8849656,8849656,8849582,74,92,utRho28
yjfZ,8855052,8855052,8854844,208,242,utRho28
yjgA,8916162,8916162,8915730,432,66,utRho28
yjgL,8950802,8950874,8950802,72,180,utRho28
yjgM,8959342,8959342,8959074,268,42,utRho28
yjgN,8959132,8959460,8959132,328,22,utRho28
yjgR,8980170,8980170,8980126,44,188,utRho28
yjgZ,9002116,9002520,9002116,404,1060,utRho28
yjhB,9007764,9008116,9007764,352,1122,utRho28
yjhG,9048452,9048452,9048188,264,1288,utRho28
yjhU,9041080,9041080,9040648,432,2214,utRho28
yjiA,9178096,9178096,9177730,366,234,utRho28
yjiJ,9125364,9125364,9125350,14,32,utRho28
yjiK,9127270,9127270,9127422,152,190,utRho28
yjiL,9129604,9129604,9129378,226,58,utRho28
yjiS,9143410,9143502,9143410,92,126,utRho28
yjiY,9182734,9182734,9182558,176,384,utRho28
yjjA,9200674,9200674,9200378,296,382,utRho28
yjjB,18408708,18408708,18407800,908,964,utRho28
yjjJ,9243314,9243538,9243314,224,0,utRho28
yjjK,9261132,9261132,9261044,88,130,utRho28
yjjL,9189764,9189764,9189444,320,130,utRho28
yjjM,9191894,9191894,9191702,192,762,utRho28
yjjP,9206068,9206068,9205716,352,778,utRho28
yjjQ,9206638,9206954,9206638,316,178,utRho28
yjjX,9267798,9267798,9267490,308,230,utRho28
yjjY,9280716,9280804,9280716,88,112,utRho28
yjjZ,9211554,9211608,9211554,54,332,utRho28
yjtD,9281676,9281884,9281676,208,476,utRho28
ykfB,532454,532454,532174,280,158,utRho28
ykfI,527636,527636,527338,298,398,utRho28
ykgB,637050,637050,636638,412,122,utRho28
ykgC,640430,640430,640002,428,396,utRho28
ykgD,640232,640454,640232,222,310,utRho28
ykgE,642962,643216,642962,254,2330,utRho28
ykgJ,608524,608524,608364,160,286,utRho28
ykgL,623878,624224,623878,346,324,utRho28
ykgM,625610,625610,625554,56,50,utRho28
ykgR,626570,626570,626484,86,64,utRho28
ylaC,958576,958576,958502,74,316,utRho28
yliE,1745938,1745958,1745938,20,0,utRho28
ymcE,2103660,2103694,2103660,34,26,utRho28
ymdA,2210450,2210828,2210450,378,72,utRho28
ymdB,2211428,2211640,2211428,212,0,utRho28
ymfD,2395322,2395322,2395064,258,444,utRho28
ymfI,2402880,2402994,2402880,114,186,utRho28
ymfJ,2404518,2404518,2404168,350,88,utRho28
ymfK,2406176,2406176,2405866,310,48,utRho28
ymfT,2405766,2406048,2405766,282,100,utRho28
ymgE,2489110,2489456,2489110,346,504,utRho28
ymgF,2437628,2437966,2437628,338,152,utRho28
ymiA,2670112,2670320,2670112,208,118,utRho28
ymjA,2715620,2715620,2715336,284,134,utRho28
ynaI,2791946,2791946,2791844,102,0,utRho28
ynaK,2850438,2850754,2850438,316,134,utRho28
ynbA,2954924,2955242,2954924,318,278,utRho28
yncD,3046552,3046552,3046130,422,64,utRho28
yncE,3046454,3046614,3046454,160,34,utRho28
yncG,3052456,3052494,3052456,38,442,utRho28
yncL,3034492,3034492,3034388,104,166,utRho28
yneE,3218364,3218364,3218044,320,128,utRho28
yneF,3223748,3223748,3223708,40,644,utRho28
yneJ,3229560,3229608,3229560,48,58,utRho28
yneK,3231100,3231526,3231100,426,388,utRho28
yneM,3245176,3245292,3245176,116,70,utRho28
ynfA,3311398,3311398,3311346,52,18,utRho28
ynfB,3311418,3311616,3311418,198,202,utRho28
ynfC,3315094,3315094,3314914,180,0,utRho28
ynfD,3314828,3315130,3314828,302,0,utRho28
ynfE,3316006,3316138,3316006,132,12,utRho28
ynfK,3334670,3334670,3334438,232,2,utRho28
ynfL,3339304,3339304,3339184,120,0,utRho28
ynfM,3339260,3339398,3339260,138,0,utRho28
ynfN,3276598,3276598,3276218,380,44,utRho28
ynfO,3273454,3273512,3273454,58,4,utRho28
ynhG,3517890,3517890,3517450,440,200,utRho28
yniA,3615158,3615592,3615158,434,310,utRho28
yniB,3618526,3618526,3618466,60,78,utRho28
yniC,3618652,3618760,3618652,108,58,utRho28
yniD,3610202,3610330,3610202,128,60,utRho28
ynjE,3678880,3678934,3678880,54,26,utRho28
ynjF,3683222,3683222,3682806,416,130,utRho28
ynjH,3684376,3684376,3684270,106,96,utRho28
ynjI,3690022,3690022,3689742,280,474,utRho28
yoaB,3786642,3786734,3786642,92,154,utRho28
yoaC,3787932,3788146,3787932,214,266,utRho28
yoaE,3803544,3803544,3803170,374,302,utRho28
yoaF,3755444,3755444,3755064,380,62,utRho28
yoaH,3789866,3789866,3789462,404,602,utRho28
yobB,3850418,3850880,3850418,462,12,utRho28
yobF,3815586,3815586,3815182,404,334,utRho28
yobH,3817800,3817850,3817800,50,0,utRho28
yodB,4084352,4084736,4084352,384,366,utRho28
yodC,4057008,4057008,4056740,268,180,utRho28
yohC,4451358,4451358,4451262,96,34,utRho28
yohD,4451526,4451602,4451526,76,22,utRho28
yohJ,4460986,4461248,4460986,262,818,utRho28
yohO,4431172,4431314,4431172,142,52,utRho28
yojI,4617282,4617282,4617230,52,152,utRho28
ypdI,4988988,4989396,4988988,408,196,utRho28
ypfG,5165786,5165786,5165554,232,48,utRho28
ypfM,5182140,5182140,5181732,408,888,utRho28
yphB,5349590,5349590,5349376,214,0,utRho28
ypjA,5565644,5565644,5565452,192,634,utRho28
ypjB,5569636,5569636,5568858,778,50,utRho28
ypjD,5495860,5495774,5495860,86,42,utRho28
yqaE,5594170,5594170,5594056,114,156,utRho28
yqcA,5846100,5846100,5845968,132,142,utRho28
yqcE,5800944,5801184,5800944,240,14,utRho28
yqeC,6030468,6030468,6030114,354,126,utRho28
yqeF,5971618,5971618,5971184,434,598,utRho28
yqeG,5971438,5971694,5971438,256,594,utRho28
yqeH,5975016,5975072,5975016,56,942,utRho28
yqeI,5976688,5977004,5976688,316,130,utRho28
yqeK,5981140,5981140,5980720,420,1590,utRho28
yqfA,6086728,6086728,6086296,432,294,utRho28
yqgA,6219042,6219106,6219042,64,6,utRho28
yqgB,6172500,6172500,6172102,398,560,utRho28
yqgE,6185768,6185874,6185768,106,2,utRho28
yqhA,6299150,6299150,6298942,208,64,utRho28
yqhC,6310768,6310768,6310436,332,208,utRho28
yqhD,6310604,6310710,6310604,106,6,utRho28
yqhH,6316842,6317254,6316842,412,532,utRho28
yqiC,6369662,6369680,6369662,18,138,utRho28
yqiJ,6384108,6384416,6384108,308,568,utRho28
yqjA,6495096,6495546,6495096,450,112,utRho28
yqjF,6500932,6501124,6500932,192,170,utRho28
yqjG,6501948,6502048,6501948,100,12,utRho28
yqjH,6433078,6433078,6432982,96,0,utRho28
yqjI,6433506,6433558,6433506,52,54,utRho28
yraH,6574552,6574852,6574552,300,106,utRho28
yraP,6592144,6592818,6592144,674,196,utRho28
yraQ,6596414,6596414,6596276,138,0,utRho28
yraR,6598024,6598024,6597692,332,492,utRho28
yrbG,13360844,13361100,13360844,256,168,utRho28
yrbL,6696842,6696904,6696842,62,714,utRho28
yrbN,6616172,6616172,6615866,306,348,utRho28
yrdB,6860176,6860176,6860046,130,190,utRho28
yrfF,7052548,7052938,7052548,390,96,utRho28
yrhB,7169440,7169518,7169440,78,6,utRho28
ysaB,7451804,7451804,7451424,380,224,utRho28
ysgA,8032686,8032686,8032338,348,154,utRho28
ytfB,8857638,8857638,8857434,204,306,utRho28
ytfE,8864018,8864018,8863966,52,32,utRho28
ytfF,8866296,8866296,8866130,166,574,utRho28
ytfH,8868164,8868226,8868164,62,256,utRho28
ytfI,8875234,8875414,8875234,180,158,utRho28
ytfJ,8878572,8878572,8878524,48,66,utRho28
ytfK,8879022,8879174,8879022,152,372,utRho28
ytfL,8882642,8882642,8882430,212,114,utRho28
ytfQ,8899634,8899924,8899634,290,70,utRho28
ytjB,9249598,9249598,9249578,20,0,utRho28
yzfA,8896588,8896588,8896490,98,0,utRho28
zapA,6111102,6111224,6111102,122,286,utRho28
zapB,8236772,8237030,8236772,258,190,utRho28
zapC,2011700,2011904,2011700,204,60,utRho28
zinT,4082692,4082750,4082692,58,0,utRho28
zipA,5062814,5062814,5062466,348,0,utRho28
zitB,1569716,1569716,1569646,70,0,utRho28
zntA,7212844,7212902,7212844,58,16,utRho28
zntR,6878336,6878336,6878260,76,32,utRho28
znuA,3885322,3885322,3885166,156,32,utRho28
znuC,3885268,3885324,3885268,56,32,utRho28
zraP,8403424,8403424,8403376,48,0,utRho28
zraS,8403810,8403852,8403810,42,0,utRho28
zupT,6364866,6365100,6364866,234,250,utRho28
zur,8520282,8520282,8520006,276,520,utRho28
zwf,3872752,3872752,3872628,124,0,utRho28
C0343,2818676,2818728,2818676,52,0,utRho29
aaeB,6776526,6776526,6776376,150,14,utRho29
aaeR,6778762,6779040,6778762,278,250,utRho29
aaeX,6778860,6778860,6778674,186,186,utRho29
aat,1854920,1854920,1854864,56,0,utRho29
accA,416822,417242,416822,420,282,utRho29
accB,6810280,6810872,6810280,592,1368,utRho29
accD,4868030,4868030,4867852,178,120,utRho29
aceB,8430804,8430956,8430804,152,454,utRho29
aceE,245938,246034,245938,96,38,utRho29
ackA,4826918,4826940,4826918,22,194,utRho29
acnA,2670848,2671662,2670848,814,518,utRho29
acnB,263038,263230,263038,192,586,utRho29
acpP,2303148,2303230,2303148,82,310,utRho29
acpS,5402324,5402324,5401996,328,780,utRho29
acrA,971396,971396,971238,158,84,utRho29
acrB,969370,969370,968806,564,486,utRho29
acrD,5174950,5175190,5174950,240,130,utRho29
acrE,6827404,6827728,6827404,324,108,utRho29
acrR,971398,971522,971398,124,0,utRho29
acrZ,1589502,1589546,1589502,44,36,utRho29
acs,8575190,8575190,8574742,448,1792,utRho29
actP,8569870,8569870,8569804,66,130,utRho29
ada,4620854,4620854,4620810,44,10,utRho29
add,3404404,3404466,3404404,62,8,utRho29
ade,7687802,7687928,7687802,126,16,utRho29
adhE,2596826,2596826,2596242,584,22,utRho29
adhP,3107988,3107988,3107676,312,388,utRho29
adiA,8681112,8681112,8681042,70,52,utRho29
adiC,8674404,8674404,8674062,342,212,utRho29
adiY,8676084,8676084,8675858,226,18,utRho29
adk,994278,994350,994278,72,978,utRho29
adrA,807374,807406,807374,32,48,utRho29
aer,6438240,6438240,6438152,88,0,utRho29
aes,1000102,1000102,999946,156,56,utRho29
agaR,6557406,6557406,6557330,76,78,utRho29
agaS,6563778,6563952,6563778,174,8,utRho29
agp,2131118,2131170,2131118,52,0,utRho29
agrA,7296126,7296126,7296126,0,0,utRho29
agrB,7296588,7296588,7296588,0,0,utRho29
ahpC,1277386,1277890,1277386,504,782,utRho29
ahpF,1278004,1279506,1278004,1502,28258,utRho29
ahr,8992698,8992698,8992418,280,408,utRho29
aidB,8828494,8828550,8828494,56,0,utRho29
ais,4731512,4731512,4731240,272,142,utRho29
alaA,4814816,4815122,4814816,306,96,utRho29
alaC,4996798,4996798,4996590,208,0,utRho29
alaE,5598140,5598328,5598140,188,260,utRho29
alaS,5644180,5644180,5644022,158,458,utRho29
alaW,5036612,5036612,5036462,150,72,utRho29
aldA,2976380,2976464,2976380,84,64,utRho29
aldB,7513070,7513070,7513022,48,148,utRho29
alkA,4295118,4295118,4295080,38,272,utRho29
alkB,4618890,4618890,4618682,208,112,utRho29
allA,1064780,1064902,1064780,122,58,utRho29
allD,1092822,1092822,1092726,96,0,utRho29
allE,1088112,1088112,1088092,20,106,utRho29
allS,1064600,1064600,1064442,158,216,utRho29
alr,8531178,8531564,8531178,386,390,utRho29
alsE,8617334,8617334,8616956,378,900,utRho29
alsK,8615990,8615990,8615598,392,982,utRho29
alx,6476740,6477160,6476740,420,58,utRho29
amiA,5104482,5104704,5104482,222,96,utRho29
amiC,5898378,5898378,5898020,358,42,utRho29
amn,4110062,4110122,4110062,60,22,utRho29
ampC,8758006,8758006,8757888,118,2,utRho29
ampD,237362,237466,237362,104,120,utRho29
ampG,907372,907372,907090,282,70,utRho29
ampH,792726,792726,792574,152,36,utRho29
amyA,4012230,4012312,4012230,82,4,utRho29
anmK,3439346,3439346,3439204,142,40,utRho29
ansB,6201580,6201580,6201456,124,266,utRho29
ansP,3052040,3052040,3051960,80,64,utRho29
apaG,104068,104068,103212,856,364,utRho29
apaH,102586,102586,102444,142,562,utRho29
apbE,4623188,4623188,4623068,120,0,utRho29
appA,2081198,2081234,2081198,36,0,utRho29
appC,2075420,2075480,2075420,60,44,utRho29
appY,1167134,1167362,1167134,228,0,utRho29
apt,982620,982824,982620,204,64,utRho29
aqpZ,1832424,1832424,1832094,330,72,utRho29
araB,140150,140150,140096,54,12,utRho29
araC,140482,140774,140482,292,374,utRho29
araE,5964416,5964416,5964364,52,0,utRho29
araF,3972476,3972476,3972256,220,0,utRho29
araH,3967120,3967120,3967086,34,302,utRho29
araJ,825058,825058,824962,96,862,utRho29
arcA,9281602,9281602,9280612,990,1342,utRho29
arcB,6706098,6706098,6706050,48,36,utRho29
arcZ,6701154,6701154,6701154,0,0,utRho29
arfA,6877346,6877346,6877298,48,40,utRho29
argA,5898312,5898484,5898312,172,40,utRho29
argC,8309770,8310002,8309770,232,128,utRho29
argD,6980442,6980442,6980360,82,88,utRho29
argE,8310156,8310156,8309694,462,184,utRho29
argF,580680,580680,580610,70,72,utRho29
argG,6637124,6637274,6637124,150,20,utRho29
argI,8956688,8956688,8956622,66,78,utRho29
argO,6137672,6137672,6137616,56,128,utRho29
argP,6119460,6119506,6119460,46,42,utRho29
argR,6769204,6769406,6769204,202,64,utRho29
argS,3920002,3920124,3920002,122,38,utRho29
argT,4855698,4855698,4855582,116,128,utRho29
argU,1129406,1129446,1129406,40,0,utRho29
argW,4932616,4932618,4932616,2,0,utRho29
argX,7964728,7964750,7964728,22,70,utRho29
aroF,5482402,5482402,5482300,102,0,utRho29
aroG,1571182,1571266,1571182,84,20,utRho29
aroH,3576636,3576870,3576636,234,282,utRho29
aroK,7038760,7038760,7038128,632,742,utRho29
aroL,812560,812810,812560,250,1690,utRho29
aroP,243342,243342,243102,240,16,utRho29
arpA,8445382,8445382,8444974,408,0,utRho29
arrS,7316108,7316108,7316108,0,0,utRho29
arsR,7297024,7297056,7297024,32,0,utRho29
artJ,1801252,1801252,1801150,102,0,utRho29
artP,1807686,1807686,1807468,218,1010,utRho29
ascF,5678858,5679048,5678858,190,48,utRho29
ascG,5678574,5678574,5678528,46,146,utRho29
aslB,7965562,7965916,7965562,354,68,utRho29
asnA,7854258,7854310,7854258,52,792,utRho29
asnB,1398444,1398444,1398354,90,228,utRho29
asnC,23562186,23562186,23562018,168,1164,utRho29
asnS,1978088,1978088,1977970,118,1140,utRho29
asnT,4089082,4089098,4089082,16,22,utRho29
asnU,4119690,4119702,4119690,12,4,utRho29
asnV,4124504,4124520,4124504,16,22,utRho29
aspA,17473728,17473728,17473308,420,116,utRho29
aspC,1971486,1971486,1971418,68,62,utRho29
aspS,3901402,3901402,3901044,358,246,utRho29
aspT,7893560,7893744,7893560,184,55674,utRho29
aspV,473826,473862,473826,36,344,utRho29
asr,3342654,3342752,3342654,98,70,utRho29
astC,3664088,3664088,3663964,124,90,utRho29
astE,3654138,3654138,3653846,292,188,utRho29
atoD,4646824,4646894,4646824,70,286,utRho29
atpB,7844540,7844540,7844102,438,684,utRho29
atpC,7832118,7832118,7831944,174,396,utRho29
atpI,7845050,7845050,7844880,170,1114,utRho29
avtA,7479348,7479410,7479348,62,636,utRho29
azoR,2965982,2965982,2965720,262,104,utRho29
azuC,3976002,3976002,3975918,84,60,utRho29
bacA,6408350,6408350,6408262,88,11198,utRho29
bamA,394052,395856,394052,1804,1986,utRho29
bamB,5277950,5277950,5277304,646,892,utRho29
bamC,5198028,5198028,5197730,298,518,utRho29
bamD,5471922,5472292,5471922,370,204,utRho29
bamE,5506972,5507210,5506972,238,866,utRho29
basS,8666954,8666954,8666544,410,568,utRho29
bax,7474468,7474468,7474354,114,272,utRho29
bcp,5200874,5200956,5200874,82,120,utRho29
bcsB,7385346,7385346,7385214,132,66,utRho29
bcsE,7392644,7392916,7392644,272,194,utRho29
bdcA,8948128,8948128,8948106,22,250,utRho29
bdcR,8948192,8948248,8948192,56,290,utRho29
bdm,3112680,3112680,3112560,120,82,utRho29
betA,654522,654522,654494,28,0,utRho29
betI,658722,658722,658668,54,138,utRho29
betT,658842,658926,658842,84,196,utRho29
bfr,6933498,6933498,6933450,48,34,utRho29
bglG,23440182,23440182,23439402,780,1992,utRho29
bglX,4444240,4444240,4443978,262,0,utRho29
bhsA,2337962,2338146,2337962,184,64,utRho29
bioA,1618584,1618584,1618514,70,0,utRho29
bioB,1618604,1618688,1618604,84,0,utRho29
bioH,7089716,7089716,7089688,28,0,utRho29
bisC,7433026,7433026,7432788,238,70,utRho29
blc,8755490,8755490,8755444,46,0,utRho29
blr,3409024,3409102,3409024,78,472,utRho29
bluF,2431226,2431226,2430950,276,110,utRho29
bluR,2428226,2428226,2428118,108,2,utRho29
bolA,908698,908944,908698,246,80,utRho29
borD,1157842,1157842,1157786,56,4,utRho29
brnQ,838976,839182,838976,206,680,utRho29
bssR,1756492,1756496,1756492,4,2,utRho29
bssS,2242116,2242116,2241910,206,632,utRho29
btuB,8326798,8327278,8326798,480,568,utRho29
cadB,8720212,8720212,8720062,150,806,utRho29
cadC,8723926,8723926,8723868,58,0,utRho29
caiE,70998,70998,70742,256,68,utRho29
caiF,68436,68600,68436,164,348,utRho29
caiT,84074,84074,83862,212,92,utRho29
can,285406,285406,285340,66,194,utRho29
carA,59102,59302,59102,200,738,utRho29
carB,61550,61634,61550,84,66,utRho29
cas2,5757830,5757830,5757706,124,188,utRho29
casA,5768638,5768638,5768276,362,144,utRho29
cbl,4121882,4121882,4121828,54,72,utRho29
cbpA,2128074,2128074,2127550,524,96,utRho29
cbrA,7738628,7738754,7738628,126,8,utRho29
cbrB,7794958,7795012,7794958,54,24,utRho29
ccmH,4585242,4585242,4584820,422,4,utRho29
cdaR,364894,364926,364894,32,120,utRho29
cdd,4463638,4463688,4463638,50,24,utRho29
cdh,8219814,8219860,8219814,46,138,utRho29
cdsA,391110,391354,391110,244,488,utRho29
cedA,3627484,3627484,3627326,158,184,utRho29
cfa,3482402,3482826,3482402,424,92,utRho29
chaC,2544844,2544972,2544844,128,268,utRho29
chbB,3643452,3643452,3643238,214,28,utRho29
chbG,3634624,3634624,3634270,354,24,utRho29
cheW,3946924,3946924,3946678,246,168,utRho29
chiA,6939792,6939792,6939706,86,548,utRho29
chiP,1416472,1416668,1416472,196,22,utRho29
cho,3646984,3647030,3646984,46,0,utRho29
chpS,8896804,8896894,8896804,90,32,utRho29
cirA,4493884,4493884,4493538,346,272,utRho29
citC,1304078,1304078,1303712,366,614,utRho29
citT,1293264,1293264,1293160,104,0,utRho29
clcA,350104,350214,350104,110,0,utRho29
clpA,1846160,1846528,1846160,368,100,utRho29
clpB,5468410,5468410,5468346,64,410,utRho29
clpP,913154,913354,913154,200,802,utRho29
clpS,1845500,1845826,1845500,326,32,utRho29
clpX,914404,914852,914404,448,1380,utRho29
clsA,2617346,2617346,2617290,56,220,utRho29
clsC,2212584,2212710,2212584,126,16,utRho29
cmk,1922330,1922402,1922330,72,2,utRho29
cnu,3409522,3409898,3409522,376,862,utRho29
coaA,8350214,8350214,8350052,162,1364,utRho29
cobC,1340092,1340092,1339814,278,314,utRho29
cobT,4129202,4129202,4128934,268,80,utRho29
cobU,4131944,4131944,4131528,416,156,utRho29
codB,709768,709844,709768,76,90,utRho29
comR,2337726,2337726,2337664,62,0,utRho29
copA,1022822,1022822,1022758,64,64,utRho29
corA,8002388,8002852,8002388,464,21926,utRho29
cpdB,8873258,8873258,8873130,128,244,utRho29
cptB,6082198,6082198,6082140,58,10,utRho29
cpxA,8210202,8210202,8209950,252,62,utRho29
cpxP,8211570,8211640,8211570,70,116,utRho29
cpxR,8211372,8211372,8211340,32,0,utRho29
cra,175894,176056,175894,162,300,utRho29
crcB,1316016,1316016,1315876,140,0,utRho29
creA,9270486,9271042,9270486,556,482,utRho29
creD,9276320,9276356,9276320,36,66,utRho29
crl,515620,515658,515620,38,1088,utRho29
crp,6971906,6972240,6971906,334,380,utRho29
crr,5070960,5071668,5070960,708,1484,utRho29
csdA,5886414,5886674,5886414,260,0,utRho29
csgB,2207718,2207902,2207718,184,0,utRho29
csgD,2206688,2206688,2206392,296,544,utRho29
csgG,2203510,2203510,2203368,142,204,utRho29
csiD,5577854,5577970,5577854,116,220,utRho29
csiE,5330802,5330870,5330802,68,100,utRho29
csiR,5590942,5591348,5590942,406,46,utRho29
cspA,7439778,7440098,7439778,320,744,utRho29
cspB,3283430,3283430,3283108,322,14,utRho29
cspC,3815018,3815018,3814870,148,126,utRho29
cspD,1845352,1845352,1845180,172,4564,utRho29
cspE,1314294,1314584,1314294,290,404,utRho29
cspF,3283380,3283710,3283380,330,888,utRho29
cspG,2102610,2102922,2102610,312,406,utRho29
cspH,2102746,2102746,2102350,396,120,utRho29
cspI,3277624,3277624,3277334,290,0,utRho29
csrA,5638746,5638746,5638292,454,2110,utRho29
csrB,5849048,5849048,5849048,0,0,utRho29
csrC,8102072,8102072,8102072,0,0,utRho29
csrD,6806850,6806850,6806664,186,134,utRho29
cstA,1259710,1259788,1259710,78,96,utRho29
cueO,274090,274166,274090,76,0,utRho29
cueR,1027948,1027986,1027948,38,0,utRho29
curA,3037784,3038054,3037784,270,214,utRho29
cusC,1191146,1191200,1191146,54,100,utRho29
cusR,1190924,1190924,1190886,38,126,utRho29
cutA,8730784,8730784,8730712,72,0,utRho29
cutC,3918534,3918534,3917920,614,716,utRho29
cvpA,4861600,4861600,4861526,74,220,utRho29
cvrA,2484328,2484328,2484142,186,64,utRho29
cyaA,7981548,7982306,7981548,758,1118,utRho29
cyaR,4334228,4334224,4334228,4,12,utRho29
cyaY,7988166,7988166,7988118,48,198,utRho29
cybB,2981522,2981804,2981522,282,238,utRho29
cycA,8859560,8859728,8859560,168,372,utRho29
cydA,1542340,1542916,1542340,576,2958,utRho29
cydC,1858800,1858800,1858390,410,84,utRho29
cydD,1862062,1862062,1861924,138,0,utRho29
cydX,1548300,1548392,1548300,92,36,utRho29
cynR,717418,717418,717380,38,38,utRho29
cynT,1435092,1435196,1435092,104,72,utRho29
cyoA,903306,903306,903220,86,280,utRho29
cyoE,895540,895540,895410,130,108,utRho29
cysB,2667576,2667710,2667576,134,114,utRho29
cysC,5748056,5748056,5747984,72,94,utRho29
cysD,5752736,5752736,5752658,78,110,utRho29
cysE,7565362,7565362,7565124,238,480,utRho29
cysG,6995508,6995656,6995508,148,2766,utRho29
cysJ,5783928,5783928,5783796,132,1040,utRho29
cysK,5064688,5064818,5064688,130,0,utRho29
cysP,5087114,5087114,5087056,58,54,utRho29
cysS,1109154,1109222,1109154,68,76,utRho29
cysT,3984100,3984100,3983974,126,22,utRho29
cysZ,5062766,5062926,5062766,160,330,utRho29
cytR,8249018,8249018,8248912,106,694,utRho29
dacA,1328002,1328002,1327926,76,0,utRho29
dacB,6657714,6657926,6657714,212,0,utRho29
dacC,1761306,1761454,1761306,148,904,utRho29
dadA,2475018,2475142,2475018,124,50,utRho29
dam,7032504,7032504,7031826,678,58,utRho29
damX,7035200,7035200,7034612,588,2262,utRho29
dapA,5199568,5199568,5199520,48,54,utRho29
dapB,56576,56748,56576,172,722,utRho29
dapD,371954,371954,371894,60,318,utRho29
dapE,5183120,5183214,5183120,94,532,utRho29
dcp,3254844,3254844,3254760,84,0,utRho29
dcrB,7219534,7219910,7219534,376,262,utRho29
dctA,7366996,7366996,7366894,102,404,utRho29
dcuA,8733686,8733686,8733546,140,918,utRho29
dcuB,8698182,8698182,8697488,694,1050,utRho29
dcuC,1312166,1312166,1311936,230,1070,utRho29
dcuD,6749166,6749738,6749166,572,344,utRho29
dcuR,8701130,8701130,8700068,1062,752,utRho29
dcuS,8703370,8703370,8703324,46,260,utRho29
dcyD,3999016,3999016,3998960,56,0,utRho29
ddpX,3126498,3126498,3126152,346,72,utRho29
deaD,6615818,6615818,6615720,98,172,utRho29
dedA,4869880,4869880,4869482,398,336,utRho29
dedD,4863750,4863750,4863368,382,90,utRho29
def,6867300,6867380,6867300,80,0,utRho29
degP,361690,361768,361690,78,0,utRho29
degQ,6761308,6761486,6761308,178,512,utRho29
deoB,9239134,9239206,9239134,72,44,utRho29
deoC,9233358,9234646,9233358,1288,834,utRho29
dfp,7625406,7625462,7625406,56,72,utRho29
dgcZ,3247758,3247758,3247700,58,0,utRho29
dgkA,8512914,8513274,8512914,360,344,utRho29
dgt,358392,358474,358392,82,28,utRho29
dhaK,2501888,2501888,2501676,212,66,utRho29
dhaR,2502006,2502132,2502006,126,234,utRho29
dicB,3299194,3299218,3299194,24,0,utRho29
dicC,3295752,3295752,3295700,52,0,utRho29
dinB,501760,501796,501760,36,100,utRho29
dinD,7635398,7635520,7635398,122,138,utRho29
dinG,1666146,1666140,1666146,6,0,utRho29
dinI,2243018,2243018,2242974,44,144,utRho29
dinJ,493230,493230,493004,226,102,utRho29
dinQ,7295964,7295964,7295576,388,256,utRho29
djlA,114536,114728,114536,192,60,utRho29
dkgA,6313142,6313246,6313142,104,28,utRho29
dkgB,458196,458334,458196,138,26,utRho29
dksA,321502,321502,321208,294,830,utRho29
dld,4444164,4444370,4444164,206,0,utRho29
dmlA,3763424,3763824,3763424,400,190,utRho29
dmlR,3763710,3763710,3763618,92,22,utRho29
dmsA,1881646,1881918,1881646,272,48,utRho29
dnaA,7767922,7767922,7767458,464,122,utRho29
dnaB,8528566,8528628,8528566,62,240,utRho29
dnaK,24096,24326,24096,230,3536,utRho29
dnaN,7765466,7765466,7764642,824,368,utRho29
dnaQ,471868,472134,471868,266,906,utRho29
dnaT,18406460,18406460,18406068,392,0,utRho29
dnaX,984112,984184,984112,72,204,utRho29
dosP,3131486,3131486,3131466,20,0,utRho29
dpiB,1303968,1304470,1303968,502,220,utRho29
dppA,7415740,7415740,7415410,330,1568,utRho29
dps,1697900,1697900,1697822,78,202,utRho29
dsbA,8086754,8086836,8086754,82,452,utRho29
dsbB,2466294,2466294,2466060,234,182,utRho29
dsbC,6079266,6079266,6077644,1622,1108,utRho29
dsbG,1277600,1277600,1277146,454,360,utRho29
dsdA,4958242,4958404,4958242,162,214,utRho29
dsdC,4955492,4955492,4955258,234,132,utRho29
dsdX,4955642,4955694,4955642,52,1232,utRho29
dsrA,4050626,4050626,4050626,0,0,utRho29
dsrB,4049686,4049686,4049646,40,248,utRho29
dtpD,1485340,1485340,1485112,228,412,utRho29
dusA,8523200,8523338,8523200,138,1046,utRho29
dusB,6820492,6820560,6820492,68,0,utRho29
dusC,4460790,4460790,4460770,20,0,utRho29
dut,7627704,7627864,7627704,160,994,utRho29
dxr,386670,387042,386670,372,418,utRho29
ebgA,6445102,6445266,6445102,164,136,utRho29
ebgR,6442874,6442932,6442874,58,0,utRho29
ecnB,8753018,8753106,8753018,88,40,utRho29
eco,4607594,4607810,4607594,216,0,utRho29
ecpA,621594,621594,621342,252,82,utRho29
ecpB,620238,620238,620052,186,20,utRho29
ecpR,622964,622964,622672,292,0,utRho29
eda,3866218,3866218,3865512,706,2,utRho29
edd,3869426,3869426,3869208,218,0,utRho29
efeO,2164308,2164486,2164308,178,24,utRho29
efeU_1,2162614,2162712,2162614,98,184,utRho29
efp,8751134,8751398,8751134,264,946,utRho29
elaA,4763372,4763372,4763086,286,304,utRho29
elaD,4765308,4765426,4765308,118,156,utRho29
elfA,1995530,1995736,1995530,206,12,utRho29
elfD,1996642,1996980,1996642,338,236,utRho29
emrD,7707690,7707844,7707690,154,110,utRho29
emrK,4966896,4966896,4966678,218,166,utRho29
emrY,4964668,4964668,4964352,316,570,utRho29
emtA,2486250,2486360,2486250,110,64,utRho29
endA,12361100,12361388,12361100,288,92,utRho29
eno,5817692,5817692,5815882,1810,770,utRho29
entC,1249662,1249770,1249662,108,0,utRho29
entD,1220508,1220508,1220158,350,316,utRho29
entH,1258584,1258600,1258584,16,0,utRho29
entS,1244506,1244600,1244506,94,64,utRho29
envR,6827266,6827266,6826930,336,28,utRho29
epd,12295292,12295292,12294764,528,840,utRho29
epmA,8765236,8765286,8765236,50,80,utRho29
epmB,8751406,8751406,8751314,92,546,utRho29
eptB,7421162,7421162,7420950,212,44,utRho29
eptC,8300622,8300622,8300530,92,212,utRho29
erfK,4126708,4126708,4126646,62,34,utRho29
erpA,353122,353220,353122,98,4,utRho29
esrE,8039956,8039956,8039956,0,0,utRho29
essD,1153746,1154796,1153746,1050,138,utRho29
etk,2088606,2088606,2088420,186,104,utRho29
evgA,4967262,4967510,4967262,248,226,utRho29
exbB,6304028,6304028,6303968,60,320,utRho29
exbD,6302780,6302780,6302486,294,194,utRho29
exuR,6493016,6493304,6493016,288,190,utRho29
exuT,6490004,6490208,6490004,204,0,utRho29
fabA,2032996,2032996,2032940,56,74,utRho29
fabB,4883282,4883282,4883210,72,2,utRho29
fabH,2297032,2297518,2297032,486,178,utRho29
fabI,2702236,2702236,2702078,158,4,utRho29
fadB,8062026,8062026,8061942,84,10,utRho29
fadD,3779614,3779614,3779492,122,76,utRho29
fadE,486812,486812,486606,206,88,utRho29
fadH,6463248,6463330,6463248,82,22,utRho29
fadI,4921022,4921022,4920938,84,324,utRho29
fadL,4922410,4922600,4922410,190,158,utRho29
fadM,928720,928804,928720,84,0,utRho29
fadR,2469810,2469876,2469810,66,12,utRho29
fbaB,4357334,4357334,4357128,206,2,utRho29
fdhE,8162722,8162722,8162456,266,282,utRho29
fdhF,8598814,8598814,8598732,82,72,utRho29
fdnG,3094744,3094802,3094744,58,0,utRho29
fdrA,1093012,1093360,1093012,348,64,utRho29
feaB,2894994,2895038,2894994,44,0,utRho29
feaR,2894734,2894734,2894566,168,0,utRho29
fecA,9033454,9033454,9033354,100,50,utRho29
fecE,9023288,9023288,9022914,374,2520,utRho29
fecI,9036564,9036564,9036470,94,0,utRho29
feoA,7080114,7080326,7080114,212,106,utRho29
fepA,1225334,1225334,1224988,346,596,utRho29
fepB,1249454,1249454,1249020,434,68,utRho29
fepD,1244468,1244468,1244378,90,0,utRho29
fes,1225374,1225630,1225374,256,452,utRho29
ffh,5495706,5495706,5495590,116,318,utRho29
ffs,952576,952848,952576,272,206,utRho29
fhuA,334884,334968,334884,84,138,utRho29
fhuE,2323294,2323294,2323102,192,238,utRho29
fhuF,9211504,9211504,9211326,178,840,utRho29
fic,6983296,6983296,6982926,370,4,utRho29
fieF,8212864,8212938,8212864,74,138,utRho29
fimA,9085388,9086230,9085388,842,1158,utRho29
fimB,9081334,9081914,9081334,580,2370,utRho29
fimE,9083742,9084074,9083742,332,788,utRho29
fimZ,1129214,1129214,1128960,254,194,utRho29
fiu,1683296,1683296,1683062,234,224,utRho29
fixA,84650,84806,84650,156,180,utRho29
fkpA,6955050,6955050,6954838,212,5668,utRho29
fldA,2846084,2846084,2845860,224,428,utRho29
fldB,6079644,6079710,6079644,66,0,utRho29
flgA,2261770,2261770,2261726,44,356,utRho29
flgB,2261986,2262036,2261986,50,76,utRho29
flgK,2276702,2276756,2276702,54,76,utRho29
flgM,2260330,2260330,2260256,74,198,utRho29
flgN,2259828,2259828,2259660,168,0,utRho29
flhB,3932432,3932432,3932382,50,264,utRho29
flhC,3955864,3955864,3955688,176,2,utRho29
flhD,3957154,3957154,3956394,760,790,utRho29
fliA,4003638,4003638,4003578,60,54,utRho29
fliC,4007352,4007352,4007212,140,40,utRho29
fliD,4007634,4007744,4007634,110,148,utRho29
fliE,4026186,4026186,4026028,158,142,utRho29
fliF,4026292,4026458,4026292,166,242,utRho29
fliL,4039168,4039236,4039168,68,12,utRho29
flk,4875824,4875900,4875824,76,12,utRho29
flu,4142634,4143078,4142634,444,400,utRho29
flxA,3292776,3292810,3292776,34,60,utRho29
fnr,2799104,2799104,2799052,52,32,utRho29
fnrS,2818258,2818258,2818258,0,0,utRho29
focA,1909628,1909628,1908932,696,116,utRho29
folA,99598,99646,99598,48,116,utRho29
folB,6409296,6409296,6409178,118,794,utRho29
folD,1115562,1115562,1115482,80,230,utRho29
folE,4487696,4487696,4487304,392,150,utRho29
fpr,8228998,8228998,8228944,54,86,utRho29
frc,4986878,4986878,4986508,370,566,utRho29
frdA,8764824,8764824,8764636,188,0,utRho29
frdD,8758948,8758948,8758732,216,366,utRho29
fre,8052886,8053054,8052886,168,90,utRho29
frlA,6999518,6999820,6999518,302,132,utRho29
frr,385624,385744,385624,120,340,utRho29
frsA,513004,513054,513004,50,54,utRho29
fruB,4527194,4527194,4526990,204,0,utRho29
frvR,8179804,8179804,8179710,94,0,utRho29
fryA,5008986,5008986,5008970,16,0,utRho29
fsaA,1727060,1727284,1727060,224,348,utRho29
fsr,1009710,1009710,1009392,318,848,utRho29
ftnA,3977364,3977432,3977364,68,0,utRho29
ftnB,3973550,3973850,3973550,300,220,utRho29
ftsA,207122,207964,207122,842,1320,utRho29
ftsB,5745802,5745802,5745640,162,78,utRho29
ftsH,6654204,6654204,6653870,334,1430,utRho29
ftsK,1865858,1866448,1865858,590,908,utRho29
ftsL,181376,182064,181376,688,440,utRho29
ftsP,6325732,6325732,6325338,394,52,utRho29
ftsQ,205484,206310,205484,826,750,utRho29
ftsX,7204512,7204512,7204172,340,626,utRho29
ftsZ,209272,210610,209272,1338,338,utRho29
fucA,5867708,5867708,5867376,332,1634,utRho29
fucP,5868238,5868470,5868238,232,314,utRho29
fumA,6753760,6753760,6753508,252,1376,utRho29
fumB,8694696,8694696,8694652,44,2,utRho29
fumC,3373418,3373418,3373176,242,0,utRho29
fur,2842892,2842892,2842584,308,424,utRho29
fusA,6947370,6947370,6947028,342,5468,utRho29
fxsA,8737206,8737328,8737206,122,938,utRho29
gabD,5581824,5582546,5581824,722,1088,utRho29
gadA,7335214,7335214,7335160,54,18,utRho29
gadB,3144144,3144144,3144090,54,50,utRho29
gadC,3141168,3141168,3140978,190,738,utRho29
gadE,7315600,7316732,7315600,1132,784,utRho29
gadW,7329562,7329562,7329236,326,16,utRho29
gadX,14663356,14663356,14663240,116,172,utRho29
gadY,7329728,7329728,7329728,0,0,utRho29
galE,1584354,1584354,1584110,244,46,utRho29
galF,4228702,4228702,4228654,48,156,utRho29
galM,1577796,1577796,1577674,122,256,utRho29
galP,6176510,6176568,6176510,58,64,utRho29
galR,5953138,5953198,5953138,60,0,utRho29
galS,4483420,4483420,4483336,84,82,utRho29
galU,2582810,2582914,2582810,104,124,utRho29
gapA,3724480,3725542,3724480,1062,1418,utRho29
garP,6549868,6549868,6549814,54,582,utRho29
gatY,4354468,4354468,4354408,60,0,utRho29
gatZ,4352864,4352864,4352642,222,426,utRho29
gcd,282558,282558,282450,108,56,utRho29
gcl,1067814,1067832,1067814,18,20,utRho29
gcvA,5885278,5885278,5885134,144,0,utRho29
gcvB,5885392,5885392,5885392,0,0,utRho29
gcvR,5199758,5199812,5199758,54,72,utRho29
gcvT,6101544,6101544,6101334,210,192,utRho29
gdhA,3684616,3684742,3684616,126,0,utRho29
gfcA,2099668,2099668,2099488,180,228,utRho29
gfcD,2096236,2096236,2095890,346,162,utRho29
ghrA,2195648,2195772,2195648,124,178,utRho29
ghrB,7434378,7434620,7434378,242,1348,utRho29
glcA,6242728,6242728,6242558,170,252,utRho29
glcC,6256412,6256544,6256412,132,16,utRho29
glcD,6256152,6256152,6256042,110,72,utRho29
gldA,8278092,8278092,8278070,22,80,utRho29
glgA,7136784,7136784,7136066,718,686,utRho29
glgB,7147314,7147314,7147004,310,200,utRho29
glgC,7139142,7139142,7138656,486,68,utRho29
glgP,7133546,7133546,7133162,384,308,utRho29
glgS,6384024,6384024,6383878,146,500,utRho29
glgX,7142838,7142838,7142638,200,0,utRho29
glk,5018922,5018922,5018852,70,0,utRho29
glmS,7827622,7827622,7827336,286,610,utRho29
glmU,7830652,7830652,7830400,252,204,utRho29
glmY,10765360,10765360,10765360,0,0,utRho29
glmZ,7972864,7972864,7972864,0,0,utRho29
glnA,16232888,16232888,16232136,752,104,utRho29
glnB,5375052,5375052,5374816,236,40,utRho29
glnD,377310,377310,377300,10,244,utRho29
glnE,6399602,6399602,6399282,320,104,utRho29
glnH,1696396,1696396,1696008,388,400,utRho29
glnK,945112,945196,945112,84,172,utRho29
glnL,8112742,8112742,8112678,64,0,utRho29
glnQ,1693262,1693262,1692926,336,362,utRho29
glnS,1411998,1412186,1411998,188,1348,utRho29
gloA,3455602,3455674,3455602,72,0,utRho29
gloB,469852,469852,469564,288,540,utRho29
glpA,4705166,4705294,4705166,128,34,utRho29
glpD,7123942,7124026,7123942,84,0,utRho29
glpE,7123698,7123698,7123646,52,10,utRho29
glpF,8236322,8236322,8236180,142,1652,utRho29
glpG,7122960,7122960,7122904,56,70,utRho29
glpR,7121782,7121782,7121210,572,3112,utRho29
glpT,4704902,4704902,4704748,154,264,utRho29
glpX,8231212,8231212,8231158,54,244,utRho29
glrK,5382246,5382246,5382196,50,0,utRho29
gltA,1509534,1509534,1508936,598,1574,utRho29
gltB,6709018,6709264,6709018,246,140,utRho29
gltI,1375792,1375792,1375494,298,656,utRho29
gltP,8588536,8588962,8588536,426,402,utRho29
gltS,7657382,7657382,7657330,52,804,utRho29
gltX,5041568,5041568,5041344,224,116,utRho29
gluQ,320286,320286,320224,62,4,utRho29
glyA,5371148,5371148,5371014,134,72,utRho29
glyQ,7450708,7450708,7450636,72,6,utRho29
glyS,7448990,7448990,7448794,196,510,utRho29
glyU,5998128,5998128,5998114,14,0,utRho29
glyV,8784626,8784720,8784626,94,158,utRho29
glyW,3984360,3984360,3984234,126,0,utRho29
gmhB,445612,445666,445612,54,0,utRho29
gmk,7642776,7642856,7642776,80,0,utRho29
gmr,2693686,2693686,2693484,202,132,utRho29
gnd,4202648,4202648,4202536,112,480,utRho29
gnsB,3275692,3275692,3275564,128,0,utRho29
gntK,14310580,14310580,14310368,212,768,utRho29
gntP,9102668,9102668,9102592,76,906,utRho29
gntR,7157760,7157760,7157452,308,164,utRho29
gntT,7092810,7093118,7092810,308,386,utRho29
gntU,7154170,7154170,7154122,48,302,utRho29
gntX,7089334,7089764,7089334,430,304,utRho29
gor,7292224,7292598,7292224,374,140,utRho29
gpmA,1575340,1575340,1575190,150,0,utRho29
gpmM,7570374,7570520,7570374,146,26,utRho29
gpsA,7567620,7567620,7567322,298,3064,utRho29
gpt,511828,511954,511828,126,284,utRho29
grcA,5433046,5433046,5432898,148,534,utRho29
greA,6657728,6657728,6657430,298,920,utRho29
greB,7073488,7073624,7073488,136,26,utRho29
groL,8741566,8742050,8741566,484,11870,utRho29
groS,8741232,8741376,8741232,144,8484,utRho29
grpE,5501494,5501494,5501416,78,432,utRho29
grxA,1781552,1781552,1781506,46,0,utRho29
grxB,2248206,2248206,2248108,98,666,utRho29
grxC,7569152,7569152,7568884,268,1128,utRho29
grxD,3468324,3468324,3468202,122,1794,utRho29
gspA,6911268,6911268,6910796,472,734,utRho29
gspC,6910964,6911156,6910964,192,470,utRho29
gss,6277220,6277220,6277044,176,106,utRho29
gstA,3428654,3428754,3428654,100,0,utRho29
gstB,1761038,1761038,1760960,78,378,utRho29
guaB,5268214,5268214,5268140,74,84,utRho29
gudD,5839026,5839026,5838770,256,52,utRho29
gyrA,4678914,4678914,4678840,74,92,utRho29
gyrB,7760300,7760300,7760238,62,218,utRho29
hcaE,5337964,5338064,5337964,100,166,utRho29
hcaR,5337928,5337928,5337792,136,260,utRho29
hcaT,5336106,5336106,5335692,414,212,utRho29
hchA,4071260,4071670,4071260,410,0,utRho29
hcp,1828258,1828258,1827628,630,198,utRho29
hcr,1824400,1824400,1824300,100,0,utRho29
hdeA,7313582,7313582,7313480,102,0,utRho29
hdeD,7313920,7313990,7313920,70,1696,utRho29
hdfR,7896320,7896320,7895934,386,96,utRho29
hdhA,3396244,3396244,3396080,164,152,utRho29
helD,2048876,2048942,2048876,66,48,utRho29
hemA,2527166,2527428,2527166,262,258,utRho29
hemB,779722,779722,779454,268,184,utRho29
hemF,5106410,5106450,5106410,40,46,utRho29
hemH,996062,996110,996062,48,0,utRho29
hemL,349882,349882,349764,118,48,utRho29
hemN,8103886,8104090,8103886,204,0,utRho29
hepA,127176,127176,126528,648,7880,utRho29
hflD,2385372,2385372,2385262,110,104,utRho29
hfq,8799602,8800576,8799602,974,2896,utRho29
hha,961006,961006,960616,390,0,utRho29
hicA,3018442,3018572,3018442,130,10,utRho29
higA,6468682,6468682,6468288,394,1280,utRho29
higB,6468960,6468960,6468910,50,182,utRho29
hinT,2323642,2323770,2323642,128,34,utRho29
hipB,3184964,3184964,3184884,80,52,utRho29
hisB,4186720,4186936,4186720,216,306,utRho29
hisJ,4853674,4853674,4853576,98,0,utRho29
hisL,8359856,8359984,8359856,128,272,utRho29
hisS,5281284,5281284,5281150,134,30,utRho29
hlpA,400910,400964,400910,54,84,utRho29
hlyE,2460932,2460932,2460788,144,564,utRho29
hmp,5371594,5371670,5371594,76,6,utRho29
hns,2585916,2585916,2585844,72,3504,utRho29
hofM,7045856,7045856,7045502,354,176,utRho29
hokA,7441620,7441620,7441200,420,372,utRho29
hokC,33902,33902,33806,96,168,utRho29
hokE,1215462,1215672,1215462,210,26,utRho29
holC,8968546,8968546,8968560,14,110,utRho29
holD,9215562,9215606,9215562,44,24,utRho29
holE,3850040,3850216,3850040,176,60,utRho29
hpt,282720,282862,282720,142,228,utRho29
hrpB,324150,324210,324150,60,36,utRho29
hscB,5319048,5319048,5318934,114,112,utRho29
hscC,1367188,1367188,1366786,402,114,utRho29
hsdS,9163004,9163004,9162924,80,536,utRho29
hslJ,2883560,2883560,2883486,74,374,utRho29
hslO,7059344,7059548,7059344,204,41920,utRho29
hslR,7058220,7058696,7058220,476,4804,utRho29
hslV,8244708,8244708,8244574,134,100,utRho29
hsrA,7881412,7881412,7881224,188,48,utRho29
htgA,21286,21660,21286,374,532,utRho29
htpG,989634,990240,989634,606,810,utRho29
htpX,3825236,3825236,3825152,84,12,utRho29
htrE,311036,311036,310852,184,510,utRho29
htrL,7587668,7587668,7587366,302,574,utRho29
hupA,8400352,8400562,8400352,210,18,utRho29
hupB,1845220,1845804,1845220,584,808,utRho29
hyaA,2063968,2064278,2063968,310,38,utRho29
hybO,6292726,6292726,6292522,204,444,utRho29
hycA,5700922,5700922,5700870,52,0,utRho29
hycI,5686204,5686204,5686086,118,1064,utRho29
hydN,5676264,5676264,5676210,54,18,utRho29
hyfA,5202342,5202402,5202342,60,0,utRho29
hypA,11402508,11402588,11402508,80,140,utRho29
hypB,11403356,11404004,11403356,648,472,utRho29
hypF,5676210,5676210,5674850,1360,3360,utRho29
hypT,9116634,9116634,9116578,56,0,utRho29
hyuA,6019660,6020056,6019660,396,96,utRho29
iaaA,1733074,1733136,1733074,62,14,utRho29
iadA,9119074,9119074,9119052,22,90,utRho29
iap,5753072,5753162,5753072,90,64,utRho29
ibaG,6673966,6673966,6673606,360,26,utRho29
ibpA,7735036,7735036,7734844,192,4954,utRho29
ibpB,7733962,7733962,7733794,168,41552,utRho29
icd,2389922,2390246,2389922,324,348,utRho29
iclR,8447304,8447304,8447256,48,64,utRho29
idi,6065876,6066130,6065876,254,38,utRho29
idnD,8988870,8988870,8988812,58,54,utRho29
idnK,8989194,8989246,8989194,52,290,utRho29
ihfA,3591442,3591442,3591104,338,602,utRho29
ihfB,1927498,1927656,1927498,158,558,utRho29
ileS,43666,44782,43666,1116,762,utRho29
ileX,6431194,6431196,6431194,2,0,utRho29
ilvA,15820940,15821324,15820940,384,232,utRho29
ilvC,7915824,7915940,7915824,116,116,utRho29
ilvE,15809552,15809936,15809552,384,220,utRho29
ilvI,170840,171260,170840,420,236,utRho29
ilvL,23701308,23701932,23701308,624,534,utRho29
ilvY,7915734,7915734,7915640,94,232,utRho29
inaA,4698998,4698998,4698944,54,336,utRho29
infA,1853370,1853370,1852886,484,240,utRho29
infC,3602692,3602692,3601276,1416,1360,utRho29
insA-5,3958452,3958452,3958430,22,64,utRho29
insA-7,9036758,9037054,9036758,296,420,utRho29
insC-5,6372080,6372284,6372080,204,464,utRho29
insEF-2,785238,785238,785820,582,216,utRho29
insEF-4,2190310,2190310,2190892,582,220,utRho29
insG,9007098,9007098,9006862,236,88,utRho29
insH-1,550596,550596,550234,362,428,utRho29
insH-11,7306538,7306538,7306396,142,670,utRho29
insH-2,1151548,1151548,1151506,42,302,utRho29
insH-3,1378444,1378444,1378026,418,136,utRho29
insH-4,2791942,2792152,2791942,210,148,utRho29
insH-5,2857852,2857852,2857452,400,110,utRho29
insH-6,4135022,4135022,4134642,380,246,utRho29
insH-7,4206186,4206186,4205822,364,4118,utRho29
insH-9,6260050,6260356,6260050,306,216,utRho29
insI-3,9017372,9017372,9017234,138,118,utRho29
insJ,7441188,7441360,7441188,172,124,utRho29
insK,7442130,7442308,7442130,178,0,utRho29
insL-1,30760,30890,30760,130,6664,utRho29
insL-2,1216112,1216130,1216112,18,102,utRho29
insL-3,5028644,5028662,5028644,18,162,utRho29
insN-1,540452,540484,540452,32,46,utRho29
intD,1132202,1132202,1131956,246,528,utRho29
intR,2826520,2826520,2826470,50,152,utRho29
intS,4933026,4933090,4933026,64,2,utRho29
intZ,5117386,5117542,5117386,156,118,utRho29
iraD,9113152,9113986,9113152,834,656,utRho29
iraM,2424246,2424246,2424006,240,204,utRho29
iraP,802638,802772,802638,134,0,utRho29
iscA,5319924,5319924,5319772,152,530,utRho29
iscR,5324398,5324398,5324262,136,1852,utRho29
iscX,5313834,5313834,5313472,362,278,utRho29
ispF,5743968,5743968,5743560,408,90,utRho29
ispG,5283908,5283908,5283608,300,48,utRho29
ispU,389568,389806,389568,238,6,utRho29
isrA,2811502,2811502,2811618,116,38,utRho29
istr-1,7706384,7706384,7706384,0,0,utRho29
istr-2,7706514,7706514,7706514,0,0,utRho29
ivbL,15412092,15412092,15411952,140,64,utRho29
ivy,480638,480686,480638,48,0,utRho29
katE,3627628,3627734,3627628,106,122,utRho29
katG,8267624,8267670,8267624,46,148,utRho29
kbaZ,6557732,6557828,6557732,96,32,utRho29
kbl,7585154,7585154,7585102,52,342,utRho29
kch,2621046,2621046,2620538,508,124,utRho29
kdgR,3820506,3820506,3820198,308,52,utRho29
kdpE,1443788,1443788,1443466,322,250,utRho29
kdpF,1457698,1457698,1457642,56,0,utRho29
kdsA,2535708,2536330,2535708,622,490,utRho29
kdsC,6683438,6684546,6683438,1108,3682,utRho29
kduI,5968388,5968388,5968248,140,632,utRho29
kefF,94160,94492,94160,332,1670,utRho29
kgtP,5451624,5451624,5451492,132,610,utRho29
kup,7862206,7862632,7862206,426,3040,utRho29
lacI,735076,735076,735020,56,24,utRho29
lacZ,1465508,1465508,1465220,288,1280,utRho29
ldcA,2486394,2486394,2486160,234,112,utRho29
ldhA,2885830,2885830,2885686,144,114,utRho29
ldrA,2538954,2538954,2538550,404,338,utRho29
ldrB,2540024,2540024,2539620,404,76,utRho29
ldrC,2541092,2541092,2540690,402,158,utRho29
ldrD,7400544,7400544,7400174,370,444,utRho29
lepA,5414392,5414392,5414248,144,602,utRho29
lepB,5410928,5410928,5410618,310,1682,utRho29
leuD,159188,159188,158906,282,104,utRho29
leuE,3761600,3761600,3761518,82,124,utRho29
leuL,168048,168048,167416,632,124,utRho29
leuO,168308,168736,168308,428,132,utRho29
leuQ,9212864,9212864,9212802,62,2,utRho29
leuU,6644556,6644556,6644316,240,1680,utRho29
leuV,9212546,9212546,9212330,216,282,utRho29
leuX,8992772,8992810,8992772,38,0,utRho29
lexA,8514174,8514230,8514174,56,122,utRho29
lhr,3456706,3458174,3456706,1468,220,utRho29
ligA,5060402,5060402,5060352,50,0,utRho29
ligB,7642576,7642576,7642340,236,88,utRho29
lipA,1320602,1320602,1320432,170,206,utRho29
lipB,1324802,1324802,1324556,246,4882,utRho29
lit,2397032,2397390,2397032,358,364,utRho29
livJ,7199524,7199524,7199316,208,2924,utRho29
livK,7195510,7195510,7195120,390,1506,utRho29
lldP,7554578,7554798,7554578,220,362,utRho29
lnt,1381968,1381968,1381762,206,256,utRho29
loiP,6163784,6163826,6163784,42,10,utRho29
lolA,1874656,1874738,1874656,82,78,utRho29
lolB,2527112,2527112,2527000,112,14,utRho29
lolC,2350748,2350854,2350748,106,0,utRho29
lon,917630,917776,917630,146,170,utRho29
lpcA,486936,487086,486936,150,0,utRho29
lpd,255434,255824,255434,390,580,utRho29
lplA,9248476,9248476,9248234,242,772,utRho29
lplT,5947878,5947878,5947724,154,72,utRho29
lpoA,6586422,6586800,6586422,378,198,utRho29
lpp,3514592,3514842,3514592,250,258,utRho29
lptA,6686598,6686760,6686598,162,90,utRho29
lptB,6686792,6687888,6686792,1096,1350,utRho29
lptD,114672,114672,114218,454,276,utRho29
lptF,8972244,8972436,8972244,192,0,utRho29
lpxC,213016,213114,213016,98,1152,utRho29
lpxD,401920,401942,401920,22,0,utRho29
lpxL,2233418,2233418,2233164,254,174,utRho29
lpxM,3880456,3880456,3880386,70,0,utRho29
lpxP,4991156,4991290,4991156,134,142,utRho29
lrhA,4813312,4813312,4813282,30,40,utRho29
lrp,1864656,1865190,1864656,534,744,utRho29
lspA,50028,50414,50028,386,506,utRho29
lsrA,3202920,3202980,3202920,60,46,utRho29
lsrR,3202514,3202514,3202482,32,368,utRho29
ltaE,1818640,1818640,1818588,52,0,utRho29
luxS,5630130,5630130,5629466,664,1172,utRho29
lysA,5957902,5957902,5957798,104,16,utRho29
lysC,8467232,8467232,8466466,766,460,utRho29
lysP,4497120,4497120,4497064,56,140,utRho29
lysR,5957900,5958042,5957900,142,0,utRho29
lysT,1561028,1561108,1561028,80,4,utRho29
lysU,8709610,8709610,8709434,176,70,utRho29
macB,1840188,1840694,1840188,506,660,utRho29
maeA,3111484,3111484,3111338,146,404,utRho29
mak,820236,820288,820236,52,0,utRho29
malE,8492928,8492928,8492838,90,14,utRho29
malI,3398456,3398456,3398360,96,0,utRho29
malK,8493472,8493568,8493472,96,66,utRho29
malP,7105020,7105020,7104946,74,616,utRho29
malQ,7100798,7100798,7100140,658,562,utRho29
malS,14949880,14949988,14949880,108,12,utRho29
malT,7106048,7106170,7106048,122,172,utRho29
malX,3398626,3398710,3398626,84,2,utRho29
malZ,1689980,1690072,1689980,92,0,utRho29
manA,3377102,3377152,3377102,50,0,utRho29
manX,3803866,3804096,3803866,230,36,utRho29
marC,3237882,3237882,3237816,66,140,utRho29
marR,3238186,3238240,3238186,54,0,utRho29
matP,2036918,2036970,2036918,52,0,utRho29
mazE,5822736,5822736,5822678,58,70,utRho29
mazG,5821720,5821720,5821370,350,1760,utRho29
mcbA,1684306,1684306,1684112,194,22,utRho29
mcbR,3040192,3040524,3040192,332,0,utRho29
mcrA,2420278,2420692,2420278,414,168,utRho29
mcrC,9156124,9156124,9155916,208,364,utRho29
mdaB,6344814,6345060,6344814,246,22,utRho29
mdfA,1767138,1767346,1767138,208,266,utRho29
mdh,6768940,6768940,6768536,404,92,utRho29
mdoB,9198988,9198988,9198882,106,156,utRho29
mdoD,2993290,2993712,2993290,422,0,utRho29
mdoG,2218514,2218670,2218514,156,140,utRho29
mdtA,4307958,4308032,4307958,74,0,utRho29
mdtE,7318168,7318464,7318168,296,1572,utRho29
mdtK,3486538,3486914,3486538,376,542,utRho29
mdtP,8602472,8602472,8602060,412,830,utRho29
melA,8683774,8683822,8683774,48,0,utRho29
melR,8683300,8683300,8683256,44,458,utRho29
menA,8240812,8240812,8240698,114,12,utRho29
menB,4753774,4753774,4753638,136,24,utRho29
mepH,3468714,3468870,3468714,156,0,utRho29
mepM,3883666,3883666,3883270,396,96,utRho29
mepS,4539840,4539958,4539840,118,14,utRho29
metA,8428318,8428560,8428318,242,36,utRho29
metB,8257272,8257344,8257272,72,468,utRho29
metC,6304150,6304472,6304150,322,338,utRho29
metE,8025768,8026106,8025768,338,4,utRho29
metF,8265092,8265232,8265092,140,54,utRho29
metG,4388538,4388600,4388538,62,48,utRho29
metH,8447010,8447656,8447010,646,592,utRho29
metJ,8257116,8257116,8256790,326,246,utRho29
metK,6173154,6173412,6173154,258,302,utRho29
metN,445428,445428,445290,138,42,utRho29
metR,8025710,8025710,8025632,78,0,utRho29
metT,1394326,1394326,1394266,60,10,utRho29
metY,19910250,19910250,19909734,516,618,utRho29
metZ,11789528,11789548,11789528,20,116,utRho29
mfd,2348056,2348056,2347928,128,50,utRho29
mglA,4478782,4478782,4478578,204,26,utRho29
mglB,4481132,4481132,4480696,436,8048,utRho29
mglC,4475918,4475918,4475506,412,92,utRho29
mgrB,3817584,3817584,3817532,52,54,utRho29
mgrR,3245828,3245828,3245828,0,0,utRho29
mgsA,2054082,2054082,2054030,52,78,utRho29
mgtL,8934560,8934862,8934560,302,128,utRho29
mhpA,737038,737222,737038,184,188,utRho29
mhpR,737072,737072,736840,232,112,utRho29
mhpT,750772,750918,750772,146,0,utRho29
miaA,8797964,8798504,8797964,540,344,utRho29
micA,5629604,5629604,5629604,0,0,utRho29
micC,2874242,2874238,2874242,4,0,utRho29
micF,4626168,4626168,4626168,0,0,utRho29
micM,1014408,1014408,1014408,0,0,utRho29
minE,2449422,2449422,2449090,332,436,utRho29
mioC,7852950,7852950,7852910,40,30,utRho29
mipA,3733012,3733012,3732944,68,722,utRho29
mlaA,4930270,4930270,4930014,256,188,utRho29
mlc,3337206,3337206,3337128,78,94,utRho29
mlrA,4429498,4429732,4429498,234,182,utRho29
mltA,5894546,5894546,5894356,190,72,utRho29
mltD,468050,468050,467910,140,164,utRho29
mltF,5391534,5391602,5391534,68,58,utRho29
mmuP,550238,550650,550238,412,450,utRho29
mngA,1531622,1531968,1531622,346,60,utRho29
mngR,1531852,1531852,1531750,102,58,utRho29
mnmG,7851348,7851348,7851266,82,368,utRho29
mntH,5025470,5025470,5025412,58,0,utRho29
mntP,3810918,3811376,3810918,458,196,utRho29
mntR,1706160,1706366,1706160,206,0,utRho29
mntS,1706128,1706128,1705994,134,0,utRho29
moaA,1633654,1634088,1633654,434,142,utRho29
moaB,1635954,1636110,1635954,156,6,utRho29
mobA,8084242,8084242,8083998,244,102,utRho29
mocA,6030112,6030320,6030112,208,50,utRho29
modA,1589990,1590178,1589990,188,88,utRho29
moeA,1732788,1732788,1732728,60,38,utRho29
mokB,2984610,2984610,2984258,352,48,utRho29
molR_1,4392888,4392948,4392888,60,10,utRho29
motA,3954604,3954604,3954278,326,96,utRho29
mpaA,2781278,2781278,2781196,82,132,utRho29
mpl,8911456,8911570,8911456,114,110,utRho29
mppA,2786108,2786454,2786108,346,8,utRho29
mprA,5621494,5621540,5621494,46,36,utRho29
mqo,4613848,4613848,4613508,340,0,utRho29
mqsA,6336742,6336742,6336492,250,736,utRho29
mqsR,6337306,6337306,6337088,218,798,utRho29
mraZ,179192,179268,179192,76,752,utRho29
mrcA,7045652,7045742,7045652,90,40,utRho29
mrcB,329442,329460,329442,18,0,utRho29
mreB,13605424,13605424,13604348,1076,884,utRho29
mreD,6798166,6798166,6797750,416,292,utRho29
mrp,4388360,4388360,4388336,24,54,utRho29
mscK,972984,973072,972984,88,124,utRho29
mscL,6876002,6876048,6876002,46,576,utRho29
mscS,6139742,6139742,6139614,128,182,utRho29
msrA,8884522,8884522,8884352,170,1860,utRho29
msrB,3725168,3725168,3724858,310,72,utRho29
msyB,2228426,2228426,2228362,64,26,utRho29
mtfA,4087236,4087302,4087236,66,238,utRho29
mtgA,6699662,6699662,6699618,44,888,utRho29
mtlA,30177504,30178248,30177504,744,9176,utRho29
mtn,358366,358366,358306,60,340,utRho29
mtr,6611864,6611864,6611634,230,102,utRho29
mug,6430992,6430992,6430946,46,1432,utRho29
murQ,5091466,5091546,5091466,80,346,utRho29
murR,5091586,5091586,5091218,368,844,utRho29
mutH,5939164,5939324,5939164,160,348,utRho29
mutL,8794092,8794824,8794092,732,350,utRho29
mutM,7622554,7622554,7622304,250,272,utRho29
mutS,5714038,5714186,5714038,148,658,utRho29
mutY,18617466,18618078,18617466,612,0,utRho29
nac,4123956,4123956,4123866,90,82,utRho29
nadA,1564122,1564170,1564122,48,0,utRho29
nadB,5420714,5420840,5420714,126,90,utRho29
nadC,237326,237326,237290,36,158,utRho29
nadE,3644604,3644916,3644604,312,0,utRho29
nadK,5501526,5501662,5501526,136,44,utRho29
nagA,1406350,1406350,1405502,848,1468,utRho29
nagB,1407416,1407416,1407222,194,164,utRho29
nagC,1404016,1404016,1403188,828,128,utRho29
nagE,1407680,1407888,1407680,208,862,utRho29
nagK,2357080,2357186,2357080,106,70,utRho29
nanA,6747240,6747240,6747152,88,366,utRho29
nanC,9079856,9079856,9079002,854,514,utRho29
nanR,6749406,6749406,6748978,428,696,utRho29
nanS,9075406,9075406,9075188,218,2,utRho29
napF,4607390,4607390,4606994,396,12,utRho29
narG,2559614,2559728,2559614,114,224,utRho29
narK,2555642,2555914,2555642,272,276,utRho29
narP,4580844,4581000,4580844,156,92,utRho29
narQ,5171154,5171462,5171154,308,228,utRho29
narU,3088326,3088326,3088120,206,176,utRho29
narW,3077374,3077374,3074618,2756,760,utRho29
narX,2555554,2555554,2555236,318,280,utRho29
narZ,3085380,3085380,3085180,200,0,utRho29
ndh,2331984,2332170,2331984,186,674,utRho29
ndk,5289920,5289920,5289728,192,206,utRho29
nemR,6904084,6904092,6904084,8,152,utRho29
nepI,7683542,7683542,7683478,64,72,utRho29
nfo,4501612,4501680,4501612,68,0,utRho29
nfsB,1210906,1210906,1210848,58,0,utRho29
nfuA,7090916,7091248,7090916,332,618,utRho29
nhaA,34634,34978,34634,344,424,utRho29
nhaB,2469534,2469534,2469434,100,122,utRho29
nhoA,3067926,3068048,3067926,122,0,utRho29
nikA,7226878,7227334,7226878,456,538,utRho29
nikR,7237074,7237176,7237074,102,102,utRho29
nirB,6987974,6988022,6987974,48,28,utRho29
nlpA,7680034,7680034,7679986,48,0,utRho29
nlpC,3585654,3585654,3585462,192,40,utRho29
nlpD,5737658,5737658,5737506,152,148,utRho29
nlpI,6618080,6618080,6617848,232,62,utRho29
nmpC,1153740,1153740,1153650,90,0,utRho29
nohA,3273206,3273206,3272734,472,316,utRho29
norR,5664614,5664614,5664578,36,338,utRho29
norV,5664878,5664952,5664878,74,406,utRho29
nrdA,4689510,4689730,4689510,220,8408,utRho29
nrdD,8925676,8925676,8925320,356,200,utRho29
nrdH,5601312,5601446,5601312,134,570,utRho29
nrdR,865954,866004,865954,50,0,utRho29
nrfA,8575342,8575528,8575342,186,96,utRho29
nsrR,8812088,8812380,8812088,292,182,utRho29
nudB,3897348,3897348,3897264,84,0,utRho29
nudC,8393428,8393806,8393428,378,70,utRho29
nudE,7052658,7052658,7052298,360,128,utRho29
nudG,3682876,3682980,3682876,104,0,utRho29
nudI,4729050,4729108,4729050,58,0,utRho29
nudJ,2388874,2388874,2388576,298,70,utRho29
nuoA,4810670,4810670,4810144,526,5518,utRho29
nuoN,4783434,4783434,4783010,424,236,utRho29
nupC,5026018,5026084,5026018,66,2,utRho29
nupG,6211302,6211428,6211302,126,22,utRho29
ogrK,4335096,4335096,4335040,56,0,utRho29
ogt,2800568,2800568,2800472,96,216,utRho29
ohsC,5401036,5401040,5401036,4,382,utRho29
ompA,2040382,2040382,2040106,276,5368,utRho29
ompC,4625774,4625774,4625498,276,348,utRho29
ompF,1974184,1974184,1973964,220,2,utRho29
ompL,8128958,8128958,8128590,368,600,utRho29
ompN,2874158,2874158,2873786,372,0,utRho29
ompR,7073510,7073510,7073168,342,166,utRho29
ompT,1171330,1171330,1171266,64,0,utRho29
ompW,2627982,2628040,2627982,58,122,utRho29
ompX,1700418,1700900,1700418,482,828,utRho29
omrA,5952378,5952378,5952378,0,0,utRho29
omrB,5952770,5952770,5952770,0,0,utRho29
oppA,2602170,2602364,2602170,194,278,utRho29
orn,8783168,8783208,8783168,40,168,utRho29
osmB,2686952,2686952,2686656,296,540,utRho29
osmC,3113192,3113250,3113192,58,278,utRho29
osmE,3644566,3644566,3644512,54,0,utRho29
osmF,4439046,4439046,4438962,84,104,utRho29
osmY,9222306,9222792,9222306,486,72,utRho29
otsA,3963302,3963302,3963224,78,0,utRho29
otsB,3964930,3964930,3964774,156,496,utRho29
oxc,4984288,4984288,4983900,388,376,utRho29
oxyR,8316914,8316980,8316914,66,246,utRho29
oxyS,8316788,8316788,8316788,0,0,utRho29
paaA,2907730,2907854,2907730,124,2,utRho29
paaX,2927018,2927078,2927018,60,0,utRho29
paaZ,2907340,2907340,2907284,56,0,utRho29
pabA,6981702,6981702,6981658,44,60,utRho29
pabB,3789256,3789610,3789256,354,242,utRho29
pabC,2306186,2306600,2306186,414,162,utRho29
pagP,1313052,1313114,1313052,62,52,utRho29
panB,299260,299260,299202,58,1050,utRho29
panC,297840,297840,297590,250,50,utRho29
panD,293490,293490,293388,102,106,utRho29
panZ,7195656,7195968,7195656,312,178,utRho29
parC,6332060,6332060,6331946,114,300,utRho29
patA,6438916,6438988,6438916,72,172,utRho29
patD,3030830,3031156,3030830,326,40,utRho29
pbpC,5294986,5294986,5294650,336,0,utRho29
pbpG,4450132,4450132,4449740,392,96,utRho29
pck,7065358,7065636,7065358,278,1374,utRho29
pcnB,318782,318782,318252,530,126,utRho29
pdhR,244068,244184,244068,116,4,utRho29
pdxB,4875768,4875768,4875702,66,0,utRho29
pdxH,3436068,3436068,3436014,54,2,utRho29
pdxJ,5403626,5403626,5403458,168,370,utRho29
pdxK,5074638,5074638,5074474,164,68,utRho29
pepA,8972278,8972278,8971902,376,18,utRho29
pepD,511618,511618,511432,186,626,utRho29
pepN,1981182,1981244,1981182,62,1530,utRho29
pepQ,8062294,8062322,8062294,28,48,utRho29
pepT,2371646,2371688,2371646,42,26,utRho29
pfkA,8214948,8215104,8214948,156,134,utRho29
pfkB,3612646,3612740,3612646,94,0,utRho29
pflA,1902456,1902456,1902160,296,24,utRho29
pflB,1907850,1907850,1907108,742,288,utRho29
pflD,8287716,8287990,8287716,274,0,utRho29
pgaA,2185046,2185046,2184578,468,626,utRho29
pgi,8467444,8467516,8467444,72,60,utRho29
pgk,12291428,12291428,12290488,940,1544,utRho29
pgl,1597078,1597172,1597078,94,68,utRho29
pgpB,2678324,2678660,2678324,336,342,utRho29
pgpC,5397276,5397276,5397100,176,32,utRho29
pgrR,2783744,2783982,2783744,238,328,utRho29
pheL,5475158,5475198,5475158,40,0,utRho29
pheM,7197204,7197204,7197080,124,0,utRho29
pheP,1203858,1203918,1203858,60,32,utRho29
pheU,8725254,8725254,8725252,2,4,utRho29
pheV,6220730,6220732,6220730,2,0,utRho29
phnC,8650412,8650412,8650330,82,72,utRho29
phoA,803414,803494,803414,80,226,utRho29
phoB,834202,834284,834202,82,118,utRho29
phoE,520316,520316,520200,116,142,utRho29
phoH,2169730,2169984,2169730,254,20,utRho29
phoP,2381016,2381016,2380894,122,662,utRho29
phoQ,2379880,2379880,2379552,328,82,utRho29
phoU,7815330,7815330,7815156,174,58,utRho29
phr,1478842,1479014,1478842,172,68,utRho29
pinE,2419054,2419370,2419054,316,70,utRho29
pinQ,3267168,3267244,3267168,76,0,utRho29
pinR,2867424,2867424,2867348,76,2,utRho29
pitA,7275224,7275284,7275224,60,20,utRho29
pitB,6272806,6272806,6272742,64,0,utRho29
pka,5439862,5439906,5439862,44,0,utRho29
plaP,4174476,4174476,4174124,352,316,utRho29
pldA,8009628,8009724,8009628,96,640,utRho29
pldB,8018028,8018340,8018028,312,554,utRho29
plsB,8513196,8513196,8512932,264,274,utRho29
pmbA,8915890,8915918,8915890,28,86,utRho29
pmrD,4747148,4747148,4747076,72,0,utRho29
pncB,1980828,1980828,1980712,116,210,utRho29
pncC,5648788,5648788,5648692,96,8,utRho29
pnp,6622652,6622652,6622336,316,186,utRho29
pntA,3355950,3355950,3355806,144,30,utRho29
pntB,3353096,3353096,3352720,376,638,utRho29
polA,8093880,8093932,8093880,52,76,utRho29
polB,131606,131606,131560,46,0,utRho29
potD,2365700,2365700,2365658,42,0,utRho29
potE,1436688,1436688,1436530,158,26,utRho29
potF,1787268,1787568,1787268,300,68,utRho29
poxB,1822152,1822152,1822098,54,38,utRho29
ppa,8899372,8899372,8899304,68,44,utRho29
ppc,8306380,8306380,8306196,184,1122,utRho29
ppdA,5928440,5928440,5928354,86,126,utRho29
ppdD,235410,235410,235098,312,284,utRho29
pphA,3846770,3846770,3845938,832,794,utRho29
pphB,5719474,5719520,5719474,46,32,utRho29
ppiA,6984898,6984898,6984594,304,132,utRho29
ppiC,7919682,7919682,7919626,56,60,utRho29
ppiD,923638,923830,923638,192,46,utRho29
ppk,5245748,5246088,5245748,340,146,utRho29
pppA,6228958,6228958,6228704,254,124,utRho29
ppsA,3574322,3574322,3574224,98,0,utRho29
ppsR,3574678,3574890,3574678,212,0,utRho29
pptA,3065716,3066104,3065716,388,286,utRho29
pqiA,2023318,2024002,2023318,684,102,utRho29
prc,3830054,3830054,3829632,422,1030,utRho29
preT,4467978,4468066,4467978,88,104,utRho29
prfC,9218688,9218828,9218688,140,0,utRho29
prkB,6968622,6968980,6968622,358,236,utRho29
prlC,7290476,7290476,7290364,112,576,utRho29
prlF,6553944,6554004,6553944,60,334,utRho29
proB,520432,520776,520432,344,224,utRho29
proC,811372,811372,811288,84,26,utRho29
proK,7417388,7417388,7417384,4,0,utRho29
proL,4572414,4572422,4572414,8,22,utRho29
proP,8660640,8661004,8660640,364,366,utRho29
proS,437674,437674,437550,124,0,utRho29
proV,5609126,5609630,5609126,504,392,utRho29
prpB,697292,697364,697292,72,26,utRho29
prpR,696942,696942,696886,56,34,utRho29
prs,2524354,2524354,2523750,604,4588,utRho29
psd,8781276,8781276,8780720,556,588,utRho29
psiE,8480600,8480650,8480600,50,0,utRho29
pspA,2736076,2736158,2736076,82,0,utRho29
pspF,2736080,2736080,2735824,256,0,utRho29
pspG,8525632,8525680,8525632,48,28,utRho29
pssA,5445156,5445454,5445156,298,1062,utRho29
pstB,7817112,7817112,7816732,380,38,utRho29
pstC,7821084,7821084,7820796,288,134,utRho29
pstS,23469408,23469408,23469150,258,12,utRho29
psuG,4517114,4517114,4516734,380,1610,utRho29
psuT,4514992,4514992,4514670,322,130,utRho29
pth,2517084,2517084,2517026,58,18,utRho29
ptrA,5918022,5918022,5917768,254,56,utRho29
ptrB,3857730,3857730,3857678,52,148,utRho29
ptsG,2315252,2315738,2315252,486,308,utRho29
ptsH,5066996,5067528,5066996,532,358,utRho29
purA,8809328,8809374,8809328,46,354,utRho29
purC,5195562,5195562,5195236,326,4,utRho29
purD,8411972,8411972,8411862,110,0,utRho29
purE,1106284,1106284,1106200,84,108,utRho29
purH,8415254,8415254,8415064,190,116,utRho29
purL,5391178,5391178,5391086,92,1244,utRho29
purM,5242306,5242394,5242306,88,80,utRho29
purR,3475378,3475688,3475378,310,42,utRho29
purT,3861438,3861762,3861438,324,28,utRho29
purU,2577512,2577512,2577248,264,158,utRho29
putA,2157850,2157850,2157764,86,58,utRho29
putP,2158336,2158610,2158336,274,134,utRho29
puuA,2721936,2721936,2721816,120,0,utRho29
puuC,2725456,2725486,2725456,30,50,utRho29
puuD,2722104,2722240,2722104,136,0,utRho29
puuP,2718746,2718746,2718374,372,122,utRho29
pykA,3874988,3875298,3874988,310,84,utRho29
pykF,3510934,3511396,3510934,462,42,utRho29
pyrC,2245286,2245286,2245214,72,230,utRho29
pyrD,2009464,2009536,2009464,72,324,utRho29
pyrE,7631970,7631970,7631536,434,80,utRho29
pyrF,2683740,2683842,2683740,102,588,utRho29
pyrG,5819594,5819594,5819332,262,638,utRho29
pyrH,383624,383710,383624,86,306,utRho29
pyrL,8945490,8945490,8945066,424,304,utRho29
qmcA,1031646,1031646,1031546,100,486,utRho29
qor,8528608,8528608,8528462,146,266,utRho29
qseB,6339502,6339656,6339502,154,92,utRho29
queA,849970,850022,849970,52,72,utRho29
queE,5811212,5811212,5810836,376,90,utRho29
queF,5850642,5850696,5850642,54,112,utRho29
queG,8788184,8788184,8788134,50,606,utRho29
racC,2835630,2835630,2835526,104,0,utRho29
racR,2840898,2840898,2840482,416,884,utRho29
raiA,5474208,5474308,5474208,100,72,utRho29
rarD,8008594,8008594,8008356,238,576,utRho29
ravA,7862256,7862256,7862186,70,538,utRho29
rayT,495088,495274,495088,186,244,utRho29
rbn,4763162,4763216,4763162,54,160,utRho29
rbsD,7866644,7866702,7866644,58,0,utRho29
rcnA,4371654,4371834,4371654,180,94,utRho29
rcnB,4373768,4373920,4373768,152,264,utRho29
rcnR,4371806,4371806,4371592,214,168,utRho29
rcsA,4047672,4047936,4047672,264,134,utRho29
rcsB,4631390,4632354,4631390,964,338,utRho29
rcsC,4640162,4640162,4639656,506,60,utRho29
rcsD,4626904,4626976,4626904,72,64,utRho29
rdgB,6193240,6193362,6193240,122,104,utRho29
rdlA,2538646,2538646,2538646,0,0,utRho29
rdlB,2539712,2539716,2539712,4,0,utRho29
rdlC,2540782,2540786,2540782,4,0,utRho29
rdlD,7400272,7400272,7400272,0,0,utRho29
rdoA,8084782,8084830,8084782,48,28,utRho29
recA,11295276,11295276,11295076,200,788,utRho29
recC,5925014,5925014,5924856,158,36,utRho29
recF,7763722,7763722,7762442,1280,1700,utRho29
recN,5503518,5503590,5503518,72,0,utRho29
recQ,8011666,8011728,8011666,62,146,utRho29
relA,5828554,5828554,5827302,1252,268,utRho29
relB,3291806,3291806,3291744,62,0,utRho29
rem,3289950,3289950,3289804,146,138,utRho29
rep,7921294,7921354,7921294,60,124,utRho29
rfaD,7587730,7587974,7587730,244,748,utRho29
rfaE,6393852,6393852,6393506,346,56,utRho29
rfaH,8049930,8049930,8049642,288,796,utRho29
rfbX,4219436,4219436,4219168,268,824,utRho29
rfe,7935600,7935832,7935600,232,744,utRho29
rhaB,8194944,8194944,8194896,48,182,utRho29
rhaD,8188770,8188770,8188544,226,28,utRho29
rhaS,8195422,8195472,8195422,50,0,utRho29
rhaT,8201132,8201132,8201050,82,496,utRho29
rhlE,1661566,1661744,1661566,178,196,utRho29
rhoL,47593944,47594772,47593944,828,2412,utRho29
rhsB,7238006,7238384,7238006,378,24,utRho29
rhsC,1458758,1459166,1458758,408,78,utRho29
rhsD,1046132,1046522,1046132,390,238,utRho29
rhtA,1700608,1700608,1700194,414,1324,utRho29
rhtC,8015478,8015514,8015478,36,22,utRho29
ribA,2678468,2678468,2678320,148,228,utRho29
ribC,3486916,3486916,3486484,432,992,utRho29
ribE,869008,869294,869008,286,2942,utRho29
ribF,42766,42814,42766,48,152,utRho29
ridA,8941892,8941892,8941826,66,10,utRho29
rihA,1369204,1369204,1368824,380,442,utRho29
rihB,4510504,4510504,4510372,132,130,utRho29
rimJ,2251044,2251124,2251044,80,110,utRho29
rimK,1783752,1783934,1783752,182,30,utRho29
rimL,2997486,2997876,2997486,390,108,utRho29
rimO,1756140,1756140,1756070,70,80,utRho29
rimP,6636350,6636350,6636012,338,500,utRho29
rlmA,3814172,3814172,3814120,52,0,utRho29
rlmD,5830086,5830086,5830000,86,0,utRho29
rlmE,6655520,6655520,6655328,192,396,utRho29
rlmF,1684384,1684664,1684384,280,220,utRho29
rlmG,6471784,6471784,6471750,34,52,utRho29
rlmI,2060002,2060002,2059938,64,254,utRho29
rlmJ,7290700,7290770,7290700,70,24,utRho29
rlmL,2015344,2015688,2015344,344,590,utRho29
rlpA,1330444,1330444,1330380,64,106,utRho29
rluA,120900,120900,120692,208,12,utRho29
rluF,8460324,8460708,8460324,384,28,utRho29
rmf,2031006,2031430,2031006,424,626,utRho29
rna,1290068,1290068,1290006,62,0,utRho29
rnb,2698258,2698258,2697824,434,714,utRho29
rnc,10816892,10816892,10816252,640,52580,utRho29
rnd,3776122,3776122,3775982,140,0,utRho29
rne,2289746,2289746,2288734,1012,2540,utRho29
rnhA,472082,472082,472004,78,404,utRho29
rnk,1288360,1288360,1287934,426,44,utRho29
rnlA,5531788,5531836,5531788,48,82,utRho29
rnlB,5533414,5533968,5533414,554,706,utRho29
rnpB,19623552,19623552,19623552,0,0,utRho29
rob,9270706,9270706,9270620,86,116,utRho29
rodZ,5285868,5285868,5285688,180,62,utRho29
rpe,7030306,7030306,7030118,188,52,utRho29
rph,15266320,15266320,15266196,124,480,utRho29
rpiA,6118706,6118706,6118650,56,4,utRho29
rpiB,8626514,8626700,8626514,186,498,utRho29
rpiR,8626274,8626274,8625982,292,22,utRho29
rplJ,8359246,8359992,8359246,746,5258,utRho29
rplK,8356708,8356894,8356708,186,204,utRho29
rplM,6757344,6757344,6757302,42,2276,utRho29
rplN,6896444,6896444,6896298,146,696,utRho29
rplS,5489284,5489284,5489060,224,7328,utRho29
rplT,7199052,7199052,7198996,56,188,utRho29
rplU,6667036,6667036,6666902,134,108,utRho29
rplY,4564866,4565034,4564866,168,108,utRho29
rpmA,6666450,6666450,6666238,212,346,utRho29
rpmB,15247980,15247980,15246696,1284,42464,utRho29
rpmE,8253816,8254026,8253816,210,290,utRho29
rpmF,2294676,2294734,2294676,58,9156,utRho29
rpmH,7768130,7768672,7768130,542,2082,utRho29
rpmI,3600854,3600854,3599998,856,4900,utRho29
rpoB,8362126,8362490,8362126,364,144,utRho29
rpoD,6424946,6426094,6424946,1148,27336,utRho29
rpoE,5420372,5420372,5420024,348,16,utRho29
rpoH,7202006,7202006,7201566,440,1994,utRho29
rpoN,6689324,6689434,6689324,110,166,utRho29
rpoS,5736236,5736236,5735102,1134,1810,utRho29
rpoZ,7644154,7644212,7644154,58,102,utRho29
rppH,5937986,5937986,5937954,32,268,utRho29
rprA,3540744,3540744,3540744,0,0,utRho29
rpsA,1923434,1923990,1923434,556,23026,utRho29
rpsF,8850050,8850236,8850050,186,6268,utRho29
rpsI,6756580,6756580,6756414,166,5100,utRho29
rpsJ,6906884,6906884,6906540,344,1580,utRho29
rpsL,6949242,6949242,6949104,138,934,utRho29
rpsM,6885130,6885130,6884942,188,306,utRho29
rpsO,13247144,13247144,13246736,408,84,utRho29
rpsP,5492508,5492508,5492370,138,0,utRho29
rpsT,42420,42420,42156,264,168,utRho29
rpsU,12842584,12843124,12842584,540,2940,utRho29
rraA,8238716,8238716,8238660,56,216,utRho29
rraB,8956768,8956946,8956768,178,70,utRho29
rrsA,8070478,8071062,8070478,584,1306,utRho29
rrsB,16665468,16666636,16665468,1168,2592,utRho29
rrsC,7883032,7883616,7883032,584,626,utRho29
rrsD,6858094,6858094,6857524,570,378,utRho29
rrsE,8415726,8416294,8415726,568,504,utRho29
rrsG,5462896,5462896,5462314,582,1278,utRho29
rrsH,446970,447542,446970,572,472,utRho29
rsd,8393908,8393908,8393616,292,140,utRho29
rseA,5419264,5419264,5418808,456,598,utRho29
rseP,392940,393092,392940,152,246,utRho29
rseX,4067298,4067298,4067298,0,0,utRho29
rsfS,1338144,1338144,1338072,72,66,utRho29
rsgA,8783132,8783132,8783018,114,72,utRho29
rsmA,105176,105176,104860,316,128,utRho29
rsmB,6869982,6870414,6869982,432,138,utRho29
rsmC,9215736,9215736,9215400,336,84,utRho29
rsmD,7208594,7208786,7208594,192,118,utRho29
rsmE,6182036,6182268,6182036,232,136,utRho29
rsmG,7847512,7847512,7847360,152,96,utRho29
rsmH,180020,180188,180020,168,0,utRho29
rsmI,6587106,6587106,6586670,436,382,utRho29
rssA,2578212,2578412,2578212,200,0,utRho29
rssB,2580440,2580484,2580440,44,106,utRho29
rstA,3364276,3364300,3364276,24,0,utRho29
rsuA,4561096,4561096,4560966,130,40,utRho29
rsxA,3411510,3411534,3411510,24,228,utRho29
rtcA,7114004,7114004,7113698,306,644,utRho29
rtcB,7116214,7116214,7116158,56,8,utRho29
rtn,4541356,4541452,4541356,96,0,utRho29
rutA,2148052,2148052,2148022,30,66,utRho29
rutG,2140090,2140090,2139678,412,68,utRho29
rutR,2148226,2148484,2148226,258,282,utRho29
ruvA,7784096,7784096,7783904,192,0,utRho29
ruvB,7782176,7782176,7781424,752,320,utRho29
ruvC,3894878,3894878,3894752,126,42,utRho29
rybB,1776114,1776114,1776114,0,0,utRho29
rydB,3529860,3529860,3529322,538,394,utRho29
rydC,2983012,2983012,2983012,0,0,utRho29
ryfA,5307398,5307710,5307398,312,0,utRho29
ryfD,5468590,5468590,5468590,0,0,utRho29
ryhB,7162032,7162032,7162032,0,0,utRho29
ryjA,8556132,8556132,8556132,0,0,utRho29
ryjB,9055954,9055954,9055954,0,0,utRho29
sad,3229598,3229598,3229406,192,64,utRho29
safA,3168056,3168056,3167918,138,98,utRho29
sanA,4465368,4465756,4465368,388,0,utRho29
sapF,2705314,2705314,2705268,46,0,utRho29
sbcB,4165456,4165512,4165456,56,20,utRho29
sbcC,831694,831694,831506,188,0,utRho29
sbcD,833954,833954,833904,50,156,utRho29
sbmA,793106,793278,793106,172,950,utRho29
sbmC,4162650,4162650,4162524,126,0,utRho29
sdaA,3793618,3793864,3793618,246,450,utRho29
sdaC,5856070,5856458,5856070,388,16308,utRho29
sdhC,1509916,1510354,1509916,438,8770,utRho29
sdhD,1510808,1511120,1510808,312,196,utRho29
sdiA,3993834,3993834,3993664,170,142,utRho29
secE,8354354,8354716,8354354,362,746,utRho29
secG,6645180,6645180,6645010,170,288,utRho29
selA,7522594,7522594,7522498,96,30,utRho29
selB,7519850,7519850,7519722,128,64,utRho29
selC,7672396,7672444,7672396,48,46,utRho29
selD,3696058,3696058,3696016,42,1078,utRho29
seqA,1425884,1425974,1425884,90,16,utRho29
serA,6117098,6117098,6116820,278,0,utRho29
serB,9249712,9249790,9249712,78,72,utRho29
serC,3830380,3830612,3830380,232,144,utRho29
serS,1878730,1878856,1878730,126,422,utRho29
serT,2063438,2063438,2063424,14,0,utRho29
serU,4087124,4087124,4087114,10,52,utRho29
serV,5637394,5637394,5637290,104,36,utRho29
serW,1852014,1852014,1851942,72,100,utRho29
serX,2195352,2195352,2195304,48,0,utRho29
setB,4527426,4527726,4527426,300,32,utRho29
setC,7673488,7673906,7673488,418,598,utRho29
sfmA,1116124,1116424,1116124,300,170,utRho29
sfmC,1117606,1117948,1117606,342,22,utRho29
sfsA,323030,323030,322972,58,68,utRho29
sfsB,6669592,6669818,6669592,226,58,utRho29
sgrR,154676,154676,154598,78,128,utRho29
sgrS,154734,154734,154734,0,0,utRho29
shiA,4107068,4107286,4107068,218,0,utRho29
sibA,4306622,4306622,4306622,0,0,utRho29
sibB,4307292,4307292,4307292,0,0,utRho29
sibC,6113702,6113702,6113702,0,0,utRho29
sibD,6389730,6389730,6389730,0,0,utRho29
sibE,6390480,6390480,6390480,0,0,utRho29
sixA,4913998,4913998,4913624,374,4,utRho29
slp,7307872,7307922,7307872,50,156,utRho29
slt,9261400,9261466,9261400,66,0,utRho29
slyA,3442028,3442028,3441648,380,26,utRho29
slyB,3439496,3439752,3439496,256,108,utRho29
slyD,6957398,6957398,6956994,404,226,utRho29
slyX,6954862,6955280,6954862,418,5642,utRho29
smf,6867372,6867372,6867120,252,150,utRho29
smpB,5509534,5509792,5509534,258,1204,utRho29
smrA,2811872,2811958,2811872,86,432,utRho29
smrB,4896872,4897212,4896872,340,260,utRho29
smtA,1946808,1947074,1946808,266,54,utRho29
sodA,8201518,8201620,8201518,102,1188,utRho29
sodB,3470646,3470756,3470646,110,0,utRho29
sodC,3449358,3449358,3449310,48,0,utRho29
sohB,2658568,2658664,2658568,96,164,utRho29
sokB,2984232,2984238,2984232,6,86,utRho29
solA,2241218,2241218,2241172,46,180,utRho29
soxR,8554894,8554938,8554894,44,2,utRho29
soxS,8554846,8554846,8554766,80,56,utRho29
speA,6172096,6172096,6171822,274,644,utRho29
speB,6167892,6167892,6167594,298,158,utRho29
speC,6218350,6218350,6218310,40,12,utRho29
spf,8099798,8099798,8099798,0,0,utRho29
sppA,3697422,3697674,3697422,252,476,utRho29
spy,3651376,3651376,3651250,126,12,utRho29
sra,3112092,3112092,3111926,166,0,utRho29
sraB,2293178,2293178,2293178,0,0,utRho29
sraC,3846132,3846132,3846132,0,0,utRho29
srlA,5651582,5651664,5651582,82,526,utRho29
srlR,5657720,5658094,5657720,374,2332,utRho29
srmB,5425752,5425792,5425752,40,192,utRho29
sroA,151216,151216,151216,0,0,utRho29
sroG,6369436,6369436,6369436,0,0,utRho29
sroH,8380974,8380974,8380974,0,0,utRho29
ssb,8548022,8548250,8548022,228,282,utRho29
sseA,5304782,5304988,5304782,206,2012,utRho29
sspA,6755138,6755138,6754840,298,26,utRho29
ssrA,5511014,5511186,5511014,172,836,utRho29
ssrS,12223036,12223932,12223036,896,1708,utRho29
sstT,6479726,6479888,6479726,162,62,utRho29
ssuB,1988282,1988282,1988088,194,620,utRho29
ssuE,1995126,1995126,1995024,102,194,utRho29
sthA,8321604,8321604,8321580,24,76,utRho29
stpA,5597156,5597156,5596990,166,52,utRho29
sucA,3034344,3034824,3034344,480,76,utRho29
sufA,3528836,3528836,3528772,64,2,utRho29
sufE,3518962,3518962,3518580,382,110,utRho29
sugE,8753588,8753750,8753588,162,86,utRho29
sulA,2041894,2041894,2041838,56,6060,utRho29
syd,5850738,5850738,5850560,178,194,utRho29
symE,9159834,9159834,9159680,154,26,utRho29
symR,9159670,9159670,9159670,0,0,utRho29
tabA,8949566,8949724,8949566,158,0,utRho29
talA,5157140,5157332,5157140,192,66,utRho29
talB,16382,16476,16382,94,3682,utRho29
tam,3214442,3214692,3214442,250,1422,utRho29
tamA,8884540,8884764,8884540,224,1832,utRho29
tar,3945432,3945432,3945382,50,10,utRho29
tas,5943138,5943194,5943138,56,42,utRho29
tatA,16087636,16087780,16087636,144,228,utRho29
tatE,1317742,1317894,1317742,152,118,utRho29
tauA,770410,770464,770410,54,84,utRho29
tdcA,6534186,6534186,6534130,56,26,utRho29
tdcG,6519652,6519652,6519298,354,198,utRho29
tdcR,6534380,6534760,6534380,380,180,utRho29
tdk,2586986,2587054,2586986,68,148,utRho29
tehA,3001072,3001146,3001072,74,38,utRho29
tesA,1039898,1039898,1039530,368,566,utRho29
tesB,950402,950402,950322,80,0,utRho29
tfaE,2418532,2418532,2418238,294,176,utRho29
tfaQ,3269912,3269912,3269770,142,138,utRho29
tff,379424,379256,379424,168,292,utRho29
tgt,852110,852274,852110,164,38,utRho29
thiD,4369346,4369346,4369032,314,94,utRho29
thiI,882936,883098,882936,162,42,utRho29
thiM,4370902,4370902,4370602,300,574,utRho29
thiQ,146170,146170,145854,316,5266,utRho29
thrL,592,760,592,168,384,utRho29
thrS,7210932,7210932,7210280,652,1024,utRho29
thrU,8350762,8350776,8350762,14,380,utRho29
thrV,6847414,6847414,6847310,104,139626,utRho29
thrW,525682,525742,525682,60,80,utRho29
thyA,5930696,5930696,5930310,386,702,utRho29
tig,909986,910266,909986,280,400,utRho29
tisB,7706674,7707106,7706674,432,608,utRho29
tktA,6163414,6163414,6163270,144,70,utRho29
tktB,5158616,5159272,5158616,656,1034,utRho29
tldD,6784368,6784368,6784056,312,24,utRho29
tmcA,5191876,5191876,5191718,158,214,utRho29
tnaC,15553644,15553740,15553644,96,84,utRho29
tolB,1555074,1555480,1555074,406,530,utRho29
tolC,6356008,6356230,6356008,222,78,utRho29
tomB,961588,961588,961416,172,182,utRho29
tonB,2622108,2622178,2622108,70,168,utRho29
topA,2661578,2662096,2661578,518,356,utRho29
torC,2116112,2116168,2116112,56,202,utRho29
torR,2115968,2115968,2115908,60,232,utRho29
torS,2112364,2112364,2112356,8,0,utRho29
torT,2112414,2112522,2112414,108,0,utRho29
tpiA,8223138,8223138,8223014,124,2,utRho29
tppB,3425342,3425538,3425342,196,276,utRho29
tpr,2574376,2574376,2574376,0,0,utRho29
tpx,2777688,2777688,2777622,66,710,utRho29
tqsA,3347780,3347826,3347780,46,28,utRho29
treA,2494850,2494850,2494752,98,84,utRho29
treB,8932420,8932420,8932360,60,154,utRho29
treF,7339102,7339184,7339102,82,108,utRho29
treR,8934694,8934694,8934492,202,40,utRho29
trg,2984878,2984940,2984878,62,0,utRho29
trkG,2847342,2847564,2847342,222,666,utRho29
trmA,8326590,8326590,8326540,50,56,utRho29
trpA,2634678,2634678,2634444,234,194,utRho29
trpC,2639888,2639888,2639570,318,44,utRho29
trpL,5292432,5292432,5292328,104,0,utRho29
trpR,9265408,9265520,9265408,112,220,utRho29
trpS,7027394,7027394,7027276,118,64,utRho29
trpT,7893560,7893914,7893560,354,56408,utRho29
trxA,7931294,7931522,7931294,228,1168,utRho29
trxB,1864156,1864156,1864100,56,72,utRho29
trxC,5437350,5437470,5437350,120,502,utRho29
tsaD,6421256,6421256,6421086,170,1324,utRho29
tsgA,6985038,6985136,6985038,98,80,utRho29
tsr,9182824,9183314,9182824,490,944,utRho29
tsx,864490,864490,864026,464,426,utRho29
ttcA,2823970,2823970,2823896,74,1048,utRho29
ttdA,6412848,6412926,6412848,78,18,utRho29
ttdR,6412760,6412760,6412512,248,420,utRho29
tufA,6943448,6943448,6942658,790,24042,utRho29
tus,3368346,3368518,3368346,172,40,utRho29
tusA,7218040,7218040,7217992,48,98,utRho29
tusB,6950218,6950218,6949930,288,230,utRho29
tynA,2902996,2902996,2902698,298,104,utRho29
typA,8116460,8116814,8116460,354,380,utRho29
tyrB,8534164,8534228,8534164,64,114,utRho29
tyrP,3979004,3979362,3979004,358,54,utRho29
tyrR,2773384,2773440,2773384,56,70,utRho29
tyrS,3434566,3434566,3434444,122,0,utRho29
tyrT,2575330,2575330,2575244,86,2,utRho29
uacT,6062378,6062734,6062378,356,578,utRho29
ubiC,8504886,8505012,8504886,126,196,utRho29
ubiD,8049618,8049976,8049618,358,850,utRho29
ubiE,8037494,8037710,8037494,216,206,utRho29
ubiG,4679078,4679134,4679078,56,72,utRho29
ucpA,5089342,5089342,5089246,96,302,utRho29
udp,8032782,8032862,8032782,80,252,utRho29
ugd,4199470,4199470,4199226,244,102,utRho29
ugpB,7184852,7184852,7184650,202,1440,utRho29
ugpQ,7176600,7176600,7176226,374,234,utRho29
uhpT,7694396,7694396,7694334,62,176,utRho29
uidA,3392304,3392304,3392142,162,0,utRho29
uidC,3386012,3386012,3385702,310,0,utRho29
uidR,3394150,3394150,3394104,46,0,utRho29
ulaA,8839854,8839960,8839854,106,98,utRho29
ulaG,8839350,8839350,8839250,100,80,utRho29
ulaR,8837124,8837124,8836906,218,6,utRho29
umpG,5741372,5741372,5740548,824,124,utRho29
umpH,1400704,1400704,1400652,52,44,utRho29
umuD,2461476,2461534,2461476,58,0,utRho29
ung,5433476,5433508,5433476,32,160,utRho29
uof,2843316,2843316,2842900,416,552,utRho29
upp,5241818,5241818,5241744,74,284,utRho29
usg,4873780,4873780,4873298,482,298,utRho29
ushA,1009772,1009828,1009772,56,272,utRho29
uspA,7279966,7280222,7279966,256,518,utRho29
uspB,7279696,7279696,7279440,256,202,utRho29
uspC,3959172,3959506,3959172,334,168,utRho29
uspE,2797318,2797318,2797244,74,0,utRho29
uspF,2871282,2871282,2871238,44,128,utRho29
uspG,1283806,1283806,1283734,72,230,utRho29
uvrA,8547872,8547872,8547742,130,276,utRho29
uvrB,1626304,1627052,1626304,748,270,utRho29
uvrC,3989758,3989758,3989412,346,0,utRho29
uvrD,7995814,7995966,7995814,152,0,utRho29
uvrY,3990812,3990812,3990718,94,34,utRho29
uxaB,3221474,3221474,3221360,114,244,utRho29
uxaC,6489714,6489714,6489482,232,0,utRho29
uxuA,9103036,9103272,9103036,236,718,utRho29
uxuR,9108916,9109152,9108916,236,28,utRho29
valS,8967854,8967854,8967674,180,138,utRho29
valU,5041848,5041862,5041848,14,2,utRho29
valV,3492830,3492870,3492830,40,8,utRho29
ves,3649968,3649968,3649874,94,0,utRho29
waaA,7616512,7617080,7616512,568,972,utRho29
waaH,7580298,7580298,7580162,136,58,utRho29
waaQ,7616476,7616476,7616196,280,714,utRho29
waaU,7598996,7598996,7598624,372,212,utRho29
waaY,7602272,7602272,7601930,342,7642,utRho29
wbbH,4214888,4214888,4214452,436,2404,utRho29
wbbK,4209212,4209212,4209018,194,294,utRho29
wcaM,4231868,4231868,4231792,76,38,utRho29
wrbA,2135516,2135516,2135416,100,78,utRho29
wza,4275166,4275166,4274486,680,152,utRho29
wzxC,4240674,4240674,4240316,358,52,utRho29
wzzB,4196950,4196950,4196602,348,40,utRho29
xanP,7657642,7657890,7657642,248,236,utRho29
xanQ,6048520,6048702,6048520,182,12,utRho29
xapA,5049820,5049820,5049756,64,0,utRho29
xapR,10090252,10090252,10089908,344,232,utRho29
xdhA,6000514,6000690,6000514,176,348,utRho29
xerD,6079702,6079702,6079486,216,84,utRho29
xseA,5268394,5268464,5268394,70,198,utRho29
xseB,882746,882746,882686,60,58,utRho29
xthA,3664798,3664856,3664798,58,0,utRho29
xylA,7461614,7461614,7461530,84,1634,utRho29
xylE,8484540,8484540,8484508,32,0,utRho29
xylF,7462138,7462262,7462138,124,1130,utRho29
xylR,7469812,7469958,7469812,146,0,utRho29
yaaA,13230,13230,12918,312,224,utRho29
yaaI,23876,23876,23572,304,98,utRho29
yaaJ,16034,16034,15918,116,72,utRho29
yaaU,91184,91614,91184,430,746,utRho29
yaaW,23084,23084,22712,372,328,utRho29
yaaX,10060,10468,10060,408,0,utRho29
yabI,142542,142702,142542,160,134,utRho29
yacC,273880,273880,273834,46,48,utRho29
yacH,262932,262932,262520,412,34,utRho29
yacL,268678,268776,268678,98,178,utRho29
yadD,293796,293936,293796,140,62,utRho29
yadE,289930,290162,289930,232,340,utRho29
yadN,314110,314110,313766,344,48,utRho29
yadS,355572,355572,355248,324,560,utRho29
yadV,312470,312470,312402,68,532,utRho29
yaeF,434270,434270,434006,264,78,utRho29
yaeP,428374,428374,428250,124,120,utRho29
yaeQ,428176,428582,428176,406,156,utRho29
yaeR,423716,423754,423716,38,14,utRho29
yafC,462166,462166,461762,404,334,utRho29
yafD,462128,462244,462128,116,348,utRho29
yafK,491986,491986,491610,376,162,utRho29
yafL,493282,493424,493282,142,94,utRho29
yafN,503938,504010,503938,72,44,utRho29
yafS,469568,469632,469568,64,202,utRho29
yafT,474470,474670,474470,200,140,utRho29
yafV,480432,480432,480378,54,0,utRho29
yafZ,536052,536052,536010,42,10,utRho29
yagE,564446,564556,564446,110,0,utRho29
yagG,570414,570790,570414,376,0,utRho29
yagI,578384,578384,578324,60,0,utRho29
yagK,586236,586236,585896,340,788,utRho29
yagL,588062,588062,587836,226,154,utRho29
yagN,591342,591342,591158,184,48,utRho29
yahA,663746,664742,663746,996,3346,utRho29
yahC,670136,670136,670044,92,414,utRho29
yahE,671478,671850,671478,372,606,utRho29
yahM,690504,690808,690504,304,482,utRho29
yahN,692872,692872,692674,198,464,utRho29
yahO,692864,692968,692864,104,532,utRho29
yaiE,816296,816354,816296,58,72,utRho29
yaiI,811396,811528,811396,132,26,utRho29
yaiO,761946,761946,761684,262,140,utRho29
yaiP,767970,767970,767870,100,52,utRho29
yaiS,769660,769660,769232,428,224,utRho29
yaiV,788922,788922,788922,0,0,utRho29
yaiY,799094,799094,798666,428,298,utRho29
yaiZ,798888,799186,798888,298,110,utRho29
yajC,854410,854574,854410,164,88,utRho29
yajD,860938,861210,860938,272,80,utRho29
yajI,866068,866068,865702,366,108,utRho29
yajL,887496,887496,887282,214,152,utRho29
yajQ,889316,889366,889316,50,64,utRho29
yajR,893374,893374,893332,42,46,utRho29
ybaB,987418,988152,987418,734,282,utRho29
ybaL,1006590,1006590,1006476,114,20,utRho29
ybaM,980648,980648,980542,106,476,utRho29
ybaN,981436,981764,981436,328,636,utRho29
ybaO,936704,936766,936704,62,0,utRho29
ybaP,1016568,1016568,1016160,408,326,utRho29
ybaQ,1016348,1016436,1016348,88,54,utRho29
ybaS,1023146,1023282,1023146,136,708,utRho29
ybaV,927504,927874,927504,370,10,utRho29
ybaY,950490,950758,950490,268,198,utRho29
ybbB,1062724,1062724,1062452,272,246,utRho29
ybbJ,1030154,1030154,1029718,436,344,utRho29
ybbL,1031784,1031838,1031784,54,16,utRho29
ybbN,1037136,1037136,1036558,578,396,utRho29
ybbO,1038658,1038658,1038298,360,240,utRho29
ybbY,1080718,1081130,1080718,412,204,utRho29
ybcH,1176140,1176140,1175962,178,48,utRho29
ybcI,1113264,1113264,1113106,158,292,utRho29
ybcJ,1114050,1114050,1113746,304,20,utRho29
ybcK,1137502,1137804,1137502,302,188,utRho29
ybcL,1141690,1141786,1141690,96,12,utRho29
ybcN,1144628,1144932,1144628,304,236,utRho29
ybcQ,1147548,1147912,1147548,364,176,utRho29
ybcW,1159610,1159760,1159610,150,36,utRho29
ybdD,1263982,1264364,1263982,382,338,utRho29
ybdF,1212106,1212106,1211772,334,0,utRho29
ybdH,1267048,1267048,1266954,94,0,utRho29
ybdJ,1212822,1212822,1212398,424,0,utRho29
ybdK,1215122,1215122,1214766,356,276,utRho29
ybdL,1267114,1267172,1267114,58,0,utRho29
ybdM,1271110,1271110,1270752,358,222,utRho29
ybdN,1273372,1273372,1273138,234,84,utRho29
ybdR,1283844,1284176,1283844,332,360,utRho29
ybeD,1325412,1325412,1325284,128,480,utRho29
ybeF,1323090,1323090,1322756,334,820,utRho29
ybeL,1349986,1350036,1349986,50,56,utRho29
ybeQ,1353412,1353412,1353094,318,38,utRho29
ybeR,1353120,1353422,1353120,302,38,utRho29
ybeT,1358832,1358832,1358812,20,0,utRho29
ybeU,1358924,1359016,1358924,92,52,utRho29
ybeZ,1386938,1386938,1386834,104,74,utRho29
ybfA,1458074,1458268,1458074,194,460,utRho29
ybfE,1423878,1423878,1423796,82,156,utRho29
ybfF,1425692,1425692,1425604,88,120,utRho29
ybfH,1433282,1433282,1433194,88,118,utRho29
ybgA,1477840,1478002,1477840,162,22,utRho29
ybgC,1549288,1549504,1549288,216,0,utRho29
ybgD,1505916,1505916,1505590,326,2598,utRho29
ybgI,1485238,1485654,1485238,416,0,utRho29
ybgO,1498370,1498370,1497964,406,0,utRho29
ybgS,1570992,1570992,1570634,358,26,utRho29
ybhA,1597184,1597184,1596862,322,154,utRho29
ybhB,1616070,1616070,1615818,252,138,utRho29
ybhC,1614642,1614642,1614562,80,106,utRho29
ybhD,1601418,1601418,1601276,142,138,utRho29
ybhH,1601104,1601518,1601104,414,180,utRho29
ybhK,1633384,1633384,1633294,90,50,utRho29
ybhM,1641556,1641586,1641556,30,0,utRho29
ybhN,1645296,1645296,1644996,300,164,utRho29
ybhQ,1649202,1649260,1649202,58,174,utRho29
ybiA,1665920,1665920,1665900,20,0,utRho29
ybiI,1676968,1676968,1676912,56,132,utRho29
ybiO,1691328,1691328,1690960,368,406,utRho29
ybiP,1705252,1705252,1705194,58,22,utRho29
ybiS,1711572,1711572,1711488,84,122,utRho29
ybiT,1711894,1711926,1711894,32,0,utRho29
ybiU,1718212,1718212,1718122,90,2,utRho29
ybiV,1720176,1720176,1720056,120,0,utRho29
ybiW,1725566,1725566,1725212,354,3052,utRho29
ybiX,1678548,1678548,1678414,134,620,utRho29
ybjC,1781784,1781826,1781784,42,0,utRho29
ybjE,1830154,1830154,1829714,440,834,utRho29
ybjG,1767016,1767016,1766776,240,1002,utRho29
ybjL,1779882,1779882,1779638,244,24,utRho29
ybjM,1779770,1780178,1779770,408,102,utRho29
ybjO,1795704,1795978,1795704,274,0,utRho29
ybjP,1809046,1809046,1808934,112,0,utRho29
ybjQ,1809034,1809186,1809034,152,38,utRho29
ybjS,1813796,1813796,1813506,290,134,utRho29
ybjX,1838206,1838206,1838168,38,0,utRho29
ycaD,1891438,1891742,1891438,304,0,utRho29
ycaI,1928210,1928640,1928210,430,78,utRho29
ycaK,1899094,1899336,1899094,242,266,utRho29
ycaL,1920264,1920528,1920264,264,46,utRho29
ycaM,1894240,1894458,1894240,218,46,utRho29
ycaR,1941284,1941346,1941284,62,110,utRho29
ycbB,1961862,1962094,1961862,232,380,utRho29
ycbJ,1943344,1943504,1943344,160,76,utRho29
ycbK,1966046,1966150,1966046,104,50,utRho29
ycbZ,2036920,2036920,2036598,322,138,utRho29
yccA,2062886,2062886,2062836,50,302,utRho29
yccF,2048730,2048730,2048696,34,24,utRho29
yccS,2047988,2047988,2047766,222,656,utRho29
yccT,2055674,2055674,2055546,128,28,utRho29
yccX,2059960,2060128,2059960,168,352,utRho29
ycdT,2185682,2185752,2185682,70,6,utRho29
ycdU,2191266,2191686,2191266,420,184,utRho29
ycdZ,2200504,2200592,2200504,88,66,utRho29
yceA,2233544,2233614,2233544,70,90,utRho29
yceD,2293298,2293588,2293298,290,938,utRho29
yceF,2293522,2293522,2293190,332,488,utRho29
yceH,2252154,2252314,2252154,160,74,utRho29
yceI,2237282,2237282,2236952,330,0,utRho29
yceJ,2238142,2238142,2238092,50,188,utRho29
yceM,2253208,2253612,2253208,404,338,utRho29
yceO,2239264,2239264,2238894,370,550,utRho29
yceQ,2288760,2289004,2288760,244,2476,utRho29
ycfD,2376540,2376540,2376480,60,126,utRho29
ycfJ,2334814,2335198,2334814,384,2,utRho29
ycfS,2340834,2340834,2340748,86,0,utRho29
ycfT,2350658,2350658,2350330,328,108,utRho29
ycfZ,2362760,2362760,2362534,226,518,utRho29
ycgB,2474570,2474570,2474482,88,48,utRho29
ycgG,2434614,2434656,2434614,42,206,utRho29
ycgJ,2452956,2453200,2452956,244,24,utRho29
ycgL,2455218,2455362,2455218,144,20,utRho29
ycgN,2457366,2457660,2457366,294,132,utRho29
ycgR,2489112,2489112,2489054,58,2,utRho29
ycgV,2512222,2512222,2511904,318,328,utRho29
ycgX,2426568,2426568,2426214,354,2006,utRho29
ycgY,2490166,2490320,2490166,154,624,utRho29
ycgZ,2431504,2431578,2431504,74,64,utRho29
ychE,2596904,2597196,2596904,292,36,utRho29
ychF,2515764,2515764,2515624,140,6,utRho29
ychH,2517476,2517582,2517476,106,446,utRho29
ychJ,2578354,2578354,2578264,90,0,utRho29
ychN,2547310,2547310,2547198,112,68,utRho29
ychO,2547520,2547850,2547520,330,164,utRho29
ychQ,2533798,2533848,2533798,50,0,utRho29
yciA,2624828,2624828,2624492,336,112,utRho29
yciB,2626110,2626110,2625780,330,478,utRho29
yciC,2627396,2627396,2627326,70,0,utRho29
yciE,2630794,2630794,2630448,346,146,utRho29
yciG,5264368,5264368,5264140,228,0,utRho29
yciI,2621784,2621784,2621730,54,152,utRho29
yciN,2661606,2661606,2661336,270,62,utRho29
yciS,2680270,2680486,2680270,216,0,utRho29
yciT,2689088,2689088,2688692,396,142,utRho29
yciU,2614718,2614718,2614300,418,74,utRho29
yciV,2646376,2646440,2646376,64,0,utRho29
yciW,2700472,2700472,2700214,258,160,utRho29
yciZ,2689276,2689276,2689218,58,126,utRho29
ycjD,2703792,2703792,2703520,272,26,utRho29
ycjG,2777748,2777860,2777748,112,58,utRho29
ycjM,2740006,2740432,2740006,426,282,utRho29
ycjW,2767982,2767982,2767922,60,32,utRho29
ycjX,2768138,2768234,2768138,96,58,utRho29
ycjY,5568288,5568288,5567460,828,1056,utRho29
ydaE,2836438,2836438,2836016,422,42,utRho29
ydaN,2816048,2816100,2816048,52,48,utRho29
ydaS,2840340,2840730,2840340,390,744,utRho29
ydbC,2948376,2948442,2948376,66,64,utRho29
ydbD,2950132,2950288,2950132,156,0,utRho29
ydbH,2885800,2886102,2885800,302,1740,utRho29
ydbJ,2881712,2882116,2881712,404,318,utRho29
ydbK,2881692,2881692,2881568,124,52,utRho29
ydcA,2983294,2983354,2983294,60,142,utRho29
ydcF,2974404,2974470,2974404,66,0,utRho29
ydcI,2990268,2990268,2990142,126,60,utRho29
ydcJ,2990266,2990576,2990266,310,0,utRho29
ydcK,3001280,3001280,3000898,382,84,utRho29
ydcL,3004646,3004914,3004646,268,76,utRho29
ydcN,3012308,3012344,3012308,36,76,utRho29
ydcP,3013508,3013562,3013508,54,0,utRho29
ydcR,3019956,3020006,3019956,50,0,utRho29
ydcS,3022906,3023308,3022906,402,184,utRho29
ydcX,3034442,3034778,3034442,336,220,utRho29
ydcY,3035220,3035296,3035220,76,0,utRho29
ydcZ,3036750,3036750,3036662,88,112,utRho29
yddB,3155332,3155332,3155238,94,182,utRho29
yddE,3071738,3071738,3071716,22,26,utRho29
yddG,3094410,3094410,3094338,72,72,utRho29
yddJ,3089732,3089732,3089438,294,928,utRho29
yddW,3137704,3137704,3137646,58,0,utRho29
ydeA,3233910,3234056,3233910,146,3184,utRho29
ydeE,3242528,3242664,3242528,136,528,utRho29
ydeI,3249118,3249118,3248994,124,0,utRho29
ydeJ,3249376,3249546,3249376,170,0,utRho29
ydeN,3165458,3165458,3165048,410,10,utRho29
ydeP,3173328,3173328,3172972,356,132,utRho29
ydeR,3176596,3176596,3176592,4,52,utRho29
ydfA,3296872,3297016,3296872,144,0,utRho29
ydfG,3254982,3255034,3254982,52,20,utRho29
ydfH,3256652,3256704,3256652,52,54,utRho29
ydfK,3265446,3266144,3265446,698,778,utRho29
ydgA,3379588,3379704,3379588,116,4,utRho29
ydgC,3364124,3364124,3364060,64,0,utRho29
ydgD,3343906,3343920,3343906,14,0,utRho29
ydgH,3356754,3356854,3356754,100,80,utRho29
ydgJ,3408798,3408798,3408616,182,104,utRho29
ydgK,3410414,3410500,3410414,86,410,utRho29
ydhB,3479618,3479618,3479596,22,18,utRho29
ydhC,3479698,3479822,3479698,124,66,utRho29
ydhF,3451310,3451310,3451264,46,0,utRho29
ydhI,3441996,3442050,3441996,54,0,utRho29
ydhL,3451864,3451864,3451840,24,148,utRho29
ydhQ,3492404,3492404,3492254,150,0,utRho29
ydhS,3494136,3494262,3494136,126,0,utRho29
ydhT,3499138,3499138,3499118,20,0,utRho29
ydhY,3509284,3509284,3508954,330,4,utRho29
ydhZ,3510418,3510418,3510282,136,0,utRho29
ydiE,3579206,3579226,3579206,20,0,utRho29
ydiH,3530582,3530582,3530406,176,12,utRho29
ydiM,3541852,3542142,3541852,290,6,utRho29
ydiN,3544818,3545024,3544818,206,108,utRho29
ydiP,3558656,3558656,3558602,54,72,utRho29
ydiU,3582508,3582508,3582488,20,4,utRho29
ydiV,3584174,3584174,3584040,134,20,utRho29
ydiY,3612500,3612500,3612166,334,286,utRho29
ydjA,3697400,3697400,3697352,48,190,utRho29
ydjE,3708082,3708082,3707958,124,0,utRho29
ydjF,3709848,3709848,3709708,140,196,utRho29
ydjM,3620340,3620422,3620340,82,0,utRho29
ydjO,3626696,3626696,3626288,408,0,utRho29
ydjX,3666434,3666802,3666434,368,200,utRho29
yeaE,3731448,3731448,3731272,176,22,utRho29
yeaG,3733530,3733816,3733530,286,62,utRho29
yeaI,3740486,3740770,3740486,284,52,utRho29
yeaJ,3743874,3744082,3743874,208,34,utRho29
yeaL,3748646,3748704,3748646,58,312,utRho29
yeaM,3751296,3751296,3751152,144,0,utRho29
yeaN,3750926,3751346,3750926,420,22,utRho29
yeaO,3753554,3753818,3753554,264,0,utRho29
yeaP,3755314,3755430,3755314,116,12,utRho29
yeaQ,3758780,3758780,3758510,270,132,utRho29
yeaR,3759988,3759988,3759896,92,142,utRho29
yeaY,3781122,3781122,3781064,58,0,utRho29
yebB,3892220,3892502,3892220,282,190,utRho29
yebC,3896370,3896370,3896302,68,68,utRho29
yebE,3859464,3859464,3859414,50,180,utRho29
yebG,3861530,3861530,3861494,36,0,utRho29
yebK,3873180,3873304,3873180,124,2,utRho29
yebQ,3820314,3820552,3820314,238,32,utRho29
yebS,3832238,3832516,3832238,278,176,utRho29
yebV,3843430,3843560,3843430,130,0,utRho29
yebW,3843914,3844242,3843914,328,1036,utRho29
yecC,3995646,3995646,3995628,18,0,utRho29
yecD,3901272,3901664,3901272,392,100,utRho29
yecF,3991434,3991636,3991434,202,194,utRho29
yecH,3979304,3979304,3978980,324,108,utRho29
yecJ,3975604,3975604,3975516,88,0,utRho29
yecM,3919968,3919968,3919692,276,682,utRho29
yecR,3976400,3976444,3976400,44,38,utRho29
yecT,3923862,3923944,3923862,82,0,utRho29
yedD,4016522,4016522,4016180,342,4,utRho29
yedE,4016310,4016554,4016310,244,34,utRho29
yedI,4058922,4058922,4058732,190,266,utRho29
yedJ,4066446,4066446,4066158,288,392,utRho29
yedV,4076404,4076404,4076304,100,126,utRho29
yedX,4077680,4077912,4077680,232,94,utRho29
yedY,4078572,4078956,4078572,384,46,utRho29
yeeA,4161322,4161322,4161182,140,84,utRho29
yeeE,4171104,4171104,4171050,54,272,utRho29
yeeJ,4089526,4089822,4089526,296,44,utRho29
yeeN,4113508,4113716,4113508,208,76,utRho29
yeeO,4119444,4119444,4119692,248,280,utRho29
yeeX,4158834,4158834,4158722,112,50,utRho29
yeeZ,4178422,4178422,4178256,166,188,utRho29
yefM,4179466,4179466,4179426,40,6,utRho29
yegD,4295288,4295348,4295288,60,278,utRho29
yegH,4275726,4275804,4275726,78,198,utRho29
yegI,4302154,4302154,4301970,184,0,utRho29
yegJ,4302032,4302370,4302032,338,142,utRho29
yegQ,4331182,4331336,4331182,154,0,utRho29
yegR,4336698,4336698,4336612,86,576,utRho29
yegS,4337086,4337424,4337086,338,282,utRho29
yegT,4357562,4357642,4357562,80,176,utRho29
yegX,4367640,4367640,4367302,338,0,utRho29
yehA,4376944,4376944,4376828,116,154,utRho29
yehE,4385818,4385818,4385592,226,24,utRho29
yehK,4407568,4407944,4407568,376,62,utRho29
yehL,4408804,4409192,4408804,388,0,utRho29
yeiB,4486146,4486146,4485934,212,0,utRho29
yeiE,4499422,4499422,4499236,186,66,utRho29
yeiG,4487776,4487820,4487776,44,30,utRho29
yeiH,4499332,4499434,4499332,102,80,utRho29
yeiI,4503306,4503400,4503306,94,46,utRho29
yeiL,4510580,4510710,4510580,130,82,utRho29
yeiP,4530834,4530900,4530834,66,182,utRho29
yeiQ,4532328,4532490,4532328,162,0,utRho29
yeiR,4535484,4535658,4535484,174,108,utRho29
yeiW,4530840,4530840,4530590,250,530,utRho29
yejA,4544624,4544728,4544624,104,0,utRho29
yejG,4556892,4556892,4556474,418,1016,utRho29
yejH,4561244,4561264,4561244,20,62,utRho29
yejK,4568218,4568218,4567894,324,0,utRho29
yejO,4578352,4578352,4577800,552,174,utRho29
yfaD,4713380,4713808,4713380,428,156,utRho29
yfaE,4696676,4697028,4696676,352,430,utRho29
yfaL,4688568,4688568,4688338,230,20,utRho29
yfaP,4656398,4656398,4656286,112,22,utRho29
yfaU,4717892,4717892,4717690,202,0,utRho29
yfaY,4727310,4727310,4727266,44,818,utRho29
yfaZ,4728744,4728744,4728550,194,418,utRho29
yfbK,4771810,4771810,4771444,366,1058,utRho29
yfbL,4771500,4771720,4771500,220,1006,utRho29
yfbN,4777174,4777174,4776852,322,1038,utRho29
yfbO,4776916,4777162,4776916,246,940,utRho29
yfbP,4777990,4778232,4777990,242,890,utRho29
yfbR,4817662,4817724,4817662,62,0,utRho29
yfcI,4847424,4847424,4847078,346,270,utRho29
yfcJ,4880482,4880482,4880240,242,62,utRho29
yfcL,4888502,4888502,4888338,164,0,utRho29
yfcV,4911642,4911642,4911292,350,112,utRho29
yfcZ,4921958,4921958,4921868,90,92,utRho29
yfdF,4925604,4926024,4925604,420,3136,utRho29
yfdG,4935474,4935710,4935474,236,64,utRho29
yfdP,4946844,4947040,4946844,196,214,utRho29
yfdX,4988866,4988866,4988804,62,150,utRho29
yfdY,4990672,4990672,4990584,88,680,utRho29
yfeA,5035784,5035784,5035664,120,248,utRho29
yfeC,5036668,5036934,5036668,266,46,utRho29
yfeH,5053818,5053892,5053818,74,0,utRho29
yfeK,5074630,5074684,5074630,54,34,utRho29
yfeO,5018906,5019260,5018906,354,2,utRho29
yfeR,5054078,5054078,5053712,366,0,utRho29
yfeX,5101356,5101356,5101090,266,0,utRho29
yfeY,5102486,5102486,5102432,54,146,utRho29
yfeZ,5103842,5103842,5103452,390,404,utRho29
yffO,5123804,5124222,5123804,418,224,utRho29
yffQ,5126778,5127154,5126778,376,474,utRho29
yffS,5128800,5128986,5128800,186,52,utRho29
yfgC,5232052,5232188,5232052,136,0,utRho29
yfgF,5258062,5258062,5257876,186,1056,utRho29
yfgG,5258170,5258580,5258170,410,1414,utRho29
yfgH,5259344,5259584,5259344,240,0,utRho29
yfgM,5278866,5278866,5278566,300,496,utRho29
yfhH,5397414,5397518,5397414,104,234,utRho29
yfhM,5304648,5304648,5304574,74,62,utRho29
yfhR,5328408,5328726,5328408,318,134,utRho29
yfiC,5425610,5425610,5425528,82,276,utRho29
yfiE,5430688,5430688,5430640,48,628,utRho29
yfiL,5482630,5482720,5482630,90,44,utRho29
yfiM,5448066,5448358,5448066,292,1376,utRho29
yfiR,5483354,5483750,5483354,396,376,utRho29
yfjH,5517326,5517326,5517200,126,20,utRho29
yfjI,5517710,5517970,5517710,260,186,utRho29
yfjJ,5521014,5521094,5521014,80,114,utRho29
yfjM,5531970,5531970,5531552,418,1474,utRho29
yfjP,5535080,5535420,5535080,340,3810,utRho29
yfjW,5546570,5546636,5546570,66,0,utRho29
yfjX,5551776,5551838,5551776,62,52,utRho29
ygaC,5601180,5601180,5599988,1192,5152,utRho29
ygaM,5600242,5600292,5600242,50,1844,utRho29
ygaU,5593628,5593628,5593572,56,52,utRho29
ygaZ,5619190,5619234,5619190,44,62,utRho29
ygbA,5713656,5713656,5713612,44,112,utRho29
ygbE,5746784,5746784,5746674,110,72,utRho29
ygbI,5722882,5722882,5722528,354,518,utRho29
ygbK,5724394,5724670,5724394,276,106,utRho29
ygbL,5727074,5727186,5727074,112,116,utRho29
ygbN,5729814,5730202,5729814,388,118,utRho29
ygcG,5811210,5811422,5811210,212,108,utRho29
ygcN,5785144,5785314,5785144,170,146,utRho29
ygcU,5799214,5799214,5798836,378,366,utRho29
ygcW,5800942,5800942,5800546,396,36,utRho29
ygdD,5883442,5883442,5883262,180,442,utRho29
ygdG,5861746,5861930,5861746,184,206,utRho29
ygdI,5886526,5886526,5886290,236,0,utRho29
ygdQ,5940784,5940840,5940784,56,26,utRho29
ygdR,5942494,5942542,5942494,48,38,utRho29
ygeA,5961606,5961606,5961270,336,132,utRho29
ygeH,5983758,5984188,5983758,430,8,utRho29
ygeI,5987162,5987276,5987162,114,364,utRho29
ygeR,6000078,6000078,5999782,296,982,utRho29
ygeV,6011694,6011694,6011572,122,18,utRho29
ygeW,6012234,6012524,6012234,290,1726,utRho29
ygfB,6110946,6110946,6110888,58,12,utRho29
ygfK,6031984,6032120,6031984,136,8,utRho29
ygfS,6058328,6058328,6058024,304,0,utRho29
ygfZ,6082564,6082626,6082564,62,72,utRho29
yggC,6149512,6149512,6149378,134,112,utRho29
yggE,6136370,6136370,6136160,210,344,utRho29
yggI,6179176,6179510,6179176,334,104,utRho29
yggL,6204508,6204508,6204266,242,88,utRho29
yggM,6199514,6199514,6199130,384,36,utRho29
yggN,6203596,6203596,6203246,350,248,utRho29
yggX,18623958,18624558,18623958,600,216,utRho29
yghA,6298966,6299324,6298966,358,128,utRho29
yghB,6307058,6307126,6307058,68,152,utRho29
yghD,6222614,6222614,6222252,362,118,utRho29
yghF,6225798,6225798,6225840,42,0,utRho29
yghJ,6238640,6238640,6238224,416,286,utRho29
yghQ,6265186,6265186,6264816,370,134,utRho29
yghT,6267830,6268262,6267830,432,484,utRho29
yghU,6277400,6277454,6277400,54,128,utRho29
yghW,6293506,6293506,6293474,32,104,utRho29
yghZ,6295562,6295794,6295562,232,0,utRho29
ygiD,6365122,6365122,6364868,254,144,utRho29
ygiH,6409066,6409388,6409066,322,2834,utRho29
ygiL,6370622,6370828,6370622,206,28,utRho29
ygiM,6402084,6402414,6402084,330,278,utRho29
ygiN,6346156,6346284,6346156,128,440,utRho29
ygiQ,6322620,6322620,6322292,328,38,utRho29
ygiS,6335462,6335462,6335436,26,0,utRho29
ygiV,6338582,6338582,6338462,120,16,utRho29
ygiW,6339774,6339774,6339352,422,204,utRho29
ygiZ,6344506,6344506,6344422,84,36,utRho29
ygjH,6442528,6442528,6442494,34,42,utRho29
ygjI,6452140,6452468,6452140,328,0,utRho29
ygjQ,6472730,6473080,6472730,350,344,utRho29
ygjR,6474564,6474586,6474564,22,64,utRho29
ygjV,6483638,6483638,6483488,150,0,utRho29
yhaB,6535632,6535708,6535632,76,116,utRho29
yhaH,6504498,6504608,6504498,110,290,utRho29
yhaI,6505400,6505822,6505400,422,156,utRho29
yhaJ,6508560,6508560,6508428,132,18,utRho29
yhaK,6508538,6508638,6508538,100,76,utRho29
yhbQ,6599878,6599932,6599878,54,206,utRho29
yhbT,6602736,6602736,6602552,184,948,utRho29
yhbU,6602558,6602970,6602558,412,1136,utRho29
yhbX,6643302,6643302,6643226,76,124,utRho29
yhbY,6655518,6655580,6655518,62,166,utRho29
yhcA,6723956,6724224,6723956,268,14,utRho29
yhcB,6760364,6760382,6760364,18,0,utRho29
yhcC,6708470,6708470,6708100,370,238,utRho29
yhcF,6733440,6733852,6733440,412,142,utRho29
yhcH,6739124,6739124,6738956,168,558,utRho29
yhcM,6760312,6760312,6759994,318,208,utRho29
yhcN,6770812,6771076,6770812,264,164,utRho29
yhcO,6772606,6772606,6772258,348,0,utRho29
yhdH,6806560,6806968,6806560,408,272,utRho29
yhdJ,6823234,6823306,6823234,72,2,utRho29
yhdN,6879092,6879092,6879018,74,330,utRho29
yhdT,6814702,6814750,6814702,48,28,utRho29
yhdU,6824994,6825242,6824994,248,152,utRho29
yhdV,6836392,6836780,6836392,388,94,utRho29
yhdW,6837944,6838298,6837944,354,0,utRho29
yheO,6953082,6953082,6952880,202,152,utRho29
yheV,6957970,6957970,6957584,386,148,utRho29
yhfA,6971902,6971902,6971636,266,494,utRho29
yhfG,6983294,6983294,6983240,54,2,utRho29
yhfL,6998622,6998896,6998622,274,492,utRho29
yhfY,7023244,7023244,7022844,400,266,utRho29
yhgA,7086294,7086334,7086294,40,0,utRho29
yhgE,7065176,7065176,7064878,298,754,utRho29
yhgF,7074352,7074770,7074352,418,1436,utRho29
yhhA,7173458,7173886,7173458,428,564,utRho29
yhhI,7248346,7248756,7248346,410,0,utRho29
yhhJ,7253696,7253696,7253606,90,102,utRho29
yhhM,7211588,7211588,7211220,368,2446,utRho29
yhhN,7211150,7211502,7211150,352,1260,utRho29
yhhQ,7218238,7218434,7218238,196,384,utRho29
yhhT,7223682,7223730,7223682,48,0,utRho29
yhhX,7162032,7162032,7161610,422,72,utRho29
yhhY,7162222,7162276,7162222,54,36,utRho29
yhhZ,7163516,7163726,7163516,210,546,utRho29
yhiD,7312220,7312220,7311804,416,3656,utRho29
yhiJ,7265190,7265190,7265180,10,126,utRho29
yhiM,7269270,7269682,7269270,412,2064,utRho29
yhiN,7275000,7275000,7274820,180,296,utRho29
yhjA,7338522,7338522,7338376,146,130,utRho29
yhjB,7344090,7344090,7343788,302,746,utRho29
yhjC,7344272,7344684,7344272,412,468,utRho29
yhjD,7346660,7346724,7346660,64,8,utRho29
yhjE,7349274,7349572,7349274,298,1058,utRho29
yhjG,7356824,7356824,7356730,94,48,utRho29
yhjH,7358458,7358458,7358374,84,294,utRho29
yhjJ,7364032,7364032,7363880,152,196,utRho29
yhjK,7371296,7371296,7371158,138,272,utRho29
yhjR,7392750,7392750,7392370,380,96,utRho29
yhjV,7400796,7401126,7400796,330,706,utRho29
yhjX,7424194,7424194,7424014,180,180,utRho29
yhjY,7425966,7425966,7425868,98,36,utRho29
yiaB,7455654,7455654,7455496,158,364,utRho29
yiaD,7432712,7433094,7432712,382,102,utRho29
yiaF,7438194,7438194,7438088,106,196,utRho29
yiaG,7438862,7438956,7438862,94,426,utRho29
yiaJ,7485236,7485236,7485064,172,30,utRho29
yiaK,7485348,7485466,7485348,118,44,utRho29
yiaT,7503924,7503924,7503736,188,0,utRho29
yiaU,7503792,7503984,7503792,192,0,utRho29
yiaY,7515856,7515856,7515654,202,124,utRho29
yibF,7523950,7523950,7523910,40,68,utRho29
yibG,7536128,7536354,7536128,226,854,utRho29
yibL,7553194,7553330,7553194,136,400,utRho29
yibN,7570112,7570112,7570030,82,294,utRho29
yibT,7552848,7552848,7552760,88,746,utRho29
yicC,7633290,7633352,7633290,62,80,utRho29
yicH,7660862,7660914,7660862,52,0,utRho29
yicJ,7673328,7673328,7671858,1470,8440,utRho29
yicN,7685018,7685018,7684804,214,1204,utRho29
yicO,7687914,7687914,7687578,336,110,utRho29
yicR,15250308,15250308,15250236,72,120,utRho29
yidB,7755230,7755230,7754930,300,1274,utRho29
yidE,7732780,7732780,7732546,234,0,utRho29
yidF,7711580,7711580,7711222,358,62,utRho29
yidQ,7735088,7735456,7735088,368,966,utRho29
yidR,7738824,7738824,7738618,206,8,utRho29
yieE,7787658,7787738,7787658,80,140,utRho29
yieH,7793314,7793548,7793314,234,46,utRho29
yieK,7798928,7798928,7798786,142,104,utRho29
yifB,7900350,7900350,7899998,352,212,utRho29
yifL,7988984,7989044,7988984,60,212,utRho29
yigF,8005750,8005750,8005598,152,1666,utRho29
yigI,8009448,8009448,8009394,54,286,utRho29
yigM,8022100,8022152,8022100,52,592,utRho29
yihA,8101970,8101970,8101458,512,60,utRho29
yihD,8084098,8084138,8084098,40,84,utRho29
yihF,8088110,8088398,8088110,288,304,utRho29
yihG,8093304,8093304,8093204,100,60,utRho29
yihI,8102616,8102694,8102616,78,0,utRho29
yihL,8120506,8120894,8120506,388,996,utRho29
yihN,8124332,8124494,8124332,162,1150,utRho29
yihO,8131942,8131942,8131532,410,104,utRho29
yihQ,8138892,8138892,8138552,340,32,utRho29
yihV,8147064,8147478,8147064,414,80,utRho29
yihX,8151096,8151106,8151096,10,0,utRho29
yiiE,8158192,8158582,8158192,390,608,utRho29
yiiF,8159124,8159502,8159124,378,274,utRho29
yiiG,8173762,8174004,8173762,242,182,utRho29
yiiM,8205506,8205644,8205506,138,816,utRho29
yiiQ,8224624,8224624,8224428,196,0,utRho29
yiiS,8225738,8225934,8225738,196,40,utRho29
yijE,8272178,8272216,8272178,38,32,utRho29
yijF,8275728,8275728,8275314,414,936,utRho29
yijO,8296858,8296858,8296634,224,0,utRho29
yjaA,8426240,8426468,8426240,228,53646,utRho29
yjaB,8428312,8428312,8428246,66,38,utRho29
yjaG,8398746,8399008,8398746,262,0,utRho29
yjaH,8401022,8401132,8401022,110,60,utRho29
yjaZ,8379506,8379572,8379506,66,12,utRho29
yjbB,8455204,8455462,8455204,258,10,utRho29
yjbE,16943432,16943624,16943432,192,160,utRho29
yjbL,8520318,8520642,8520318,324,80,utRho29
yjbQ,8540428,8540476,8540428,48,6,utRho29
yjcB,8550328,8550328,8550082,246,402,utRho29
yjcC,8550836,8550942,8550836,106,136,utRho29
yjcD,8556628,8556958,8556628,330,592,utRho29
yjcE,8559658,8559960,8559658,302,382,utRho29
yjcF,8566212,8566212,8566150,62,0,utRho29
yjcO,8594660,8594660,8594250,410,262,utRho29
yjdA,8654128,8654270,8654128,142,0,utRho29
yjdC,8726660,8726660,8726616,44,114,utRho29
yjdK,8704780,8705168,8704780,388,866,utRho29
yjdL,8713034,8713034,8712822,212,28,utRho29
yjdM,8653672,8653672,8653468,204,1626,utRho29
yjeF,8787354,8788132,8787354,778,2158,utRho29
yjeI,8745522,8745618,8745522,96,78,utRho29
yjeJ,8748806,8748806,8748468,338,600,utRho29
yjeV,8785472,8785784,8785472,312,102,utRho29
yjfP,8833512,8833904,8833512,392,120,utRho29
yjfY,8849656,8849656,8849582,74,0,utRho29
yjfZ,8855052,8855052,8854844,208,236,utRho29
yjgA,8916162,8916162,8915730,432,188,utRho29
yjgL,8950802,8950874,8950802,72,16,utRho29
yjgM,8959342,8959342,8959074,268,26,utRho29
yjgN,8959132,8959460,8959132,328,34,utRho29
yjgR,8980170,8980170,8980126,44,204,utRho29
yjgZ,9002116,9002520,9002116,404,740,utRho29
yjhB,9007764,9008116,9007764,352,826,utRho29
yjhG,9048452,9048452,9048188,264,1454,utRho29
yjhU,9041080,9041080,9040648,432,1290,utRho29
yjiA,9178096,9178096,9177730,366,374,utRho29
yjiJ,9125364,9125364,9125350,14,48,utRho29
yjiK,9127270,9127270,9127422,152,142,utRho29
yjiL,9129604,9129604,9129378,226,28,utRho29
yjiS,9143410,9143502,9143410,92,0,utRho29
yjiY,9182734,9182734,9182558,176,34,utRho29
yjjA,9200674,9200674,9200378,296,64,utRho29
yjjB,18408708,18408708,18407800,908,688,utRho29
yjjJ,9243314,9243538,9243314,224,0,utRho29
yjjK,9261132,9261132,9261044,88,164,utRho29
yjjL,9189764,9189764,9189444,320,270,utRho29
yjjM,9191894,9191894,9191702,192,272,utRho29
yjjP,9206068,9206068,9205716,352,644,utRho29
yjjQ,9206638,9206954,9206638,316,944,utRho29
yjjX,9267798,9267798,9267490,308,486,utRho29
yjjY,9280716,9280804,9280716,88,186,utRho29
yjjZ,9211554,9211608,9211554,54,754,utRho29
yjtD,9281676,9281884,9281676,208,364,utRho29
ykfB,532454,532454,532174,280,174,utRho29
ykfI,527636,527636,527338,298,730,utRho29
ykgB,637050,637050,636638,412,72,utRho29
ykgC,640430,640430,640002,428,182,utRho29
ykgD,640232,640454,640232,222,214,utRho29
ykgE,642962,643216,642962,254,956,utRho29
ykgJ,608524,608524,608364,160,286,utRho29
ykgL,623878,624224,623878,346,302,utRho29
ykgM,625610,625610,625554,56,66,utRho29
ykgR,626570,626570,626484,86,24,utRho29
ylaC,958576,958576,958502,74,178,utRho29
yliE,1745938,1745958,1745938,20,0,utRho29
ymcE,2103660,2103694,2103660,34,0,utRho29
ymdA,2210450,2210828,2210450,378,0,utRho29
ymdB,2211428,2211640,2211428,212,0,utRho29
ymfD,2395322,2395322,2395064,258,158,utRho29
ymfI,2402880,2402994,2402880,114,0,utRho29
ymfJ,2404518,2404518,2404168,350,120,utRho29
ymfK,2406176,2406176,2405866,310,258,utRho29
ymfT,2405766,2406048,2405766,282,258,utRho29
ymgE,2489110,2489456,2489110,346,870,utRho29
ymgF,2437628,2437966,2437628,338,210,utRho29
ymiA,2670112,2670320,2670112,208,232,utRho29
ymjA,2715620,2715620,2715336,284,148,utRho29
ynaI,2791946,2791946,2791844,102,44,utRho29
ynaK,2850438,2850754,2850438,316,160,utRho29
ynbA,2954924,2955242,2954924,318,150,utRho29
yncD,3046552,3046552,3046130,422,260,utRho29
yncE,3046454,3046614,3046454,160,126,utRho29
yncG,3052456,3052494,3052456,38,156,utRho29
yncL,3034492,3034492,3034388,104,170,utRho29
yneE,3218364,3218364,3218044,320,90,utRho29
yneF,3223748,3223748,3223708,40,502,utRho29
yneJ,3229560,3229608,3229560,48,26,utRho29
yneK,3231100,3231526,3231100,426,88,utRho29
yneM,3245176,3245292,3245176,116,50,utRho29
ynfA,3311398,3311398,3311346,52,0,utRho29
ynfB,3311418,3311616,3311418,198,56,utRho29
ynfC,3315094,3315094,3314914,180,10,utRho29
ynfD,3314828,3315130,3314828,302,10,utRho29
ynfE,3316006,3316138,3316006,132,102,utRho29
ynfK,3334670,3334670,3334438,232,0,utRho29
ynfL,3339304,3339304,3339184,120,0,utRho29
ynfM,3339260,3339398,3339260,138,20,utRho29
ynfN,3276598,3276598,3276218,380,82,utRho29
ynfO,3273454,3273512,3273454,58,52,utRho29
ynhG,3517890,3517890,3517450,440,182,utRho29
yniA,3615158,3615592,3615158,434,292,utRho29
yniB,3618526,3618526,3618466,60,142,utRho29
yniC,3618652,3618760,3618652,108,102,utRho29
yniD,3610202,3610330,3610202,128,56,utRho29
ynjE,3678880,3678934,3678880,54,32,utRho29
ynjF,3683222,3683222,3682806,416,210,utRho29
ynjH,3684376,3684376,3684270,106,58,utRho29
ynjI,3690022,3690022,3689742,280,270,utRho29
yoaB,3786642,3786734,3786642,92,126,utRho29
yoaC,3787932,3788146,3787932,214,196,utRho29
yoaE,3803544,3803544,3803170,374,410,utRho29
yoaF,3755444,3755444,3755064,380,12,utRho29
yoaH,3789866,3789866,3789462,404,402,utRho29
yobB,3850418,3850880,3850418,462,12,utRho29
yobF,3815586,3815586,3815182,404,52,utRho29
yobH,3817800,3817850,3817800,50,74,utRho29
yodB,4084352,4084736,4084352,384,676,utRho29
yodC,4057008,4057008,4056740,268,116,utRho29
yohC,4451358,4451358,4451262,96,0,utRho29
yohD,4451526,4451602,4451526,76,0,utRho29
yohJ,4460986,4461248,4460986,262,206,utRho29
yohO,4431172,4431314,4431172,142,68,utRho29
yojI,4617282,4617282,4617230,52,188,utRho29
ypdI,4988988,4989396,4988988,408,264,utRho29
ypfG,5165786,5165786,5165554,232,78,utRho29
ypfM,5182140,5182140,5181732,408,718,utRho29
yphB,5349590,5349590,5349376,214,0,utRho29
ypjA,5565644,5565644,5565452,192,812,utRho29
ypjB,5569636,5569636,5568858,778,248,utRho29
ypjD,5495860,5495774,5495860,86,0,utRho29
yqaE,5594170,5594170,5594056,114,234,utRho29
yqcA,5846100,5846100,5845968,132,64,utRho29
yqcE,5800944,5801184,5800944,240,8,utRho29
yqeC,6030468,6030468,6030114,354,74,utRho29
yqeF,5971618,5971618,5971184,434,796,utRho29
yqeG,5971438,5971694,5971438,256,928,utRho29
yqeH,5975016,5975072,5975016,56,732,utRho29
yqeI,5976688,5977004,5976688,316,336,utRho29
yqeK,5981140,5981140,5980720,420,2824,utRho29
yqfA,6086728,6086728,6086296,432,246,utRho29
yqgA,6219042,6219106,6219042,64,22,utRho29
yqgB,6172500,6172500,6172102,398,438,utRho29
yqgE,6185768,6185874,6185768,106,6,utRho29
yqhA,6299150,6299150,6298942,208,70,utRho29
yqhC,6310768,6310768,6310436,332,110,utRho29
yqhD,6310604,6310710,6310604,106,6,utRho29
yqhH,6316842,6317254,6316842,412,222,utRho29
yqiC,6369662,6369680,6369662,18,32,utRho29
yqiJ,6384108,6384416,6384108,308,916,utRho29
yqjA,6495096,6495546,6495096,450,328,utRho29
yqjF,6500932,6501124,6500932,192,460,utRho29
yqjG,6501948,6502048,6501948,100,0,utRho29
yqjH,6433078,6433078,6432982,96,0,utRho29
yqjI,6433506,6433558,6433506,52,0,utRho29
yraH,6574552,6574852,6574552,300,26,utRho29
yraP,6592144,6592818,6592144,674,196,utRho29
yraQ,6596414,6596414,6596276,138,32,utRho29
yraR,6598024,6598024,6597692,332,464,utRho29
yrbG,13360844,13361100,13360844,256,56,utRho29
yrbL,6696842,6696904,6696842,62,662,utRho29
yrbN,6616172,6616172,6615866,306,446,utRho29
yrdB,6860176,6860176,6860046,130,10,utRho29
yrfF,7052548,7052938,7052548,390,116,utRho29
yrhB,7169440,7169518,7169440,78,52,utRho29
ysaB,7451804,7451804,7451424,380,30,utRho29
ysgA,8032686,8032686,8032338,348,302,utRho29
ytfB,8857638,8857638,8857434,204,190,utRho29
ytfE,8864018,8864018,8863966,52,26,utRho29
ytfF,8866296,8866296,8866130,166,322,utRho29
ytfH,8868164,8868226,8868164,62,206,utRho29
ytfI,8875234,8875414,8875234,180,46,utRho29
ytfJ,8878572,8878572,8878524,48,114,utRho29
ytfK,8879022,8879174,8879022,152,358,utRho29
ytfL,8882642,8882642,8882430,212,60,utRho29
ytfQ,8899634,8899924,8899634,290,14,utRho29
ytjB,9249598,9249598,9249578,20,0,utRho29
yzfA,8896588,8896588,8896490,98,0,utRho29
zapA,6111102,6111224,6111102,122,392,utRho29
zapB,8236772,8237030,8236772,258,344,utRho29
zapC,2011700,2011904,2011700,204,92,utRho29
zinT,4082692,4082750,4082692,58,16,utRho29
zipA,5062814,5062814,5062466,348,34,utRho29
zitB,1569716,1569716,1569646,70,10,utRho29
zntA,7212844,7212902,7212844,58,0,utRho29
zntR,6878336,6878336,6878260,76,0,utRho29
znuA,3885322,3885322,3885166,156,92,utRho29
znuC,3885268,3885324,3885268,56,48,utRho29
zraP,8403424,8403424,8403376,48,0,utRho29
zraS,8403810,8403852,8403810,42,68,utRho29
zupT,6364866,6365100,6364866,234,96,utRho29
zur,8520282,8520282,8520006,276,42,utRho29
zwf,3872752,3872752,3872628,124,0,utRho29
C0343,2818676,2818728,2818676,52,0,utRho30
aaeB,6776526,6776526,6776376,150,86,utRho30
aaeR,6778762,6779040,6778762,278,596,utRho30
aaeX,6778860,6778860,6778674,186,684,utRho30
aat,1854920,1854920,1854864,56,146,utRho30
accA,416822,417242,416822,420,552,utRho30
accB,6810280,6810872,6810280,592,1544,utRho30
accD,4868030,4868030,4867852,178,294,utRho30
aceB,8430804,8430956,8430804,152,878,utRho30
aceE,245938,246034,245938,96,102,utRho30
ackA,4826918,4826940,4826918,22,218,utRho30
acnA,2670848,2671662,2670848,814,268,utRho30
acnB,263038,263230,263038,192,600,utRho30
acpP,2303148,2303230,2303148,82,194,utRho30
acpS,5402324,5402324,5401996,328,1010,utRho30
acrA,971396,971396,971238,158,294,utRho30
acrB,969370,969370,968806,564,512,utRho30
acrD,5174950,5175190,5174950,240,216,utRho30
acrE,6827404,6827728,6827404,324,356,utRho30
acrR,971398,971522,971398,124,160,utRho30
acrZ,1589502,1589546,1589502,44,128,utRho30
acs,8575190,8575190,8574742,448,3842,utRho30
actP,8569870,8569870,8569804,66,136,utRho30
ada,4620854,4620854,4620810,44,10,utRho30
add,3404404,3404466,3404404,62,70,utRho30
ade,7687802,7687928,7687802,126,204,utRho30
adhE,2596826,2596826,2596242,584,58,utRho30
adhP,3107988,3107988,3107676,312,126,utRho30
adiA,8681112,8681112,8681042,70,220,utRho30
adiC,8674404,8674404,8674062,342,550,utRho30
adiY,8676084,8676084,8675858,226,0,utRho30
adk,994278,994350,994278,72,3426,utRho30
adrA,807374,807406,807374,32,14,utRho30
aer,6438240,6438240,6438152,88,24,utRho30
aes,1000102,1000102,999946,156,190,utRho30
agaR,6557406,6557406,6557330,76,56,utRho30
agaS,6563778,6563952,6563778,174,248,utRho30
agp,2131118,2131170,2131118,52,38,utRho30
agrA,7296126,7296126,7296126,0,0,utRho30
agrB,7296588,7296588,7296588,0,0,utRho30
ahpC,1277386,1277890,1277386,504,1008,utRho30
ahpF,1278004,1279506,1278004,1502,28530,utRho30
ahr,8992698,8992698,8992418,280,528,utRho30
aidB,8828494,8828550,8828494,56,0,utRho30
ais,4731512,4731512,4731240,272,128,utRho30
alaA,4814816,4815122,4814816,306,258,utRho30
alaC,4996798,4996798,4996590,208,158,utRho30
alaE,5598140,5598328,5598140,188,498,utRho30
alaS,5644180,5644180,5644022,158,498,utRho30
alaW,5036612,5036612,5036462,150,164,utRho30
aldA,2976380,2976464,2976380,84,110,utRho30
aldB,7513070,7513070,7513022,48,338,utRho30
alkA,4295118,4295118,4295080,38,180,utRho30
alkB,4618890,4618890,4618682,208,480,utRho30
allA,1064780,1064902,1064780,122,236,utRho30
allD,1092822,1092822,1092726,96,18,utRho30
allE,1088112,1088112,1088092,20,14,utRho30
allS,1064600,1064600,1064442,158,218,utRho30
alr,8531178,8531564,8531178,386,536,utRho30
alsE,8617334,8617334,8616956,378,1390,utRho30
alsK,8615990,8615990,8615598,392,586,utRho30
alx,6476740,6477160,6476740,420,152,utRho30
amiA,5104482,5104704,5104482,222,18,utRho30
amiC,5898378,5898378,5898020,358,190,utRho30
amn,4110062,4110122,4110062,60,0,utRho30
ampC,8758006,8758006,8757888,118,24,utRho30
ampD,237362,237466,237362,104,2,utRho30
ampG,907372,907372,907090,282,112,utRho30
ampH,792726,792726,792574,152,62,utRho30
amyA,4012230,4012312,4012230,82,72,utRho30
anmK,3439346,3439346,3439204,142,36,utRho30
ansB,6201580,6201580,6201456,124,456,utRho30
ansP,3052040,3052040,3051960,80,150,utRho30
apaG,104068,104068,103212,856,790,utRho30
apaH,102586,102586,102444,142,878,utRho30
apbE,4623188,4623188,4623068,120,0,utRho30
appA,2081198,2081234,2081198,36,84,utRho30
appC,2075420,2075480,2075420,60,104,utRho30
appY,1167134,1167362,1167134,228,0,utRho30
apt,982620,982824,982620,204,84,utRho30
aqpZ,1832424,1832424,1832094,330,368,utRho30
araB,140150,140150,140096,54,0,utRho30
araC,140482,140774,140482,292,208,utRho30
araE,5964416,5964416,5964364,52,0,utRho30
araF,3972476,3972476,3972256,220,186,utRho30
araH,3967120,3967120,3967086,34,130,utRho30
araJ,825058,825058,824962,96,1786,utRho30
arcA,9281602,9281602,9280612,990,2850,utRho30
arcB,6706098,6706098,6706050,48,266,utRho30
arcZ,6701154,6701154,6701154,0,0,utRho30
arfA,6877346,6877346,6877298,48,192,utRho30
argA,5898312,5898484,5898312,172,112,utRho30
argC,8309770,8310002,8309770,232,142,utRho30
argD,6980442,6980442,6980360,82,306,utRho30
argE,8310156,8310156,8309694,462,644,utRho30
argF,580680,580680,580610,70,124,utRho30
argG,6637124,6637274,6637124,150,202,utRho30
argI,8956688,8956688,8956622,66,182,utRho30
argO,6137672,6137672,6137616,56,384,utRho30
argP,6119460,6119506,6119460,46,18,utRho30
argR,6769204,6769406,6769204,202,54,utRho30
argS,3920002,3920124,3920002,122,68,utRho30
argT,4855698,4855698,4855582,116,0,utRho30
argU,1129406,1129446,1129406,40,4,utRho30
argW,4932616,4932618,4932616,2,0,utRho30
argX,7964728,7964750,7964728,22,4,utRho30
aroF,5482402,5482402,5482300,102,64,utRho30
aroG,1571182,1571266,1571182,84,16,utRho30
aroH,3576636,3576870,3576636,234,618,utRho30
aroK,7038760,7038760,7038128,632,2356,utRho30
aroL,812560,812810,812560,250,2736,utRho30
aroP,243342,243342,243102,240,0,utRho30
arpA,8445382,8445382,8444974,408,150,utRho30
arrS,7316108,7316108,7316108,0,0,utRho30
arsR,7297024,7297056,7297024,32,0,utRho30
artJ,1801252,1801252,1801150,102,0,utRho30
artP,1807686,1807686,1807468,218,2322,utRho30
ascF,5678858,5679048,5678858,190,88,utRho30
ascG,5678574,5678574,5678528,46,226,utRho30
aslB,7965562,7965916,7965562,354,126,utRho30
asnA,7854258,7854310,7854258,52,996,utRho30
asnB,1398444,1398444,1398354,90,612,utRho30
asnC,23562186,23562186,23562018,168,894,utRho30
asnS,1978088,1978088,1977970,118,822,utRho30
asnT,4089082,4089098,4089082,16,32,utRho30
asnU,4119690,4119702,4119690,12,6,utRho30
asnV,4124504,4124520,4124504,16,26,utRho30
aspA,17473728,17473728,17473308,420,624,utRho30
aspC,1971486,1971486,1971418,68,2,utRho30
aspS,3901402,3901402,3901044,358,466,utRho30
aspT,7893560,7893744,7893560,184,50994,utRho30
aspV,473826,473862,473826,36,148,utRho30
asr,3342654,3342752,3342654,98,30,utRho30
astC,3664088,3664088,3663964,124,220,utRho30
astE,3654138,3654138,3653846,292,286,utRho30
atoD,4646824,4646894,4646824,70,468,utRho30
atpB,7844540,7844540,7844102,438,1366,utRho30
atpC,7832118,7832118,7831944,174,532,utRho30
atpI,7845050,7845050,7844880,170,2358,utRho30
avtA,7479348,7479410,7479348,62,1500,utRho30
azoR,2965982,2965982,2965720,262,736,utRho30
azuC,3976002,3976002,3975918,84,124,utRho30
bacA,6408350,6408350,6408262,88,25404,utRho30
bamA,394052,395856,394052,1804,2404,utRho30
bamB,5277950,5277950,5277304,646,714,utRho30
bamC,5198028,5198028,5197730,298,1096,utRho30
bamD,5471922,5472292,5471922,370,630,utRho30
bamE,5506972,5507210,5506972,238,2062,utRho30
basS,8666954,8666954,8666544,410,554,utRho30
bax,7474468,7474468,7474354,114,1090,utRho30
bcp,5200874,5200956,5200874,82,428,utRho30
bcsB,7385346,7385346,7385214,132,20,utRho30
bcsE,7392644,7392916,7392644,272,318,utRho30
bdcA,8948128,8948128,8948106,22,450,utRho30
bdcR,8948192,8948248,8948192,56,308,utRho30
bdm,3112680,3112680,3112560,120,258,utRho30
betA,654522,654522,654494,28,0,utRho30
betI,658722,658722,658668,54,254,utRho30
betT,658842,658926,658842,84,588,utRho30
bfr,6933498,6933498,6933450,48,180,utRho30
bglG,23440182,23440182,23439402,780,2892,utRho30
bglX,4444240,4444240,4443978,262,114,utRho30
bhsA,2337962,2338146,2337962,184,244,utRho30
bioA,1618584,1618584,1618514,70,0,utRho30
bioB,1618604,1618688,1618604,84,0,utRho30
bioH,7089716,7089716,7089688,28,28,utRho30
bisC,7433026,7433026,7432788,238,70,utRho30
blc,8755490,8755490,8755444,46,4,utRho30
blr,3409024,3409102,3409024,78,586,utRho30
bluF,2431226,2431226,2430950,276,624,utRho30
bluR,2428226,2428226,2428118,108,12,utRho30
bolA,908698,908944,908698,246,212,utRho30
borD,1157842,1157842,1157786,56,126,utRho30
brnQ,838976,839182,838976,206,2260,utRho30
bssR,1756492,1756496,1756492,4,0,utRho30
bssS,2242116,2242116,2241910,206,1112,utRho30
btuB,8326798,8327278,8326798,480,1508,utRho30
cadB,8720212,8720212,8720062,150,828,utRho30
cadC,8723926,8723926,8723868,58,74,utRho30
caiE,70998,70998,70742,256,74,utRho30
caiF,68436,68600,68436,164,596,utRho30
caiT,84074,84074,83862,212,350,utRho30
can,285406,285406,285340,66,296,utRho30
carA,59102,59302,59102,200,1158,utRho30
carB,61550,61634,61550,84,304,utRho30
cas2,5757830,5757830,5757706,124,362,utRho30
casA,5768638,5768638,5768276,362,88,utRho30
cbl,4121882,4121882,4121828,54,64,utRho30
cbpA,2128074,2128074,2127550,524,200,utRho30
cbrA,7738628,7738754,7738628,126,4,utRho30
cbrB,7794958,7795012,7794958,54,136,utRho30
ccmH,4585242,4585242,4584820,422,206,utRho30
cdaR,364894,364926,364894,32,56,utRho30
cdd,4463638,4463688,4463638,50,32,utRho30
cdh,8219814,8219860,8219814,46,542,utRho30
cdsA,391110,391354,391110,244,990,utRho30
cedA,3627484,3627484,3627326,158,380,utRho30
cfa,3482402,3482826,3482402,424,214,utRho30
chaC,2544844,2544972,2544844,128,574,utRho30
chbB,3643452,3643452,3643238,214,338,utRho30
chbG,3634624,3634624,3634270,354,20,utRho30
cheW,3946924,3946924,3946678,246,362,utRho30
chiA,6939792,6939792,6939706,86,1600,utRho30
chiP,1416472,1416668,1416472,196,80,utRho30
cho,3646984,3647030,3646984,46,0,utRho30
chpS,8896804,8896894,8896804,90,202,utRho30
cirA,4493884,4493884,4493538,346,684,utRho30
citC,1304078,1304078,1303712,366,1666,utRho30
citT,1293264,1293264,1293160,104,206,utRho30
clcA,350104,350214,350104,110,10,utRho30
clpA,1846160,1846528,1846160,368,182,utRho30
clpB,5468410,5468410,5468346,64,1114,utRho30
clpP,913154,913354,913154,200,2882,utRho30
clpS,1845500,1845826,1845500,326,844,utRho30
clpX,914404,914852,914404,448,5764,utRho30
clsA,2617346,2617346,2617290,56,142,utRho30
clsC,2212584,2212710,2212584,126,174,utRho30
cmk,1922330,1922402,1922330,72,40,utRho30
cnu,3409522,3409898,3409522,376,690,utRho30
coaA,8350214,8350214,8350052,162,1092,utRho30
cobC,1340092,1340092,1339814,278,560,utRho30
cobT,4129202,4129202,4128934,268,164,utRho30
cobU,4131944,4131944,4131528,416,712,utRho30
codB,709768,709844,709768,76,480,utRho30
comR,2337726,2337726,2337664,62,0,utRho30
copA,1022822,1022822,1022758,64,126,utRho30
corA,8002388,8002852,8002388,464,13870,utRho30
cpdB,8873258,8873258,8873130,128,150,utRho30
cptB,6082198,6082198,6082140,58,0,utRho30
cpxA,8210202,8210202,8209950,252,98,utRho30
cpxP,8211570,8211640,8211570,70,350,utRho30
cpxR,8211372,8211372,8211340,32,0,utRho30
cra,175894,176056,175894,162,550,utRho30
crcB,1316016,1316016,1315876,140,56,utRho30
creA,9270486,9271042,9270486,556,1160,utRho30
creD,9276320,9276356,9276320,36,534,utRho30
crl,515620,515658,515620,38,912,utRho30
crp,6971906,6972240,6971906,334,586,utRho30
crr,5070960,5071668,5070960,708,2628,utRho30
csdA,5886414,5886674,5886414,260,0,utRho30
csgB,2207718,2207902,2207718,184,0,utRho30
csgD,2206688,2206688,2206392,296,1640,utRho30
csgG,2203510,2203510,2203368,142,888,utRho30
csiD,5577854,5577970,5577854,116,260,utRho30
csiE,5330802,5330870,5330802,68,0,utRho30
csiR,5590942,5591348,5590942,406,418,utRho30
cspA,7439778,7440098,7439778,320,1192,utRho30
cspB,3283430,3283430,3283108,322,144,utRho30
cspC,3815018,3815018,3814870,148,158,utRho30
cspD,1845352,1845352,1845180,172,4480,utRho30
cspE,1314294,1314584,1314294,290,632,utRho30
cspF,3283380,3283710,3283380,330,2054,utRho30
cspG,2102610,2102922,2102610,312,740,utRho30
cspH,2102746,2102746,2102350,396,330,utRho30
cspI,3277624,3277624,3277334,290,48,utRho30
csrA,5638746,5638746,5638292,454,2328,utRho30
csrB,5849048,5849048,5849048,0,0,utRho30
csrC,8102072,8102072,8102072,0,0,utRho30
csrD,6806850,6806850,6806664,186,350,utRho30
cstA,1259710,1259788,1259710,78,0,utRho30
cueO,274090,274166,274090,76,0,utRho30
cueR,1027948,1027986,1027948,38,76,utRho30
curA,3037784,3038054,3037784,270,488,utRho30
cusC,1191146,1191200,1191146,54,14,utRho30
cusR,1190924,1190924,1190886,38,260,utRho30
cutA,8730784,8730784,8730712,72,156,utRho30
cutC,3918534,3918534,3917920,614,750,utRho30
cvpA,4861600,4861600,4861526,74,78,utRho30
cvrA,2484328,2484328,2484142,186,22,utRho30
cyaA,7981548,7982306,7981548,758,926,utRho30
cyaR,4334228,4334224,4334228,4,2,utRho30
cyaY,7988166,7988166,7988118,48,690,utRho30
cybB,2981522,2981804,2981522,282,100,utRho30
cycA,8859560,8859728,8859560,168,476,utRho30
cydA,1542340,1542916,1542340,576,6714,utRho30
cydC,1858800,1858800,1858390,410,324,utRho30
cydD,1862062,1862062,1861924,138,0,utRho30
cydX,1548300,1548392,1548300,92,202,utRho30
cynR,717418,717418,717380,38,68,utRho30
cynT,1435092,1435196,1435092,104,40,utRho30
cyoA,903306,903306,903220,86,922,utRho30
cyoE,895540,895540,895410,130,154,utRho30
cysB,2667576,2667710,2667576,134,750,utRho30
cysC,5748056,5748056,5747984,72,228,utRho30
cysD,5752736,5752736,5752658,78,286,utRho30
cysE,7565362,7565362,7565124,238,480,utRho30
cysG,6995508,6995656,6995508,148,4748,utRho30
cysJ,5783928,5783928,5783796,132,2008,utRho30
cysK,5064688,5064818,5064688,130,44,utRho30
cysP,5087114,5087114,5087056,58,100,utRho30
cysS,1109154,1109222,1109154,68,122,utRho30
cysT,3984100,3984100,3983974,126,16,utRho30
cysZ,5062766,5062926,5062766,160,576,utRho30
cytR,8249018,8249018,8248912,106,406,utRho30
dacA,1328002,1328002,1327926,76,110,utRho30
dacB,6657714,6657926,6657714,212,170,utRho30
dacC,1761306,1761454,1761306,148,1094,utRho30
dadA,2475018,2475142,2475018,124,120,utRho30
dam,7032504,7032504,7031826,678,526,utRho30
damX,7035200,7035200,7034612,588,3756,utRho30
dapA,5199568,5199568,5199520,48,0,utRho30
dapB,56576,56748,56576,172,908,utRho30
dapD,371954,371954,371894,60,456,utRho30
dapE,5183120,5183214,5183120,94,876,utRho30
dcp,3254844,3254844,3254760,84,50,utRho30
dcrB,7219534,7219910,7219534,376,806,utRho30
dctA,7366996,7366996,7366894,102,672,utRho30
dcuA,8733686,8733686,8733546,140,2392,utRho30
dcuB,8698182,8698182,8697488,694,3808,utRho30
dcuC,1312166,1312166,1311936,230,1216,utRho30
dcuD,6749166,6749738,6749166,572,1420,utRho30
dcuR,8701130,8701130,8700068,1062,1384,utRho30
dcuS,8703370,8703370,8703324,46,554,utRho30
dcyD,3999016,3999016,3998960,56,0,utRho30
ddpX,3126498,3126498,3126152,346,58,utRho30
deaD,6615818,6615818,6615720,98,28,utRho30
dedA,4869880,4869880,4869482,398,512,utRho30
dedD,4863750,4863750,4863368,382,90,utRho30
def,6867300,6867380,6867300,80,214,utRho30
degP,361690,361768,361690,78,76,utRho30
degQ,6761308,6761486,6761308,178,938,utRho30
deoB,9239134,9239206,9239134,72,78,utRho30
deoC,9233358,9234646,9233358,1288,1460,utRho30
dfp,7625406,7625462,7625406,56,70,utRho30
dgcZ,3247758,3247758,3247700,58,170,utRho30
dgkA,8512914,8513274,8512914,360,472,utRho30
dgt,358392,358474,358392,82,302,utRho30
dhaK,2501888,2501888,2501676,212,116,utRho30
dhaR,2502006,2502132,2502006,126,164,utRho30
dicB,3299194,3299218,3299194,24,0,utRho30
dicC,3295752,3295752,3295700,52,40,utRho30
dinB,501760,501796,501760,36,0,utRho30
dinD,7635398,7635520,7635398,122,154,utRho30
dinG,1666146,1666140,1666146,6,12,utRho30
dinI,2243018,2243018,2242974,44,384,utRho30
dinJ,493230,493230,493004,226,208,utRho30
dinQ,7295964,7295964,7295576,388,240,utRho30
djlA,114536,114728,114536,192,130,utRho30
dkgA,6313142,6313246,6313142,104,180,utRho30
dkgB,458196,458334,458196,138,136,utRho30
dksA,321502,321502,321208,294,1086,utRho30
dld,4444164,4444370,4444164,206,130,utRho30
dmlA,3763424,3763824,3763424,400,978,utRho30
dmlR,3763710,3763710,3763618,92,474,utRho30
dmsA,1881646,1881918,1881646,272,180,utRho30
dnaA,7767922,7767922,7767458,464,122,utRho30
dnaB,8528566,8528628,8528566,62,300,utRho30
dnaK,24096,24326,24096,230,9838,utRho30
dnaN,7765466,7765466,7764642,824,456,utRho30
dnaQ,471868,472134,471868,266,3834,utRho30
dnaT,18406460,18406460,18406068,392,204,utRho30
dnaX,984112,984184,984112,72,46,utRho30
dosP,3131486,3131486,3131466,20,66,utRho30
dpiB,1303968,1304470,1303968,502,318,utRho30
dppA,7415740,7415740,7415410,330,2252,utRho30
dps,1697900,1697900,1697822,78,434,utRho30
dsbA,8086754,8086836,8086754,82,458,utRho30
dsbB,2466294,2466294,2466060,234,64,utRho30
dsbC,6079266,6079266,6077644,1622,2354,utRho30
dsbG,1277600,1277600,1277146,454,416,utRho30
dsdA,4958242,4958404,4958242,162,432,utRho30
dsdC,4955492,4955492,4955258,234,318,utRho30
dsdX,4955642,4955694,4955642,52,1068,utRho30
dsrA,4050626,4050626,4050626,0,0,utRho30
dsrB,4049686,4049686,4049646,40,576,utRho30
dtpD,1485340,1485340,1485112,228,404,utRho30
dusA,8523200,8523338,8523200,138,1052,utRho30
dusB,6820492,6820560,6820492,68,64,utRho30
dusC,4460790,4460790,4460770,20,0,utRho30
dut,7627704,7627864,7627704,160,858,utRho30
dxr,386670,387042,386670,372,260,utRho30
ebgA,6445102,6445266,6445102,164,76,utRho30
ebgR,6442874,6442932,6442874,58,18,utRho30
ecnB,8753018,8753106,8753018,88,0,utRho30
eco,4607594,4607810,4607594,216,0,utRho30
ecpA,621594,621594,621342,252,190,utRho30
ecpB,620238,620238,620052,186,32,utRho30
ecpR,622964,622964,622672,292,34,utRho30
eda,3866218,3866218,3865512,706,180,utRho30
edd,3869426,3869426,3869208,218,0,utRho30
efeO,2164308,2164486,2164308,178,0,utRho30
efeU_1,2162614,2162712,2162614,98,306,utRho30
efp,8751134,8751398,8751134,264,2194,utRho30
elaA,4763372,4763372,4763086,286,198,utRho30
elaD,4765308,4765426,4765308,118,426,utRho30
elfA,1995530,1995736,1995530,206,0,utRho30
elfD,1996642,1996980,1996642,338,342,utRho30
emrD,7707690,7707844,7707690,154,514,utRho30
emrK,4966896,4966896,4966678,218,172,utRho30
emrY,4964668,4964668,4964352,316,1110,utRho30
emtA,2486250,2486360,2486250,110,8,utRho30
endA,12361100,12361388,12361100,288,84,utRho30
eno,5817692,5817692,5815882,1810,476,utRho30
entC,1249662,1249770,1249662,108,48,utRho30
entD,1220508,1220508,1220158,350,84,utRho30
entH,1258584,1258600,1258584,16,0,utRho30
entS,1244506,1244600,1244506,94,62,utRho30
envR,6827266,6827266,6826930,336,122,utRho30
epd,12295292,12295292,12294764,528,312,utRho30
epmA,8765236,8765286,8765236,50,382,utRho30
epmB,8751406,8751406,8751314,92,1500,utRho30
eptB,7421162,7421162,7420950,212,214,utRho30
eptC,8300622,8300622,8300530,92,202,utRho30
erfK,4126708,4126708,4126646,62,160,utRho30
erpA,353122,353220,353122,98,16,utRho30
esrE,8039956,8039956,8039956,0,0,utRho30
essD,1153746,1154796,1153746,1050,554,utRho30
etk,2088606,2088606,2088420,186,208,utRho30
evgA,4967262,4967510,4967262,248,382,utRho30
exbB,6304028,6304028,6303968,60,338,utRho30
exbD,6302780,6302780,6302486,294,398,utRho30
exuR,6493016,6493304,6493016,288,14,utRho30
exuT,6490004,6490208,6490004,204,114,utRho30
fabA,2032996,2032996,2032940,56,52,utRho30
fabB,4883282,4883282,4883210,72,50,utRho30
fabH,2297032,2297518,2297032,486,28,utRho30
fabI,2702236,2702236,2702078,158,42,utRho30
fadB,8062026,8062026,8061942,84,4,utRho30
fadD,3779614,3779614,3779492,122,474,utRho30
fadE,486812,486812,486606,206,162,utRho30
fadH,6463248,6463330,6463248,82,114,utRho30
fadI,4921022,4921022,4920938,84,498,utRho30
fadL,4922410,4922600,4922410,190,386,utRho30
fadM,928720,928804,928720,84,0,utRho30
fadR,2469810,2469876,2469810,66,124,utRho30
fbaB,4357334,4357334,4357128,206,40,utRho30
fdhE,8162722,8162722,8162456,266,372,utRho30
fdhF,8598814,8598814,8598732,82,244,utRho30
fdnG,3094744,3094802,3094744,58,0,utRho30
fdrA,1093012,1093360,1093012,348,28,utRho30
feaB,2894994,2895038,2894994,44,0,utRho30
feaR,2894734,2894734,2894566,168,60,utRho30
fecA,9033454,9033454,9033354,100,0,utRho30
fecE,9023288,9023288,9022914,374,1372,utRho30
fecI,9036564,9036564,9036470,94,176,utRho30
feoA,7080114,7080326,7080114,212,306,utRho30
fepA,1225334,1225334,1224988,346,750,utRho30
fepB,1249454,1249454,1249020,434,206,utRho30
fepD,1244468,1244468,1244378,90,50,utRho30
fes,1225374,1225630,1225374,256,784,utRho30
ffh,5495706,5495706,5495590,116,1262,utRho30
ffs,952576,952848,952576,272,898,utRho30
fhuA,334884,334968,334884,84,392,utRho30
fhuE,2323294,2323294,2323102,192,546,utRho30
fhuF,9211504,9211504,9211326,178,920,utRho30
fic,6983296,6983296,6982926,370,282,utRho30
fieF,8212864,8212938,8212864,74,334,utRho30
fimA,9085388,9086230,9085388,842,3198,utRho30
fimB,9081334,9081914,9081334,580,5502,utRho30
fimE,9083742,9084074,9083742,332,1622,utRho30
fimZ,1129214,1129214,1128960,254,174,utRho30
fiu,1683296,1683296,1683062,234,256,utRho30
fixA,84650,84806,84650,156,390,utRho30
fkpA,6955050,6955050,6954838,212,9786,utRho30
fldA,2846084,2846084,2845860,224,1416,utRho30
fldB,6079644,6079710,6079644,66,148,utRho30
flgA,2261770,2261770,2261726,44,748,utRho30
flgB,2261986,2262036,2261986,50,70,utRho30
flgK,2276702,2276756,2276702,54,200,utRho30
flgM,2260330,2260330,2260256,74,38,utRho30
flgN,2259828,2259828,2259660,168,28,utRho30
flhB,3932432,3932432,3932382,50,410,utRho30
flhC,3955864,3955864,3955688,176,148,utRho30
flhD,3957154,3957154,3956394,760,3182,utRho30
fliA,4003638,4003638,4003578,60,32,utRho30
fliC,4007352,4007352,4007212,140,130,utRho30
fliD,4007634,4007744,4007634,110,152,utRho30
fliE,4026186,4026186,4026028,158,1420,utRho30
fliF,4026292,4026458,4026292,166,1130,utRho30
fliL,4039168,4039236,4039168,68,196,utRho30
flk,4875824,4875900,4875824,76,42,utRho30
flu,4142634,4143078,4142634,444,546,utRho30
flxA,3292776,3292810,3292776,34,452,utRho30
fnr,2799104,2799104,2799052,52,8,utRho30
fnrS,2818258,2818258,2818258,0,0,utRho30
focA,1909628,1909628,1908932,696,750,utRho30
folA,99598,99646,99598,48,192,utRho30
folB,6409296,6409296,6409178,118,1408,utRho30
folD,1115562,1115562,1115482,80,88,utRho30
folE,4487696,4487696,4487304,392,282,utRho30
fpr,8228998,8228998,8228944,54,32,utRho30
frc,4986878,4986878,4986508,370,268,utRho30
frdA,8764824,8764824,8764636,188,120,utRho30
frdD,8758948,8758948,8758732,216,644,utRho30
fre,8052886,8053054,8052886,168,150,utRho30
frlA,6999518,6999820,6999518,302,134,utRho30
frr,385624,385744,385624,120,338,utRho30
frsA,513004,513054,513004,50,30,utRho30
fruB,4527194,4527194,4526990,204,116,utRho30
frvR,8179804,8179804,8179710,94,124,utRho30
fryA,5008986,5008986,5008970,16,102,utRho30
fsaA,1727060,1727284,1727060,224,310,utRho30
fsr,1009710,1009710,1009392,318,1488,utRho30
ftnA,3977364,3977432,3977364,68,38,utRho30
ftnB,3973550,3973850,3973550,300,398,utRho30
ftsA,207122,207964,207122,842,1012,utRho30
ftsB,5745802,5745802,5745640,162,250,utRho30
ftsH,6654204,6654204,6653870,334,2534,utRho30
ftsK,1865858,1866448,1865858,590,458,utRho30
ftsL,181376,182064,181376,688,482,utRho30
ftsP,6325732,6325732,6325338,394,208,utRho30
ftsQ,205484,206310,205484,826,2034,utRho30
ftsX,7204512,7204512,7204172,340,680,utRho30
ftsZ,209272,210610,209272,1338,762,utRho30
fucA,5867708,5867708,5867376,332,7632,utRho30
fucP,5868238,5868470,5868238,232,862,utRho30
fumA,6753760,6753760,6753508,252,1904,utRho30
fumB,8694696,8694696,8694652,44,0,utRho30
fumC,3373418,3373418,3373176,242,50,utRho30
fur,2842892,2842892,2842584,308,372,utRho30
fusA,6947370,6947370,6947028,342,5818,utRho30
fxsA,8737206,8737328,8737206,122,2836,utRho30
gabD,5581824,5582546,5581824,722,2284,utRho30
gadA,7335214,7335214,7335160,54,0,utRho30
gadB,3144144,3144144,3144090,54,248,utRho30
gadC,3141168,3141168,3140978,190,1812,utRho30
gadE,7315600,7316732,7315600,1132,2232,utRho30
gadW,7329562,7329562,7329236,326,494,utRho30
gadX,14663356,14663356,14663240,116,120,utRho30
gadY,7329728,7329728,7329728,0,0,utRho30
galE,1584354,1584354,1584110,244,86,utRho30
galF,4228702,4228702,4228654,48,476,utRho30
galM,1577796,1577796,1577674,122,162,utRho30
galP,6176510,6176568,6176510,58,174,utRho30
galR,5953138,5953198,5953138,60,112,utRho30
galS,4483420,4483420,4483336,84,4,utRho30
galU,2582810,2582914,2582810,104,136,utRho30
gapA,3724480,3725542,3724480,1062,2120,utRho30
garP,6549868,6549868,6549814,54,622,utRho30
gatY,4354468,4354468,4354408,60,0,utRho30
gatZ,4352864,4352864,4352642,222,428,utRho30
gcd,282558,282558,282450,108,130,utRho30
gcl,1067814,1067832,1067814,18,0,utRho30
gcvA,5885278,5885278,5885134,144,180,utRho30
gcvB,5885392,5885392,5885392,0,0,utRho30
gcvR,5199758,5199812,5199758,54,66,utRho30
gcvT,6101544,6101544,6101334,210,362,utRho30
gdhA,3684616,3684742,3684616,126,70,utRho30
gfcA,2099668,2099668,2099488,180,312,utRho30
gfcD,2096236,2096236,2095890,346,678,utRho30
ghrA,2195648,2195772,2195648,124,528,utRho30
ghrB,7434378,7434620,7434378,242,896,utRho30
glcA,6242728,6242728,6242558,170,816,utRho30
glcC,6256412,6256544,6256412,132,76,utRho30
glcD,6256152,6256152,6256042,110,234,utRho30
gldA,8278092,8278092,8278070,22,206,utRho30
glgA,7136784,7136784,7136066,718,956,utRho30
glgB,7147314,7147314,7147004,310,572,utRho30
glgC,7139142,7139142,7138656,486,346,utRho30
glgP,7133546,7133546,7133162,384,688,utRho30
glgS,6384024,6384024,6383878,146,842,utRho30
glgX,7142838,7142838,7142638,200,6,utRho30
glk,5018922,5018922,5018852,70,18,utRho30
glmS,7827622,7827622,7827336,286,362,utRho30
glmU,7830652,7830652,7830400,252,630,utRho30
glmY,10765360,10765360,10765360,0,0,utRho30
glmZ,7972864,7972864,7972864,0,0,utRho30
glnA,16232888,16232888,16232136,752,412,utRho30
glnB,5375052,5375052,5374816,236,168,utRho30
glnD,377310,377310,377300,10,546,utRho30
glnE,6399602,6399602,6399282,320,0,utRho30
glnH,1696396,1696396,1696008,388,534,utRho30
glnK,945112,945196,945112,84,458,utRho30
glnL,8112742,8112742,8112678,64,0,utRho30
glnQ,1693262,1693262,1692926,336,416,utRho30
glnS,1411998,1412186,1411998,188,4894,utRho30
gloA,3455602,3455674,3455602,72,8,utRho30
gloB,469852,469852,469564,288,1404,utRho30
glpA,4705166,4705294,4705166,128,156,utRho30
glpD,7123942,7124026,7123942,84,176,utRho30
glpE,7123698,7123698,7123646,52,60,utRho30
glpF,8236322,8236322,8236180,142,2106,utRho30
glpG,7122960,7122960,7122904,56,84,utRho30
glpR,7121782,7121782,7121210,572,6386,utRho30
glpT,4704902,4704902,4704748,154,320,utRho30
glpX,8231212,8231212,8231158,54,258,utRho30
glrK,5382246,5382246,5382196,50,0,utRho30
gltA,1509534,1509534,1508936,598,2034,utRho30
gltB,6709018,6709264,6709018,246,426,utRho30
gltI,1375792,1375792,1375494,298,2746,utRho30
gltP,8588536,8588962,8588536,426,418,utRho30
gltS,7657382,7657382,7657330,52,542,utRho30
gltX,5041568,5041568,5041344,224,960,utRho30
gluQ,320286,320286,320224,62,134,utRho30
glyA,5371148,5371148,5371014,134,0,utRho30
glyQ,7450708,7450708,7450636,72,132,utRho30
glyS,7448990,7448990,7448794,196,144,utRho30
glyU,5998128,5998128,5998114,14,0,utRho30
glyV,8784626,8784720,8784626,94,80,utRho30
glyW,3984360,3984360,3984234,126,2,utRho30
gmhB,445612,445666,445612,54,0,utRho30
gmk,7642776,7642856,7642776,80,66,utRho30
gmr,2693686,2693686,2693484,202,4,utRho30
gnd,4202648,4202648,4202536,112,416,utRho30
gnsB,3275692,3275692,3275564,128,104,utRho30
gntK,14310580,14310580,14310368,212,1056,utRho30
gntP,9102668,9102668,9102592,76,1774,utRho30
gntR,7157760,7157760,7157452,308,346,utRho30
gntT,7092810,7093118,7092810,308,1760,utRho30
gntU,7154170,7154170,7154122,48,452,utRho30
gntX,7089334,7089764,7089334,430,590,utRho30
gor,7292224,7292598,7292224,374,40,utRho30
gpmA,1575340,1575340,1575190,150,4,utRho30
gpmM,7570374,7570520,7570374,146,174,utRho30
gpsA,7567620,7567620,7567322,298,2472,utRho30
gpt,511828,511954,511828,126,278,utRho30
grcA,5433046,5433046,5432898,148,810,utRho30
greA,6657728,6657728,6657430,298,1556,utRho30
greB,7073488,7073624,7073488,136,198,utRho30
groL,8741566,8742050,8741566,484,33984,utRho30
groS,8741232,8741376,8741232,144,27816,utRho30
grpE,5501494,5501494,5501416,78,1230,utRho30
grxA,1781552,1781552,1781506,46,14,utRho30
grxB,2248206,2248206,2248108,98,784,utRho30
grxC,7569152,7569152,7568884,268,940,utRho30
grxD,3468324,3468324,3468202,122,1316,utRho30
gspA,6911268,6911268,6910796,472,1126,utRho30
gspC,6910964,6911156,6910964,192,422,utRho30
gss,6277220,6277220,6277044,176,530,utRho30
gstA,3428654,3428754,3428654,100,4,utRho30
gstB,1761038,1761038,1760960,78,442,utRho30
guaB,5268214,5268214,5268140,74,216,utRho30
gudD,5839026,5839026,5838770,256,124,utRho30
gyrA,4678914,4678914,4678840,74,64,utRho30
gyrB,7760300,7760300,7760238,62,82,utRho30
hcaE,5337964,5338064,5337964,100,332,utRho30
hcaR,5337928,5337928,5337792,136,382,utRho30
hcaT,5336106,5336106,5335692,414,698,utRho30
hchA,4071260,4071670,4071260,410,238,utRho30
hcp,1828258,1828258,1827628,630,902,utRho30
hcr,1824400,1824400,1824300,100,12,utRho30
hdeA,7313582,7313582,7313480,102,136,utRho30
hdeD,7313920,7313990,7313920,70,4186,utRho30
hdfR,7896320,7896320,7895934,386,318,utRho30
hdhA,3396244,3396244,3396080,164,236,utRho30
helD,2048876,2048942,2048876,66,208,utRho30
hemA,2527166,2527428,2527166,262,210,utRho30
hemB,779722,779722,779454,268,500,utRho30
hemF,5106410,5106450,5106410,40,54,utRho30
hemH,996062,996110,996062,48,0,utRho30
hemL,349882,349882,349764,118,36,utRho30
hemN,8103886,8104090,8103886,204,166,utRho30
hepA,127176,127176,126528,648,35584,utRho30
hflD,2385372,2385372,2385262,110,150,utRho30
hfq,8799602,8800576,8799602,974,11964,utRho30
hha,961006,961006,960616,390,16,utRho30
hicA,3018442,3018572,3018442,130,154,utRho30
higA,6468682,6468682,6468288,394,1730,utRho30
higB,6468960,6468960,6468910,50,540,utRho30
hinT,2323642,2323770,2323642,128,88,utRho30
hipB,3184964,3184964,3184884,80,108,utRho30
hisB,4186720,4186936,4186720,216,322,utRho30
hisJ,4853674,4853674,4853576,98,122,utRho30
hisL,8359856,8359984,8359856,128,1140,utRho30
hisS,5281284,5281284,5281150,134,2,utRho30
hlpA,400910,400964,400910,54,68,utRho30
hlyE,2460932,2460932,2460788,144,294,utRho30
hmp,5371594,5371670,5371594,76,0,utRho30
hns,2585916,2585916,2585844,72,4886,utRho30
hofM,7045856,7045856,7045502,354,460,utRho30
hokA,7441620,7441620,7441200,420,1118,utRho30
hokC,33902,33902,33806,96,1216,utRho30
hokE,1215462,1215672,1215462,210,102,utRho30
holC,8968546,8968546,8968560,14,98,utRho30
holD,9215562,9215606,9215562,44,0,utRho30
holE,3850040,3850216,3850040,176,158,utRho30
hpt,282720,282862,282720,142,562,utRho30
hrpB,324150,324210,324150,60,108,utRho30
hscB,5319048,5319048,5318934,114,140,utRho30
hscC,1367188,1367188,1366786,402,258,utRho30
hsdS,9163004,9163004,9162924,80,1788,utRho30
hslJ,2883560,2883560,2883486,74,1480,utRho30
hslO,7059344,7059548,7059344,204,177112,utRho30
hslR,7058220,7058696,7058220,476,15886,utRho30
hslV,8244708,8244708,8244574,134,350,utRho30
hsrA,7881412,7881412,7881224,188,16,utRho30
htgA,21286,21660,21286,374,2470,utRho30
htpG,989634,990240,989634,606,1120,utRho30
htpX,3825236,3825236,3825152,84,210,utRho30
htrE,311036,311036,310852,184,984,utRho30
htrL,7587668,7587668,7587366,302,1202,utRho30
hupA,8400352,8400562,8400352,210,22,utRho30
hupB,1845220,1845804,1845220,584,1056,utRho30
hyaA,2063968,2064278,2063968,310,136,utRho30
hybO,6292726,6292726,6292522,204,424,utRho30
hycA,5700922,5700922,5700870,52,70,utRho30
hycI,5686204,5686204,5686086,118,750,utRho30
hydN,5676264,5676264,5676210,54,86,utRho30
hyfA,5202342,5202402,5202342,60,56,utRho30
hypA,11402508,11402588,11402508,80,488,utRho30
hypB,11403356,11404004,11403356,648,120,utRho30
hypF,5676210,5676210,5674850,1360,4884,utRho30
hypT,9116634,9116634,9116578,56,60,utRho30
hyuA,6019660,6020056,6019660,396,204,utRho30
iaaA,1733074,1733136,1733074,62,98,utRho30
iadA,9119074,9119074,9119052,22,482,utRho30
iap,5753072,5753162,5753072,90,122,utRho30
ibaG,6673966,6673966,6673606,360,202,utRho30
ibpA,7735036,7735036,7734844,192,13328,utRho30
ibpB,7733962,7733962,7733794,168,153552,utRho30
icd,2389922,2390246,2389922,324,136,utRho30
iclR,8447304,8447304,8447256,48,284,utRho30
idi,6065876,6066130,6065876,254,166,utRho30
idnD,8988870,8988870,8988812,58,40,utRho30
idnK,8989194,8989246,8989194,52,364,utRho30
ihfA,3591442,3591442,3591104,338,176,utRho30
ihfB,1927498,1927656,1927498,158,154,utRho30
ileS,43666,44782,43666,1116,2632,utRho30
ileX,6431194,6431196,6431194,2,54,utRho30
ilvA,15820940,15821324,15820940,384,652,utRho30
ilvC,7915824,7915940,7915824,116,206,utRho30
ilvE,15809552,15809936,15809552,384,204,utRho30
ilvI,170840,171260,170840,420,266,utRho30
ilvL,23701308,23701932,23701308,624,648,utRho30
ilvY,7915734,7915734,7915640,94,360,utRho30
inaA,4698998,4698998,4698944,54,280,utRho30
infA,1853370,1853370,1852886,484,254,utRho30
infC,3602692,3602692,3601276,1416,1154,utRho30
insA-5,3958452,3958452,3958430,22,98,utRho30
insA-7,9036758,9037054,9036758,296,740,utRho30
insC-5,6372080,6372284,6372080,204,1050,utRho30
insEF-2,785238,785238,785820,582,822,utRho30
insEF-4,2190310,2190310,2190892,582,716,utRho30
insG,9007098,9007098,9006862,236,32,utRho30
insH-1,550596,550596,550234,362,914,utRho30
insH-11,7306538,7306538,7306396,142,646,utRho30
insH-2,1151548,1151548,1151506,42,400,utRho30
insH-3,1378444,1378444,1378026,418,850,utRho30
insH-4,2791942,2792152,2791942,210,360,utRho30
insH-5,2857852,2857852,2857452,400,292,utRho30
insH-6,4135022,4135022,4134642,380,948,utRho30
insH-7,4206186,4206186,4205822,364,2236,utRho30
insH-9,6260050,6260356,6260050,306,1196,utRho30
insI-3,9017372,9017372,9017234,138,62,utRho30
insJ,7441188,7441360,7441188,172,562,utRho30
insK,7442130,7442308,7442130,178,82,utRho30
insL-1,30760,30890,30760,130,19262,utRho30
insL-2,1216112,1216130,1216112,18,434,utRho30
insL-3,5028644,5028662,5028644,18,468,utRho30
insN-1,540452,540484,540452,32,0,utRho30
intD,1132202,1132202,1131956,246,1082,utRho30
intR,2826520,2826520,2826470,50,72,utRho30
intS,4933026,4933090,4933026,64,98,utRho30
intZ,5117386,5117542,5117386,156,726,utRho30
iraD,9113152,9113986,9113152,834,872,utRho30
iraM,2424246,2424246,2424006,240,134,utRho30
iraP,802638,802772,802638,134,58,utRho30
iscA,5319924,5319924,5319772,152,942,utRho30
iscR,5324398,5324398,5324262,136,2674,utRho30
iscX,5313834,5313834,5313472,362,484,utRho30
ispF,5743968,5743968,5743560,408,136,utRho30
ispG,5283908,5283908,5283608,300,66,utRho30
ispU,389568,389806,389568,238,244,utRho30
isrA,2811502,2811502,2811618,116,80,utRho30
istr-1,7706384,7706384,7706384,0,0,utRho30
istr-2,7706514,7706514,7706514,0,0,utRho30
ivbL,15412092,15412092,15411952,140,280,utRho30
ivy,480638,480686,480638,48,0,utRho30
katE,3627628,3627734,3627628,106,446,utRho30
katG,8267624,8267670,8267624,46,584,utRho30
kbaZ,6557732,6557828,6557732,96,28,utRho30
kbl,7585154,7585154,7585102,52,436,utRho30
kch,2621046,2621046,2620538,508,392,utRho30
kdgR,3820506,3820506,3820198,308,108,utRho30
kdpE,1443788,1443788,1443466,322,400,utRho30
kdpF,1457698,1457698,1457642,56,286,utRho30
kdsA,2535708,2536330,2535708,622,854,utRho30
kdsC,6683438,6684546,6683438,1108,7396,utRho30
kduI,5968388,5968388,5968248,140,854,utRho30
kefF,94160,94492,94160,332,4252,utRho30
kgtP,5451624,5451624,5451492,132,688,utRho30
kup,7862206,7862632,7862206,426,5928,utRho30
lacI,735076,735076,735020,56,190,utRho30
lacZ,1465508,1465508,1465220,288,740,utRho30
ldcA,2486394,2486394,2486160,234,92,utRho30
ldhA,2885830,2885830,2885686,144,952,utRho30
ldrA,2538954,2538954,2538550,404,976,utRho30
ldrB,2540024,2540024,2539620,404,396,utRho30
ldrC,2541092,2541092,2540690,402,218,utRho30
ldrD,7400544,7400544,7400174,370,442,utRho30
lepA,5414392,5414392,5414248,144,1254,utRho30
lepB,5410928,5410928,5410618,310,3828,utRho30
leuD,159188,159188,158906,282,256,utRho30
leuE,3761600,3761600,3761518,82,240,utRho30
leuL,168048,168048,167416,632,246,utRho30
leuO,168308,168736,168308,428,200,utRho30
leuQ,9212864,9212864,9212802,62,4,utRho30
leuU,6644556,6644556,6644316,240,636,utRho30
leuV,9212546,9212546,9212330,216,394,utRho30
leuX,8992772,8992810,8992772,38,52,utRho30
lexA,8514174,8514230,8514174,56,1172,utRho30
lhr,3456706,3458174,3456706,1468,756,utRho30
ligA,5060402,5060402,5060352,50,0,utRho30
ligB,7642576,7642576,7642340,236,246,utRho30
lipA,1320602,1320602,1320432,170,556,utRho30
lipB,1324802,1324802,1324556,246,14386,utRho30
lit,2397032,2397390,2397032,358,892,utRho30
livJ,7199524,7199524,7199316,208,4706,utRho30
livK,7195510,7195510,7195120,390,2894,utRho30
lldP,7554578,7554798,7554578,220,396,utRho30
lnt,1381968,1381968,1381762,206,1542,utRho30
loiP,6163784,6163826,6163784,42,92,utRho30
lolA,1874656,1874738,1874656,82,24,utRho30
lolB,2527112,2527112,2527000,112,198,utRho30
lolC,2350748,2350854,2350748,106,0,utRho30
lon,917630,917776,917630,146,2328,utRho30
lpcA,486936,487086,486936,150,10,utRho30
lpd,255434,255824,255434,390,514,utRho30
lplA,9248476,9248476,9248234,242,1126,utRho30
lplT,5947878,5947878,5947724,154,0,utRho30
lpoA,6586422,6586800,6586422,378,512,utRho30
lpp,3514592,3514842,3514592,250,110,utRho30
lptA,6686598,6686760,6686598,162,228,utRho30
lptB,6686792,6687888,6686792,1096,1366,utRho30
lptD,114672,114672,114218,454,290,utRho30
lptF,8972244,8972436,8972244,192,20,utRho30
lpxC,213016,213114,213016,98,1146,utRho30
lpxD,401920,401942,401920,22,38,utRho30
lpxL,2233418,2233418,2233164,254,240,utRho30
lpxM,3880456,3880456,3880386,70,54,utRho30
lpxP,4991156,4991290,4991156,134,600,utRho30
lrhA,4813312,4813312,4813282,30,152,utRho30
lrp,1864656,1865190,1864656,534,708,utRho30
lspA,50028,50414,50028,386,404,utRho30
lsrA,3202920,3202980,3202920,60,68,utRho30
lsrR,3202514,3202514,3202482,32,66,utRho30
ltaE,1818640,1818640,1818588,52,84,utRho30
luxS,5630130,5630130,5629466,664,890,utRho30
lysA,5957902,5957902,5957798,104,48,utRho30
lysC,8467232,8467232,8466466,766,528,utRho30
lysP,4497120,4497120,4497064,56,110,utRho30
lysR,5957900,5958042,5957900,142,56,utRho30
lysT,1561028,1561108,1561028,80,14,utRho30
lysU,8709610,8709610,8709434,176,140,utRho30
macB,1840188,1840694,1840188,506,762,utRho30
maeA,3111484,3111484,3111338,146,130,utRho30
mak,820236,820288,820236,52,80,utRho30
malE,8492928,8492928,8492838,90,14,utRho30
malI,3398456,3398456,3398360,96,50,utRho30
malK,8493472,8493568,8493472,96,190,utRho30
malP,7105020,7105020,7104946,74,772,utRho30
malQ,7100798,7100798,7100140,658,612,utRho30
malS,14949880,14949988,14949880,108,112,utRho30
malT,7106048,7106170,7106048,122,214,utRho30
malX,3398626,3398710,3398626,84,102,utRho30
malZ,1689980,1690072,1689980,92,256,utRho30
manA,3377102,3377152,3377102,50,94,utRho30
manX,3803866,3804096,3803866,230,70,utRho30
marC,3237882,3237882,3237816,66,572,utRho30
marR,3238186,3238240,3238186,54,142,utRho30
matP,2036918,2036970,2036918,52,26,utRho30
mazE,5822736,5822736,5822678,58,90,utRho30
mazG,5821720,5821720,5821370,350,1500,utRho30
mcbA,1684306,1684306,1684112,194,510,utRho30
mcbR,3040192,3040524,3040192,332,110,utRho30
mcrA,2420278,2420692,2420278,414,564,utRho30
mcrC,9156124,9156124,9155916,208,1084,utRho30
mdaB,6344814,6345060,6344814,246,138,utRho30
mdfA,1767138,1767346,1767138,208,496,utRho30
mdh,6768940,6768940,6768536,404,186,utRho30
mdoB,9198988,9198988,9198882,106,722,utRho30
mdoD,2993290,2993712,2993290,422,298,utRho30
mdoG,2218514,2218670,2218514,156,176,utRho30
mdtA,4307958,4308032,4307958,74,98,utRho30
mdtE,7318168,7318464,7318168,296,3958,utRho30
mdtK,3486538,3486914,3486538,376,868,utRho30
mdtP,8602472,8602472,8602060,412,1602,utRho30
melA,8683774,8683822,8683774,48,0,utRho30
melR,8683300,8683300,8683256,44,924,utRho30
menA,8240812,8240812,8240698,114,212,utRho30
menB,4753774,4753774,4753638,136,8,utRho30
mepH,3468714,3468870,3468714,156,8,utRho30
mepM,3883666,3883666,3883270,396,120,utRho30
mepS,4539840,4539958,4539840,118,56,utRho30
metA,8428318,8428560,8428318,242,78,utRho30
metB,8257272,8257344,8257272,72,716,utRho30
metC,6304150,6304472,6304150,322,920,utRho30
metE,8025768,8026106,8025768,338,604,utRho30
metF,8265092,8265232,8265092,140,242,utRho30
metG,4388538,4388600,4388538,62,176,utRho30
metH,8447010,8447656,8447010,646,2048,utRho30
metJ,8257116,8257116,8256790,326,500,utRho30
metK,6173154,6173412,6173154,258,246,utRho30
metN,445428,445428,445290,138,42,utRho30
metR,8025710,8025710,8025632,78,0,utRho30
metT,1394326,1394326,1394266,60,72,utRho30
metY,19910250,19910250,19909734,516,666,utRho30
metZ,11789528,11789548,11789528,20,100,utRho30
mfd,2348056,2348056,2347928,128,134,utRho30
mglA,4478782,4478782,4478578,204,56,utRho30
mglB,4481132,4481132,4480696,436,6318,utRho30
mglC,4475918,4475918,4475506,412,152,utRho30
mgrB,3817584,3817584,3817532,52,208,utRho30
mgrR,3245828,3245828,3245828,0,0,utRho30
mgsA,2054082,2054082,2054030,52,246,utRho30
mgtL,8934560,8934862,8934560,302,874,utRho30
mhpA,737038,737222,737038,184,376,utRho30
mhpR,737072,737072,736840,232,296,utRho30
mhpT,750772,750918,750772,146,12,utRho30
miaA,8797964,8798504,8797964,540,582,utRho30
micA,5629604,5629604,5629604,0,0,utRho30
micC,2874242,2874238,2874242,4,0,utRho30
micF,4626168,4626168,4626168,0,0,utRho30
micM,1014408,1014408,1014408,0,0,utRho30
minE,2449422,2449422,2449090,332,286,utRho30
mioC,7852950,7852950,7852910,40,0,utRho30
mipA,3733012,3733012,3732944,68,846,utRho30
mlaA,4930270,4930270,4930014,256,94,utRho30
mlc,3337206,3337206,3337128,78,98,utRho30
mlrA,4429498,4429732,4429498,234,216,utRho30
mltA,5894546,5894546,5894356,190,136,utRho30
mltD,468050,468050,467910,140,78,utRho30
mltF,5391534,5391602,5391534,68,98,utRho30
mmuP,550238,550650,550238,412,998,utRho30
mngA,1531622,1531968,1531622,346,290,utRho30
mngR,1531852,1531852,1531750,102,182,utRho30
mnmG,7851348,7851348,7851266,82,476,utRho30
mntH,5025470,5025470,5025412,58,0,utRho30
mntP,3810918,3811376,3810918,458,292,utRho30
mntR,1706160,1706366,1706160,206,50,utRho30
mntS,1706128,1706128,1705994,134,74,utRho30
moaA,1633654,1634088,1633654,434,312,utRho30
moaB,1635954,1636110,1635954,156,90,utRho30
mobA,8084242,8084242,8083998,244,222,utRho30
mocA,6030112,6030320,6030112,208,68,utRho30
modA,1589990,1590178,1589990,188,284,utRho30
moeA,1732788,1732788,1732728,60,0,utRho30
mokB,2984610,2984610,2984258,352,212,utRho30
molR_1,4392888,4392948,4392888,60,16,utRho30
motA,3954604,3954604,3954278,326,34,utRho30
mpaA,2781278,2781278,2781196,82,292,utRho30
mpl,8911456,8911570,8911456,114,86,utRho30
mppA,2786108,2786454,2786108,346,180,utRho30
mprA,5621494,5621540,5621494,46,186,utRho30
mqo,4613848,4613848,4613508,340,274,utRho30
mqsA,6336742,6336742,6336492,250,512,utRho30
mqsR,6337306,6337306,6337088,218,1286,utRho30
mraZ,179192,179268,179192,76,932,utRho30
mrcA,7045652,7045742,7045652,90,146,utRho30
mrcB,329442,329460,329442,18,0,utRho30
mreB,13605424,13605424,13604348,1076,1132,utRho30
mreD,6798166,6798166,6797750,416,296,utRho30
mrp,4388360,4388360,4388336,24,114,utRho30
mscK,972984,973072,972984,88,456,utRho30
mscL,6876002,6876048,6876002,46,1488,utRho30
mscS,6139742,6139742,6139614,128,66,utRho30
msrA,8884522,8884522,8884352,170,2978,utRho30
msrB,3725168,3725168,3724858,310,116,utRho30
msyB,2228426,2228426,2228362,64,334,utRho30
mtfA,4087236,4087302,4087236,66,54,utRho30
mtgA,6699662,6699662,6699618,44,1048,utRho30
mtlA,30177504,30178248,30177504,744,17784,utRho30
mtn,358366,358366,358306,60,540,utRho30
mtr,6611864,6611864,6611634,230,8,utRho30
mug,6430992,6430992,6430946,46,3848,utRho30
murQ,5091466,5091546,5091466,80,608,utRho30
murR,5091586,5091586,5091218,368,1628,utRho30
mutH,5939164,5939324,5939164,160,314,utRho30
mutL,8794092,8794824,8794092,732,844,utRho30
mutM,7622554,7622554,7622304,250,160,utRho30
mutS,5714038,5714186,5714038,148,1264,utRho30
mutY,18617466,18618078,18617466,612,0,utRho30
nac,4123956,4123956,4123866,90,24,utRho30
nadA,1564122,1564170,1564122,48,64,utRho30
nadB,5420714,5420840,5420714,126,80,utRho30
nadC,237326,237326,237290,36,2,utRho30
nadE,3644604,3644916,3644604,312,378,utRho30
nadK,5501526,5501662,5501526,136,318,utRho30
nagA,1406350,1406350,1405502,848,1058,utRho30
nagB,1407416,1407416,1407222,194,98,utRho30
nagC,1404016,1404016,1403188,828,20,utRho30
nagE,1407680,1407888,1407680,208,890,utRho30
nagK,2357080,2357186,2357080,106,62,utRho30
nanA,6747240,6747240,6747152,88,290,utRho30
nanC,9079856,9079856,9079002,854,1084,utRho30
nanR,6749406,6749406,6748978,428,2288,utRho30
nanS,9075406,9075406,9075188,218,152,utRho30
napF,4607390,4607390,4606994,396,152,utRho30
narG,2559614,2559728,2559614,114,702,utRho30
narK,2555642,2555914,2555642,272,362,utRho30
narP,4580844,4581000,4580844,156,320,utRho30
narQ,5171154,5171462,5171154,308,302,utRho30
narU,3088326,3088326,3088120,206,736,utRho30
narW,3077374,3077374,3074618,2756,1718,utRho30
narX,2555554,2555554,2555236,318,486,utRho30
narZ,3085380,3085380,3085180,200,10,utRho30
ndh,2331984,2332170,2331984,186,1992,utRho30
ndk,5289920,5289920,5289728,192,16,utRho30
nemR,6904084,6904092,6904084,8,644,utRho30
nepI,7683542,7683542,7683478,64,98,utRho30
nfo,4501612,4501680,4501612,68,100,utRho30
nfsB,1210906,1210906,1210848,58,0,utRho30
nfuA,7090916,7091248,7090916,332,1548,utRho30
nhaA,34634,34978,34634,344,1976,utRho30
nhaB,2469534,2469534,2469434,100,316,utRho30
nhoA,3067926,3068048,3067926,122,146,utRho30
nikA,7226878,7227334,7226878,456,870,utRho30
nikR,7237074,7237176,7237074,102,94,utRho30
nirB,6987974,6988022,6987974,48,204,utRho30
nlpA,7680034,7680034,7679986,48,212,utRho30
nlpC,3585654,3585654,3585462,192,376,utRho30
nlpD,5737658,5737658,5737506,152,52,utRho30
nlpI,6618080,6618080,6617848,232,132,utRho30
nmpC,1153740,1153740,1153650,90,14,utRho30
nohA,3273206,3273206,3272734,472,970,utRho30
norR,5664614,5664614,5664578,36,94,utRho30
norV,5664878,5664952,5664878,74,106,utRho30
nrdA,4689510,4689730,4689510,220,6760,utRho30
nrdD,8925676,8925676,8925320,356,536,utRho30
nrdH,5601312,5601446,5601312,134,640,utRho30
nrdR,865954,866004,865954,50,102,utRho30
nrfA,8575342,8575528,8575342,186,0,utRho30
nsrR,8812088,8812380,8812088,292,138,utRho30
nudB,3897348,3897348,3897264,84,4,utRho30
nudC,8393428,8393806,8393428,378,58,utRho30
nudE,7052658,7052658,7052298,360,1098,utRho30
nudG,3682876,3682980,3682876,104,2,utRho30
nudI,4729050,4729108,4729050,58,124,utRho30
nudJ,2388874,2388874,2388576,298,284,utRho30
nuoA,4810670,4810670,4810144,526,13628,utRho30
nuoN,4783434,4783434,4783010,424,904,utRho30
nupC,5026018,5026084,5026018,66,0,utRho30
nupG,6211302,6211428,6211302,126,8,utRho30
ogrK,4335096,4335096,4335040,56,0,utRho30
ogt,2800568,2800568,2800472,96,892,utRho30
ohsC,5401036,5401040,5401036,4,396,utRho30
ompA,2040382,2040382,2040106,276,4576,utRho30
ompC,4625774,4625774,4625498,276,492,utRho30
ompF,1974184,1974184,1973964,220,316,utRho30
ompL,8128958,8128958,8128590,368,992,utRho30
ompN,2874158,2874158,2873786,372,56,utRho30
ompR,7073510,7073510,7073168,342,244,utRho30
ompT,1171330,1171330,1171266,64,164,utRho30
ompW,2627982,2628040,2627982,58,218,utRho30
ompX,1700418,1700900,1700418,482,1824,utRho30
omrA,5952378,5952378,5952378,0,0,utRho30
omrB,5952770,5952770,5952770,0,0,utRho30
oppA,2602170,2602364,2602170,194,772,utRho30
orn,8783168,8783208,8783168,40,54,utRho30
osmB,2686952,2686952,2686656,296,1594,utRho30
osmC,3113192,3113250,3113192,58,212,utRho30
osmE,3644566,3644566,3644512,54,2,utRho30
osmF,4439046,4439046,4438962,84,196,utRho30
osmY,9222306,9222792,9222306,486,188,utRho30
otsA,3963302,3963302,3963224,78,88,utRho30
otsB,3964930,3964930,3964774,156,336,utRho30
oxc,4984288,4984288,4983900,388,1452,utRho30
oxyR,8316914,8316980,8316914,66,460,utRho30
oxyS,8316788,8316788,8316788,0,0,utRho30
paaA,2907730,2907854,2907730,124,78,utRho30
paaX,2927018,2927078,2927018,60,0,utRho30
paaZ,2907340,2907340,2907284,56,0,utRho30
pabA,6981702,6981702,6981658,44,218,utRho30
pabB,3789256,3789610,3789256,354,348,utRho30
pabC,2306186,2306600,2306186,414,78,utRho30
pagP,1313052,1313114,1313052,62,132,utRho30
panB,299260,299260,299202,58,2278,utRho30
panC,297840,297840,297590,250,26,utRho30
panD,293490,293490,293388,102,142,utRho30
panZ,7195656,7195968,7195656,312,484,utRho30
parC,6332060,6332060,6331946,114,244,utRho30
patA,6438916,6438988,6438916,72,84,utRho30
patD,3030830,3031156,3030830,326,52,utRho30
pbpC,5294986,5294986,5294650,336,60,utRho30
pbpG,4450132,4450132,4449740,392,6,utRho30
pck,7065358,7065636,7065358,278,3874,utRho30
pcnB,318782,318782,318252,530,338,utRho30
pdhR,244068,244184,244068,116,180,utRho30
pdxB,4875768,4875768,4875702,66,164,utRho30
pdxH,3436068,3436068,3436014,54,2,utRho30
pdxJ,5403626,5403626,5403458,168,280,utRho30
pdxK,5074638,5074638,5074474,164,80,utRho30
pepA,8972278,8972278,8971902,376,36,utRho30
pepD,511618,511618,511432,186,444,utRho30
pepN,1981182,1981244,1981182,62,2118,utRho30
pepQ,8062294,8062322,8062294,28,46,utRho30
pepT,2371646,2371688,2371646,42,18,utRho30
pfkA,8214948,8215104,8214948,156,208,utRho30
pfkB,3612646,3612740,3612646,94,174,utRho30
pflA,1902456,1902456,1902160,296,0,utRho30
pflB,1907850,1907850,1907108,742,426,utRho30
pflD,8287716,8287990,8287716,274,280,utRho30
pgaA,2185046,2185046,2184578,468,1598,utRho30
pgi,8467444,8467516,8467444,72,226,utRho30
pgk,12291428,12291428,12290488,940,1780,utRho30
pgl,1597078,1597172,1597078,94,182,utRho30
pgpB,2678324,2678660,2678324,336,272,utRho30
pgpC,5397276,5397276,5397100,176,34,utRho30
pgrR,2783744,2783982,2783744,238,760,utRho30
pheL,5475158,5475198,5475158,40,12,utRho30
pheM,7197204,7197204,7197080,124,0,utRho30
pheP,1203858,1203918,1203858,60,94,utRho30
pheU,8725254,8725254,8725252,2,0,utRho30
pheV,6220730,6220732,6220730,2,22,utRho30
phnC,8650412,8650412,8650330,82,322,utRho30
phoA,803414,803494,803414,80,26,utRho30
phoB,834202,834284,834202,82,488,utRho30
phoE,520316,520316,520200,116,8,utRho30
phoH,2169730,2169984,2169730,254,142,utRho30
phoP,2381016,2381016,2380894,122,722,utRho30
phoQ,2379880,2379880,2379552,328,544,utRho30
phoU,7815330,7815330,7815156,174,270,utRho30
phr,1478842,1479014,1478842,172,0,utRho30
pinE,2419054,2419370,2419054,316,346,utRho30
pinQ,3267168,3267244,3267168,76,124,utRho30
pinR,2867424,2867424,2867348,76,38,utRho30
pitA,7275224,7275284,7275224,60,54,utRho30
pitB,6272806,6272806,6272742,64,182,utRho30
pka,5439862,5439906,5439862,44,146,utRho30
plaP,4174476,4174476,4174124,352,274,utRho30
pldA,8009628,8009724,8009628,96,1042,utRho30
pldB,8018028,8018340,8018028,312,680,utRho30
plsB,8513196,8513196,8512932,264,436,utRho30
pmbA,8915890,8915918,8915890,28,80,utRho30
pmrD,4747148,4747148,4747076,72,0,utRho30
pncB,1980828,1980828,1980712,116,222,utRho30
pncC,5648788,5648788,5648692,96,64,utRho30
pnp,6622652,6622652,6622336,316,738,utRho30
pntA,3355950,3355950,3355806,144,258,utRho30
pntB,3353096,3353096,3352720,376,732,utRho30
polA,8093880,8093932,8093880,52,484,utRho30
polB,131606,131606,131560,46,0,utRho30
potD,2365700,2365700,2365658,42,64,utRho30
potE,1436688,1436688,1436530,158,364,utRho30
potF,1787268,1787568,1787268,300,678,utRho30
poxB,1822152,1822152,1822098,54,36,utRho30
ppa,8899372,8899372,8899304,68,138,utRho30
ppc,8306380,8306380,8306196,184,4034,utRho30
ppdA,5928440,5928440,5928354,86,66,utRho30
ppdD,235410,235410,235098,312,302,utRho30
pphA,3846770,3846770,3845938,832,752,utRho30
pphB,5719474,5719520,5719474,46,164,utRho30
ppiA,6984898,6984898,6984594,304,228,utRho30
ppiC,7919682,7919682,7919626,56,14,utRho30
ppiD,923638,923830,923638,192,116,utRho30
ppk,5245748,5246088,5245748,340,664,utRho30
pppA,6228958,6228958,6228704,254,112,utRho30
ppsA,3574322,3574322,3574224,98,46,utRho30
ppsR,3574678,3574890,3574678,212,40,utRho30
pptA,3065716,3066104,3065716,388,744,utRho30
pqiA,2023318,2024002,2023318,684,148,utRho30
prc,3830054,3830054,3829632,422,1358,utRho30
preT,4467978,4468066,4467978,88,248,utRho30
prfC,9218688,9218828,9218688,140,190,utRho30
prkB,6968622,6968980,6968622,358,566,utRho30
prlC,7290476,7290476,7290364,112,1188,utRho30
prlF,6553944,6554004,6553944,60,1070,utRho30
proB,520432,520776,520432,344,36,utRho30
proC,811372,811372,811288,84,162,utRho30
proK,7417388,7417388,7417384,4,26,utRho30
proL,4572414,4572422,4572414,8,38,utRho30
proP,8660640,8661004,8660640,364,660,utRho30
proS,437674,437674,437550,124,20,utRho30
proV,5609126,5609630,5609126,504,1538,utRho30
prpB,697292,697364,697292,72,192,utRho30
prpR,696942,696942,696886,56,112,utRho30
prs,2524354,2524354,2523750,604,2164,utRho30
psd,8781276,8781276,8780720,556,1034,utRho30
psiE,8480600,8480650,8480600,50,42,utRho30
pspA,2736076,2736158,2736076,82,0,utRho30
pspF,2736080,2736080,2735824,256,44,utRho30
pspG,8525632,8525680,8525632,48,10,utRho30
pssA,5445156,5445454,5445156,298,974,utRho30
pstB,7817112,7817112,7816732,380,142,utRho30
pstC,7821084,7821084,7820796,288,44,utRho30
pstS,23469408,23469408,23469150,258,438,utRho30
psuG,4517114,4517114,4516734,380,3992,utRho30
psuT,4514992,4514992,4514670,322,144,utRho30
pth,2517084,2517084,2517026,58,182,utRho30
ptrA,5918022,5918022,5917768,254,248,utRho30
ptrB,3857730,3857730,3857678,52,232,utRho30
ptsG,2315252,2315738,2315252,486,292,utRho30
ptsH,5066996,5067528,5066996,532,566,utRho30
purA,8809328,8809374,8809328,46,920,utRho30
purC,5195562,5195562,5195236,326,134,utRho30
purD,8411972,8411972,8411862,110,0,utRho30
purE,1106284,1106284,1106200,84,24,utRho30
purH,8415254,8415254,8415064,190,274,utRho30
purL,5391178,5391178,5391086,92,1880,utRho30
purM,5242306,5242394,5242306,88,248,utRho30
purR,3475378,3475688,3475378,310,58,utRho30
purT,3861438,3861762,3861438,324,388,utRho30
purU,2577512,2577512,2577248,264,0,utRho30
putA,2157850,2157850,2157764,86,64,utRho30
putP,2158336,2158610,2158336,274,304,utRho30
puuA,2721936,2721936,2721816,120,164,utRho30
puuC,2725456,2725486,2725456,30,30,utRho30
puuD,2722104,2722240,2722104,136,112,utRho30
puuP,2718746,2718746,2718374,372,134,utRho30
pykA,3874988,3875298,3874988,310,96,utRho30
pykF,3510934,3511396,3510934,462,212,utRho30
pyrC,2245286,2245286,2245214,72,0,utRho30
pyrD,2009464,2009536,2009464,72,872,utRho30
pyrE,7631970,7631970,7631536,434,218,utRho30
pyrF,2683740,2683842,2683740,102,1606,utRho30
pyrG,5819594,5819594,5819332,262,984,utRho30
pyrH,383624,383710,383624,86,348,utRho30
pyrL,8945490,8945490,8945066,424,800,utRho30
qmcA,1031646,1031646,1031546,100,1162,utRho30
qor,8528608,8528608,8528462,146,320,utRho30
qseB,6339502,6339656,6339502,154,224,utRho30
queA,849970,850022,849970,52,168,utRho30
queE,5811212,5811212,5810836,376,328,utRho30
queF,5850642,5850696,5850642,54,260,utRho30
queG,8788184,8788184,8788134,50,2140,utRho30
racC,2835630,2835630,2835526,104,0,utRho30
racR,2840898,2840898,2840482,416,872,utRho30
raiA,5474208,5474308,5474208,100,116,utRho30
rarD,8008594,8008594,8008356,238,546,utRho30
ravA,7862256,7862256,7862186,70,934,utRho30
rayT,495088,495274,495088,186,126,utRho30
rbn,4763162,4763216,4763162,54,0,utRho30
rbsD,7866644,7866702,7866644,58,12,utRho30
rcnA,4371654,4371834,4371654,180,374,utRho30
rcnB,4373768,4373920,4373768,152,180,utRho30
rcnR,4371806,4371806,4371592,214,642,utRho30
rcsA,4047672,4047936,4047672,264,1142,utRho30
rcsB,4631390,4632354,4631390,964,502,utRho30
rcsC,4640162,4640162,4639656,506,192,utRho30
rcsD,4626904,4626976,4626904,72,280,utRho30
rdgB,6193240,6193362,6193240,122,336,utRho30
rdlA,2538646,2538646,2538646,0,0,utRho30
rdlB,2539712,2539716,2539712,4,0,utRho30
rdlC,2540782,2540786,2540782,4,0,utRho30
rdlD,7400272,7400272,7400272,0,0,utRho30
rdoA,8084782,8084830,8084782,48,160,utRho30
recA,11295276,11295276,11295076,200,696,utRho30
recC,5925014,5925014,5924856,158,16,utRho30
recF,7763722,7763722,7762442,1280,1106,utRho30
recN,5503518,5503590,5503518,72,0,utRho30
recQ,8011666,8011728,8011666,62,208,utRho30
relA,5828554,5828554,5827302,1252,904,utRho30
relB,3291806,3291806,3291744,62,0,utRho30
rem,3289950,3289950,3289804,146,78,utRho30
rep,7921294,7921354,7921294,60,114,utRho30
rfaD,7587730,7587974,7587730,244,1970,utRho30
rfaE,6393852,6393852,6393506,346,276,utRho30
rfaH,8049930,8049930,8049642,288,2124,utRho30
rfbX,4219436,4219436,4219168,268,898,utRho30
rfe,7935600,7935832,7935600,232,1434,utRho30
rhaB,8194944,8194944,8194896,48,56,utRho30
rhaD,8188770,8188770,8188544,226,18,utRho30
rhaS,8195422,8195472,8195422,50,34,utRho30
rhaT,8201132,8201132,8201050,82,296,utRho30
rhlE,1661566,1661744,1661566,178,22,utRho30
rhoL,47593944,47594772,47593944,828,5916,utRho30
rhsB,7238006,7238384,7238006,378,436,utRho30
rhsC,1458758,1459166,1458758,408,52,utRho30
rhsD,1046132,1046522,1046132,390,334,utRho30
rhtA,1700608,1700608,1700194,414,2028,utRho30
rhtC,8015478,8015514,8015478,36,310,utRho30
ribA,2678468,2678468,2678320,148,144,utRho30
ribC,3486916,3486916,3486484,432,1362,utRho30
ribE,869008,869294,869008,286,8908,utRho30
ribF,42766,42814,42766,48,134,utRho30
ridA,8941892,8941892,8941826,66,28,utRho30
rihA,1369204,1369204,1368824,380,988,utRho30
rihB,4510504,4510504,4510372,132,336,utRho30
rimJ,2251044,2251124,2251044,80,182,utRho30
rimK,1783752,1783934,1783752,182,88,utRho30
rimL,2997486,2997876,2997486,390,238,utRho30
rimO,1756140,1756140,1756070,70,90,utRho30
rimP,6636350,6636350,6636012,338,448,utRho30
rlmA,3814172,3814172,3814120,52,66,utRho30
rlmD,5830086,5830086,5830000,86,0,utRho30
rlmE,6655520,6655520,6655328,192,1092,utRho30
rlmF,1684384,1684664,1684384,280,1078,utRho30
rlmG,6471784,6471784,6471750,34,52,utRho30
rlmI,2060002,2060002,2059938,64,336,utRho30
rlmJ,7290700,7290770,7290700,70,98,utRho30
rlmL,2015344,2015688,2015344,344,654,utRho30
rlpA,1330444,1330444,1330380,64,32,utRho30
rluA,120900,120900,120692,208,908,utRho30
rluF,8460324,8460708,8460324,384,72,utRho30
rmf,2031006,2031430,2031006,424,584,utRho30
rna,1290068,1290068,1290006,62,0,utRho30
rnb,2698258,2698258,2697824,434,308,utRho30
rnc,10816892,10816892,10816252,640,88188,utRho30
rnd,3776122,3776122,3775982,140,0,utRho30
rne,2289746,2289746,2288734,1012,1018,utRho30
rnhA,472082,472082,472004,78,1256,utRho30
rnk,1288360,1288360,1287934,426,138,utRho30
rnlA,5531788,5531836,5531788,48,890,utRho30
rnlB,5533414,5533968,5533414,554,2144,utRho30
rnpB,19623552,19623552,19623552,0,0,utRho30
rob,9270706,9270706,9270620,86,364,utRho30
rodZ,5285868,5285868,5285688,180,146,utRho30
rpe,7030306,7030306,7030118,188,174,utRho30
rph,15266320,15266320,15266196,124,288,utRho30
rpiA,6118706,6118706,6118650,56,362,utRho30
rpiB,8626514,8626700,8626514,186,770,utRho30
rpiR,8626274,8626274,8625982,292,34,utRho30
rplJ,8359246,8359992,8359246,746,3938,utRho30
rplK,8356708,8356894,8356708,186,208,utRho30
rplM,6757344,6757344,6757302,42,1388,utRho30
rplN,6896444,6896444,6896298,146,688,utRho30
rplS,5489284,5489284,5489060,224,6092,utRho30
rplT,7199052,7199052,7198996,56,276,utRho30
rplU,6667036,6667036,6666902,134,280,utRho30
rplY,4564866,4565034,4564866,168,162,utRho30
rpmA,6666450,6666450,6666238,212,298,utRho30
rpmB,15247980,15247980,15246696,1284,23648,utRho30
rpmE,8253816,8254026,8253816,210,1372,utRho30
rpmF,2294676,2294734,2294676,58,5070,utRho30
rpmH,7768130,7768672,7768130,542,1268,utRho30
rpmI,3600854,3600854,3599998,856,5064,utRho30
rpoB,8362126,8362490,8362126,364,320,utRho30
rpoD,6424946,6426094,6424946,1148,71912,utRho30
rpoE,5420372,5420372,5420024,348,0,utRho30
rpoH,7202006,7202006,7201566,440,2526,utRho30
rpoN,6689324,6689434,6689324,110,166,utRho30
rpoS,5736236,5736236,5735102,1134,1910,utRho30
rpoZ,7644154,7644212,7644154,58,30,utRho30
rppH,5937986,5937986,5937954,32,496,utRho30
rprA,3540744,3540744,3540744,0,0,utRho30
rpsA,1923434,1923990,1923434,556,8922,utRho30
rpsF,8850050,8850236,8850050,186,5012,utRho30
rpsI,6756580,6756580,6756414,166,3598,utRho30
rpsJ,6906884,6906884,6906540,344,922,utRho30
rpsL,6949242,6949242,6949104,138,3638,utRho30
rpsM,6885130,6885130,6884942,188,556,utRho30
rpsO,13247144,13247144,13246736,408,100,utRho30
rpsP,5492508,5492508,5492370,138,28,utRho30
rpsT,42420,42420,42156,264,450,utRho30
rpsU,12842584,12843124,12842584,540,4280,utRho30
rraA,8238716,8238716,8238660,56,782,utRho30
rraB,8956768,8956946,8956768,178,100,utRho30
rrsA,8070478,8071062,8070478,584,1262,utRho30
rrsB,16665468,16666636,16665468,1168,3152,utRho30
rrsC,7883032,7883616,7883032,584,764,utRho30
rrsD,6858094,6858094,6857524,570,246,utRho30
rrsE,8415726,8416294,8415726,568,568,utRho30
rrsG,5462896,5462896,5462314,582,1086,utRho30
rrsH,446970,447542,446970,572,504,utRho30
rsd,8393908,8393908,8393616,292,218,utRho30
rseA,5419264,5419264,5418808,456,924,utRho30
rseP,392940,393092,392940,152,418,utRho30
rseX,4067298,4067298,4067298,0,0,utRho30
rsfS,1338144,1338144,1338072,72,256,utRho30
rsgA,8783132,8783132,8783018,114,72,utRho30
rsmA,105176,105176,104860,316,612,utRho30
rsmB,6869982,6870414,6869982,432,114,utRho30
rsmC,9215736,9215736,9215400,336,16,utRho30
rsmD,7208594,7208786,7208594,192,156,utRho30
rsmE,6182036,6182268,6182036,232,326,utRho30
rsmG,7847512,7847512,7847360,152,44,utRho30
rsmH,180020,180188,180020,168,92,utRho30
rsmI,6587106,6587106,6586670,436,830,utRho30
rssA,2578212,2578412,2578212,200,196,utRho30
rssB,2580440,2580484,2580440,44,410,utRho30
rstA,3364276,3364300,3364276,24,0,utRho30
rsuA,4561096,4561096,4560966,130,104,utRho30
rsxA,3411510,3411534,3411510,24,198,utRho30
rtcA,7114004,7114004,7113698,306,1356,utRho30
rtcB,7116214,7116214,7116158,56,114,utRho30
rtn,4541356,4541452,4541356,96,66,utRho30
rutA,2148052,2148052,2148022,30,58,utRho30
rutG,2140090,2140090,2139678,412,104,utRho30
rutR,2148226,2148484,2148226,258,456,utRho30
ruvA,7784096,7784096,7783904,192,172,utRho30
ruvB,7782176,7782176,7781424,752,616,utRho30
ruvC,3894878,3894878,3894752,126,0,utRho30
rybB,1776114,1776114,1776114,0,0,utRho30
rydB,3529860,3529860,3529322,538,222,utRho30
rydC,2983012,2983012,2983012,0,0,utRho30
ryfA,5307398,5307710,5307398,312,14,utRho30
ryfD,5468590,5468590,5468590,0,0,utRho30
ryhB,7162032,7162032,7162032,0,0,utRho30
ryjA,8556132,8556132,8556132,0,0,utRho30
ryjB,9055954,9055954,9055954,0,0,utRho30
sad,3229598,3229598,3229406,192,540,utRho30
safA,3168056,3168056,3167918,138,376,utRho30
sanA,4465368,4465756,4465368,388,0,utRho30
sapF,2705314,2705314,2705268,46,66,utRho30
sbcB,4165456,4165512,4165456,56,108,utRho30
sbcC,831694,831694,831506,188,64,utRho30
sbcD,833954,833954,833904,50,1038,utRho30
sbmA,793106,793278,793106,172,1564,utRho30
sbmC,4162650,4162650,4162524,126,110,utRho30
sdaA,3793618,3793864,3793618,246,1786,utRho30
sdaC,5856070,5856458,5856070,388,49186,utRho30
sdhC,1509916,1510354,1509916,438,4962,utRho30
sdhD,1510808,1511120,1510808,312,366,utRho30
sdiA,3993834,3993834,3993664,170,346,utRho30
secE,8354354,8354716,8354354,362,1226,utRho30
secG,6645180,6645180,6645010,170,528,utRho30
selA,7522594,7522594,7522498,96,406,utRho30
selB,7519850,7519850,7519722,128,266,utRho30
selC,7672396,7672444,7672396,48,102,utRho30
selD,3696058,3696058,3696016,42,756,utRho30
seqA,1425884,1425974,1425884,90,54,utRho30
serA,6117098,6117098,6116820,278,100,utRho30
serB,9249712,9249790,9249712,78,112,utRho30
serC,3830380,3830612,3830380,232,36,utRho30
serS,1878730,1878856,1878730,126,890,utRho30
serT,2063438,2063438,2063424,14,24,utRho30
serU,4087124,4087124,4087114,10,26,utRho30
serV,5637394,5637394,5637290,104,18,utRho30
serW,1852014,1852014,1851942,72,268,utRho30
serX,2195352,2195352,2195304,48,10,utRho30
setB,4527426,4527726,4527426,300,72,utRho30
setC,7673488,7673906,7673488,418,498,utRho30
sfmA,1116124,1116424,1116124,300,318,utRho30
sfmC,1117606,1117948,1117606,342,56,utRho30
sfsA,323030,323030,322972,58,56,utRho30
sfsB,6669592,6669818,6669592,226,94,utRho30
sgrR,154676,154676,154598,78,470,utRho30
sgrS,154734,154734,154734,0,0,utRho30
shiA,4107068,4107286,4107068,218,0,utRho30
sibA,4306622,4306622,4306622,0,0,utRho30
sibB,4307292,4307292,4307292,0,0,utRho30
sibC,6113702,6113702,6113702,0,0,utRho30
sibD,6389730,6389730,6389730,0,0,utRho30
sibE,6390480,6390480,6390480,0,0,utRho30
sixA,4913998,4913998,4913624,374,176,utRho30
slp,7307872,7307922,7307872,50,164,utRho30
slt,9261400,9261466,9261400,66,0,utRho30
slyA,3442028,3442028,3441648,380,12,utRho30
slyB,3439496,3439752,3439496,256,204,utRho30
slyD,6957398,6957398,6956994,404,544,utRho30
slyX,6954862,6955280,6954862,418,9782,utRho30
smf,6867372,6867372,6867120,252,716,utRho30
smpB,5509534,5509792,5509534,258,2284,utRho30
smrA,2811872,2811958,2811872,86,1358,utRho30
smrB,4896872,4897212,4896872,340,778,utRho30
smtA,1946808,1947074,1946808,266,58,utRho30
sodA,8201518,8201620,8201518,102,480,utRho30
sodB,3470646,3470756,3470646,110,34,utRho30
sodC,3449358,3449358,3449310,48,112,utRho30
sohB,2658568,2658664,2658568,96,148,utRho30
sokB,2984232,2984238,2984232,6,108,utRho30
solA,2241218,2241218,2241172,46,214,utRho30
soxR,8554894,8554938,8554894,44,0,utRho30
soxS,8554846,8554846,8554766,80,0,utRho30
speA,6172096,6172096,6171822,274,1268,utRho30
speB,6167892,6167892,6167594,298,344,utRho30
speC,6218350,6218350,6218310,40,0,utRho30
spf,8099798,8099798,8099798,0,0,utRho30
sppA,3697422,3697674,3697422,252,900,utRho30
spy,3651376,3651376,3651250,126,80,utRho30
sra,3112092,3112092,3111926,166,88,utRho30
sraB,2293178,2293178,2293178,0,0,utRho30
sraC,3846132,3846132,3846132,0,0,utRho30
srlA,5651582,5651664,5651582,82,590,utRho30
srlR,5657720,5658094,5657720,374,1906,utRho30
srmB,5425752,5425792,5425752,40,214,utRho30
sroA,151216,151216,151216,0,0,utRho30
sroG,6369436,6369436,6369436,0,0,utRho30
sroH,8380974,8380974,8380974,0,0,utRho30
ssb,8548022,8548250,8548022,228,136,utRho30
sseA,5304782,5304988,5304782,206,2044,utRho30
sspA,6755138,6755138,6754840,298,170,utRho30
ssrA,5511014,5511186,5511014,172,766,utRho30
ssrS,12223036,12223932,12223036,896,1984,utRho30
sstT,6479726,6479888,6479726,162,132,utRho30
ssuB,1988282,1988282,1988088,194,952,utRho30
ssuE,1995126,1995126,1995024,102,298,utRho30
sthA,8321604,8321604,8321580,24,348,utRho30
stpA,5597156,5597156,5596990,166,192,utRho30
sucA,3034344,3034824,3034344,480,288,utRho30
sufA,3528836,3528836,3528772,64,48,utRho30
sufE,3518962,3518962,3518580,382,336,utRho30
sugE,8753588,8753750,8753588,162,290,utRho30
sulA,2041894,2041894,2041838,56,30834,utRho30
syd,5850738,5850738,5850560,178,356,utRho30
symE,9159834,9159834,9159680,154,0,utRho30
symR,9159670,9159670,9159670,0,0,utRho30
tabA,8949566,8949724,8949566,158,0,utRho30
talA,5157140,5157332,5157140,192,122,utRho30
talB,16382,16476,16382,94,1918,utRho30
tam,3214442,3214692,3214442,250,1110,utRho30
tamA,8884540,8884764,8884540,224,3054,utRho30
tar,3945432,3945432,3945382,50,12,utRho30
tas,5943138,5943194,5943138,56,112,utRho30
tatA,16087636,16087780,16087636,144,1032,utRho30
tatE,1317742,1317894,1317742,152,58,utRho30
tauA,770410,770464,770410,54,38,utRho30
tdcA,6534186,6534186,6534130,56,230,utRho30
tdcG,6519652,6519652,6519298,354,506,utRho30
tdcR,6534380,6534760,6534380,380,294,utRho30
tdk,2586986,2587054,2586986,68,242,utRho30
tehA,3001072,3001146,3001072,74,80,utRho30
tesA,1039898,1039898,1039530,368,838,utRho30
tesB,950402,950402,950322,80,0,utRho30
tfaE,2418532,2418532,2418238,294,766,utRho30
tfaQ,3269912,3269912,3269770,142,226,utRho30
tff,379424,379256,379424,168,686,utRho30
tgt,852110,852274,852110,164,46,utRho30
thiD,4369346,4369346,4369032,314,256,utRho30
thiI,882936,883098,882936,162,106,utRho30
thiM,4370902,4370902,4370602,300,916,utRho30
thiQ,146170,146170,145854,316,6380,utRho30
thrL,592,760,592,168,1568,utRho30
thrS,7210932,7210932,7210280,652,2516,utRho30
thrU,8350762,8350776,8350762,14,692,utRho30
thrV,6847414,6847414,6847310,104,101318,utRho30
thrW,525682,525742,525682,60,68,utRho30
thyA,5930696,5930696,5930310,386,1028,utRho30
tig,909986,910266,909986,280,372,utRho30
tisB,7706674,7707106,7706674,432,2050,utRho30
tktA,6163414,6163414,6163270,144,342,utRho30
tktB,5158616,5159272,5158616,656,1082,utRho30
tldD,6784368,6784368,6784056,312,94,utRho30
tmcA,5191876,5191876,5191718,158,188,utRho30
tnaC,15553644,15553740,15553644,96,528,utRho30
tolB,1555074,1555480,1555074,406,564,utRho30
tolC,6356008,6356230,6356008,222,66,utRho30
tomB,961588,961588,961416,172,604,utRho30
tonB,2622108,2622178,2622108,70,90,utRho30
topA,2661578,2662096,2661578,518,894,utRho30
torC,2116112,2116168,2116112,56,606,utRho30
torR,2115968,2115968,2115908,60,546,utRho30
torS,2112364,2112364,2112356,8,30,utRho30
torT,2112414,2112522,2112414,108,60,utRho30
tpiA,8223138,8223138,8223014,124,18,utRho30
tppB,3425342,3425538,3425342,196,792,utRho30
tpr,2574376,2574376,2574376,0,0,utRho30
tpx,2777688,2777688,2777622,66,1430,utRho30
tqsA,3347780,3347826,3347780,46,2,utRho30
treA,2494850,2494850,2494752,98,152,utRho30
treB,8932420,8932420,8932360,60,210,utRho30
treF,7339102,7339184,7339102,82,92,utRho30
treR,8934694,8934694,8934492,202,372,utRho30
trg,2984878,2984940,2984878,62,56,utRho30
trkG,2847342,2847564,2847342,222,1614,utRho30
trmA,8326590,8326590,8326540,50,56,utRho30
trpA,2634678,2634678,2634444,234,328,utRho30
trpC,2639888,2639888,2639570,318,0,utRho30
trpL,5292432,5292432,5292328,104,36,utRho30
trpR,9265408,9265520,9265408,112,22,utRho30
trpS,7027394,7027394,7027276,118,348,utRho30
trpT,7893560,7893914,7893560,354,51318,utRho30
trxA,7931294,7931522,7931294,228,3678,utRho30
trxB,1864156,1864156,1864100,56,140,utRho30
trxC,5437350,5437470,5437350,120,592,utRho30
tsaD,6421256,6421256,6421086,170,4270,utRho30
tsgA,6985038,6985136,6985038,98,364,utRho30
tsr,9182824,9183314,9182824,490,1510,utRho30
tsx,864490,864490,864026,464,1226,utRho30
ttcA,2823970,2823970,2823896,74,1858,utRho30
ttdA,6412848,6412926,6412848,78,66,utRho30
ttdR,6412760,6412760,6412512,248,1362,utRho30
tufA,6943448,6943448,6942658,790,25080,utRho30
tus,3368346,3368518,3368346,172,20,utRho30
tusA,7218040,7218040,7217992,48,1240,utRho30
tusB,6950218,6950218,6949930,288,190,utRho30
tynA,2902996,2902996,2902698,298,68,utRho30
typA,8116460,8116814,8116460,354,600,utRho30
tyrB,8534164,8534228,8534164,64,246,utRho30
tyrP,3979004,3979362,3979004,358,32,utRho30
tyrR,2773384,2773440,2773384,56,68,utRho30
tyrS,3434566,3434566,3434444,122,0,utRho30
tyrT,2575330,2575330,2575244,86,6,utRho30
uacT,6062378,6062734,6062378,356,550,utRho30
ubiC,8504886,8505012,8504886,126,64,utRho30
ubiD,8049618,8049976,8049618,358,2150,utRho30
ubiE,8037494,8037710,8037494,216,258,utRho30
ubiG,4679078,4679134,4679078,56,0,utRho30
ucpA,5089342,5089342,5089246,96,484,utRho30
udp,8032782,8032862,8032782,80,464,utRho30
ugd,4199470,4199470,4199226,244,136,utRho30
ugpB,7184852,7184852,7184650,202,2684,utRho30
ugpQ,7176600,7176600,7176226,374,108,utRho30
uhpT,7694396,7694396,7694334,62,68,utRho30
uidA,3392304,3392304,3392142,162,10,utRho30
uidC,3386012,3386012,3385702,310,0,utRho30
uidR,3394150,3394150,3394104,46,0,utRho30
ulaA,8839854,8839960,8839854,106,522,utRho30
ulaG,8839350,8839350,8839250,100,350,utRho30
ulaR,8837124,8837124,8836906,218,0,utRho30
umpG,5741372,5741372,5740548,824,168,utRho30
umpH,1400704,1400704,1400652,52,60,utRho30
umuD,2461476,2461534,2461476,58,34,utRho30
ung,5433476,5433508,5433476,32,126,utRho30
uof,2843316,2843316,2842900,416,712,utRho30
upp,5241818,5241818,5241744,74,116,utRho30
usg,4873780,4873780,4873298,482,744,utRho30
ushA,1009772,1009828,1009772,56,776,utRho30
uspA,7279966,7280222,7279966,256,682,utRho30
uspB,7279696,7279696,7279440,256,728,utRho30
uspC,3959172,3959506,3959172,334,46,utRho30
uspE,2797318,2797318,2797244,74,2,utRho30
uspF,2871282,2871282,2871238,44,2,utRho30
uspG,1283806,1283806,1283734,72,472,utRho30
uvrA,8547872,8547872,8547742,130,236,utRho30
uvrB,1626304,1627052,1626304,748,430,utRho30
uvrC,3989758,3989758,3989412,346,16,utRho30
uvrD,7995814,7995966,7995814,152,16,utRho30
uvrY,3990812,3990812,3990718,94,70,utRho30
uxaB,3221474,3221474,3221360,114,594,utRho30
uxaC,6489714,6489714,6489482,232,70,utRho30
uxuA,9103036,9103272,9103036,236,1016,utRho30
uxuR,9108916,9109152,9108916,236,76,utRho30
valS,8967854,8967854,8967674,180,706,utRho30
valU,5041848,5041862,5041848,14,80,utRho30
valV,3492830,3492870,3492830,40,42,utRho30
ves,3649968,3649968,3649874,94,64,utRho30
waaA,7616512,7617080,7616512,568,2918,utRho30
waaH,7580298,7580298,7580162,136,66,utRho30
waaQ,7616476,7616476,7616196,280,2130,utRho30
waaU,7598996,7598996,7598624,372,256,utRho30
waaY,7602272,7602272,7601930,342,10024,utRho30
wbbH,4214888,4214888,4214452,436,2214,utRho30
wbbK,4209212,4209212,4209018,194,152,utRho30
wcaM,4231868,4231868,4231792,76,68,utRho30
wrbA,2135516,2135516,2135416,100,72,utRho30
wza,4275166,4275166,4274486,680,448,utRho30
wzxC,4240674,4240674,4240316,358,224,utRho30
wzzB,4196950,4196950,4196602,348,72,utRho30
xanP,7657642,7657890,7657642,248,278,utRho30
xanQ,6048520,6048702,6048520,182,0,utRho30
xapA,5049820,5049820,5049756,64,20,utRho30
xapR,10090252,10090252,10089908,344,0,utRho30
xdhA,6000514,6000690,6000514,176,540,utRho30
xerD,6079702,6079702,6079486,216,172,utRho30
xseA,5268394,5268464,5268394,70,202,utRho30
xseB,882746,882746,882686,60,62,utRho30
xthA,3664798,3664856,3664798,58,0,utRho30
xylA,7461614,7461614,7461530,84,4032,utRho30
xylE,8484540,8484540,8484508,32,0,utRho30
xylF,7462138,7462262,7462138,124,1508,utRho30
xylR,7469812,7469958,7469812,146,0,utRho30
yaaA,13230,13230,12918,312,148,utRho30
yaaI,23876,23876,23572,304,384,utRho30
yaaJ,16034,16034,15918,116,150,utRho30
yaaU,91184,91614,91184,430,1736,utRho30
yaaW,23084,23084,22712,372,370,utRho30
yaaX,10060,10468,10060,408,174,utRho30
yabI,142542,142702,142542,160,124,utRho30
yacC,273880,273880,273834,46,556,utRho30
yacH,262932,262932,262520,412,222,utRho30
yacL,268678,268776,268678,98,376,utRho30
yadD,293796,293936,293796,140,288,utRho30
yadE,289930,290162,289930,232,246,utRho30
yadN,314110,314110,313766,344,134,utRho30
yadS,355572,355572,355248,324,710,utRho30
yadV,312470,312470,312402,68,500,utRho30
yaeF,434270,434270,434006,264,236,utRho30
yaeP,428374,428374,428250,124,264,utRho30
yaeQ,428176,428582,428176,406,370,utRho30
yaeR,423716,423754,423716,38,24,utRho30
yafC,462166,462166,461762,404,738,utRho30
yafD,462128,462244,462128,116,860,utRho30
yafK,491986,491986,491610,376,376,utRho30
yafL,493282,493424,493282,142,160,utRho30
yafN,503938,504010,503938,72,152,utRho30
yafS,469568,469632,469568,64,494,utRho30
yafT,474470,474670,474470,200,228,utRho30
yafV,480432,480432,480378,54,0,utRho30
yafZ,536052,536052,536010,42,2,utRho30
yagE,564446,564556,564446,110,278,utRho30
yagG,570414,570790,570414,376,364,utRho30
yagI,578384,578384,578324,60,72,utRho30
yagK,586236,586236,585896,340,1940,utRho30
yagL,588062,588062,587836,226,338,utRho30
yagN,591342,591342,591158,184,186,utRho30
yahA,663746,664742,663746,996,6992,utRho30
yahC,670136,670136,670044,92,728,utRho30
yahE,671478,671850,671478,372,484,utRho30
yahM,690504,690808,690504,304,876,utRho30
yahN,692872,692872,692674,198,1678,utRho30
yahO,692864,692968,692864,104,944,utRho30
yaiE,816296,816354,816296,58,72,utRho30
yaiI,811396,811528,811396,132,74,utRho30
yaiO,761946,761946,761684,262,418,utRho30
yaiP,767970,767970,767870,100,78,utRho30
yaiS,769660,769660,769232,428,656,utRho30
yaiV,788922,788922,788922,0,0,utRho30
yaiY,799094,799094,798666,428,698,utRho30
yaiZ,798888,799186,798888,298,324,utRho30
yajC,854410,854574,854410,164,286,utRho30
yajD,860938,861210,860938,272,110,utRho30
yajI,866068,866068,865702,366,308,utRho30
yajL,887496,887496,887282,214,88,utRho30
yajQ,889316,889366,889316,50,22,utRho30
yajR,893374,893374,893332,42,244,utRho30
ybaB,987418,988152,987418,734,776,utRho30
ybaL,1006590,1006590,1006476,114,326,utRho30
ybaM,980648,980648,980542,106,392,utRho30
ybaN,981436,981764,981436,328,808,utRho30
ybaO,936704,936766,936704,62,0,utRho30
ybaP,1016568,1016568,1016160,408,686,utRho30
ybaQ,1016348,1016436,1016348,88,130,utRho30
ybaS,1023146,1023282,1023146,136,2474,utRho30
ybaV,927504,927874,927504,370,54,utRho30
ybaY,950490,950758,950490,268,56,utRho30
ybbB,1062724,1062724,1062452,272,232,utRho30
ybbJ,1030154,1030154,1029718,436,824,utRho30
ybbL,1031784,1031838,1031784,54,62,utRho30
ybbN,1037136,1037136,1036558,578,1228,utRho30
ybbO,1038658,1038658,1038298,360,560,utRho30
ybbY,1080718,1081130,1080718,412,400,utRho30
ybcH,1176140,1176140,1175962,178,68,utRho30
ybcI,1113264,1113264,1113106,158,556,utRho30
ybcJ,1114050,1114050,1113746,304,188,utRho30
ybcK,1137502,1137804,1137502,302,180,utRho30
ybcL,1141690,1141786,1141690,96,8,utRho30
ybcN,1144628,1144932,1144628,304,8,utRho30
ybcQ,1147548,1147912,1147548,364,240,utRho30
ybcW,1159610,1159760,1159610,150,6,utRho30
ybdD,1263982,1264364,1263982,382,796,utRho30
ybdF,1212106,1212106,1211772,334,210,utRho30
ybdH,1267048,1267048,1266954,94,190,utRho30
ybdJ,1212822,1212822,1212398,424,8,utRho30
ybdK,1215122,1215122,1214766,356,274,utRho30
ybdL,1267114,1267172,1267114,58,0,utRho30
ybdM,1271110,1271110,1270752,358,612,utRho30
ybdN,1273372,1273372,1273138,234,64,utRho30
ybdR,1283844,1284176,1283844,332,638,utRho30
ybeD,1325412,1325412,1325284,128,1528,utRho30
ybeF,1323090,1323090,1322756,334,3452,utRho30
ybeL,1349986,1350036,1349986,50,158,utRho30
ybeQ,1353412,1353412,1353094,318,82,utRho30
ybeR,1353120,1353422,1353120,302,82,utRho30
ybeT,1358832,1358832,1358812,20,168,utRho30
ybeU,1358924,1359016,1358924,92,378,utRho30
ybeZ,1386938,1386938,1386834,104,700,utRho30
ybfA,1458074,1458268,1458074,194,1584,utRho30
ybfE,1423878,1423878,1423796,82,160,utRho30
ybfF,1425692,1425692,1425604,88,192,utRho30
ybfH,1433282,1433282,1433194,88,194,utRho30
ybgA,1477840,1478002,1477840,162,4,utRho30
ybgC,1549288,1549504,1549288,216,242,utRho30
ybgD,1505916,1505916,1505590,326,16942,utRho30
ybgI,1485238,1485654,1485238,416,0,utRho30
ybgO,1498370,1498370,1497964,406,532,utRho30
ybgS,1570992,1570992,1570634,358,32,utRho30
ybhA,1597184,1597184,1596862,322,270,utRho30
ybhB,1616070,1616070,1615818,252,110,utRho30
ybhC,1614642,1614642,1614562,80,90,utRho30
ybhD,1601418,1601418,1601276,142,12,utRho30
ybhH,1601104,1601518,1601104,414,28,utRho30
ybhK,1633384,1633384,1633294,90,4,utRho30
ybhM,1641556,1641586,1641556,30,216,utRho30
ybhN,1645296,1645296,1644996,300,178,utRho30
ybhQ,1649202,1649260,1649202,58,28,utRho30
ybiA,1665920,1665920,1665900,20,0,utRho30
ybiI,1676968,1676968,1676912,56,478,utRho30
ybiO,1691328,1691328,1690960,368,850,utRho30
ybiP,1705252,1705252,1705194,58,124,utRho30
ybiS,1711572,1711572,1711488,84,62,utRho30
ybiT,1711894,1711926,1711894,32,0,utRho30
ybiU,1718212,1718212,1718122,90,22,utRho30
ybiV,1720176,1720176,1720056,120,0,utRho30
ybiW,1725566,1725566,1725212,354,3290,utRho30
ybiX,1678548,1678548,1678414,134,750,utRho30
ybjC,1781784,1781826,1781784,42,0,utRho30
ybjE,1830154,1830154,1829714,440,2364,utRho30
ybjG,1767016,1767016,1766776,240,988,utRho30
ybjL,1779882,1779882,1779638,244,86,utRho30
ybjM,1779770,1780178,1779770,408,726,utRho30
ybjO,1795704,1795978,1795704,274,156,utRho30
ybjP,1809046,1809046,1808934,112,0,utRho30
ybjQ,1809034,1809186,1809034,152,0,utRho30
ybjS,1813796,1813796,1813506,290,218,utRho30
ybjX,1838206,1838206,1838168,38,64,utRho30
ycaD,1891438,1891742,1891438,304,20,utRho30
ycaI,1928210,1928640,1928210,430,320,utRho30
ycaK,1899094,1899336,1899094,242,208,utRho30
ycaL,1920264,1920528,1920264,264,238,utRho30
ycaM,1894240,1894458,1894240,218,350,utRho30
ycaR,1941284,1941346,1941284,62,346,utRho30
ycbB,1961862,1962094,1961862,232,636,utRho30
ycbJ,1943344,1943504,1943344,160,4,utRho30
ycbK,1966046,1966150,1966046,104,10,utRho30
ycbZ,2036920,2036920,2036598,322,88,utRho30
yccA,2062886,2062886,2062836,50,818,utRho30
yccF,2048730,2048730,2048696,34,178,utRho30
yccS,2047988,2047988,2047766,222,2386,utRho30
yccT,2055674,2055674,2055546,128,692,utRho30
yccX,2059960,2060128,2059960,168,718,utRho30
ycdT,2185682,2185752,2185682,70,60,utRho30
ycdU,2191266,2191686,2191266,420,654,utRho30
ycdZ,2200504,2200592,2200504,88,42,utRho30
yceA,2233544,2233614,2233544,70,130,utRho30
yceD,2293298,2293588,2293298,290,1360,utRho30
yceF,2293522,2293522,2293190,332,890,utRho30
yceH,2252154,2252314,2252154,160,562,utRho30
yceI,2237282,2237282,2236952,330,372,utRho30
yceJ,2238142,2238142,2238092,50,848,utRho30
yceM,2253208,2253612,2253208,404,122,utRho30
yceO,2239264,2239264,2238894,370,792,utRho30
yceQ,2288760,2289004,2288760,244,866,utRho30
ycfD,2376540,2376540,2376480,60,158,utRho30
ycfJ,2334814,2335198,2334814,384,84,utRho30
ycfS,2340834,2340834,2340748,86,22,utRho30
ycfT,2350658,2350658,2350330,328,196,utRho30
ycfZ,2362760,2362760,2362534,226,774,utRho30
ycgB,2474570,2474570,2474482,88,16,utRho30
ycgG,2434614,2434656,2434614,42,604,utRho30
ycgJ,2452956,2453200,2452956,244,378,utRho30
ycgL,2455218,2455362,2455218,144,52,utRho30
ycgN,2457366,2457660,2457366,294,132,utRho30
ycgR,2489112,2489112,2489054,58,50,utRho30
ycgV,2512222,2512222,2511904,318,886,utRho30
ycgX,2426568,2426568,2426214,354,4368,utRho30
ycgY,2490166,2490320,2490166,154,714,utRho30
ycgZ,2431504,2431578,2431504,74,288,utRho30
ychE,2596904,2597196,2596904,292,132,utRho30
ychF,2515764,2515764,2515624,140,2,utRho30
ychH,2517476,2517582,2517476,106,1314,utRho30
ychJ,2578354,2578354,2578264,90,62,utRho30
ychN,2547310,2547310,2547198,112,38,utRho30
ychO,2547520,2547850,2547520,330,490,utRho30
ychQ,2533798,2533848,2533798,50,0,utRho30
yciA,2624828,2624828,2624492,336,60,utRho30
yciB,2626110,2626110,2625780,330,600,utRho30
yciC,2627396,2627396,2627326,70,42,utRho30
yciE,2630794,2630794,2630448,346,186,utRho30
yciG,5264368,5264368,5264140,228,0,utRho30
yciI,2621784,2621784,2621730,54,282,utRho30
yciN,2661606,2661606,2661336,270,228,utRho30
yciS,2680270,2680486,2680270,216,102,utRho30
yciT,2689088,2689088,2688692,396,400,utRho30
yciU,2614718,2614718,2614300,418,358,utRho30
yciV,2646376,2646440,2646376,64,14,utRho30
yciW,2700472,2700472,2700214,258,102,utRho30
yciZ,2689276,2689276,2689218,58,310,utRho30
ycjD,2703792,2703792,2703520,272,0,utRho30
ycjG,2777748,2777860,2777748,112,154,utRho30
ycjM,2740006,2740432,2740006,426,152,utRho30
ycjW,2767982,2767982,2767922,60,108,utRho30
ycjX,2768138,2768234,2768138,96,266,utRho30
ycjY,5568288,5568288,5567460,828,1816,utRho30
ydaE,2836438,2836438,2836016,422,274,utRho30
ydaN,2816048,2816100,2816048,52,204,utRho30
ydaS,2840340,2840730,2840340,390,1276,utRho30
ydbC,2948376,2948442,2948376,66,62,utRho30
ydbD,2950132,2950288,2950132,156,100,utRho30
ydbH,2885800,2886102,2885800,302,8078,utRho30
ydbJ,2881712,2882116,2881712,404,1472,utRho30
ydbK,2881692,2881692,2881568,124,388,utRho30
ydcA,2983294,2983354,2983294,60,298,utRho30
ydcF,2974404,2974470,2974404,66,0,utRho30
ydcI,2990268,2990268,2990142,126,0,utRho30
ydcJ,2990266,2990576,2990266,310,0,utRho30
ydcK,3001280,3001280,3000898,382,494,utRho30
ydcL,3004646,3004914,3004646,268,54,utRho30
ydcN,3012308,3012344,3012308,36,160,utRho30
ydcP,3013508,3013562,3013508,54,18,utRho30
ydcR,3019956,3020006,3019956,50,52,utRho30
ydcS,3022906,3023308,3022906,402,136,utRho30
ydcX,3034442,3034778,3034442,336,342,utRho30
ydcY,3035220,3035296,3035220,76,94,utRho30
ydcZ,3036750,3036750,3036662,88,812,utRho30
yddB,3155332,3155332,3155238,94,116,utRho30
yddE,3071738,3071738,3071716,22,10,utRho30
yddG,3094410,3094410,3094338,72,42,utRho30
yddJ,3089732,3089732,3089438,294,1434,utRho30
yddW,3137704,3137704,3137646,58,0,utRho30
ydeA,3233910,3234056,3233910,146,3886,utRho30
ydeE,3242528,3242664,3242528,136,928,utRho30
ydeI,3249118,3249118,3248994,124,58,utRho30
ydeJ,3249376,3249546,3249376,170,64,utRho30
ydeN,3165458,3165458,3165048,410,46,utRho30
ydeP,3173328,3173328,3172972,356,512,utRho30
ydeR,3176596,3176596,3176592,4,124,utRho30
ydfA,3296872,3297016,3296872,144,4,utRho30
ydfG,3254982,3255034,3254982,52,180,utRho30
ydfH,3256652,3256704,3256652,52,0,utRho30
ydfK,3265446,3266144,3265446,698,1662,utRho30
ydgA,3379588,3379704,3379588,116,2,utRho30
ydgC,3364124,3364124,3364060,64,82,utRho30
ydgD,3343906,3343920,3343906,14,14,utRho30
ydgH,3356754,3356854,3356754,100,122,utRho30
ydgJ,3408798,3408798,3408616,182,510,utRho30
ydgK,3410414,3410500,3410414,86,488,utRho30
ydhB,3479618,3479618,3479596,22,0,utRho30
ydhC,3479698,3479822,3479698,124,0,utRho30
ydhF,3451310,3451310,3451264,46,0,utRho30
ydhI,3441996,3442050,3441996,54,0,utRho30
ydhL,3451864,3451864,3451840,24,434,utRho30
ydhQ,3492404,3492404,3492254,150,0,utRho30
ydhS,3494136,3494262,3494136,126,338,utRho30
ydhT,3499138,3499138,3499118,20,126,utRho30
ydhY,3509284,3509284,3508954,330,408,utRho30
ydhZ,3510418,3510418,3510282,136,336,utRho30
ydiE,3579206,3579226,3579206,20,0,utRho30
ydiH,3530582,3530582,3530406,176,0,utRho30
ydiM,3541852,3542142,3541852,290,84,utRho30
ydiN,3544818,3545024,3544818,206,72,utRho30
ydiP,3558656,3558656,3558602,54,310,utRho30
ydiU,3582508,3582508,3582488,20,158,utRho30
ydiV,3584174,3584174,3584040,134,142,utRho30
ydiY,3612500,3612500,3612166,334,818,utRho30
ydjA,3697400,3697400,3697352,48,394,utRho30
ydjE,3708082,3708082,3707958,124,46,utRho30
ydjF,3709848,3709848,3709708,140,204,utRho30
ydjM,3620340,3620422,3620340,82,0,utRho30
ydjO,3626696,3626696,3626288,408,0,utRho30
ydjX,3666434,3666802,3666434,368,556,utRho30
yeaE,3731448,3731448,3731272,176,310,utRho30
yeaG,3733530,3733816,3733530,286,336,utRho30
yeaI,3740486,3740770,3740486,284,78,utRho30
yeaJ,3743874,3744082,3743874,208,532,utRho30
yeaL,3748646,3748704,3748646,58,440,utRho30
yeaM,3751296,3751296,3751152,144,0,utRho30
yeaN,3750926,3751346,3750926,420,40,utRho30
yeaO,3753554,3753818,3753554,264,64,utRho30
yeaP,3755314,3755430,3755314,116,286,utRho30
yeaQ,3758780,3758780,3758510,270,246,utRho30
yeaR,3759988,3759988,3759896,92,70,utRho30
yeaY,3781122,3781122,3781064,58,54,utRho30
yebB,3892220,3892502,3892220,282,482,utRho30
yebC,3896370,3896370,3896302,68,112,utRho30
yebE,3859464,3859464,3859414,50,312,utRho30
yebG,3861530,3861530,3861494,36,20,utRho30
yebK,3873180,3873304,3873180,124,22,utRho30
yebQ,3820314,3820552,3820314,238,110,utRho30
yebS,3832238,3832516,3832238,278,0,utRho30
yebV,3843430,3843560,3843430,130,0,utRho30
yebW,3843914,3844242,3843914,328,1524,utRho30
yecC,3995646,3995646,3995628,18,0,utRho30
yecD,3901272,3901664,3901272,392,100,utRho30
yecF,3991434,3991636,3991434,202,280,utRho30
yecH,3979304,3979304,3978980,324,92,utRho30
yecJ,3975604,3975604,3975516,88,0,utRho30
yecM,3919968,3919968,3919692,276,734,utRho30
yecR,3976400,3976444,3976400,44,206,utRho30
yecT,3923862,3923944,3923862,82,44,utRho30
yedD,4016522,4016522,4016180,342,314,utRho30
yedE,4016310,4016554,4016310,244,282,utRho30
yedI,4058922,4058922,4058732,190,554,utRho30
yedJ,4066446,4066446,4066158,288,362,utRho30
yedV,4076404,4076404,4076304,100,360,utRho30
yedX,4077680,4077912,4077680,232,146,utRho30
yedY,4078572,4078956,4078572,384,110,utRho30
yeeA,4161322,4161322,4161182,140,72,utRho30
yeeE,4171104,4171104,4171050,54,1106,utRho30
yeeJ,4089526,4089822,4089526,296,32,utRho30
yeeN,4113508,4113716,4113508,208,366,utRho30
yeeO,4119444,4119444,4119692,248,274,utRho30
yeeX,4158834,4158834,4158722,112,338,utRho30
yeeZ,4178422,4178422,4178256,166,192,utRho30
yefM,4179466,4179466,4179426,40,76,utRho30
yegD,4295288,4295348,4295288,60,276,utRho30
yegH,4275726,4275804,4275726,78,520,utRho30
yegI,4302154,4302154,4301970,184,192,utRho30
yegJ,4302032,4302370,4302032,338,334,utRho30
yegQ,4331182,4331336,4331182,154,128,utRho30
yegR,4336698,4336698,4336612,86,2296,utRho30
yegS,4337086,4337424,4337086,338,774,utRho30
yegT,4357562,4357642,4357562,80,138,utRho30
yegX,4367640,4367640,4367302,338,112,utRho30
yehA,4376944,4376944,4376828,116,292,utRho30
yehE,4385818,4385818,4385592,226,122,utRho30
yehK,4407568,4407944,4407568,376,172,utRho30
yehL,4408804,4409192,4408804,388,0,utRho30
yeiB,4486146,4486146,4485934,212,114,utRho30
yeiE,4499422,4499422,4499236,186,84,utRho30
yeiG,4487776,4487820,4487776,44,36,utRho30
yeiH,4499332,4499434,4499332,102,292,utRho30
yeiI,4503306,4503400,4503306,94,36,utRho30
yeiL,4510580,4510710,4510580,130,76,utRho30
yeiP,4530834,4530900,4530834,66,262,utRho30
yeiQ,4532328,4532490,4532328,162,114,utRho30
yeiR,4535484,4535658,4535484,174,202,utRho30
yeiW,4530840,4530840,4530590,250,342,utRho30
yejA,4544624,4544728,4544624,104,0,utRho30
yejG,4556892,4556892,4556474,418,3058,utRho30
yejH,4561244,4561264,4561244,20,242,utRho30
yejK,4568218,4568218,4567894,324,204,utRho30
yejO,4578352,4578352,4577800,552,296,utRho30
yfaD,4713380,4713808,4713380,428,472,utRho30
yfaE,4696676,4697028,4696676,352,498,utRho30
yfaL,4688568,4688568,4688338,230,308,utRho30
yfaP,4656398,4656398,4656286,112,134,utRho30
yfaU,4717892,4717892,4717690,202,0,utRho30
yfaY,4727310,4727310,4727266,44,1176,utRho30
yfaZ,4728744,4728744,4728550,194,692,utRho30
yfbK,4771810,4771810,4771444,366,1778,utRho30
yfbL,4771500,4771720,4771500,220,1616,utRho30
yfbN,4777174,4777174,4776852,322,2210,utRho30
yfbO,4776916,4777162,4776916,246,2112,utRho30
yfbP,4777990,4778232,4777990,242,1504,utRho30
yfbR,4817662,4817724,4817662,62,48,utRho30
yfcI,4847424,4847424,4847078,346,548,utRho30
yfcJ,4880482,4880482,4880240,242,20,utRho30
yfcL,4888502,4888502,4888338,164,58,utRho30
yfcV,4911642,4911642,4911292,350,558,utRho30
yfcZ,4921958,4921958,4921868,90,80,utRho30
yfdF,4925604,4926024,4925604,420,4200,utRho30
yfdG,4935474,4935710,4935474,236,210,utRho30
yfdP,4946844,4947040,4946844,196,120,utRho30
yfdX,4988866,4988866,4988804,62,284,utRho30
yfdY,4990672,4990672,4990584,88,1404,utRho30
yfeA,5035784,5035784,5035664,120,878,utRho30
yfeC,5036668,5036934,5036668,266,168,utRho30
yfeH,5053818,5053892,5053818,74,40,utRho30
yfeK,5074630,5074684,5074630,54,50,utRho30
yfeO,5018906,5019260,5018906,354,296,utRho30
yfeR,5054078,5054078,5053712,366,80,utRho30
yfeX,5101356,5101356,5101090,266,6,utRho30
yfeY,5102486,5102486,5102432,54,0,utRho30
yfeZ,5103842,5103842,5103452,390,1158,utRho30
yffO,5123804,5124222,5123804,418,910,utRho30
yffQ,5126778,5127154,5126778,376,956,utRho30
yffS,5128800,5128986,5128800,186,88,utRho30
yfgC,5232052,5232188,5232052,136,0,utRho30
yfgF,5258062,5258062,5257876,186,1376,utRho30
yfgG,5258170,5258580,5258170,410,2208,utRho30
yfgH,5259344,5259584,5259344,240,34,utRho30
yfgM,5278866,5278866,5278566,300,658,utRho30
yfhH,5397414,5397518,5397414,104,490,utRho30
yfhM,5304648,5304648,5304574,74,68,utRho30
yfhR,5328408,5328726,5328408,318,286,utRho30
yfiC,5425610,5425610,5425528,82,404,utRho30
yfiE,5430688,5430688,5430640,48,542,utRho30
yfiL,5482630,5482720,5482630,90,20,utRho30
yfiM,5448066,5448358,5448066,292,1436,utRho30
yfiR,5483354,5483750,5483354,396,462,utRho30
yfjH,5517326,5517326,5517200,126,138,utRho30
yfjI,5517710,5517970,5517710,260,292,utRho30
yfjJ,5521014,5521094,5521014,80,206,utRho30
yfjM,5531970,5531970,5531552,418,3954,utRho30
yfjP,5535080,5535420,5535080,340,5642,utRho30
yfjW,5546570,5546636,5546570,66,8,utRho30
yfjX,5551776,5551838,5551776,62,70,utRho30
ygaC,5601180,5601180,5599988,1192,19780,utRho30
ygaM,5600242,5600292,5600242,50,5926,utRho30
ygaU,5593628,5593628,5593572,56,172,utRho30
ygaZ,5619190,5619234,5619190,44,38,utRho30
ygbA,5713656,5713656,5713612,44,122,utRho30
ygbE,5746784,5746784,5746674,110,154,utRho30
ygbI,5722882,5722882,5722528,354,302,utRho30
ygbK,5724394,5724670,5724394,276,590,utRho30
ygbL,5727074,5727186,5727074,112,46,utRho30
ygbN,5729814,5730202,5729814,388,678,utRho30
ygcG,5811210,5811422,5811210,212,184,utRho30
ygcN,5785144,5785314,5785144,170,202,utRho30
ygcU,5799214,5799214,5798836,378,740,utRho30
ygcW,5800942,5800942,5800546,396,160,utRho30
ygdD,5883442,5883442,5883262,180,1602,utRho30
ygdG,5861746,5861930,5861746,184,346,utRho30
ygdI,5886526,5886526,5886290,236,0,utRho30
ygdQ,5940784,5940840,5940784,56,182,utRho30
ygdR,5942494,5942542,5942494,48,64,utRho30
ygeA,5961606,5961606,5961270,336,394,utRho30
ygeH,5983758,5984188,5983758,430,172,utRho30
ygeI,5987162,5987276,5987162,114,746,utRho30
ygeR,6000078,6000078,5999782,296,1196,utRho30
ygeV,6011694,6011694,6011572,122,0,utRho30
ygeW,6012234,6012524,6012234,290,2062,utRho30
ygfB,6110946,6110946,6110888,58,22,utRho30
ygfK,6031984,6032120,6031984,136,156,utRho30
ygfS,6058328,6058328,6058024,304,228,utRho30
ygfZ,6082564,6082626,6082564,62,44,utRho30
yggC,6149512,6149512,6149378,134,128,utRho30
yggE,6136370,6136370,6136160,210,522,utRho30
yggI,6179176,6179510,6179176,334,112,utRho30
yggL,6204508,6204508,6204266,242,266,utRho30
yggM,6199514,6199514,6199130,384,318,utRho30
yggN,6203596,6203596,6203246,350,128,utRho30
yggX,18623958,18624558,18623958,600,342,utRho30
yghA,6298966,6299324,6298966,358,144,utRho30
yghB,6307058,6307126,6307058,68,460,utRho30
yghD,6222614,6222614,6222252,362,320,utRho30
yghF,6225798,6225798,6225840,42,2,utRho30
yghJ,6238640,6238640,6238224,416,24,utRho30
yghQ,6265186,6265186,6264816,370,460,utRho30
yghT,6267830,6268262,6267830,432,1552,utRho30
yghU,6277400,6277454,6277400,54,422,utRho30
yghW,6293506,6293506,6293474,32,224,utRho30
yghZ,6295562,6295794,6295562,232,0,utRho30
ygiD,6365122,6365122,6364868,254,366,utRho30
ygiH,6409066,6409388,6409066,322,6110,utRho30
ygiL,6370622,6370828,6370622,206,0,utRho30
ygiM,6402084,6402414,6402084,330,712,utRho30
ygiN,6346156,6346284,6346156,128,414,utRho30
ygiQ,6322620,6322620,6322292,328,130,utRho30
ygiS,6335462,6335462,6335436,26,0,utRho30
ygiV,6338582,6338582,6338462,120,74,utRho30
ygiW,6339774,6339774,6339352,422,1002,utRho30
ygiZ,6344506,6344506,6344422,84,46,utRho30
ygjH,6442528,6442528,6442494,34,24,utRho30
ygjI,6452140,6452468,6452140,328,52,utRho30
ygjQ,6472730,6473080,6472730,350,1304,utRho30
ygjR,6474564,6474586,6474564,22,50,utRho30
ygjV,6483638,6483638,6483488,150,2,utRho30
yhaB,6535632,6535708,6535632,76,540,utRho30
yhaH,6504498,6504608,6504498,110,1322,utRho30
yhaI,6505400,6505822,6505400,422,366,utRho30
yhaJ,6508560,6508560,6508428,132,38,utRho30
yhaK,6508538,6508638,6508538,100,18,utRho30
yhbQ,6599878,6599932,6599878,54,492,utRho30
yhbT,6602736,6602736,6602552,184,1302,utRho30
yhbU,6602558,6602970,6602558,412,1830,utRho30
yhbX,6643302,6643302,6643226,76,396,utRho30
yhbY,6655518,6655580,6655518,62,370,utRho30
yhcA,6723956,6724224,6723956,268,178,utRho30
yhcB,6760364,6760382,6760364,18,140,utRho30
yhcC,6708470,6708470,6708100,370,752,utRho30
yhcF,6733440,6733852,6733440,412,504,utRho30
yhcH,6739124,6739124,6738956,168,890,utRho30
yhcM,6760312,6760312,6759994,318,362,utRho30
yhcN,6770812,6771076,6770812,264,502,utRho30
yhcO,6772606,6772606,6772258,348,6,utRho30
yhdH,6806560,6806968,6806560,408,1206,utRho30
yhdJ,6823234,6823306,6823234,72,0,utRho30
yhdN,6879092,6879092,6879018,74,970,utRho30
yhdT,6814702,6814750,6814702,48,112,utRho30
yhdU,6824994,6825242,6824994,248,474,utRho30
yhdV,6836392,6836780,6836392,388,696,utRho30
yhdW,6837944,6838298,6837944,354,92,utRho30
yheO,6953082,6953082,6952880,202,92,utRho30
yheV,6957970,6957970,6957584,386,110,utRho30
yhfA,6971902,6971902,6971636,266,1440,utRho30
yhfG,6983294,6983294,6983240,54,94,utRho30
yhfL,6998622,6998896,6998622,274,646,utRho30
yhfY,7023244,7023244,7022844,400,378,utRho30
yhgA,7086294,7086334,7086294,40,0,utRho30
yhgE,7065176,7065176,7064878,298,3192,utRho30
yhgF,7074352,7074770,7074352,418,4280,utRho30
yhhA,7173458,7173886,7173458,428,1198,utRho30
yhhI,7248346,7248756,7248346,410,240,utRho30
yhhJ,7253696,7253696,7253606,90,184,utRho30
yhhM,7211588,7211588,7211220,368,1696,utRho30
yhhN,7211150,7211502,7211150,352,1014,utRho30
yhhQ,7218238,7218434,7218238,196,558,utRho30
yhhT,7223682,7223730,7223682,48,184,utRho30
yhhX,7162032,7162032,7161610,422,168,utRho30
yhhY,7162222,7162276,7162222,54,162,utRho30
yhhZ,7163516,7163726,7163516,210,1198,utRho30
yhiD,7312220,7312220,7311804,416,9064,utRho30
yhiJ,7265190,7265190,7265180,10,124,utRho30
yhiM,7269270,7269682,7269270,412,4584,utRho30
yhiN,7275000,7275000,7274820,180,854,utRho30
yhjA,7338522,7338522,7338376,146,262,utRho30
yhjB,7344090,7344090,7343788,302,1298,utRho30
yhjC,7344272,7344684,7344272,412,250,utRho30
yhjD,7346660,7346724,7346660,64,118,utRho30
yhjE,7349274,7349572,7349274,298,1532,utRho30
yhjG,7356824,7356824,7356730,94,12,utRho30
yhjH,7358458,7358458,7358374,84,424,utRho30
yhjJ,7364032,7364032,7363880,152,184,utRho30
yhjK,7371296,7371296,7371158,138,568,utRho30
yhjR,7392750,7392750,7392370,380,282,utRho30
yhjV,7400796,7401126,7400796,330,580,utRho30
yhjX,7424194,7424194,7424014,180,58,utRho30
yhjY,7425966,7425966,7425868,98,84,utRho30
yiaB,7455654,7455654,7455496,158,378,utRho30
yiaD,7432712,7433094,7432712,382,242,utRho30
yiaF,7438194,7438194,7438088,106,970,utRho30
yiaG,7438862,7438956,7438862,94,1236,utRho30
yiaJ,7485236,7485236,7485064,172,378,utRho30
yiaK,7485348,7485466,7485348,118,260,utRho30
yiaT,7503924,7503924,7503736,188,4,utRho30
yiaU,7503792,7503984,7503792,192,4,utRho30
yiaY,7515856,7515856,7515654,202,998,utRho30
yibF,7523950,7523950,7523910,40,220,utRho30
yibG,7536128,7536354,7536128,226,2158,utRho30
yibL,7553194,7553330,7553194,136,470,utRho30
yibN,7570112,7570112,7570030,82,324,utRho30
yibT,7552848,7552848,7552760,88,1996,utRho30
yicC,7633290,7633352,7633290,62,256,utRho30
yicH,7660862,7660914,7660862,52,204,utRho30
yicJ,7673328,7673328,7671858,1470,17290,utRho30
yicN,7685018,7685018,7684804,214,876,utRho30
yicO,7687914,7687914,7687578,336,278,utRho30
yicR,15250308,15250308,15250236,72,0,utRho30
yidB,7755230,7755230,7754930,300,2284,utRho30
yidE,7732780,7732780,7732546,234,108,utRho30
yidF,7711580,7711580,7711222,358,176,utRho30
yidQ,7735088,7735456,7735088,368,1158,utRho30
yidR,7738824,7738824,7738618,206,4,utRho30
yieE,7787658,7787738,7787658,80,1096,utRho30
yieH,7793314,7793548,7793314,234,162,utRho30
yieK,7798928,7798928,7798786,142,66,utRho30
yifB,7900350,7900350,7899998,352,484,utRho30
yifL,7988984,7989044,7988984,60,160,utRho30
yigF,8005750,8005750,8005598,152,3458,utRho30
yigI,8009448,8009448,8009394,54,216,utRho30
yigM,8022100,8022152,8022100,52,1062,utRho30
yihA,8101970,8101970,8101458,512,76,utRho30
yihD,8084098,8084138,8084098,40,144,utRho30
yihF,8088110,8088398,8088110,288,762,utRho30
yihG,8093304,8093304,8093204,100,138,utRho30
yihI,8102616,8102694,8102616,78,8,utRho30
yihL,8120506,8120894,8120506,388,1830,utRho30
yihN,8124332,8124494,8124332,162,3094,utRho30
yihO,8131942,8131942,8131532,410,346,utRho30
yihQ,8138892,8138892,8138552,340,48,utRho30
yihV,8147064,8147478,8147064,414,530,utRho30
yihX,8151096,8151106,8151096,10,218,utRho30
yiiE,8158192,8158582,8158192,390,730,utRho30
yiiF,8159124,8159502,8159124,378,310,utRho30
yiiG,8173762,8174004,8173762,242,36,utRho30
yiiM,8205506,8205644,8205506,138,1144,utRho30
yiiQ,8224624,8224624,8224428,196,104,utRho30
yiiS,8225738,8225934,8225738,196,172,utRho30
yijE,8272178,8272216,8272178,38,62,utRho30
yijF,8275728,8275728,8275314,414,1144,utRho30
yijO,8296858,8296858,8296634,224,156,utRho30
yjaA,8426240,8426468,8426240,228,48508,utRho30
yjaB,8428312,8428312,8428246,66,40,utRho30
yjaG,8398746,8399008,8398746,262,424,utRho30
yjaH,8401022,8401132,8401022,110,32,utRho30
yjaZ,8379506,8379572,8379506,66,62,utRho30
yjbB,8455204,8455462,8455204,258,58,utRho30
yjbE,16943432,16943624,16943432,192,404,utRho30
yjbL,8520318,8520642,8520318,324,426,utRho30
yjbQ,8540428,8540476,8540428,48,6,utRho30
yjcB,8550328,8550328,8550082,246,660,utRho30
yjcC,8550836,8550942,8550836,106,206,utRho30
yjcD,8556628,8556958,8556628,330,526,utRho30
yjcE,8559658,8559960,8559658,302,492,utRho30
yjcF,8566212,8566212,8566150,62,82,utRho30
yjcO,8594660,8594660,8594250,410,212,utRho30
yjdA,8654128,8654270,8654128,142,0,utRho30
yjdC,8726660,8726660,8726616,44,278,utRho30
yjdK,8704780,8705168,8704780,388,1964,utRho30
yjdL,8713034,8713034,8712822,212,72,utRho30
yjdM,8653672,8653672,8653468,204,2828,utRho30
yjeF,8787354,8788132,8787354,778,5026,utRho30
yjeI,8745522,8745618,8745522,96,106,utRho30
yjeJ,8748806,8748806,8748468,338,2392,utRho30
yjeV,8785472,8785784,8785472,312,138,utRho30
yjfP,8833512,8833904,8833512,392,302,utRho30
yjfY,8849656,8849656,8849582,74,152,utRho30
yjfZ,8855052,8855052,8854844,208,440,utRho30
yjgA,8916162,8916162,8915730,432,148,utRho30
yjgL,8950802,8950874,8950802,72,140,utRho30
yjgM,8959342,8959342,8959074,268,12,utRho30
yjgN,8959132,8959460,8959132,328,76,utRho30
yjgR,8980170,8980170,8980126,44,364,utRho30
yjgZ,9002116,9002520,9002116,404,1932,utRho30
yjhB,9007764,9008116,9007764,352,1160,utRho30
yjhG,9048452,9048452,9048188,264,1930,utRho30
yjhU,9041080,9041080,9040648,432,3088,utRho30
yjiA,9178096,9178096,9177730,366,506,utRho30
yjiJ,9125364,9125364,9125350,14,0,utRho30
yjiK,9127270,9127270,9127422,152,378,utRho30
yjiL,9129604,9129604,9129378,226,88,utRho30
yjiS,9143410,9143502,9143410,92,346,utRho30
yjiY,9182734,9182734,9182558,176,506,utRho30
yjjA,9200674,9200674,9200378,296,622,utRho30
yjjB,18408708,18408708,18407800,908,1760,utRho30
yjjJ,9243314,9243538,9243314,224,18,utRho30
yjjK,9261132,9261132,9261044,88,404,utRho30
yjjL,9189764,9189764,9189444,320,170,utRho30
yjjM,9191894,9191894,9191702,192,1102,utRho30
yjjP,9206068,9206068,9205716,352,1180,utRho30
yjjQ,9206638,9206954,9206638,316,1374,utRho30
yjjX,9267798,9267798,9267490,308,456,utRho30
yjjY,9280716,9280804,9280716,88,426,utRho30
yjjZ,9211554,9211608,9211554,54,876,utRho30
yjtD,9281676,9281884,9281676,208,1212,utRho30
ykfB,532454,532454,532174,280,652,utRho30
ykfI,527636,527636,527338,298,852,utRho30
ykgB,637050,637050,636638,412,18,utRho30
ykgC,640430,640430,640002,428,142,utRho30
ykgD,640232,640454,640232,222,220,utRho30
ykgE,642962,643216,642962,254,3550,utRho30
ykgJ,608524,608524,608364,160,46,utRho30
ykgL,623878,624224,623878,346,460,utRho30
ykgM,625610,625610,625554,56,122,utRho30
ykgR,626570,626570,626484,86,164,utRho30
ylaC,958576,958576,958502,74,300,utRho30
yliE,1745938,1745958,1745938,20,0,utRho30
ymcE,2103660,2103694,2103660,34,2,utRho30
ymdA,2210450,2210828,2210450,378,228,utRho30
ymdB,2211428,2211640,2211428,212,0,utRho30
ymfD,2395322,2395322,2395064,258,890,utRho30
ymfI,2402880,2402994,2402880,114,0,utRho30
ymfJ,2404518,2404518,2404168,350,54,utRho30
ymfK,2406176,2406176,2405866,310,140,utRho30
ymfT,2405766,2406048,2405766,282,118,utRho30
ymgE,2489110,2489456,2489110,346,1232,utRho30
ymgF,2437628,2437966,2437628,338,582,utRho30
ymiA,2670112,2670320,2670112,208,200,utRho30
ymjA,2715620,2715620,2715336,284,506,utRho30
ynaI,2791946,2791946,2791844,102,324,utRho30
ynaK,2850438,2850754,2850438,316,294,utRho30
ynbA,2954924,2955242,2954924,318,480,utRho30
yncD,3046552,3046552,3046130,422,170,utRho30
yncE,3046454,3046614,3046454,160,156,utRho30
yncG,3052456,3052494,3052456,38,648,utRho30
yncL,3034492,3034492,3034388,104,284,utRho30
yneE,3218364,3218364,3218044,320,0,utRho30
yneF,3223748,3223748,3223708,40,1058,utRho30
yneJ,3229560,3229608,3229560,48,210,utRho30
yneK,3231100,3231526,3231100,426,392,utRho30
yneM,3245176,3245292,3245176,116,232,utRho30
ynfA,3311398,3311398,3311346,52,46,utRho30
ynfB,3311418,3311616,3311418,198,206,utRho30
ynfC,3315094,3315094,3314914,180,0,utRho30
ynfD,3314828,3315130,3314828,302,10,utRho30
ynfE,3316006,3316138,3316006,132,30,utRho30
ynfK,3334670,3334670,3334438,232,322,utRho30
ynfL,3339304,3339304,3339184,120,0,utRho30
ynfM,3339260,3339398,3339260,138,0,utRho30
ynfN,3276598,3276598,3276218,380,14,utRho30
ynfO,3273454,3273512,3273454,58,26,utRho30
ynhG,3517890,3517890,3517450,440,270,utRho30
yniA,3615158,3615592,3615158,434,296,utRho30
yniB,3618526,3618526,3618466,60,100,utRho30
yniC,3618652,3618760,3618652,108,142,utRho30
yniD,3610202,3610330,3610202,128,370,utRho30
ynjE,3678880,3678934,3678880,54,90,utRho30
ynjF,3683222,3683222,3682806,416,226,utRho30
ynjH,3684376,3684376,3684270,106,218,utRho30
ynjI,3690022,3690022,3689742,280,414,utRho30
yoaB,3786642,3786734,3786642,92,258,utRho30
yoaC,3787932,3788146,3787932,214,226,utRho30
yoaE,3803544,3803544,3803170,374,582,utRho30
yoaF,3755444,3755444,3755064,380,342,utRho30
yoaH,3789866,3789866,3789462,404,512,utRho30
yobB,3850418,3850880,3850418,462,132,utRho30
yobF,3815586,3815586,3815182,404,840,utRho30
yobH,3817800,3817850,3817800,50,192,utRho30
yodB,4084352,4084736,4084352,384,458,utRho30
yodC,4057008,4057008,4056740,268,302,utRho30
yohC,4451358,4451358,4451262,96,210,utRho30
yohD,4451526,4451602,4451526,76,232,utRho30
yohJ,4460986,4461248,4460986,262,800,utRho30
yohO,4431172,4431314,4431172,142,92,utRho30
yojI,4617282,4617282,4617230,52,98,utRho30
ypdI,4988988,4989396,4988988,408,460,utRho30
ypfG,5165786,5165786,5165554,232,176,utRho30
ypfM,5182140,5182140,5181732,408,678,utRho30
yphB,5349590,5349590,5349376,214,8,utRho30
ypjA,5565644,5565644,5565452,192,2420,utRho30
ypjB,5569636,5569636,5568858,778,568,utRho30
ypjD,5495860,5495774,5495860,86,122,utRho30
yqaE,5594170,5594170,5594056,114,494,utRho30
yqcA,5846100,5846100,5845968,132,48,utRho30
yqcE,5800944,5801184,5800944,240,0,utRho30
yqeC,6030468,6030468,6030114,354,104,utRho30
yqeF,5971618,5971618,5971184,434,2966,utRho30
yqeG,5971438,5971694,5971438,256,2732,utRho30
yqeH,5975016,5975072,5975016,56,2004,utRho30
yqeI,5976688,5977004,5976688,316,174,utRho30
yqeK,5981140,5981140,5980720,420,3614,utRho30
yqfA,6086728,6086728,6086296,432,186,utRho30
yqgA,6219042,6219106,6219042,64,106,utRho30
yqgB,6172500,6172500,6172102,398,688,utRho30
yqgE,6185768,6185874,6185768,106,26,utRho30
yqhA,6299150,6299150,6298942,208,4,utRho30
yqhC,6310768,6310768,6310436,332,210,utRho30
yqhD,6310604,6310710,6310604,106,148,utRho30
yqhH,6316842,6317254,6316842,412,860,utRho30
yqiC,6369662,6369680,6369662,18,266,utRho30
yqiJ,6384108,6384416,6384108,308,1844,utRho30
yqjA,6495096,6495546,6495096,450,368,utRho30
yqjF,6500932,6501124,6500932,192,526,utRho30
yqjG,6501948,6502048,6501948,100,12,utRho30
yqjH,6433078,6433078,6432982,96,6,utRho30
yqjI,6433506,6433558,6433506,52,0,utRho30
yraH,6574552,6574852,6574552,300,504,utRho30
yraP,6592144,6592818,6592144,674,300,utRho30
yraQ,6596414,6596414,6596276,138,48,utRho30
yraR,6598024,6598024,6597692,332,1400,utRho30
yrbG,13360844,13361100,13360844,256,512,utRho30
yrbL,6696842,6696904,6696842,62,1200,utRho30
yrbN,6616172,6616172,6615866,306,80,utRho30
yrdB,6860176,6860176,6860046,130,386,utRho30
yrfF,7052548,7052938,7052548,390,782,utRho30
yrhB,7169440,7169518,7169440,78,162,utRho30
ysaB,7451804,7451804,7451424,380,324,utRho30
ysgA,8032686,8032686,8032338,348,346,utRho30
ytfB,8857638,8857638,8857434,204,980,utRho30
ytfE,8864018,8864018,8863966,52,310,utRho30
ytfF,8866296,8866296,8866130,166,1342,utRho30
ytfH,8868164,8868226,8868164,62,260,utRho30
ytfI,8875234,8875414,8875234,180,82,utRho30
ytfJ,8878572,8878572,8878524,48,100,utRho30
ytfK,8879022,8879174,8879022,152,290,utRho30
ytfL,8882642,8882642,8882430,212,118,utRho30
ytfQ,8899634,8899924,8899634,290,516,utRho30
ytjB,9249598,9249598,9249578,20,6,utRho30
yzfA,8896588,8896588,8896490,98,154,utRho30
zapA,6111102,6111224,6111102,122,326,utRho30
zapB,8236772,8237030,8236772,258,462,utRho30
zapC,2011700,2011904,2011700,204,144,utRho30
zinT,4082692,4082750,4082692,58,4,utRho30
zipA,5062814,5062814,5062466,348,160,utRho30
zitB,1569716,1569716,1569646,70,92,utRho30
zntA,7212844,7212902,7212844,58,4,utRho30
zntR,6878336,6878336,6878260,76,114,utRho30
znuA,3885322,3885322,3885166,156,62,utRho30
znuC,3885268,3885324,3885268,56,60,utRho30
zraP,8403424,8403424,8403376,48,2,utRho30
zraS,8403810,8403852,8403810,42,82,utRho30
zupT,6364866,6365100,6364866,234,366,utRho30
zur,8520282,8520282,8520006,276,628,utRho30
zwf,3872752,3872752,3872628,124,70,utRho30
